0,1,2,3,4,5,6,7,8,9,10,11,12,13,14,15,16,17,18,19,20,21,22,23,24,25,26,27,28,29,30,31,32,33,34,35,36
2,1,1,0,30,7,3,0,10,4,30,2,0,0,2,1,30,4,6,0,10,8,30,10,0,0,10,6,30,6,0,0,6,0,-27,3,0
2,4,1,0,30,7,3,0,10,4,30,2,0,0,2,1,30,4,6,0,10,8,30,10,0,0,10,6,30,6,0,0,6,0,-27,3,0
2,0,5,0,30,1,4,0,5,3,30,2,2,0,4,0,30,0,5,0,5,0,30,1,4,0,5,0,30,0,2,0,2,0,-27,3,0
2,2,5,0,30,1,4,0,5,3,30,2,2,0,4,0,30,0,5,0,5,0,30,1,4,0,5,0,30,0,2,0,2,0,-27,3,0
2,4,7,0,30,2,2,0,4,2,30,2,0,0,2,0,30,1,3,0,4,0,30,1,3,0,4,2,30,1,1,0,2,0,-27,3,0
2,1,11,2,30,3,9,0,12,3,30,4,0,0,4,0,30,4,8,0,12,7,30,9,3,0,12,6,30,4,0,0,4,1,-15,3,1
2,1,13,3,30,7,0,0,7,0,30,4,0,0,4,2,30,6,1,0,7,6,30,5,2,0,7,3,30,4,0,0,4,1,-15,3,1
2,2,13,3,30,7,0,0,7,0,30,4,0,0,4,2,30,6,1,0,7,6,30,5,2,0,7,3,30,4,0,0,4,1,-15,3,1
2,3,13,3,30,7,0,0,7,0,30,4,0,0,4,2,30,6,1,0,7,6,30,5,2,0,7,3,30,4,0,0,4,1,-15,3,1
2,4,13,3,30,7,0,0,7,0,30,4,0,0,4,2,30,6,1,0,7,6,30,5,2,0,7,3,30,4,0,0,4,1,-15,3,1
2,1,19,0,30,5,8,0,13,2,30,7,1,0,8,4,30,8,5,0,13,0,30,5,8,0,13,0,30,7,2,0,9,1,-15,3,1
2,3,19,0,30,5,8,0,13,2,30,7,1,0,8,4,30,8,5,0,13,0,30,5,8,0,13,0,30,7,2,0,9,1,-15,3,1
2,4,19,0,30,5,8,0,13,2,30,7,1,0,8,4,30,8,5,0,13,0,30,5,8,0,13,0,30,7,2,0,9,1,-15,3,1
2,4,22,1,30,6,2,0,8,2,30,2,0,0,2,0,30,4,4,0,8,1,30,1,7,0,8,1,30,2,2,0,4,1,-15,3,1
2,4,23,1,30,2,11,0,13,1,30,6,0,0,6,7,30,12,1,0,13,2,30,5,8,0,13,0,30,6,0,0,6,1,-15,3,1
2,1,27,1,30,4,11,0,15,4,30,1,1,0,2,0,30,5,10,0,15,4,30,4,11,0,15,1,30,6,0,0,6,1,-15,3,1
2,2,27,1,30,4,11,0,15,4,30,1,1,0,2,0,30,5,10,0,15,4,30,4,11,0,15,1,30,6,0,0,6,1,-15,3,1
2,0,29,0,30,6,8,0,14,5,30,10,2,0,12,0,30,5,9,0,14,0,30,0,14,0,14,3,30,9,0,0,9,1,-15,3,1
2,4,29,0,30,6,8,0,14,5,30,10,2,0,12,0,30,5,9,0,14,0,30,0,14,0,14,3,30,9,0,0,9,1,-15,3,1
2,4,43,0,30,7,7,0,14,6,30,6,0,0,6,0,30,4,10,0,14,1,30,3,11,0,14,3,30,5,0,0,5,1,-15,3,1
2,1,5,0,30,2,3,0,5,3,30,0,4,0,4,0,30,0,5,0,5,2,30,2,3,0,5,0,30,2,0,0,2,0,-27,3,0
2,3,5,0,30,2,3,0,5,3,30,0,4,0,4,0,30,0,5,0,5,2,30,2,3,0,5,0,30,2,0,0,2,0,-27,3,0
2,4,5,0,30,2,3,0,5,3,30,0,4,0,4,0,30,0,5,0,5,2,30,2,3,0,5,0,30,2,0,0,2,0,-27,3,0
2,2,9,0,30,1,3,0,4,2,30,2,0,0,2,0,30,0,4,0,4,0,30,1,3,0,4,1,30,1,0,0,1,0,-27,3,0
2,3,9,0,30,1,3,0,4,2,30,2,0,0,2,0,30,0,4,0,4,0,30,1,3,0,4,1,30,1,0,0,1,0,-27,3,0
2,1,13,1,30,6,1,0,7,0,30,4,0,0,4,2,30,5,2,0,7,8,30,5,2,0,7,4,30,4,0,0,4,1,-15,3,1
2,3,19,0,30,4,9,0,13,2,30,7,1,0,8,0,30,6,7,0,13,3,30,4,9,0,13,1,30,9,0,0,9,1,-15,3,1
2,4,19,0,30,4,9,0,13,2,30,7,1,0,8,0,30,6,7,0,13,3,30,4,9,0,13,1,30,9,0,0,9,1,-15,3,1
2,4,23,2,30,6,7,0,13,2,30,6,0,0,6,3,30,12,1,0,13,0,30,6,7,0,13,2,30,5,1,0,6,1,-15,3,1
2,0,25,4,30,6,8,0,14,4,30,6,0,0,6,0,30,8,6,0,14,1,30,5,9,0,14,5,30,5,1,0,6,1,-15,3,1
2,2,25,4,30,6,8,0,14,4,30,6,0,0,6,0,30,8,6,0,14,1,30,5,9,0,14,5,30,5,1,0,6,1,-15,3,1
2,3,25,4,30,6,8,0,14,4,30,6,0,0,6,0,30,8,6,0,14,1,30,5,9,0,14,5,30,5,1,0,6,1,-15,3,1
2,4,25,4,30,6,8,0,14,4,30,6,0,0,6,0,30,8,6,0,14,1,30,5,9,0,14,5,30,5,1,0,6,1,-15,3,1
2,4,31,7,30,7,5,0,12,4,30,8,0,0,8,3,30,10,2,0,12,0,30,3,9,0,12,0,30,3,3,0,6,1,-15,3,1
2,4,39,0,30,0,11,0,11,5,30,6,0,0,6,0,30,8,3,0,11,1,30,3,8,0,11,6,30,5,0,0,5,1,-15,3,1
2,4,4,4,30,7,1,0,8,5,30,4,0,0,4,0,30,1,7,0,8,0,30,4,4,0,8,0,30,3,1,0,4,0,-27,3,0
2,3,7,0,30,1,3,0,4,2,30,2,0,0,2,0,30,2,2,0,4,0,30,1,3,0,4,1,30,1,1,0,2,0,-27,3,0
2,4,7,0,30,1,3,0,4,2,30,2,0,0,2,0,30,2,2,0,4,0,30,1,3,0,4,1,30,1,1,0,2,0,-27,3,0
2,4,8,2,30,7,0,0,7,4,30,2,0,0,2,4,30,2,5,0,7,0,30,5,2,0,7,3,30,3,0,0,3,0,-27,3,0
2,1,25,1,30,9,5,0,14,2,30,6,0,0,6,0,30,10,4,0,14,1,30,5,9,0,14,4,30,5,1,0,6,1,-15,3,1
2,2,26,0,30,5,4,0,9,5,30,2,2,0,4,1,30,0,9,0,9,0,30,2,7,0,9,4,30,2,1,0,3,1,-15,3,1
2,4,26,0,30,5,4,0,9,5,30,2,2,0,4,1,30,0,9,0,9,0,30,2,7,0,9,4,30,2,1,0,3,1,-15,3,1
2,0,27,1,30,3,12,0,15,4,30,1,1,0,2,0,30,8,7,0,15,0,30,3,12,0,15,2,30,6,0,0,6,1,-15,3,1
2,3,32,2,30,7,2,0,9,4,30,2,0,0,2,0,30,7,2,0,9,0,30,2,7,0,9,4,30,2,0,0,2,1,-15,3,1
2,4,32,2,30,7,2,0,9,4,30,2,0,0,2,0,30,7,2,0,9,0,30,2,7,0,9,4,30,2,0,0,2,1,-15,3,1
2,0,5,0,30,4,1,0,5,3,30,2,2,0,4,3,30,0,5,0,5,0,30,1,4,0,5,0,30,0,2,0,2,0,-27,3,0
2,2,5,0,30,4,1,0,5,3,30,2,2,0,4,3,30,0,5,0,5,0,30,1,4,0,5,0,30,0,2,0,2,0,-27,3,0
2,3,5,0,30,4,1,0,5,3,30,2,2,0,4,3,30,0,5,0,5,0,30,1,4,0,5,0,30,0,2,0,2,0,-27,3,0
2,2,7,0,30,2,2,0,4,2,30,2,0,0,2,0,30,1,3,0,4,0,30,1,3,0,4,1,30,2,0,0,2,0,-27,3,0
2,2,13,1,30,6,1,0,7,0,30,4,0,0,4,2,30,6,1,0,7,10,30,6,1,0,7,3,30,4,0,0,4,1,-15,3,1
2,4,13,1,30,6,1,0,7,0,30,4,0,0,4,2,30,6,1,0,7,10,30,6,1,0,7,3,30,4,0,0,4,1,-15,3,1
2,2,17,2,30,9,5,0,14,2,30,6,0,0,6,0,30,6,8,0,14,2,30,5,9,0,14,3,30,4,0,0,4,1,-15,3,1
2,4,23,3,30,6,7,0,13,3,30,6,0,0,6,6,30,13,0,0,13,0,30,5,8,0,13,2,30,5,1,0,6,1,-15,3,1
2,1,25,2,30,10,4,0,14,3,30,6,0,0,6,0,30,5,9,0,14,1,30,5,9,0,14,4,30,5,1,0,6,1,-15,3,1
2,0,26,0,30,5,4,0,9,4,30,4,0,0,4,2,30,1,8,0,9,0,30,2,7,0,9,5,30,1,2,0,3,1,-15,3,1
2,2,26,0,30,5,4,0,9,4,30,4,0,0,4,2,30,1,8,0,9,0,30,2,7,0,9,5,30,1,2,0,3,1,-15,3,1
2,1,27,1,30,4,11,0,15,0,30,1,1,0,2,0,30,6,9,0,15,2,30,5,10,0,15,1,30,6,0,0,6,1,-15,3,1
2,3,39,0,30,4,7,0,11,6,30,6,0,0,6,0,30,6,5,0,11,0,30,2,9,0,11,3,30,5,0,0,5,1,-15,3,1
2,1,4,3,30,8,0,0,8,5,30,4,0,0,4,3,30,1,7,0,8,0,30,5,3,0,8,2,30,3,1,0,4,0,-27,3,0
2,1,5,0,30,2,3,0,5,2,30,4,0,0,4,0,30,0,5,0,5,0,30,1,4,0,5,0,30,1,1,0,2,0,-27,3,0
2,2,6,0,30,7,2,0,9,4,30,2,0,0,2,0,30,2,7,0,9,0,30,4,5,0,9,0,30,4,1,0,5,0,-27,3,0
2,0,9,1,30,2,2,0,4,3,30,2,0,0,2,3,30,1,3,0,4,4,30,3,1,0,4,0,30,1,0,0,1,0,-27,3,0
2,1,9,1,30,2,2,0,4,3,30,2,0,0,2,3,30,1,3,0,4,4,30,3,1,0,4,0,30,1,0,0,1,0,-27,3,0
2,4,9,0,30,2,2,0,4,3,30,2,0,0,2,3,30,1,3,0,4,4,30,3,1,0,4,0,30,1,0,0,1,0,-27,3,0
2,1,13,3,30,7,0,0,7,0,30,4,0,0,4,5,30,5,2,0,7,4,30,6,1,0,7,6,30,4,0,0,4,1,-15,3,1
2,2,13,3,30,7,0,0,7,0,30,4,0,0,4,5,30,5,2,0,7,4,30,6,1,0,7,6,30,4,0,0,4,1,-15,3,1
2,3,13,3,30,7,0,0,7,0,30,4,0,0,4,5,30,5,2,0,7,4,30,6,1,0,7,6,30,4,0,0,4,1,-15,3,1
2,4,13,3,30,7,0,0,7,0,30,4,0,0,4,5,30,5,2,0,7,4,30,6,1,0,7,6,30,4,0,0,4,1,-15,3,1
2,2,17,3,30,8,6,0,14,2,30,6,0,0,6,0,30,8,6,0,14,1,30,3,11,0,14,4,30,4,0,0,4,1,-15,3,1
2,1,19,0,30,2,11,0,13,2,30,5,3,0,8,0,30,5,8,0,13,7,30,4,9,0,13,1,30,9,0,0,9,1,-15,3,1
2,2,19,0,30,2,11,0,13,2,30,5,3,0,8,0,30,5,8,0,13,7,30,4,9,0,13,1,30,9,0,0,9,1,-15,3,1
2,4,19,0,30,2,11,0,13,2,30,5,3,0,8,0,30,5,8,0,13,7,30,4,9,0,13,1,30,9,0,0,9,1,-15,3,1
2,1,25,1,30,4,10,0,14,5,30,6,0,0,6,0,30,6,8,0,14,1,30,4,10,0,14,5,30,6,0,0,6,1,-15,3,1
2,4,25,1,30,4,10,0,14,5,30,6,0,0,6,0,30,6,8,0,14,0,30,4,10,0,14,5,30,6,0,0,6,1,-15,3,1
2,3,29,0,30,10,4,0,14,5,30,10,2,0,12,0,30,5,9,0,14,0,30,1,13,0,14,1,30,9,0,0,9,1,-15,3,1
2,4,31,1,30,7,5,0,12,5,30,8,0,0,8,3,30,8,4,0,12,0,30,3,9,0,12,2,30,3,3,0,6,1,-15,3,1
2,0,35,0,30,7,6,0,13,4,30,1,1,0,2,1,30,6,7,0,13,1,30,6,7,0,13,8,30,8,0,0,8,1,-15,3,1
2,1,35,0,30,7,6,0,13,4,30,1,1,0,2,1,30,6,7,0,13,1,30,6,7,0,13,8,30,8,0,0,8,1,-15,3,1
2,2,35,0,30,7,6,0,13,4,30,1,1,0,2,1,30,6,7,0,13,1,30,6,7,0,13,8,30,8,0,0,8,1,-15,3,1
2,3,38,0,30,2,8,0,10,7,30,6,0,0,6,0,30,1,9,0,10,0,30,4,6,0,10,8,30,6,0,0,6,1,-15,3,1
2,3,39,0,30,3,8,0,11,6,30,6,0,0,6,0,30,6,5,0,11,0,30,3,8,0,11,6,30,5,0,0,5,1,-15,3,1
2,4,39,0,30,3,8,0,11,6,30,6,0,0,6,0,30,6,5,0,11,0,30,3,8,0,11,6,30,5,0,0,5,1,-15,3,1
2,3,6,0,30,9,0,0,9,4,30,2,0,0,2,0,30,2,7,0,9,0,30,3,6,0,9,2,30,5,0,0,5,0,-27,3,0
2,4,13,3,30,7,0,0,7,0,30,4,0,0,4,2,30,6,1,0,7,4,30,5,2,0,7,2,30,4,0,0,4,1,-15,3,1
2,3,19,0,30,6,7,0,13,1,30,8,0,0,8,0,30,9,4,0,13,0,30,5,8,0,13,2,30,7,2,0,9,1,-15,3,1
2,4,19,0,30,6,7,0,13,1,30,8,0,0,8,0,30,9,4,0,13,0,30,5,8,0,13,2,30,7,2,0,9,1,-15,3,1
2,3,29,0,30,4,10,0,14,5,30,12,0,0,12,0,30,7,7,0,14,0,30,0,14,0,14,0,30,7,2,0,9,1,-15,3,1
2,4,29,0,30,4,10,0,14,5,30,12,0,0,12,0,30,7,7,0,14,0,30,0,14,0,14,0,30,7,2,0,9,1,-15,3,1
2,0,31,4,30,8,4,0,12,4,30,8,0,0,8,4,30,12,0,0,12,0,30,3,9,0,12,1,30,3,3,0,6,1,-15,3,1
2,1,31,4,30,8,4,0,12,4,30,8,0,0,8,4,30,12,0,0,12,0,30,3,9,0,12,1,30,3,3,0,6,1,-15,3,1
2,3,31,4,30,8,4,0,12,4,30,8,0,0,8,4,30,12,0,0,12,0,30,3,9,0,12,1,30,3,3,0,6,1,-15,3,1
2,0,38,0,30,7,3,0,10,8,30,6,0,0,6,0,30,1,9,0,10,0,30,4,6,0,10,7,30,6,0,0,6,1,-15,3,1
2,3,39,0,30,6,5,0,11,6,30,6,0,0,6,3,30,7,4,0,11,0,30,2,9,0,11,0,30,5,0,0,5,1,-15,3,1
2,1,1,0,30,7,3,0,10,4,30,2,0,0,2,1,30,4,6,0,10,6,30,8,2,0,10,0,30,6,0,0,6,0,-27,3,0
2,2,1,0,30,7,3,0,10,4,30,2,0,0,2,1,30,4,6,0,10,6,30,8,2,0,10,0,30,6,0,0,6,0,-27,3,0
2,3,1,0,30,7,3,0,10,4,30,2,0,0,2,1,30,4,6,0,10,6,30,8,2,0,10,0,30,6,0,0,6,0,-27,3,0
2,4,1,0,30,7,3,0,10,4,30,2,0,0,2,1,30,4,6,0,10,6,30,8,2,0,10,0,30,6,0,0,6,0,-27,3,0
2,1,4,3,30,8,0,0,8,4,30,4,0,0,4,0,30,4,4,0,8,0,30,4,4,0,8,1,30,3,1,0,4,0,-27,3,0
2,2,4,3,30,8,0,0,8,4,30,4,0,0,4,0,30,4,4,0,8,0,30,4,4,0,8,1,30,3,1,0,4,0,-27,3,0
2,3,4,3,30,8,0,0,8,4,30,4,0,0,4,0,30,4,4,0,8,0,30,4,4,0,8,1,30,3,1,0,4,0,-27,3,0
2,4,4,3,30,8,0,0,8,4,30,4,0,0,4,0,30,4,4,0,8,0,30,4,4,0,8,1,30,3,1,0,4,0,-27,3,0
2,4,8,0,30,7,0,0,7,3,30,2,0,0,2,1,30,4,3,0,7,1,30,7,0,0,7,4,30,3,0,0,3,0,-27,3,0
2,3,11,0,30,1,3,0,4,0,30,0,0,0,0,0,30,1,3,0,4,6,30,4,0,0,4,3,30,1,0,0,1,1,-15,3,1
2,2,13,0,30,7,0,0,7,0,30,4,0,0,4,2,30,5,2,0,7,6,30,5,2,0,7,5,30,4,0,0,4,1,-15,3,1
2,3,13,0,30,7,0,0,7,0,30,4,0,0,4,2,30,5,2,0,7,6,30,5,2,0,7,5,30,4,0,0,4,1,-15,3,1
2,2,17,3,30,11,3,0,14,2,30,6,0,0,6,0,30,7,7,0,14,1,30,5,9,0,14,2,30,3,1,0,4,1,-15,3,1
2,4,23,1,30,6,7,0,13,3,30,6,0,0,6,6,30,13,0,0,13,0,30,4,9,0,13,0,30,6,0,0,6,1,-15,3,1
2,3,25,0,30,5,9,0,14,4,30,6,0,0,6,0,30,10,4,0,14,1,30,7,7,0,14,4,30,5,1,0,6,1,-15,3,1
2,4,25,0,30,5,9,0,14,4,30,6,0,0,6,0,30,10,4,0,14,1,30,7,7,0,14,4,30,5,1,0,6,1,-15,3,1
2,0,27,1,30,5,10,0,15,2,30,1,1,0,2,0,30,5,10,0,15,2,30,5,10,0,15,5,30,6,0,0,6,1,-15,3,1
2,3,27,1,30,5,10,0,15,2,30,1,1,0,2,0,30,5,10,0,15,2,30,5,10,0,15,5,30,6,0,0,6,1,-15,3,1
2,2,31,2,30,8,4,0,12,4,30,8,0,0,8,4,30,11,1,0,12,0,30,3,9,0,12,0,30,5,1,0,6,1,-15,3,1
2,4,31,0,30,8,4,0,12,4,30,8,0,0,8,4,30,11,1,0,12,0,30,3,9,0,12,0,30,5,1,0,6,1,-15,3,1
2,3,32,0,30,4,5,0,9,4,30,2,0,0,2,0,30,9,0,0,9,1,30,3,6,0,9,3,30,2,0,0,2,1,-15,3,1
2,1,1,0,30,7,3,0,10,4,30,2,0,0,2,1,30,4,6,0,10,10,30,8,2,0,10,6,30,6,0,0,6,0,-27,3,0
2,2,1,0,30,7,3,0,10,4,30,2,0,0,2,1,30,4,6,0,10,10,30,8,2,0,10,6,30,6,0,0,6,0,-27,3,0
2,4,1,0,30,7,3,0,10,4,30,2,0,0,2,1,30,4,6,0,10,10,30,8,2,0,10,6,30,6,0,0,6,0,-27,3,0
2,2,5,0,30,1,4,0,5,3,30,0,4,0,4,0,30,0,5,0,5,0,30,1,4,0,5,0,30,0,2,0,2,0,-27,3,0
2,4,5,0,30,1,4,0,5,3,30,0,4,0,4,0,30,0,5,0,5,0,30,1,4,0,5,0,30,0,2,0,2,0,-27,3,0
2,1,13,1,30,5,2,0,7,0,30,4,0,0,4,2,30,6,1,0,7,11,30,6,1,0,7,5,30,4,0,0,4,1,-15,3,1
2,2,13,1,30,5,2,0,7,0,30,4,0,0,4,2,30,6,1,0,7,11,30,6,1,0,7,5,30,4,0,0,4,1,-15,3,1
2,4,19,0,30,3,10,0,13,3,30,5,3,0,8,0,30,5,8,0,13,8,30,4,9,0,13,0,30,8,1,0,9,1,-15,3,1
2,1,25,1,30,5,9,0,14,2,30,6,0,0,6,1,30,8,6,0,14,1,30,5,9,0,14,4,30,6,0,0,6,1,-15,3,1
2,3,25,1,30,5,9,0,14,2,30,6,0,0,6,1,30,8,6,0,14,1,30,5,9,0,14,4,30,6,0,0,6,1,-15,3,1
2,0,27,1,30,5,10,0,15,2,30,2,0,0,2,0,30,4,11,0,15,4,30,4,11,0,15,4,30,6,0,0,6,1,-15,3,1
2,1,27,1,30,5,10,0,15,2,30,2,0,0,2,0,30,4,11,0,15,4,30,4,11,0,15,4,30,6,0,0,6,1,-15,3,1
2,3,27,1,30,5,10,0,15,2,30,2,0,0,2,0,30,4,11,0,15,4,30,4,11,0,15,4,30,6,0,0,6,1,-15,3,1
2,3,5,0,30,2,3,0,5,2,30,3,1,0,4,0,30,1,4,0,5,0,30,1,4,0,5,0,30,0,2,0,2,0,-27,3,0
2,3,6,0,30,6,3,0,9,3,30,2,0,0,2,0,30,3,6,0,9,0,30,3,6,0,9,0,30,5,0,0,5,0,-27,3,0
2,4,6,0,30,6,3,0,9,3,30,2,0,0,2,0,30,3,6,0,9,0,30,3,6,0,9,0,30,5,0,0,5,0,-27,3,0
2,1,13,2,30,6,1,0,7,0,30,4,0,0,4,2,30,6,1,0,7,10,30,4,3,0,7,2,30,4,0,0,4,1,-15,3,1
2,2,13,2,30,6,1,0,7,0,30,4,0,0,4,2,30,6,1,0,7,10,30,4,3,0,7,2,30,4,0,0,4,1,-15,3,1
2,1,18,3,30,8,0,0,8,3,30,4,0,0,4,3,30,0,8,0,8,0,30,4,4,0,8,0,30,1,4,0,5,1,-15,3,1
2,1,25,1,30,5,9,0,14,5,30,6,0,0,6,0,30,3,11,0,14,6,30,10,4,0,14,5,30,6,0,0,6,1,-15,3,1
2,0,39,0,30,5,6,0,11,6,30,5,1,0,6,3,30,7,4,0,11,1,30,5,6,0,11,4,30,5,0,0,5,1,-15,3,1
2,2,39,0,30,5,6,0,11,6,30,5,1,0,6,3,30,7,4,0,11,1,30,5,6,0,11,4,30,5,0,0,5,1,-15,3,1
2,4,39,0,30,5,6,0,11,6,30,5,1,0,6,3,30,7,4,0,11,1,30,5,6,0,11,4,30,5,0,0,5,1,-15,3,1
2,0,1,0,30,7,3,0,10,4,30,2,0,0,2,1,30,4,6,0,10,6,30,8,2,0,10,6,30,6,0,0,6,0,-27,3,0
2,3,4,2,30,6,2,0,8,5,30,4,0,0,4,3,30,1,7,0,8,4,30,4,4,0,8,1,30,3,1,0,4,0,-27,3,0
2,4,21,2,30,8,2,0,10,4,30,6,0,0,6,1,30,2,8,0,10,3,30,4,6,0,10,2,30,4,0,0,4,1,-15,3,1
2,2,27,1,30,4,11,0,15,2,30,2,0,0,2,0,30,9,6,0,15,3,30,7,8,0,15,5,30,6,0,0,6,1,-15,3,1
2,3,1,0,30,7,3,0,10,4,30,2,0,0,2,1,30,4,6,0,10,6,30,8,2,0,10,6,30,6,0,0,6,0,-27,3,0
2,2,4,3,30,8,0,0,8,4,30,2,2,0,4,0,30,3,5,0,8,0,30,4,4,0,8,1,30,4,0,0,4,0,-27,3,0
2,3,4,3,30,8,0,0,8,4,30,2,2,0,4,0,30,3,5,0,8,0,30,4,4,0,8,1,30,4,0,0,4,0,-27,3,0
2,0,5,0,30,2,3,0,5,3,30,3,1,0,4,0,30,0,5,0,5,0,30,1,4,0,5,0,30,0,2,0,2,0,-27,3,0
2,2,5,0,30,2,3,0,5,3,30,3,1,0,4,0,30,0,5,0,5,0,30,1,4,0,5,0,30,0,2,0,2,0,-27,3,0
2,2,13,2,30,6,1,0,7,0,30,4,0,0,4,3,30,6,1,0,7,13,30,7,0,0,7,0,30,3,1,0,4,1,-15,3,1
2,3,17,3,30,9,5,0,14,3,30,6,0,0,6,0,30,4,10,0,14,1,30,6,8,0,14,3,30,4,0,0,4,1,-15,3,1
2,3,23,1,30,4,9,0,13,2,30,6,0,0,6,2,30,11,2,0,13,0,30,6,7,0,13,3,30,6,0,0,6,1,-15,3,1
2,3,25,2,30,10,4,0,14,3,30,6,0,0,6,0,30,9,5,0,14,1,30,5,9,0,14,2,30,6,0,0,6,1,-15,3,1
2,0,27,1,30,4,11,0,15,5,30,1,1,0,2,0,30,6,9,0,15,4,30,4,11,0,15,1,30,6,0,0,6,1,-15,3,1
2,4,29,0,30,5,9,0,14,5,30,10,2,0,12,0,30,8,6,0,14,0,30,1,13,0,14,0,30,9,0,0,9,1,-15,3,1
2,3,31,3,30,5,7,0,12,4,30,8,0,0,8,4,30,12,0,0,12,0,30,3,9,0,12,1,30,2,4,0,6,1,-15,3,1
2,4,31,3,30,5,7,0,12,4,30,8,0,0,8,4,30,12,0,0,12,0,30,3,9,0,12,1,30,2,4,0,6,1,-15,3,1
2,0,41,0,30,8,4,0,12,5,30,6,2,0,8,0,30,8,4,0,12,0,30,3,9,0,12,3,30,7,0,0,7,1,-15,3,1
2,1,41,0,30,8,4,0,12,5,30,6,2,0,8,0,30,8,4,0,12,0,30,3,9,0,12,3,30,7,0,0,7,1,-15,3,1
2,2,41,0,30,8,4,0,12,5,30,6,2,0,8,0,30,8,4,0,12,0,30,3,9,0,12,3,30,7,0,0,7,1,-15,3,1
2,0,5,0,30,2,3,0,5,3,30,2,2,0,4,0,30,0,5,0,5,0,30,1,4,0,5,0,30,1,1,0,2,0,-27,3,0
2,4,5,0,30,2,3,0,5,3,30,2,2,0,4,0,30,0,5,0,5,0,30,1,4,0,5,0,30,1,1,0,2,0,-27,3,0
2,2,13,0,30,3,0,0,3,0,30,2,0,0,2,0,30,3,0,0,3,10,30,3,0,0,3,4,30,2,0,0,2,1,-15,3,1
2,4,13,0,30,3,0,0,3,0,30,2,0,0,2,0,30,3,0,0,3,10,30,3,0,0,3,4,30,2,0,0,2,1,-15,3,1
2,1,13,2,30,6,1,0,7,1,30,4,0,0,4,4,30,6,1,0,7,6,30,7,0,0,7,4,30,4,0,0,4,1,-15,3,1
2,4,13,2,30,6,1,0,7,1,30,4,0,0,4,2,30,6,1,0,7,6,30,7,0,0,7,4,30,4,0,0,4,1,-15,3,1
2,4,17,0,30,10,4,0,14,1,30,6,0,0,6,0,30,6,8,0,14,1,30,4,10,0,14,4,30,4,0,0,4,1,-15,3,1
2,3,19,0,30,3,10,0,13,2,30,6,2,0,8,0,30,5,8,0,13,4,30,5,8,0,13,2,30,9,0,0,9,1,-15,3,1
2,4,19,0,30,3,10,0,13,2,30,6,2,0,8,0,30,5,8,0,13,4,30,5,8,0,13,2,30,9,0,0,9,1,-15,3,1
2,4,23,1,30,5,8,0,13,3,30,6,0,0,6,4,30,9,4,0,13,2,30,7,6,0,13,0,30,6,0,0,6,1,-15,3,1
2,1,27,1,30,3,12,0,15,5,30,1,1,0,2,0,30,5,10,0,15,2,30,4,11,0,15,4,30,6,0,0,6,1,-15,3,1
2,3,29,0,30,5,9,0,14,6,30,12,0,0,12,0,30,5,9,0,14,0,30,0,14,0,14,2,30,9,0,0,9,1,-15,3,1
2,4,29,0,30,5,9,0,14,6,30,12,0,0,12,0,30,5,9,0,14,0,30,0,14,0,14,2,30,9,0,0,9,1,-15,3,1
2,3,1,0,30,7,3,0,10,4,30,2,0,0,2,1,30,4,6,0,10,1,30,7,3,0,10,6,30,6,0,0,6,0,-27,3,0
2,4,1,0,30,7,3,0,10,4,30,2,0,0,2,1,30,4,6,0,10,1,30,7,3,0,10,6,30,6,0,0,6,0,-27,3,0
2,3,6,0,30,8,1,0,9,4,30,2,0,0,2,0,30,2,7,0,9,0,30,4,5,0,9,0,30,5,0,0,5,0,-27,3,0
2,4,6,0,30,8,1,0,9,4,30,2,0,0,2,0,30,2,7,0,9,0,30,4,5,0,9,0,30,5,0,0,5,0,-27,3,0
2,4,13,0,30,6,1,0,7,0,30,4,0,0,4,2,30,6,1,0,7,13,30,7,0,0,7,2,30,4,0,0,4,1,-15,3,1
2,4,17,4,30,10,4,0,14,4,30,6,0,0,6,0,30,3,11,0,14,1,30,7,7,0,14,0,30,4,0,0,4,1,-15,3,1
2,3,21,2,30,8,2,0,10,4,30,6,0,0,6,1,30,3,7,0,10,3,30,5,5,0,10,1,30,4,0,0,4,1,-15,3,1
2,3,25,1,30,7,7,0,14,1,30,6,0,0,6,0,30,13,1,0,14,1,30,4,10,0,14,4,30,6,0,0,6,1,-15,3,1
2,2,5,0,30,1,4,0,5,3,30,2,2,0,4,0,30,0,5,0,5,0,30,1,4,0,5,1,30,2,0,0,2,0,-27,3,0
2,4,5,0,30,1,4,0,5,3,30,2,2,0,4,0,30,0,5,0,5,0,30,1,4,0,5,1,30,2,0,0,2,0,-27,3,0
2,3,6,0,30,6,3,0,9,4,30,2,0,0,2,0,30,2,7,0,9,0,30,4,5,0,9,4,30,5,0,0,5,0,-27,3,0
2,4,6,0,30,6,3,0,9,4,30,2,0,0,2,0,30,2,7,0,9,0,30,4,5,0,9,4,30,5,0,0,5,0,-27,3,0
2,2,11,1,30,5,7,0,12,2,30,4,0,0,4,4,30,4,8,0,12,3,30,7,5,0,12,4,30,4,0,0,4,1,-15,3,1
2,3,11,1,30,5,7,0,12,2,30,4,0,0,4,4,30,4,8,0,12,3,30,7,5,0,12,4,30,4,0,0,4,1,-15,3,1
2,2,13,2,30,5,2,0,7,0,30,4,0,0,4,2,30,6,1,0,7,7,30,7,0,0,7,4,30,4,0,0,4,1,-15,3,1
2,3,17,3,30,9,5,0,14,2,30,6,0,0,6,0,30,8,6,0,14,1,30,6,8,0,14,2,30,4,0,0,4,1,-15,3,1
2,4,17,3,30,9,5,0,14,2,30,6,0,0,6,0,30,8,6,0,14,1,30,6,8,0,14,2,30,4,0,0,4,1,-15,3,1
2,1,19,0,30,2,11,0,13,2,30,8,0,0,8,0,30,5,8,0,13,0,30,3,10,0,13,0,30,8,1,0,9,1,-15,3,1
2,2,19,0,30,2,11,0,13,2,30,8,0,0,8,0,30,5,8,0,13,0,30,3,10,0,13,0,30,8,1,0,9,1,-15,3,1
2,4,19,0,30,2,11,0,13,0,30,8,0,0,8,0,30,5,8,0,13,0,30,3,10,0,13,0,30,8,1,0,9,1,-15,3,1
2,4,25,1,30,6,8,0,14,4,30,6,0,0,6,0,30,5,9,0,14,0,30,5,9,0,14,5,30,6,0,0,6,1,-15,3,1
2,4,27,0,30,4,11,0,15,2,30,1,1,0,2,0,30,6,9,0,15,0,30,6,9,0,15,3,30,6,0,0,6,1,-15,3,1
2,0,29,0,30,5,9,0,14,5,30,12,0,0,12,0,30,3,11,0,14,0,30,2,12,0,14,5,30,9,0,0,9,1,-15,3,1
2,3,29,0,30,5,9,0,14,5,30,12,0,0,12,0,30,3,11,0,14,0,30,2,12,0,14,0,30,9,0,0,9,1,-15,3,1
2,0,31,4,30,11,1,0,12,5,30,8,0,0,8,3,30,6,6,0,12,0,30,3,9,0,12,2,30,2,4,0,6,1,-15,3,1
2,1,31,4,30,11,1,0,12,5,30,8,0,0,8,3,30,6,6,0,12,0,30,3,9,0,12,2,30,2,4,0,6,1,-15,3,1
2,2,31,4,30,11,1,0,12,5,30,8,0,0,8,3,30,6,6,0,12,0,30,3,9,0,12,2,30,2,4,0,6,1,-15,3,1
2,3,31,4,30,11,1,0,12,5,30,8,0,0,8,3,30,6,6,0,12,0,30,3,9,0,12,2,30,2,4,0,6,1,-15,3,1
2,4,31,4,30,11,1,0,12,5,30,8,0,0,8,3,30,6,6,0,12,0,30,3,9,0,12,2,30,2,4,0,6,1,-15,3,1
2,1,33,1,30,3,8,0,11,5,30,4,0,0,4,1,30,10,1,0,11,0,30,3,8,0,11,5,30,4,0,0,4,1,-15,3,1
2,2,33,1,30,3,8,0,11,5,30,4,0,0,4,1,30,10,1,0,11,0,30,3,8,0,11,5,30,4,0,0,4,1,-15,3,1
2,3,33,1,30,3,8,0,11,5,30,4,0,0,4,1,30,10,1,0,11,0,30,3,8,0,11,5,30,4,0,0,4,1,-15,3,1
2,3,39,0,30,4,7,0,11,6,30,6,0,0,6,0,30,6,5,0,11,1,30,3,8,0,11,4,30,5,0,0,5,1,-15,3,1
2,4,39,0,30,4,7,0,11,6,30,6,0,0,6,0,30,6,5,0,11,1,30,3,8,0,11,4,30,5,0,0,5,1,-15,3,1
2,0,5,0,30,2,3,0,5,3,30,2,2,0,4,0,30,0,5,0,5,0,30,1,4,0,5,0,30,0,2,0,2,0,-27,3,0
2,1,5,0,30,2,3,0,5,3,30,2,2,0,4,0,30,0,5,0,5,0,30,1,4,0,5,0,30,0,2,0,2,0,-27,3,0
2,3,5,0,30,2,3,0,5,3,30,2,2,0,4,0,30,0,5,0,5,0,30,1,4,0,5,0,30,0,2,0,2,0,-27,3,0
2,1,7,0,30,2,2,0,4,2,30,2,0,0,2,0,30,1,3,0,4,0,30,0,4,0,4,1,30,2,0,0,2,0,-27,3,0
2,4,7,0,30,2,2,0,4,2,30,2,0,0,2,0,30,1,3,0,4,0,30,0,4,0,4,1,30,2,0,0,2,0,-27,3,0
2,2,19,0,30,5,8,0,13,2,30,7,1,0,8,0,30,4,9,0,13,3,30,4,9,0,13,1,30,9,0,0,9,1,-15,3,1
2,0,25,1,30,6,8,0,14,5,30,6,0,0,6,0,30,6,8,0,14,1,30,4,10,0,14,3,30,6,0,0,6,1,-15,3,1
2,1,27,1,30,5,10,0,15,3,30,2,0,0,2,0,30,3,12,0,15,3,30,4,11,0,15,0,30,5,1,0,6,1,-15,3,1
2,2,27,1,30,5,10,0,15,3,30,2,0,0,2,0,30,3,12,0,15,3,30,4,11,0,15,0,30,5,1,0,6,1,-15,3,1
2,3,27,1,30,5,10,0,15,3,30,2,0,0,2,0,30,3,12,0,15,3,30,4,11,0,15,0,30,5,1,0,6,1,-15,3,1
2,3,35,0,30,11,2,0,13,5,30,2,0,0,2,1,30,4,9,0,13,1,30,5,8,0,13,8,30,8,0,0,8,1,-15,3,1
2,1,17,2,30,10,4,0,14,2,30,6,0,0,6,0,30,5,9,0,14,5,30,5,9,0,14,5,30,4,0,0,4,1,-15,3,1
2,1,23,3,30,5,8,0,13,2,30,6,0,0,6,6,30,13,0,0,13,0,30,6,7,0,13,2,30,6,0,0,6,1,-15,3,1
2,3,23,3,30,5,8,0,13,2,30,6,0,0,6,6,30,13,0,0,13,0,30,6,7,0,13,2,30,6,0,0,6,1,-15,3,1
2,2,25,1,30,4,10,0,14,2,30,6,0,0,6,0,30,7,7,0,14,3,30,4,10,0,14,5,30,6,0,0,6,1,-15,3,1
2,3,45,0,30,6,7,0,13,10,30,10,0,0,10,0,30,0,13,0,13,0,30,4,9,0,13,10,30,5,0,0,5,1,-15,3,1
2,2,1,0,30,7,3,0,10,5,30,2,0,0,2,1,30,3,7,0,10,2,30,8,2,0,10,5,30,6,0,0,6,0,-27,3,0
2,1,5,0,30,2,3,0,5,3,30,0,4,0,4,0,30,0,5,0,5,0,30,3,2,0,5,0,30,0,2,0,2,0,-27,3,0
2,3,5,0,30,2,3,0,5,3,30,0,4,0,4,0,30,0,5,0,5,0,30,3,2,0,5,0,30,0,2,0,2,0,-27,3,0
2,3,8,2,30,7,0,0,7,4,30,2,0,0,2,0,30,2,5,0,7,0,30,5,2,0,7,3,30,3,0,0,3,0,-27,3,0
2,4,8,2,30,7,0,0,7,4,30,2,0,0,2,0,30,2,5,0,7,0,30,5,2,0,7,3,30,3,0,0,3,0,-27,3,0
2,2,13,2,30,7,0,0,7,0,30,4,0,0,4,2,30,6,1,0,7,8,30,5,2,0,7,3,30,4,0,0,4,1,-15,3,1
2,4,13,2,30,7,0,0,7,0,30,4,0,0,4,2,30,6,1,0,7,8,30,5,2,0,7,3,30,4,0,0,4,1,-15,3,1
2,2,17,5,30,11,3,0,14,3,30,6,0,0,6,0,30,4,10,0,14,0,30,6,8,0,14,1,30,4,0,0,4,1,-15,3,1
2,3,19,0,30,5,8,0,13,2,30,8,0,0,8,2,30,5,8,0,13,0,30,6,7,0,13,0,30,6,3,0,9,1,-15,3,1
2,3,25,1,30,6,8,0,14,4,30,6,0,0,6,0,30,7,7,0,14,1,30,5,9,0,14,0,30,6,0,0,6,1,-15,3,1
2,0,29,1,30,8,6,0,14,6,30,11,1,0,12,0,30,3,11,0,14,0,30,1,13,0,14,0,30,9,0,0,9,1,-15,3,1
2,1,29,1,30,8,6,0,14,6,30,11,1,0,12,0,30,3,11,0,14,0,30,1,13,0,14,0,30,9,0,0,9,1,-15,3,1
2,3,29,1,30,8,6,0,14,6,30,11,1,0,12,0,30,3,11,0,14,0,30,1,13,0,14,0,30,9,0,0,9,1,-15,3,1
2,0,38,0,30,9,1,0,10,7,30,6,0,0,6,0,30,1,9,0,10,0,30,0,10,0,10,5,30,6,0,0,6,1,-15,3,1
2,4,38,0,30,9,1,0,10,7,30,6,0,0,6,0,30,1,9,0,10,0,30,0,10,0,10,5,30,6,0,0,6,1,-15,3,1
2,3,39,0,30,6,5,0,11,7,30,6,0,0,6,0,30,4,7,0,11,1,30,2,9,0,11,2,30,5,0,0,5,1,-15,3,1
2,4,39,0,30,6,5,0,11,7,30,6,0,0,6,0,30,4,7,0,11,1,30,2,9,0,11,2,30,5,0,0,5,1,-15,3,1
2,2,41,0,30,7,5,0,12,6,30,8,0,0,8,0,30,4,8,0,12,2,30,3,9,0,12,3,30,4,3,0,7,1,-15,3,1
2,3,41,0,30,7,5,0,12,6,30,8,0,0,8,0,30,4,8,0,12,2,30,3,9,0,12,3,30,4,3,0,7,1,-15,3,1
2,4,41,0,30,7,5,0,12,6,30,8,0,0,8,0,30,4,8,0,12,2,30,3,9,0,12,3,30,4,3,0,7,1,-15,3,1
2,1,1,0,30,7,3,0,10,3,30,2,0,0,2,1,30,4,6,0,10,0,30,6,4,0,10,6,30,6,0,0,6,0,-27,3,0
2,3,1,0,30,7,3,0,10,3,30,2,0,0,2,1,30,4,6,0,10,0,30,6,4,0,10,6,30,6,0,0,6,0,-27,3,0
2,3,5,0,30,2,3,0,5,2,30,4,0,0,4,0,30,0,5,0,5,0,30,1,4,0,5,0,30,0,2,0,2,0,-27,3,0
2,3,8,1,30,7,0,0,7,4,30,2,0,0,2,0,30,3,4,0,7,0,30,5,2,0,7,1,30,3,0,0,3,0,-27,3,0
2,2,13,2,30,7,0,0,7,0,30,4,0,0,4,0,30,6,1,0,7,5,30,6,1,0,7,3,30,4,0,0,4,1,-15,3,1
2,2,15,1,30,7,6,0,13,2,30,6,0,0,6,0,30,3,10,0,13,1,30,7,6,0,13,0,30,7,2,0,9,1,-15,3,1
2,0,19,0,30,3,10,0,13,3,30,5,3,0,8,0,30,4,9,0,13,10,30,4,9,0,13,3,30,9,0,0,9,1,-15,3,1
2,0,25,1,30,5,9,0,14,6,30,6,0,0,6,0,30,4,10,0,14,1,30,7,7,0,14,7,30,6,0,0,6,1,-15,3,1
2,3,25,1,30,5,9,0,14,6,30,6,0,0,6,0,30,4,10,0,14,1,30,7,7,0,14,7,30,6,0,0,6,1,-15,3,1
2,3,29,0,30,8,6,0,14,4,30,9,3,0,12,0,30,11,3,0,14,0,30,1,13,0,14,0,30,5,4,0,9,1,-15,3,1
2,2,31,2,30,6,6,0,12,5,30,8,0,0,8,3,30,8,4,0,12,0,30,3,9,0,12,2,30,3,3,0,6,1,-15,3,1
2,3,31,2,30,6,6,0,12,5,30,8,0,0,8,3,30,8,4,0,12,0,30,3,9,0,12,2,30,3,3,0,6,1,-15,3,1
2,4,31,2,30,6,6,0,12,5,30,8,0,0,8,3,30,8,4,0,12,0,30,3,9,0,12,2,30,3,3,0,6,1,-15,3,1
2,0,1,0,30,7,3,0,10,4,30,2,0,0,2,1,30,4,6,0,10,8,30,6,4,0,10,6,30,6,0,0,6,0,-27,3,0
2,1,1,0,30,7,3,0,10,4,30,2,0,0,2,1,30,4,6,0,10,8,30,6,4,0,10,6,30,6,0,0,6,0,-27,3,0
2,4,1,0,30,7,3,0,10,4,30,2,0,0,2,1,30,4,6,0,10,8,30,6,4,0,10,6,30,6,0,0,6,0,-27,3,0
2,2,5,0,30,3,2,0,5,3,30,3,1,0,4,0,30,0,5,0,5,0,30,1,4,0,5,0,30,0,2,0,2,0,-27,3,0
2,4,5,0,30,3,2,0,5,3,30,3,1,0,4,0,30,0,5,0,5,0,30,1,4,0,5,0,30,0,2,0,2,0,-27,3,0
2,1,13,1,30,5,2,0,7,0,30,4,0,0,4,2,30,6,1,0,7,7,30,6,1,0,7,6,30,4,0,0,4,1,-15,3,1
2,4,13,1,30,5,2,0,7,0,30,4,0,0,4,2,30,6,1,0,7,7,30,6,1,0,7,6,30,4,0,0,4,1,-15,3,1
2,0,19,1,30,2,11,0,13,3,30,5,3,0,8,0,30,4,9,0,13,3,30,4,9,0,13,3,30,8,1,0,9,1,-15,3,1
2,4,19,1,30,2,11,0,13,3,30,5,3,0,8,0,30,4,9,0,13,3,30,4,9,0,13,0,30,8,1,0,9,1,-15,3,1
2,3,21,2,30,8,2,0,10,4,30,6,0,0,6,1,30,3,7,0,10,4,30,4,6,0,10,0,30,4,0,0,4,1,-15,3,1
2,3,22,1,30,6,2,0,8,2,30,2,0,0,2,0,30,5,3,0,8,4,30,6,2,0,8,1,30,2,2,0,4,1,-15,3,1
2,2,26,0,30,5,4,0,9,5,30,4,0,0,4,2,30,0,9,0,9,3,30,4,5,0,9,4,30,1,2,0,3,1,-15,3,1
2,3,26,0,30,5,4,0,9,5,30,4,0,0,4,2,30,0,9,0,9,3,30,4,5,0,9,4,30,1,2,0,3,1,-15,3,1
2,0,29,0,30,5,9,0,14,4,30,12,0,0,12,0,30,8,6,0,14,0,30,1,13,0,14,1,30,9,0,0,9,1,-15,3,1
2,1,29,0,30,5,9,0,14,4,30,12,0,0,12,0,30,8,6,0,14,0,30,1,13,0,14,1,30,9,0,0,9,1,-15,3,1
2,2,29,0,30,5,9,0,14,4,30,12,0,0,12,0,30,8,6,0,14,0,30,1,13,0,14,1,30,9,0,0,9,1,-15,3,1
2,4,39,0,30,4,7,0,11,7,30,6,0,0,6,0,30,4,7,0,11,0,30,4,7,0,11,3,30,5,0,0,5,1,-15,3,1
2,4,3,0,30,0,4,0,4,3,30,4,0,0,4,0,30,0,4,0,4,2,30,1,3,0,4,2,30,3,0,0,3,0,-27,3,0
2,0,6,0,30,8,1,0,9,3,30,2,0,0,2,0,30,5,4,0,9,0,30,4,5,0,9,0,30,3,2,0,5,0,-27,3,0
2,1,6,0,30,8,1,0,9,3,30,2,0,0,2,0,30,5,4,0,9,0,30,4,5,0,9,0,30,3,2,0,5,0,-27,3,0
2,4,6,0,30,8,1,0,9,3,30,2,0,0,2,0,30,5,4,0,9,0,30,4,5,0,9,0,30,3,2,0,5,0,-27,3,0
2,4,7,1,30,4,5,0,9,3,30,4,0,0,4,0,30,5,4,0,9,4,30,2,7,0,9,1,30,3,3,0,6,0,-27,3,0
2,4,8,2,30,7,0,0,7,3,30,2,0,0,2,0,30,1,6,0,7,0,30,5,2,0,7,4,30,3,0,0,3,0,-27,3,0
2,2,19,0,30,4,9,0,13,1,30,7,1,0,8,0,30,7,6,0,13,5,30,6,7,0,13,2,30,9,0,0,9,1,-15,3,1
2,3,23,2,30,5,8,0,13,3,30,6,0,0,6,6,30,13,0,0,13,0,30,4,9,0,13,3,30,6,0,0,6,1,-15,3,1
2,4,25,0,30,9,5,0,14,3,30,6,0,0,6,0,30,5,9,0,14,1,30,5,9,0,14,4,30,5,1,0,6,1,-15,3,1
2,4,27,1,30,4,11,0,15,3,30,2,0,0,2,0,30,5,10,0,15,0,30,6,9,0,15,4,30,6,0,0,6,1,-15,3,1
2,2,29,0,30,8,6,0,14,5,30,7,5,0,12,0,30,9,5,0,14,0,30,4,10,0,14,4,30,9,0,0,9,1,-15,3,1
2,3,29,0,30,8,6,0,14,5,30,7,5,0,12,0,30,9,5,0,14,0,30,4,10,0,14,4,30,9,0,0,9,1,-15,3,1
2,2,5,2,30,2,3,0,5,3,30,0,4,0,4,0,30,0,5,0,5,0,30,1,4,0,5,0,30,0,2,0,2,0,-27,3,0
2,3,8,0,30,7,0,0,7,3,30,2,0,0,2,6,30,3,4,0,7,4,30,6,1,0,7,2,30,3,0,0,3,0,-27,3,0
2,3,19,0,30,3,10,0,13,2,30,5,3,0,8,0,30,4,9,0,13,3,30,5,8,0,13,1,30,8,1,0,9,1,-15,3,1
2,4,19,0,30,3,10,0,13,2,30,5,3,0,8,0,30,4,9,0,13,3,30,5,8,0,13,1,30,8,1,0,9,1,-15,3,1
2,0,21,4,30,8,2,0,10,4,30,6,0,0,6,1,30,3,7,0,10,5,30,5,5,0,10,3,30,4,0,0,4,1,-15,3,1
2,1,21,4,30,8,2,0,10,4,30,6,0,0,6,1,30,3,7,0,10,5,30,5,5,0,10,3,30,4,0,0,4,1,-15,3,1
2,2,21,4,30,8,2,0,10,4,30,6,0,0,6,1,30,3,7,0,10,5,30,5,5,0,10,3,30,4,0,0,4,1,-15,3,1
2,3,25,1,30,5,9,0,14,4,30,6,0,0,6,0,30,10,4,0,14,0,30,5,9,0,14,5,30,4,2,0,6,1,-15,3,1
2,1,5,0,30,1,4,0,5,3,30,0,4,0,4,0,30,0,5,0,5,0,30,1,4,0,5,0,30,1,1,0,2,0,-27,3,0
2,3,5,0,30,1,4,0,5,3,30,0,4,0,4,0,30,0,5,0,5,0,30,1,4,0,5,0,30,1,1,0,2,0,-27,3,0
2,4,8,1,30,7,0,0,7,4,30,2,0,0,2,3,30,3,4,0,7,0,30,4,3,0,7,0,30,3,0,0,3,0,-27,3,0
2,0,13,2,30,7,0,0,7,1,30,4,0,0,4,2,30,5,2,0,7,7,30,6,1,0,7,5,30,4,0,0,4,1,-15,3,1
2,2,13,2,30,7,0,0,7,1,30,4,0,0,4,2,30,5,2,0,7,7,30,6,1,0,7,5,30,4,0,0,4,1,-15,3,1
2,4,13,2,30,7,0,0,7,1,30,4,0,0,4,2,30,5,2,0,7,7,30,6,1,0,7,5,30,4,0,0,4,1,-15,3,1
2,4,15,0,30,3,10,0,13,1,30,6,0,0,6,0,30,3,10,0,13,1,30,4,9,0,13,2,30,9,0,0,9,1,-15,3,1
2,2,17,4,30,9,5,0,14,3,30,6,0,0,6,0,30,5,9,0,14,2,30,6,8,0,14,1,30,3,1,0,4,1,-15,3,1
2,3,19,0,30,6,7,0,13,0,30,6,2,0,8,0,30,12,1,0,13,6,30,4,9,0,13,1,30,6,3,0,9,1,-15,3,1
2,4,19,0,30,6,7,0,13,0,30,6,2,0,8,0,30,12,1,0,13,6,30,4,9,0,13,1,30,6,3,0,9,1,-15,3,1
2,2,23,1,30,5,8,0,13,4,30,6,0,0,6,6,30,7,6,0,13,3,30,6,7,0,13,5,30,6,0,0,6,1,-15,3,1
2,3,23,1,30,5,8,0,13,4,30,6,0,0,6,6,30,7,6,0,13,3,30,6,7,0,13,5,30,6,0,0,6,1,-15,3,1
2,4,23,1,30,5,8,0,13,4,30,6,0,0,6,6,30,7,6,0,13,3,30,6,7,0,13,5,30,6,0,0,6,1,-15,3,1
2,2,27,3,30,4,11,0,15,5,30,1,1,0,2,0,30,5,10,0,15,0,30,3,12,0,15,2,30,6,0,0,6,1,-15,3,1
2,3,36,0,30,3,6,0,9,6,30,2,0,0,2,1,30,6,3,0,9,1,30,3,6,0,9,0,30,3,0,0,3,1,-15,3,1
2,0,4,2,30,7,1,0,8,4,30,4,0,0,4,1,30,3,5,0,8,0,30,4,4,0,8,4,30,4,0,0,4,0,-27,3,0
2,3,5,0,30,1,4,0,5,2,30,4,0,0,4,0,30,0,5,0,5,0,30,1,4,0,5,0,30,2,0,0,2,0,-27,3,0
2,4,5,0,30,1,4,0,5,2,30,4,0,0,4,0,30,0,5,0,5,0,30,1,4,0,5,0,30,2,0,0,2,0,-27,3,0
2,2,13,4,30,5,2,0,7,0,30,4,0,0,4,6,30,7,0,0,7,5,30,6,1,0,7,5,30,4,0,0,4,1,-15,3,1
2,3,13,4,30,5,2,0,7,0,30,4,0,0,4,6,30,7,0,0,7,5,30,6,1,0,7,5,30,4,0,0,4,1,-15,3,1
2,4,13,4,30,5,2,0,7,0,30,4,0,0,4,6,30,7,0,0,7,5,30,6,1,0,7,5,30,4,0,0,4,1,-15,3,1
2,2,17,3,30,8,6,0,14,2,30,6,0,0,6,0,30,6,8,0,14,1,30,6,8,0,14,7,30,3,1,0,4,1,-15,3,1
2,4,23,3,30,6,7,0,13,3,30,6,0,0,6,4,30,13,0,0,13,0,30,6,7,0,13,2,30,5,1,0,6,1,-15,3,1
2,2,25,1,30,6,8,0,14,4,30,6,0,0,6,0,30,3,11,0,14,1,30,5,9,0,14,7,30,5,1,0,6,1,-15,3,1
2,4,27,0,30,4,11,0,15,5,30,1,1,0,2,0,30,6,9,0,15,0,30,6,9,0,15,5,30,6,0,0,6,1,-15,3,1
2,2,29,0,30,8,6,0,14,6,30,11,1,0,12,0,30,4,10,0,14,0,30,1,13,0,14,2,30,9,0,0,9,1,-15,3,1
2,2,35,0,30,6,7,0,13,5,30,2,0,0,2,1,30,6,7,0,13,0,30,3,10,0,13,3,30,8,0,0,8,1,-15,3,1
2,4,39,0,30,6,5,0,11,6,30,6,0,0,6,0,30,4,7,0,11,0,30,2,9,0,11,3,30,4,1,0,5,1,-15,3,1
2,2,4,2,30,6,2,0,8,5,30,3,1,0,4,1,30,1,7,0,8,0,30,4,4,0,8,1,30,4,0,0,4,0,-27,3,0
2,4,4,2,30,6,2,0,8,5,30,3,1,0,4,1,30,1,7,0,8,0,30,4,4,0,8,1,30,4,0,0,4,0,-27,3,0
2,3,13,2,30,7,0,0,7,0,30,4,0,0,4,2,30,5,2,0,7,6,30,7,0,0,7,4,30,4,0,0,4,1,-15,3,1
2,3,15,0,30,4,9,0,13,1,30,5,1,0,6,0,30,4,9,0,13,1,30,5,8,0,13,3,30,9,0,0,9,1,-15,3,1
2,4,15,0,30,4,9,0,13,1,30,5,1,0,6,0,30,4,9,0,13,1,30,5,8,0,13,3,30,9,0,0,9,1,-15,3,1
2,2,17,3,30,11,3,0,14,2,30,6,0,0,6,0,30,7,7,0,14,2,30,3,11,0,14,3,30,4,0,0,4,1,-15,3,1
2,3,19,0,30,2,11,0,13,2,30,6,2,0,8,0,30,7,6,0,13,3,30,4,9,0,13,1,30,7,2,0,9,1,-15,3,1
2,4,25,3,30,6,8,0,14,4,30,6,0,0,6,0,30,8,6,0,14,1,30,5,9,0,14,4,30,5,1,0,6,1,-15,3,1
2,2,27,1,30,4,11,0,15,2,30,1,1,0,2,1,30,8,7,0,15,0,30,4,11,0,15,0,30,6,0,0,6,1,-15,3,1
2,3,27,1,30,4,11,0,15,2,30,1,1,0,2,1,30,8,7,0,15,0,30,4,11,0,15,0,30,6,0,0,6,1,-15,3,1
2,2,29,0,30,11,3,0,14,5,30,10,2,0,12,0,30,3,11,0,14,0,30,0,14,0,14,0,30,9,0,0,9,1,-15,3,1
2,3,29,0,30,11,3,0,14,5,30,10,2,0,12,0,30,3,11,0,14,0,30,0,14,0,14,0,30,9,0,0,9,1,-15,3,1
2,4,29,0,30,11,3,0,14,5,30,10,2,0,12,0,30,3,11,0,14,0,30,0,14,0,14,0,30,9,0,0,9,1,-15,3,1
2,4,31,3,30,7,5,0,12,5,30,8,0,0,8,3,30,8,4,0,12,0,30,3,9,0,12,1,30,4,2,0,6,1,-15,3,1
2,0,1,0,30,7,3,0,10,4,30,2,0,0,2,1,30,4,6,0,10,9,30,9,1,0,10,6,30,6,0,0,6,0,-27,3,0
2,1,1,0,30,7,3,0,10,4,30,2,0,0,2,1,30,4,6,0,10,9,30,9,1,0,10,6,30,6,0,0,6,0,-27,3,0
2,2,1,0,30,7,3,0,10,4,30,2,0,0,2,1,30,4,6,0,10,9,30,9,1,0,10,6,30,6,0,0,6,0,-27,3,0
2,0,5,0,30,2,3,0,5,3,30,3,1,0,4,0,30,0,5,0,5,0,30,1,4,0,5,0,30,1,1,0,2,0,-27,3,0
2,1,5,0,30,2,3,0,5,3,30,3,1,0,4,0,30,0,5,0,5,0,30,1,4,0,5,0,30,1,1,0,2,0,-27,3,0
2,3,5,0,30,2,3,0,5,3,30,3,1,0,4,0,30,0,5,0,5,0,30,1,4,0,5,0,30,1,1,0,2,0,-27,3,0
2,4,5,0,30,2,3,0,5,3,30,3,1,0,4,0,30,0,5,0,5,0,30,1,4,0,5,0,30,1,1,0,2,0,-27,3,0
2,4,15,1,30,4,9,0,13,0,30,6,0,0,6,0,30,5,8,0,13,1,30,2,11,0,13,1,30,6,3,0,9,1,-15,3,1
2,2,17,3,30,11,3,0,14,3,30,6,0,0,6,0,30,5,9,0,14,1,30,5,9,0,14,4,30,4,0,0,4,1,-15,3,1
2,2,19,0,30,3,10,0,13,2,30,4,4,0,8,0,30,4,9,0,13,4,30,7,6,0,13,1,30,9,0,0,9,1,-15,3,1
2,3,35,0,30,5,8,0,13,5,30,2,0,0,2,1,30,6,7,0,13,0,30,1,12,0,13,3,30,8,0,0,8,1,-15,3,1
2,3,45,0,30,6,7,0,13,6,30,10,0,0,10,0,30,11,2,0,13,0,30,4,9,0,13,4,30,5,0,0,5,1,-15,3,1
2,4,45,0,30,6,7,0,13,6,30,10,0,0,10,0,30,11,2,0,13,0,30,4,9,0,13,4,30,5,0,0,5,1,-15,3,1
2,0,4,2,30,5,3,0,8,4,30,4,0,0,4,0,30,3,5,0,8,0,30,6,2,0,8,2,30,4,0,0,4,0,-27,3,0
2,4,6,0,30,7,2,0,9,3,30,2,0,0,2,0,30,6,3,0,9,0,30,4,5,0,9,0,30,4,1,0,5,0,-27,3,0
2,3,13,3,30,7,0,0,7,0,30,4,0,0,4,2,30,6,1,0,7,5,30,5,2,0,7,1,30,4,0,0,4,1,-15,3,1
2,1,17,3,30,8,6,0,14,3,30,6,0,0,6,0,30,6,8,0,14,3,30,6,8,0,14,4,30,4,0,0,4,1,-15,3,1
2,3,17,3,30,8,6,0,14,3,30,6,0,0,6,0,30,6,8,0,14,3,30,6,8,0,14,0,30,4,0,0,4,1,-15,3,1
2,4,17,3,30,8,6,0,14,3,30,6,0,0,6,0,30,6,8,0,14,3,30,6,8,0,14,0,30,4,0,0,4,1,-15,3,1
2,1,19,0,30,3,10,0,13,2,30,7,1,0,8,0,30,5,8,0,13,3,30,5,8,0,13,1,30,7,2,0,9,1,-15,3,1
2,2,19,0,30,3,10,0,13,2,30,7,1,0,8,0,30,5,8,0,13,3,30,5,8,0,13,1,30,7,2,0,9,1,-15,3,1
2,4,23,0,30,9,4,0,13,2,30,6,0,0,6,2,30,12,1,0,13,0,30,4,9,0,13,3,30,6,0,0,6,1,-15,3,1
2,4,25,1,30,5,9,0,14,5,30,6,0,0,6,0,30,6,8,0,14,3,30,7,7,0,14,0,30,6,0,0,6,1,-15,3,1
2,0,27,1,30,6,9,0,15,4,30,1,1,0,2,0,30,5,10,0,15,0,30,4,11,0,15,1,30,5,1,0,6,1,-15,3,1
2,4,31,2,30,7,5,0,12,4,30,8,0,0,8,4,30,9,3,0,12,0,30,3,9,0,12,1,30,3,3,0,6,1,-15,3,1
2,1,37,0,30,6,5,0,11,5,30,5,3,0,8,0,30,6,5,0,11,2,30,5,6,0,11,4,30,6,0,0,6,1,-15,3,1
2,2,37,0,30,6,5,0,11,5,30,5,3,0,8,0,30,6,5,0,11,2,30,5,6,0,11,4,30,6,0,0,6,1,-15,3,1
2,4,38,0,30,2,8,0,10,7,30,6,0,0,6,0,30,3,7,0,10,0,30,5,5,0,10,5,30,6,0,0,6,1,-15,3,1
2,1,4,2,30,6,2,0,8,5,30,4,0,0,4,0,30,2,6,0,8,0,30,6,2,0,8,4,30,4,0,0,4,0,-27,3,0
2,3,4,2,30,6,2,0,8,5,30,4,0,0,4,0,30,2,6,0,8,0,30,6,2,0,8,4,30,4,0,0,4,0,-27,3,0
2,1,5,0,30,2,3,0,5,2,30,4,0,0,4,0,30,1,4,0,5,0,30,1,4,0,5,0,30,0,2,0,2,0,-27,3,0
2,3,5,0,30,2,3,0,5,2,30,4,0,0,4,0,30,1,4,0,5,0,30,1,4,0,5,0,30,0,2,0,2,0,-27,3,0
2,1,19,0,30,5,8,0,13,1,30,7,1,0,8,0,30,6,7,0,13,2,30,8,5,0,13,0,30,7,2,0,9,1,-15,3,1
2,0,27,1,30,4,11,0,15,2,30,2,0,0,2,0,30,3,12,0,15,2,30,3,12,0,15,6,30,6,0,0,6,1,-15,3,1
2,1,27,1,30,4,11,0,15,2,30,2,0,0,2,0,30,3,12,0,15,2,30,3,12,0,15,6,30,6,0,0,6,1,-15,3,1
2,2,27,1,30,4,11,0,15,2,30,2,0,0,2,0,30,3,12,0,15,2,30,3,12,0,15,6,30,6,0,0,6,1,-15,3,1
2,3,35,3,30,8,5,0,13,4,30,2,0,0,2,1,30,6,7,0,13,2,30,1,12,0,13,2,30,8,0,0,8,1,-15,3,1
2,1,5,0,30,2,3,0,5,3,30,1,3,0,4,0,30,0,5,0,5,0,30,1,4,0,5,0,30,0,2,0,2,0,-27,3,0
2,2,5,0,30,2,3,0,5,3,30,1,3,0,4,0,30,0,5,0,5,0,30,1,4,0,5,0,30,0,2,0,2,0,-27,3,0
2,3,6,0,30,7,2,0,9,4,30,2,0,0,2,0,30,2,7,0,9,0,30,4,5,0,9,2,30,5,0,0,5,0,-27,3,0
2,4,6,0,30,7,2,0,9,4,30,2,0,0,2,0,30,2,7,0,9,0,30,4,5,0,9,2,30,5,0,0,5,0,-27,3,0
2,4,8,0,30,7,0,0,7,4,30,2,0,0,2,2,30,3,4,0,7,0,30,7,0,0,7,1,30,3,0,0,3,0,-27,3,0
2,1,11,2,30,5,7,0,12,3,30,4,0,0,4,0,30,4,8,0,12,5,30,9,3,0,12,6,30,4,0,0,4,1,-15,3,1
2,2,11,2,30,5,7,0,12,3,30,4,0,0,4,0,30,4,8,0,12,5,30,9,3,0,12,6,30,4,0,0,4,1,-15,3,1
2,1,17,3,30,10,4,0,14,2,30,6,0,0,6,0,30,3,11,0,14,4,30,4,10,0,14,6,30,4,0,0,4,1,-15,3,1
2,2,17,3,30,10,4,0,14,2,30,6,0,0,6,0,30,3,11,0,14,4,30,4,10,0,14,6,30,4,0,0,4,1,-15,3,1
2,2,19,0,30,3,10,0,13,2,30,4,4,0,8,0,30,6,7,0,13,8,30,7,6,0,13,2,30,9,0,0,9,1,-15,3,1
2,2,25,3,30,4,10,0,14,3,30,6,0,0,6,0,30,10,4,0,14,1,30,4,10,0,14,3,30,5,1,0,6,1,-15,3,1
2,3,25,3,30,4,10,0,14,3,30,6,0,0,6,0,30,10,4,0,14,1,30,4,10,0,14,3,30,5,1,0,6,1,-15,3,1
2,0,27,1,30,4,11,0,15,3,30,2,0,0,2,0,30,8,7,0,15,4,30,3,12,0,15,2,30,6,0,0,6,1,-15,3,1
2,2,35,0,30,9,4,0,13,6,30,2,0,0,2,1,30,2,11,0,13,0,30,7,6,0,13,6,30,8,0,0,8,1,-15,3,1
2,4,35,0,30,9,4,0,13,6,30,2,0,0,2,1,30,2,11,0,13,0,30,7,6,0,13,6,30,8,0,0,8,1,-15,3,1
2,2,37,1,30,6,5,0,11,7,30,8,0,0,8,3,30,6,5,0,11,2,30,3,8,0,11,7,30,6,0,0,6,1,-15,3,1
2,3,37,1,30,6,5,0,11,7,30,8,0,0,8,3,30,6,5,0,11,2,30,3,8,0,11,7,30,6,0,0,6,1,-15,3,1
2,3,38,0,30,3,7,0,10,6,30,6,0,0,6,0,30,4,6,0,10,0,30,2,8,0,10,6,30,6,0,0,6,1,-15,3,1
2,4,38,0,30,3,7,0,10,6,30,6,0,0,6,0,30,4,6,0,10,0,30,2,8,0,10,6,30,6,0,0,6,1,-15,3,1
2,3,1,0,30,7,3,0,10,4,30,2,0,0,2,1,30,4,6,0,10,2,30,7,3,0,10,6,30,6,0,0,6,0,-27,3,0
2,3,4,2,30,7,1,0,8,5,30,2,2,0,4,5,30,3,5,0,8,2,30,6,2,0,8,1,30,4,0,0,4,0,-27,3,0
2,3,13,3,30,7,0,0,7,0,30,4,0,0,4,5,30,7,0,0,7,4,30,5,2,0,7,2,30,4,0,0,4,1,-15,3,1
2,4,13,3,30,7,0,0,7,0,30,4,0,0,4,5,30,7,0,0,7,4,30,5,2,0,7,2,30,4,0,0,4,1,-15,3,1
2,3,17,0,30,8,6,0,14,3,30,6,0,0,6,0,30,6,8,0,14,5,30,5,9,0,14,3,30,4,0,0,4,1,-15,3,1
2,4,17,0,30,8,6,0,14,3,30,6,0,0,6,0,30,6,8,0,14,5,30,5,9,0,14,3,30,4,0,0,4,1,-15,3,1
2,3,19,0,30,3,10,0,13,1,30,7,1,0,8,8,30,4,9,0,13,0,30,4,9,0,13,2,30,6,3,0,9,1,-15,3,1
2,3,23,1,30,4,9,0,13,3,30,6,0,0,6,3,30,13,0,0,13,0,30,5,8,0,13,4,30,6,0,0,6,1,-15,3,1
2,4,25,0,30,4,10,0,14,5,30,6,0,0,6,0,30,9,5,0,14,2,30,9,5,0,14,5,30,6,0,0,6,1,-15,3,1
2,1,26,0,30,5,4,0,9,5,30,4,0,0,4,2,30,0,9,0,9,1,30,3,6,0,9,5,30,3,0,0,3,1,-15,3,1
2,2,26,0,30,5,4,0,9,5,30,4,0,0,4,2,30,0,9,0,9,1,30,3,6,0,9,5,30,3,0,0,3,1,-15,3,1
2,3,26,0,30,5,4,0,9,5,30,4,0,0,4,2,30,0,9,0,9,1,30,3,6,0,9,5,30,3,0,0,3,1,-15,3,1
2,0,27,1,30,7,8,0,15,4,30,2,0,0,2,0,30,5,10,0,15,0,30,4,11,0,15,1,30,6,0,0,6,1,-15,3,1
2,0,29,0,30,9,5,0,14,6,30,12,0,0,12,0,30,3,11,0,14,0,30,1,13,0,14,2,30,9,0,0,9,1,-15,3,1
2,2,29,0,30,9,5,0,14,6,30,12,0,0,12,0,30,3,11,0,14,0,30,1,13,0,14,2,30,9,0,0,9,1,-15,3,1
2,2,38,0,30,1,9,0,10,7,30,5,1,0,6,0,30,1,9,0,10,0,30,4,6,0,10,7,30,6,0,0,6,1,-15,3,1
2,3,39,0,30,2,9,0,11,7,30,6,0,0,6,0,30,5,6,0,11,2,30,4,7,0,11,6,30,5,0,0,5,1,-15,3,1
2,4,39,0,30,2,9,0,11,7,30,6,0,0,6,0,30,5,6,0,11,2,30,4,7,0,11,6,30,5,0,0,5,1,-15,3,1
2,4,1,0,30,7,3,0,10,4,30,2,0,0,2,1,30,4,6,0,10,3,30,7,3,0,10,3,30,6,0,0,6,0,-27,3,0
2,0,4,2,30,8,0,0,8,4,30,4,0,0,4,0,30,3,5,0,8,0,30,5,3,0,8,2,30,4,0,0,4,0,-27,3,0
2,4,4,2,30,8,0,0,8,4,30,4,0,0,4,0,30,3,5,0,8,0,30,5,3,0,8,2,30,4,0,0,4,0,-27,3,0
2,4,15,0,30,4,9,0,13,0,30,6,0,0,6,0,30,3,10,0,13,1,30,5,8,0,13,2,30,8,1,0,9,1,-15,3,1
2,1,17,4,30,9,5,0,14,3,30,6,0,0,6,0,30,3,11,0,14,2,30,6,8,0,14,1,30,4,0,0,4,1,-15,3,1
2,2,17,4,30,9,5,0,14,3,30,6,0,0,6,0,30,3,11,0,14,2,30,6,8,0,14,1,30,4,0,0,4,1,-15,3,1
2,4,17,4,30,9,5,0,14,3,30,6,0,0,6,0,30,3,11,0,14,2,30,6,8,0,14,1,30,4,0,0,4,1,-15,3,1
2,1,19,0,30,2,11,0,13,2,30,8,0,0,8,0,30,6,7,0,13,8,30,4,9,0,13,0,30,8,1,0,9,1,-15,3,1
2,2,19,0,30,2,11,0,13,2,30,8,0,0,8,0,30,6,7,0,13,8,30,4,9,0,13,0,30,8,1,0,9,1,-15,3,1
2,0,25,1,30,3,11,0,14,3,30,6,0,0,6,0,30,9,5,0,14,4,30,8,6,0,14,6,30,6,0,0,6,1,-15,3,1
2,2,25,1,30,3,11,0,14,3,30,6,0,0,6,0,30,9,5,0,14,1,30,8,6,0,14,6,30,6,0,0,6,1,-15,3,1
2,1,26,2,30,7,2,0,9,6,30,3,1,0,4,2,30,0,9,0,9,0,30,4,5,0,9,8,30,3,0,0,3,1,-15,3,1
2,3,27,1,30,5,10,0,15,5,30,2,0,0,2,0,30,3,12,0,15,0,30,6,9,0,15,3,30,6,0,0,6,1,-15,3,1
2,4,29,0,30,5,9,0,14,6,30,12,0,0,12,0,30,4,10,0,14,0,30,1,13,0,14,0,30,9,0,0,9,1,-15,3,1
2,1,4,2,30,5,3,0,8,5,30,4,0,0,4,1,30,1,7,0,8,0,30,8,0,0,8,1,30,2,2,0,4,0,-27,3,0
2,2,4,2,30,5,3,0,8,5,30,4,0,0,4,1,30,1,7,0,8,0,30,8,0,0,8,1,30,2,2,0,4,0,-27,3,0
2,0,5,3,30,2,3,0,5,3,30,1,3,0,4,0,30,0,5,0,5,0,30,1,4,0,5,0,30,0,2,0,2,0,-27,3,0
2,2,5,3,30,2,3,0,5,3,30,1,3,0,4,0,30,0,5,0,5,0,30,1,4,0,5,0,30,0,2,0,2,0,-27,3,0
2,4,5,3,30,2,3,0,5,3,30,1,3,0,4,0,30,0,5,0,5,0,30,1,4,0,5,0,30,0,2,0,2,0,-27,3,0
2,2,19,0,30,6,7,0,13,0,30,5,3,0,8,0,30,5,8,0,13,3,30,4,9,0,13,0,30,9,0,0,9,1,-15,3,1
2,4,25,1,30,6,8,0,14,2,30,6,0,0,6,0,30,10,4,0,14,1,30,4,10,0,14,3,30,5,1,0,6,1,-15,3,1
2,2,27,1,30,4,11,0,15,3,30,1,1,0,2,0,30,11,4,0,15,0,30,8,7,0,15,1,30,5,1,0,6,1,-15,3,1
2,3,39,0,30,3,8,0,11,7,30,6,0,0,6,0,30,4,7,0,11,2,30,4,7,0,11,7,30,5,0,0,5,1,-15,3,1
2,2,5,0,30,3,2,0,5,3,30,2,2,0,4,0,30,0,5,0,5,0,30,2,3,0,5,0,30,0,2,0,2,0,-27,3,0
2,3,6,0,30,6,3,0,9,4,30,2,0,0,2,0,30,2,7,0,9,0,30,5,4,0,9,0,30,3,2,0,5,0,-27,3,0
2,3,11,1,30,6,6,0,12,1,30,3,1,0,4,0,30,5,7,0,12,4,30,5,7,0,12,1,30,4,0,0,4,1,-15,3,1
2,0,19,0,30,5,8,0,13,2,30,4,4,0,8,0,30,4,9,0,13,4,30,7,6,0,13,1,30,9,0,0,9,1,-15,3,1
2,1,19,0,30,5,8,0,13,2,30,4,4,0,8,0,30,4,9,0,13,4,30,7,6,0,13,1,30,9,0,0,9,1,-15,3,1
2,2,19,0,30,5,8,0,13,2,30,4,4,0,8,0,30,4,9,0,13,4,30,7,6,0,13,1,30,9,0,0,9,1,-15,3,1
2,3,19,0,30,5,8,0,13,2,30,4,4,0,8,0,30,4,9,0,13,4,30,7,6,0,13,1,30,9,0,0,9,1,-15,3,1
2,4,23,2,30,6,7,0,13,1,30,6,0,0,6,7,30,13,0,0,13,0,30,5,8,0,13,2,30,5,1,0,6,1,-15,3,1
2,2,33,7,30,5,6,0,11,5,30,4,0,0,4,0,30,11,0,0,11,0,30,3,8,0,11,6,30,4,0,0,4,1,-15,3,1
2,4,33,7,30,5,6,0,11,5,30,4,0,0,4,0,30,11,0,0,11,0,30,3,8,0,11,6,30,4,0,0,4,1,-15,3,1
2,4,35,0,30,8,5,0,13,5,30,2,0,0,2,0,30,2,11,0,13,3,30,2,11,0,13,5,30,8,0,0,8,1,-15,3,1
2,3,38,0,30,2,8,0,10,6,30,6,0,0,6,1,30,4,6,0,10,0,30,4,6,0,10,4,30,6,0,0,6,1,-15,3,1
2,4,3,0,30,0,4,0,4,2,30,4,0,0,4,0,30,0,4,0,4,2,30,1,3,0,4,0,30,1,2,0,3,0,-27,3,0
2,3,4,2,30,7,1,0,8,4,30,4,0,0,4,0,30,2,6,0,8,0,30,4,4,0,8,1,30,4,0,0,4,0,-27,3,0
2,3,8,3,30,7,0,0,7,4,30,2,0,0,2,4,30,1,6,0,7,2,30,6,1,0,7,1,30,3,0,0,3,0,-27,3,0
2,4,8,3,30,7,0,0,7,4,30,2,0,0,2,4,30,1,6,0,7,2,30,6,1,0,7,1,30,3,0,0,3,0,-27,3,0
2,4,11,3,30,4,8,0,12,0,30,4,0,0,4,0,30,9,3,0,12,4,30,4,8,0,12,5,30,4,0,0,4,1,-15,3,1
2,1,17,4,30,10,4,0,14,2,30,6,0,0,6,0,30,7,7,0,14,2,30,5,9,0,14,2,30,4,0,0,4,1,-15,3,1
2,2,17,4,30,10,4,0,14,2,30,6,0,0,6,0,30,7,7,0,14,2,30,5,9,0,14,2,30,4,0,0,4,1,-15,3,1
2,4,17,4,30,10,4,0,14,2,30,6,0,0,6,0,30,7,7,0,14,2,30,5,9,0,14,2,30,4,0,0,4,1,-15,3,1
2,3,23,2,30,6,7,0,13,1,30,6,0,0,6,4,30,13,0,0,13,0,30,5,8,0,13,3,30,6,0,0,6,1,-15,3,1
2,4,25,3,30,6,8,0,14,3,30,6,0,0,6,0,30,10,4,0,14,0,30,5,9,0,14,4,30,5,1,0,6,1,-15,3,1
2,0,27,1,30,3,12,0,15,4,30,2,0,0,2,0,30,7,8,0,15,0,30,6,9,0,15,2,30,6,0,0,6,1,-15,3,1
2,2,27,1,30,3,12,0,15,4,30,2,0,0,2,0,30,7,8,0,15,0,30,6,9,0,15,2,30,6,0,0,6,1,-15,3,1
2,3,29,0,30,10,4,0,14,5,30,11,1,0,12,0,30,3,11,0,14,0,30,1,13,0,14,3,30,9,0,0,9,1,-15,3,1
2,4,29,0,30,10,4,0,14,5,30,11,1,0,12,0,30,3,11,0,14,0,30,1,13,0,14,3,30,9,0,0,9,1,-15,3,1
2,3,32,0,30,7,2,0,9,4,30,2,0,0,2,0,30,7,2,0,9,1,30,3,6,0,9,6,30,2,0,0,2,1,-15,3,1
2,4,1,0,30,7,3,0,10,4,30,2,0,0,2,1,30,4,6,0,10,0,30,6,4,0,10,6,30,6,0,0,6,0,-27,3,0
2,1,4,2,30,6,2,0,8,5,30,4,0,0,4,2,30,2,6,0,8,0,30,7,1,0,8,1,30,4,0,0,4,0,-27,3,0
2,2,4,2,30,6,2,0,8,5,30,4,0,0,4,2,30,2,6,0,8,0,30,7,1,0,8,1,30,4,0,0,4,0,-27,3,0
2,4,4,2,30,6,2,0,8,5,30,4,0,0,4,2,30,2,6,0,8,0,30,7,1,0,8,1,30,4,0,0,4,0,-27,3,0
2,3,7,0,30,2,2,0,4,2,30,2,0,0,2,1,30,3,1,0,4,0,30,1,3,0,4,1,30,2,0,0,2,0,-27,3,0
2,4,7,0,30,2,2,0,4,2,30,2,0,0,2,1,30,3,1,0,4,0,30,1,3,0,4,1,30,2,0,0,2,0,-27,3,0
2,4,13,6,30,7,0,0,7,0,30,4,0,0,4,2,30,5,2,0,7,4,30,4,3,0,7,3,30,4,0,0,4,1,-15,3,1
2,4,17,4,30,8,6,0,14,2,30,6,0,0,6,0,30,10,4,0,14,5,30,7,7,0,14,2,30,4,0,0,4,1,-15,3,1
2,4,23,2,30,4,9,0,13,3,30,6,0,0,6,8,30,13,0,0,13,0,30,6,7,0,13,2,30,5,1,0,6,1,-15,3,1
2,1,27,1,30,6,9,0,15,4,30,2,0,0,2,0,30,4,11,0,15,0,30,5,10,0,15,6,30,6,0,0,6,1,-15,3,1
2,3,29,0,30,5,9,0,14,5,30,10,2,0,12,0,30,3,11,0,14,0,30,3,11,0,14,5,30,9,0,0,9,1,-15,3,1
2,3,31,1,30,7,5,0,12,5,30,8,0,0,8,3,30,8,4,0,12,0,30,7,5,0,12,0,30,5,1,0,6,1,-15,3,1
2,2,9,0,30,2,2,0,4,2,30,2,0,0,2,3,30,3,1,0,4,4,30,1,3,0,4,1,30,1,0,0,1,0,-27,3,0
2,3,9,0,30,2,2,0,4,2,30,2,0,0,2,3,30,3,1,0,4,4,30,1,3,0,4,1,30,1,0,0,1,0,-27,3,0
2,2,13,4,30,7,0,0,7,0,30,4,0,0,4,5,30,6,1,0,7,8,30,7,0,0,7,2,30,4,0,0,4,1,-15,3,1
2,0,19,0,30,3,10,0,13,2,30,4,4,0,8,0,30,6,7,0,13,1,30,5,8,0,13,1,30,8,1,0,9,1,-15,3,1
2,2,19,0,30,3,10,0,13,2,30,4,4,0,8,0,30,6,7,0,13,1,30,5,8,0,13,1,30,8,1,0,9,1,-15,3,1
2,4,19,0,30,3,10,0,13,2,30,4,4,0,8,0,30,6,7,0,13,1,30,5,8,0,13,0,30,8,1,0,9,1,-15,3,1
2,4,23,2,30,7,6,0,13,2,30,6,0,0,6,1,30,10,3,0,13,0,30,7,6,0,13,0,30,4,2,0,6,1,-15,3,1
2,4,25,1,30,4,10,0,14,5,30,6,0,0,6,0,30,8,6,0,14,0,30,7,7,0,14,2,30,5,1,0,6,1,-15,3,1
2,0,27,2,30,5,10,0,15,3,30,2,0,0,2,0,30,5,10,0,15,0,30,6,9,0,15,0,30,6,0,0,6,1,-15,3,1
2,4,27,2,30,5,10,0,15,3,30,2,0,0,2,0,30,5,10,0,15,0,30,6,9,0,15,0,30,6,0,0,6,1,-15,3,1
2,2,47,0,30,0,14,0,14,7,30,4,0,0,4,0,30,3,11,0,14,1,30,3,11,0,14,10,30,7,0,0,7,1,-15,3,1
2,2,5,0,30,3,2,0,5,4,30,0,4,0,4,0,30,0,5,0,5,0,30,3,2,0,5,0,30,0,2,0,2,0,-27,3,0
2,3,5,0,30,3,2,0,5,4,30,0,4,0,4,0,30,0,5,0,5,0,30,3,2,0,5,0,30,0,2,0,2,0,-27,3,0
2,2,13,1,30,7,0,0,7,0,30,4,0,0,4,1,30,6,1,0,7,5,30,7,0,0,7,3,30,4,0,0,4,1,-15,3,1
2,2,25,2,30,8,6,0,14,4,30,6,0,0,6,0,30,7,7,0,14,1,30,5,9,0,14,4,30,5,1,0,6,1,-15,3,1
2,4,25,2,30,8,6,0,14,4,30,6,0,0,6,0,30,7,7,0,14,1,30,5,9,0,14,4,30,5,1,0,6,1,-15,3,1
2,0,27,1,30,4,11,0,15,3,30,1,1,0,2,0,30,6,9,0,15,0,30,7,8,0,15,3,30,6,0,0,6,1,-15,3,1
2,2,27,1,30,4,11,0,15,3,30,1,1,0,2,0,30,6,9,0,15,0,30,7,8,0,15,3,30,6,0,0,6,1,-15,3,1
2,4,27,1,30,4,11,0,15,2,30,1,1,0,2,0,30,6,9,0,15,0,30,7,8,0,15,3,30,6,0,0,6,1,-15,3,1
2,4,29,0,30,8,6,0,14,6,30,7,5,0,12,0,30,3,11,0,14,0,30,1,13,0,14,3,30,9,0,0,9,1,-15,3,1
2,1,4,0,30,6,2,0,8,5,30,4,0,0,4,0,30,1,7,0,8,0,30,7,1,0,8,3,30,4,0,0,4,0,-27,3,0
2,2,4,0,30,6,2,0,8,5,30,4,0,0,4,0,30,1,7,0,8,0,30,7,1,0,8,3,30,4,0,0,4,0,-27,3,0
2,0,5,0,30,2,3,0,5,3,30,4,0,0,4,0,30,0,5,0,5,0,30,1,4,0,5,0,30,2,0,0,2,0,-27,3,0
2,1,5,0,30,2,3,0,5,3,30,4,0,0,4,0,30,0,5,0,5,0,30,1,4,0,5,0,30,2,0,0,2,0,-27,3,0
2,2,6,1,30,8,1,0,9,4,30,2,0,0,2,0,30,2,7,0,9,0,30,3,6,0,9,0,30,4,1,0,5,0,-27,3,0
2,3,6,1,30,8,1,0,9,4,30,2,0,0,2,0,30,2,7,0,9,0,30,3,6,0,9,0,30,4,1,0,5,0,-27,3,0
2,4,7,1,30,6,3,0,9,2,30,3,1,0,4,0,30,7,2,0,9,4,30,2,7,0,9,1,30,4,2,0,6,0,-27,3,0
2,2,9,0,30,2,2,0,4,2,30,2,0,0,2,0,30,2,2,0,4,0,30,0,4,0,4,0,30,1,0,0,1,0,-27,3,0
2,1,13,1,30,6,1,0,7,0,30,4,0,0,4,8,30,7,0,0,7,8,30,4,3,0,7,4,30,4,0,0,4,1,-15,3,1
2,4,13,1,30,6,1,0,7,0,30,4,0,0,4,8,30,7,0,0,7,8,30,4,3,0,7,4,30,4,0,0,4,1,-15,3,1
2,3,17,2,30,7,7,0,14,3,30,6,0,0,6,0,30,5,9,0,14,2,30,8,6,0,14,4,30,4,0,0,4,1,-15,3,1
2,4,17,2,30,7,7,0,14,3,30,6,0,0,6,0,30,5,9,0,14,2,30,8,6,0,14,4,30,4,0,0,4,1,-15,3,1
2,1,27,0,30,4,11,0,15,3,30,2,0,0,2,0,30,3,12,0,15,0,30,7,8,0,15,4,30,6,0,0,6,1,-15,3,1
2,3,29,0,30,11,3,0,14,5,30,9,3,0,12,0,30,5,9,0,14,0,30,1,13,0,14,3,30,9,0,0,9,1,-15,3,1
2,4,29,0,30,11,3,0,14,5,30,9,3,0,12,0,30,5,9,0,14,0,30,1,13,0,14,3,30,9,0,0,9,1,-15,3,1
2,2,31,3,30,6,6,0,12,3,30,8,0,0,8,3,30,12,0,0,12,3,30,3,9,0,12,0,30,1,5,0,6,1,-15,3,1
2,3,31,3,30,6,6,0,12,3,30,8,0,0,8,3,30,12,0,0,12,3,30,3,9,0,12,0,30,1,5,0,6,1,-15,3,1
2,4,31,3,30,6,6,0,12,3,30,8,0,0,8,3,30,12,0,0,12,3,30,3,9,0,12,0,30,1,5,0,6,1,-15,3,1
2,4,1,0,30,7,3,0,10,4,30,2,0,0,2,1,30,4,6,0,10,3,30,7,3,0,10,6,30,6,0,0,6,0,-27,3,0
2,3,3,0,30,1,3,0,4,1,30,4,0,0,4,0,30,0,4,0,4,1,30,2,2,0,4,0,30,1,2,0,3,0,-27,3,0
2,1,5,0,30,0,5,0,5,3,30,0,4,0,4,0,30,1,4,0,5,0,30,1,4,0,5,0,30,2,0,0,2,0,-27,3,0
2,3,5,0,30,0,5,0,5,3,30,0,4,0,4,0,30,1,4,0,5,0,30,1,4,0,5,0,30,2,0,0,2,0,-27,3,0
2,3,8,1,30,7,0,0,7,4,30,2,0,0,2,1,30,3,4,0,7,1,30,7,0,0,7,2,30,3,0,0,3,0,-27,3,0
2,4,8,1,30,7,0,0,7,4,30,2,0,0,2,1,30,3,4,0,7,1,30,7,0,0,7,2,30,3,0,0,3,0,-27,3,0
2,4,13,2,30,5,2,0,7,1,30,4,0,0,4,0,30,6,1,0,7,5,30,6,1,0,7,4,30,4,0,0,4,1,-15,3,1
2,4,15,0,30,4,9,0,13,1,30,6,0,0,6,0,30,3,10,0,13,1,30,7,6,0,13,1,30,9,0,0,9,1,-15,3,1
2,1,17,5,30,9,5,0,14,3,30,6,0,0,6,0,30,7,7,0,14,1,30,6,8,0,14,2,30,4,0,0,4,1,-15,3,1
2,4,17,5,30,9,5,0,14,3,30,6,0,0,6,0,30,7,7,0,14,1,30,6,8,0,14,2,30,4,0,0,4,1,-15,3,1
2,4,23,3,30,5,8,0,13,4,30,6,0,0,6,8,30,10,3,0,13,0,30,6,7,0,13,1,30,5,1,0,6,1,-15,3,1
2,0,25,1,30,7,7,0,14,4,30,6,0,0,6,0,30,7,7,0,14,1,30,8,6,0,14,3,30,5,1,0,6,1,-15,3,1
2,1,25,1,30,7,7,0,14,4,30,6,0,0,6,0,30,7,7,0,14,1,30,8,6,0,14,3,30,5,1,0,6,1,-15,3,1
2,4,25,0,30,7,7,0,14,4,30,6,0,0,6,0,30,7,7,0,14,1,30,8,6,0,14,3,30,5,1,0,6,1,-15,3,1
2,0,27,1,30,4,11,0,15,2,30,2,0,0,2,0,30,5,10,0,15,2,30,4,11,0,15,3,30,6,0,0,6,1,-15,3,1
2,2,27,1,30,4,11,0,15,2,30,2,0,0,2,0,30,5,10,0,15,2,30,4,11,0,15,3,30,6,0,0,6,1,-15,3,1
2,3,27,1,30,4,11,0,15,2,30,2,0,0,2,0,30,5,10,0,15,2,30,4,11,0,15,3,30,6,0,0,6,1,-15,3,1
2,4,27,1,30,4,11,0,15,2,30,2,0,0,2,0,30,5,10,0,15,2,30,4,11,0,15,3,30,6,0,0,6,1,-15,3,1
2,3,29,0,30,5,9,0,14,6,30,12,0,0,12,0,30,3,11,0,14,0,30,1,13,0,14,2,30,9,0,0,9,1,-15,3,1
2,4,29,0,30,5,9,0,14,6,30,12,0,0,12,0,30,3,11,0,14,0,30,1,13,0,14,2,30,9,0,0,9,1,-15,3,1
2,3,31,1,30,10,2,0,12,3,30,8,0,0,8,3,30,10,2,0,12,0,30,3,9,0,12,0,30,3,3,0,6,1,-15,3,1
2,2,39,0,30,3,8,0,11,6,30,6,0,0,6,0,30,4,7,0,11,1,30,3,8,0,11,1,30,3,2,0,5,1,-15,3,1
2,2,5,0,30,2,3,0,5,3,30,3,1,0,4,0,30,0,5,0,5,0,30,1,4,0,5,0,30,1,1,0,2,0,-27,3,0
2,3,7,0,30,2,2,0,4,2,30,2,0,0,2,1,30,3,1,0,4,2,30,2,2,0,4,1,30,1,1,0,2,0,-27,3,0
2,2,11,0,30,9,3,0,12,0,30,4,0,0,4,0,30,8,4,0,12,3,30,5,7,0,12,4,30,4,0,0,4,1,-15,3,1
2,4,17,1,30,10,4,0,14,2,30,6,0,0,6,0,30,4,10,0,14,0,30,5,9,0,14,4,30,4,0,0,4,1,-15,3,1
2,3,19,0,30,3,10,0,13,2,30,6,2,0,8,0,30,5,8,0,13,4,30,5,8,0,13,1,30,9,0,0,9,1,-15,3,1
2,1,21,4,30,10,0,0,10,4,30,6,0,0,6,1,30,3,7,0,10,2,30,5,5,0,10,0,30,3,1,0,4,1,-15,3,1
2,3,23,1,30,6,7,0,13,4,30,6,0,0,6,7,30,11,2,0,13,0,30,5,8,0,13,2,30,6,0,0,6,1,-15,3,1
2,4,23,1,30,6,7,0,13,4,30,6,0,0,6,7,30,11,2,0,13,0,30,5,8,0,13,2,30,6,0,0,6,1,-15,3,1
2,3,25,1,30,5,9,0,14,4,30,6,0,0,6,0,30,6,8,0,14,3,30,6,8,0,14,5,30,5,1,0,6,1,-15,3,1
2,0,27,3,30,4,11,0,15,3,30,1,1,0,2,0,30,9,6,0,15,1,30,5,10,0,15,3,30,6,0,0,6,1,-15,3,1
2,3,39,0,30,4,7,0,11,7,30,6,0,0,6,0,30,5,6,0,11,2,30,4,7,0,11,5,30,5,0,0,5,1,-15,3,1
2,0,5,0,30,3,2,0,5,3,30,1,3,0,4,0,30,0,5,0,5,0,30,1,4,0,5,0,30,0,2,0,2,0,-27,3,0
2,4,8,2,30,7,0,0,7,3,30,2,0,0,2,3,30,4,3,0,7,1,30,7,0,0,7,1,30,3,0,0,3,0,-27,3,0
2,4,15,1,30,4,9,0,13,1,30,6,0,0,6,0,30,4,9,0,13,0,30,6,7,0,13,2,30,6,3,0,9,1,-15,3,1
2,1,17,4,30,8,6,0,14,3,30,6,0,0,6,0,30,7,7,0,14,2,30,8,6,0,14,3,30,4,0,0,4,1,-15,3,1
2,2,17,4,30,8,6,0,14,3,30,6,0,0,6,0,30,7,7,0,14,2,30,8,6,0,14,3,30,4,0,0,4,1,-15,3,1
2,3,23,1,30,5,8,0,13,4,30,6,0,0,6,7,30,11,2,0,13,0,30,5,8,0,13,4,30,6,0,0,6,1,-15,3,1
2,4,23,1,30,5,8,0,13,4,30,6,0,0,6,7,30,11,2,0,13,0,30,5,8,0,13,4,30,6,0,0,6,1,-15,3,1
2,3,25,1,30,8,6,0,14,3,30,6,0,0,6,0,30,6,8,0,14,1,30,5,9,0,14,4,30,5,1,0,6,1,-15,3,1
2,1,27,1,30,4,11,0,15,3,30,2,0,0,2,0,30,5,10,0,15,0,30,5,10,0,15,6,30,6,0,0,6,1,-15,3,1
2,1,29,0,30,4,10,0,14,6,30,10,2,0,12,0,30,3,11,0,14,0,30,5,9,0,14,3,30,9,0,0,9,1,-15,3,1
2,2,29,0,30,4,10,0,14,6,30,10,2,0,12,0,30,3,11,0,14,0,30,5,9,0,14,3,30,9,0,0,9,1,-15,3,1
2,3,31,1,30,7,5,0,12,5,30,8,0,0,8,3,30,8,4,0,12,2,30,6,6,0,12,0,30,5,1,0,6,1,-15,3,1
2,0,1,0,30,7,3,0,10,4,30,2,0,0,2,1,30,4,6,0,10,4,30,6,4,0,10,6,30,6,0,0,6,0,-27,3,0
2,1,1,0,30,7,3,0,10,4,30,2,0,0,2,1,30,4,6,0,10,4,30,6,4,0,10,6,30,6,0,0,6,0,-27,3,0
2,2,1,0,30,7,3,0,10,4,30,2,0,0,2,1,30,4,6,0,10,4,30,6,4,0,10,6,30,6,0,0,6,0,-27,3,0
2,3,6,0,30,7,2,0,9,4,30,2,0,0,2,0,30,2,7,0,9,0,30,4,5,0,9,0,30,5,0,0,5,0,-27,3,0
2,4,7,0,30,2,2,0,4,2,30,2,0,0,2,0,30,1,3,0,4,0,30,1,3,0,4,2,30,2,0,0,2,0,-27,3,0
2,3,8,1,30,7,0,0,7,3,30,2,0,0,2,4,30,5,2,0,7,1,30,7,0,0,7,0,30,3,0,0,3,0,-27,3,0
2,4,8,1,30,7,0,0,7,3,30,2,0,0,2,4,30,5,2,0,7,1,30,7,0,0,7,0,30,3,0,0,3,0,-27,3,0
2,4,11,1,30,5,7,0,12,1,30,4,0,0,4,0,30,5,7,0,12,0,30,5,7,0,12,3,30,4,0,0,4,1,-15,3,1
2,2,13,1,30,6,1,0,7,0,30,4,0,0,4,2,30,5,2,0,7,6,30,6,1,0,7,3,30,4,0,0,4,1,-15,3,1
2,3,13,1,30,6,1,0,7,0,30,4,0,0,4,2,30,5,2,0,7,6,30,6,1,0,7,3,30,4,0,0,4,1,-15,3,1
2,4,27,4,30,7,8,0,15,3,30,2,0,0,2,0,30,8,7,0,15,0,30,5,10,0,15,1,30,4,2,0,6,1,-15,3,1
2,2,29,0,30,5,9,0,14,6,30,12,0,0,12,0,30,6,8,0,14,0,30,1,13,0,14,3,30,9,0,0,9,1,-15,3,1
2,4,29,0,30,5,9,0,14,6,30,12,0,0,12,0,30,6,8,0,14,0,30,1,13,0,14,3,30,9,0,0,9,1,-15,3,1
2,1,39,0,30,4,7,0,11,6,30,5,1,0,6,0,30,5,6,0,11,0,30,2,9,0,11,5,30,5,0,0,5,1,-15,3,1
2,2,39,0,30,4,7,0,11,6,30,5,1,0,6,0,30,5,6,0,11,0,30,2,9,0,11,5,30,5,0,0,5,1,-15,3,1
2,3,39,0,30,4,7,0,11,6,30,5,1,0,6,0,30,5,6,0,11,0,30,2,9,0,11,5,30,5,0,0,5,1,-15,3,1
2,4,39,0,30,4,7,0,11,6,30,5,1,0,6,0,30,5,6,0,11,0,30,2,9,0,11,5,30,5,0,0,5,1,-15,3,1
2,0,5,0,30,2,3,0,5,3,30,2,2,0,4,0,30,0,5,0,5,0,30,1,4,0,5,2,30,2,0,0,2,0,-27,3,0
2,2,5,0,30,2,3,0,5,3,30,2,2,0,4,0,30,0,5,0,5,0,30,1,4,0,5,1,30,2,0,0,2,0,-27,3,0
2,4,5,0,30,2,3,0,5,3,30,2,2,0,4,0,30,0,5,0,5,0,30,1,4,0,5,1,30,2,0,0,2,0,-27,3,0
2,4,8,2,30,7,0,0,7,3,30,2,0,0,2,0,30,7,0,0,7,0,30,6,1,0,7,0,30,3,0,0,3,0,-27,3,0
2,4,17,2,30,9,5,0,14,2,30,6,0,0,6,0,30,6,8,0,14,1,30,5,9,0,14,4,30,4,0,0,4,1,-15,3,1
2,0,19,0,30,3,10,0,13,3,30,8,0,0,8,0,30,5,8,0,13,7,30,7,6,0,13,1,30,8,1,0,9,1,-15,3,1
2,1,19,0,30,3,10,0,13,3,30,8,0,0,8,0,30,5,8,0,13,7,30,7,6,0,13,1,30,8,1,0,9,1,-15,3,1
2,2,25,4,30,7,7,0,14,1,30,6,0,0,6,0,30,9,5,0,14,1,30,4,10,0,14,4,30,5,1,0,6,1,-15,3,1
2,4,25,4,30,7,7,0,14,1,30,6,0,0,6,0,30,9,5,0,14,1,30,4,10,0,14,4,30,5,1,0,6,1,-15,3,1
2,3,29,0,30,6,8,0,14,6,30,12,0,0,12,0,30,3,11,0,14,0,30,0,14,0,14,3,30,9,0,0,9,1,-15,3,1
2,0,4,0,30,6,2,0,8,5,30,3,1,0,4,0,30,1,7,0,8,1,30,7,1,0,8,3,30,3,1,0,4,0,-27,3,0
2,2,4,0,30,6,2,0,8,5,30,3,1,0,4,0,30,1,7,0,8,1,30,7,1,0,8,3,30,3,1,0,4,0,-27,3,0
2,4,4,0,30,6,2,0,8,5,30,3,1,0,4,0,30,1,7,0,8,1,30,7,1,0,8,3,30,3,1,0,4,0,-27,3,0
2,0,5,0,30,3,2,0,5,3,30,3,1,0,4,0,30,0,5,0,5,0,30,1,4,0,5,0,30,2,0,0,2,0,-27,3,0
2,2,13,2,30,3,0,0,3,0,30,2,0,0,2,1,30,3,0,0,3,7,30,2,1,0,3,4,30,2,0,0,2,1,-15,3,1
2,4,13,2,30,3,0,0,3,0,30,2,0,0,2,1,30,3,0,0,3,7,30,2,1,0,3,4,30,2,0,0,2,1,-15,3,1
2,1,13,1,30,7,0,0,7,0,30,4,0,0,4,2,30,7,0,0,7,8,30,6,1,0,7,5,30,4,0,0,4,1,-15,3,1
2,2,13,1,30,7,0,0,7,0,30,4,0,0,4,2,30,7,0,0,7,8,30,6,1,0,7,5,30,4,0,0,4,1,-15,3,1
2,1,17,4,30,11,3,0,14,3,30,6,0,0,6,0,30,4,10,0,14,2,30,5,9,0,14,4,30,4,0,0,4,1,-15,3,1
2,1,19,0,30,3,10,0,13,2,30,6,2,0,8,0,30,5,8,0,13,9,30,4,9,0,13,0,30,8,1,0,9,1,-15,3,1
2,1,23,1,30,4,9,0,13,3,30,6,0,0,6,4,30,12,1,0,13,3,30,6,7,0,13,1,30,6,0,0,6,1,-15,3,1
2,2,23,1,30,4,9,0,13,3,30,6,0,0,6,4,30,12,1,0,13,3,30,6,7,0,13,1,30,6,0,0,6,1,-15,3,1
2,4,23,1,30,4,9,0,13,3,30,6,0,0,6,4,30,12,1,0,13,3,30,6,7,0,13,1,30,6,0,0,6,1,-15,3,1
2,1,27,5,30,4,11,0,15,4,30,1,1,0,2,0,30,6,9,0,15,1,30,4,11,0,15,0,30,5,1,0,6,1,-15,3,1
2,3,27,5,30,4,11,0,15,4,30,1,1,0,2,0,30,6,9,0,15,1,30,4,11,0,15,0,30,5,1,0,6,1,-15,3,1
2,2,29,0,30,4,10,0,14,5,30,11,1,0,12,0,30,6,8,0,14,0,30,0,14,0,14,2,30,9,0,0,9,1,-15,3,1
2,0,37,3,30,8,3,0,11,5,30,6,2,0,8,1,30,9,2,0,11,2,30,4,7,0,11,3,30,5,1,0,6,1,-15,3,1
2,1,37,3,30,8,3,0,11,5,30,6,2,0,8,1,30,9,2,0,11,2,30,4,7,0,11,3,30,5,1,0,6,1,-15,3,1
2,3,37,3,30,8,3,0,11,5,30,6,2,0,8,1,30,9,2,0,11,2,30,4,7,0,11,3,30,5,1,0,6,1,-15,3,1
2,4,37,3,30,8,3,0,11,5,30,6,2,0,8,1,30,9,2,0,11,2,30,4,7,0,11,3,30,5,1,0,6,1,-15,3,1
2,0,38,0,30,7,3,0,10,7,30,6,0,0,6,0,30,2,8,0,10,0,30,2,8,0,10,2,30,6,0,0,6,1,-15,3,1
2,2,38,0,30,7,3,0,10,7,30,6,0,0,6,0,30,2,8,0,10,0,30,2,8,0,10,2,30,6,0,0,6,1,-15,3,1
2,4,41,0,30,6,6,0,12,6,30,8,0,0,8,0,30,7,5,0,12,0,30,3,9,0,12,1,30,5,2,0,7,1,-15,3,1
2,3,43,0,30,5,9,0,14,6,30,6,0,0,6,0,30,7,7,0,14,1,30,1,13,0,14,2,30,5,0,0,5,1,-15,3,1
2,1,4,2,30,6,2,0,8,5,30,4,0,0,4,0,30,3,5,0,8,2,30,8,0,0,8,3,30,4,0,0,4,0,-27,3,0
2,4,4,2,30,6,2,0,8,5,30,4,0,0,4,0,30,3,5,0,8,0,30,8,0,0,8,3,30,4,0,0,4,0,-27,3,0
2,0,5,0,30,2,3,0,5,3,30,4,0,0,4,0,30,0,5,0,5,2,30,1,4,0,5,0,30,2,0,0,2,0,-27,3,0
2,3,5,0,30,2,3,0,5,3,30,4,0,0,4,0,30,0,5,0,5,1,30,1,4,0,5,0,30,2,0,0,2,0,-27,3,0
2,4,5,0,30,2,3,0,5,3,30,4,0,0,4,0,30,0,5,0,5,1,30,1,4,0,5,0,30,2,0,0,2,0,-27,3,0
2,4,13,4,30,7,0,0,7,2,30,4,0,0,4,2,30,6,1,0,7,2,30,5,2,0,7,2,30,4,0,0,4,1,-15,3,1
2,2,17,3,30,7,7,0,14,3,30,6,0,0,6,0,30,7,7,0,14,2,30,9,5,0,14,8,30,4,0,0,4,1,-15,3,1
2,2,19,1,30,5,8,0,13,1,30,6,2,0,8,0,30,4,9,0,13,0,30,7,6,0,13,2,30,8,1,0,9,1,-15,3,1
2,4,19,1,30,5,8,0,13,1,30,6,2,0,8,0,30,4,9,0,13,0,30,7,6,0,13,2,30,8,1,0,9,1,-15,3,1
2,3,21,2,30,6,4,0,10,4,30,6,0,0,6,1,30,3,7,0,10,2,30,4,6,0,10,0,30,4,0,0,4,1,-15,3,1
2,4,23,1,30,6,7,0,13,3,30,6,0,0,6,9,30,13,0,0,13,0,30,5,8,0,13,2,30,6,0,0,6,1,-15,3,1
2,2,25,1,30,10,4,0,14,4,30,6,0,0,6,0,30,6,8,0,14,1,30,5,9,0,14,5,30,5,1,0,6,1,-15,3,1
2,2,26,4,30,8,1,0,9,6,30,4,0,0,4,5,30,0,9,0,9,0,30,2,7,0,9,4,30,2,1,0,3,1,-15,3,1
2,4,26,4,30,8,1,0,9,6,30,4,0,0,4,5,30,0,9,0,9,0,30,2,7,0,9,4,30,2,1,0,3,1,-15,3,1
2,0,27,1,30,5,10,0,15,4,30,2,0,0,2,0,30,6,9,0,15,0,30,4,11,0,15,1,30,3,3,0,6,1,-15,3,1
2,2,27,1,30,5,10,0,15,4,30,2,0,0,2,0,30,6,9,0,15,0,30,4,11,0,15,1,30,3,3,0,6,1,-15,3,1
2,3,27,1,30,5,10,0,15,4,30,2,0,0,2,0,30,6,9,0,15,0,30,4,11,0,15,1,30,3,3,0,6,1,-15,3,1
2,0,5,0,30,2,3,0,5,3,30,2,2,0,4,0,30,0,5,0,5,0,30,1,4,0,5,0,30,2,0,0,2,0,-27,3,0
2,2,5,0,30,2,3,0,5,3,30,2,2,0,4,0,30,0,5,0,5,0,30,1,4,0,5,0,30,2,0,0,2,0,-27,3,0
2,2,6,1,30,7,2,0,9,4,30,2,0,0,2,0,30,2,7,0,9,0,30,4,5,0,9,0,30,3,2,0,5,0,-27,3,0
2,3,6,1,30,7,2,0,9,4,30,2,0,0,2,0,30,2,7,0,9,0,30,4,5,0,9,0,30,3,2,0,5,0,-27,3,0
2,3,15,0,30,4,9,0,13,1,30,6,0,0,6,0,30,7,6,0,13,1,30,7,6,0,13,5,30,9,0,0,9,1,-15,3,1
2,1,17,1,30,7,7,0,14,2,30,6,0,0,6,1,30,8,6,0,14,2,30,5,9,0,14,3,30,4,0,0,4,1,-15,3,1
2,2,17,1,30,7,7,0,14,2,30,6,0,0,6,1,30,8,6,0,14,2,30,5,9,0,14,3,30,4,0,0,4,1,-15,3,1
2,3,17,1,30,7,7,0,14,2,30,6,0,0,6,1,30,8,6,0,14,2,30,5,9,0,14,3,30,4,0,0,4,1,-15,3,1
2,1,27,1,30,8,7,0,15,3,30,2,0,0,2,0,30,5,10,0,15,2,30,3,12,0,15,1,30,6,0,0,6,1,-15,3,1
2,4,27,1,30,8,7,0,15,3,30,2,0,0,2,0,30,5,10,0,15,1,30,3,12,0,15,1,30,6,0,0,6,1,-15,3,1
2,2,29,0,30,6,8,0,14,6,30,12,0,0,12,0,30,5,9,0,14,0,30,1,13,0,14,1,30,9,0,0,9,1,-15,3,1
2,4,29,0,30,6,8,0,14,6,30,12,0,0,12,0,30,5,9,0,14,0,30,1,13,0,14,0,30,9,0,0,9,1,-15,3,1
2,0,47,0,30,2,12,0,14,5,30,4,0,0,4,0,30,7,7,0,14,1,30,2,12,0,14,7,30,7,0,0,7,1,-15,3,1
2,1,47,0,30,2,12,0,14,5,30,4,0,0,4,0,30,7,7,0,14,1,30,2,12,0,14,7,30,7,0,0,7,1,-15,3,1
2,3,47,0,30,2,12,0,14,5,30,4,0,0,4,0,30,7,7,0,14,1,30,2,12,0,14,7,30,7,0,0,7,1,-15,3,1
2,2,13,3,30,5,2,0,7,0,30,4,0,0,4,1,30,7,0,0,7,11,30,6,1,0,7,4,30,4,0,0,4,1,-15,3,1
2,4,13,3,30,5,2,0,7,0,30,4,0,0,4,1,30,7,0,0,7,11,30,6,1,0,7,4,30,4,0,0,4,1,-15,3,1
2,0,19,0,30,2,11,0,13,3,30,5,3,0,8,6,30,5,8,0,13,3,30,8,5,0,13,1,30,8,1,0,9,1,-15,3,1
2,1,19,0,30,2,11,0,13,3,30,5,3,0,8,6,30,5,8,0,13,3,30,8,5,0,13,1,30,8,1,0,9,1,-15,3,1
2,2,19,0,30,2,11,0,13,3,30,5,3,0,8,6,30,5,8,0,13,3,30,8,5,0,13,1,30,8,1,0,9,1,-15,3,1
2,4,19,0,30,2,11,0,13,3,30,5,3,0,8,6,30,5,8,0,13,0,30,8,5,0,13,1,30,8,1,0,9,1,-15,3,1
2,2,25,2,30,7,7,0,14,2,30,6,0,0,6,0,30,9,5,0,14,1,30,5,9,0,14,3,30,5,1,0,6,1,-15,3,1
2,4,25,2,30,7,7,0,14,2,30,6,0,0,6,0,30,9,5,0,14,1,30,5,9,0,14,3,30,5,1,0,6,1,-15,3,1
2,4,1,0,30,7,3,0,10,4,30,2,0,0,2,0,30,4,6,0,10,7,30,7,3,0,10,6,30,6,0,0,6,0,-27,3,0
2,2,4,2,30,6,2,0,8,5,30,4,0,0,4,1,30,2,6,0,8,4,30,8,0,0,8,0,30,3,1,0,4,0,-27,3,0
2,3,4,2,30,6,2,0,8,5,30,4,0,0,4,1,30,2,6,0,8,4,30,8,0,0,8,0,30,3,1,0,4,0,-27,3,0
2,4,4,2,30,6,2,0,8,5,30,4,0,0,4,1,30,2,6,0,8,4,30,8,0,0,8,0,30,3,1,0,4,0,-27,3,0
2,4,8,7,30,7,0,0,7,3,30,2,0,0,2,4,30,4,3,0,7,0,30,1,6,0,7,0,30,3,0,0,3,0,-27,3,0
2,3,11,0,30,1,3,0,4,0,30,0,0,0,0,0,30,3,1,0,4,4,30,4,0,0,4,0,30,1,0,0,1,1,-15,3,1
2,1,13,3,30,5,2,0,7,0,30,4,0,0,4,2,30,6,1,0,7,5,30,7,0,0,7,5,30,4,0,0,4,1,-15,3,1
2,3,13,3,30,5,2,0,7,0,30,4,0,0,4,2,30,6,1,0,7,5,30,7,0,0,7,5,30,4,0,0,4,1,-15,3,1
2,4,17,0,30,9,5,0,14,3,30,6,0,0,6,0,30,4,10,0,14,4,30,7,7,0,14,1,30,3,1,0,4,1,-15,3,1
2,2,19,0,30,4,9,0,13,0,30,7,1,0,8,2,30,8,5,0,13,1,30,3,10,0,13,0,30,8,1,0,9,1,-15,3,1
2,3,31,4,30,6,6,0,12,4,30,8,0,0,8,3,30,8,4,0,12,0,30,3,9,0,12,1,30,2,4,0,6,1,-15,3,1
2,1,37,1,30,8,3,0,11,5,30,6,2,0,8,0,30,6,5,0,11,7,30,3,8,0,11,8,30,6,0,0,6,1,-15,3,1
2,4,4,2,30,8,0,0,8,5,30,4,0,0,4,0,30,1,7,0,8,2,30,6,2,0,8,2,30,4,0,0,4,0,-27,3,0
2,2,5,0,30,2,3,0,5,2,30,4,0,0,4,0,30,0,5,0,5,0,30,1,4,0,5,0,30,1,1,0,2,0,-27,3,0
2,2,17,8,30,11,3,0,14,3,30,6,0,0,6,0,30,5,9,0,14,1,30,5,9,0,14,2,30,4,0,0,4,1,-15,3,1
2,3,17,8,30,11,3,0,14,3,30,6,0,0,6,0,30,5,9,0,14,1,30,5,9,0,14,2,30,4,0,0,4,1,-15,3,1
2,4,17,8,30,11,3,0,14,3,30,6,0,0,6,0,30,5,9,0,14,1,30,5,9,0,14,2,30,4,0,0,4,1,-15,3,1
2,4,19,0,30,4,9,0,13,0,30,7,1,0,8,0,30,7,6,0,13,8,30,5,8,0,13,1,30,7,2,0,9,1,-15,3,1
2,2,23,2,30,5,8,0,13,3,30,6,0,0,6,6,30,13,0,0,13,0,30,5,8,0,13,2,30,6,0,0,6,1,-15,3,1
2,4,23,2,30,5,8,0,13,3,30,6,0,0,6,6,30,13,0,0,13,0,30,5,8,0,13,2,30,6,0,0,6,1,-15,3,1
2,2,25,1,30,6,8,0,14,4,30,6,0,0,6,0,30,5,9,0,14,3,30,5,9,0,14,5,30,6,0,0,6,1,-15,3,1
2,3,25,1,30,6,8,0,14,4,30,6,0,0,6,0,30,5,9,0,14,3,30,5,9,0,14,5,30,6,0,0,6,1,-15,3,1
2,4,25,1,30,6,8,0,14,4,30,6,0,0,6,0,30,5,9,0,14,3,30,5,9,0,14,5,30,6,0,0,6,1,-15,3,1
2,2,5,0,30,2,3,0,5,3,30,3,1,0,4,1,30,0,5,0,5,0,30,1,4,0,5,0,30,0,2,0,2,0,-27,3,0
2,1,6,2,30,7,2,0,9,4,30,2,0,0,2,0,30,2,7,0,9,0,30,4,5,0,9,0,30,3,2,0,5,0,-27,3,0
2,2,6,2,30,7,2,0,9,4,30,2,0,0,2,0,30,2,7,0,9,0,30,4,5,0,9,0,30,3,2,0,5,0,-27,3,0
2,3,8,2,30,7,0,0,7,4,30,2,0,0,2,3,30,4,3,0,7,2,30,6,1,0,7,0,30,3,0,0,3,0,-27,3,0
2,3,9,2,30,9,2,0,11,3,30,6,0,0,6,1,30,7,4,0,11,0,30,2,9,0,11,2,30,3,1,0,4,0,-27,3,0
2,4,9,2,30,9,2,0,11,3,30,6,0,0,6,1,30,7,4,0,11,0,30,2,9,0,11,2,30,3,1,0,4,0,-27,3,0
2,2,13,4,30,3,0,0,3,0,30,2,0,0,2,0,30,3,0,0,3,7,30,2,1,0,3,3,30,2,0,0,2,1,-15,3,1
2,1,13,3,30,7,0,0,7,0,30,4,0,0,4,2,30,6,1,0,7,8,30,6,1,0,7,3,30,4,0,0,4,1,-15,3,1
2,2,17,4,30,11,3,0,14,2,30,6,0,0,6,0,30,4,10,0,14,1,30,6,8,0,14,1,30,3,1,0,4,1,-15,3,1
2,4,17,4,30,11,3,0,14,2,30,6,0,0,6,0,30,4,10,0,14,1,30,6,8,0,14,1,30,3,1,0,4,1,-15,3,1
2,2,19,0,30,4,9,0,13,2,30,5,3,0,8,0,30,4,9,0,13,4,30,4,9,0,13,2,30,9,0,0,9,1,-15,3,1
2,3,19,0,30,4,9,0,13,2,30,5,3,0,8,0,30,4,9,0,13,4,30,4,9,0,13,2,30,9,0,0,9,1,-15,3,1
2,4,19,0,30,4,9,0,13,2,30,5,3,0,8,0,30,4,9,0,13,4,30,4,9,0,13,2,30,9,0,0,9,1,-15,3,1
2,2,23,3,30,6,7,0,13,3,30,6,0,0,6,5,30,11,2,0,13,0,30,6,7,0,13,3,30,6,0,0,6,1,-15,3,1
2,3,23,3,30,6,7,0,13,3,30,6,0,0,6,5,30,11,2,0,13,0,30,6,7,0,13,3,30,6,0,0,6,1,-15,3,1
2,4,23,3,30,6,7,0,13,3,30,6,0,0,6,5,30,11,2,0,13,0,30,6,7,0,13,3,30,6,0,0,6,1,-15,3,1
2,1,27,2,30,3,12,0,15,5,30,2,0,0,2,0,30,2,13,0,15,2,30,3,12,0,15,4,30,6,0,0,6,1,-15,3,1
2,2,27,2,30,3,12,0,15,5,30,2,0,0,2,0,30,2,13,0,15,2,30,3,12,0,15,4,30,6,0,0,6,1,-15,3,1
2,3,27,2,30,3,12,0,15,5,30,2,0,0,2,0,30,2,13,0,15,2,30,3,12,0,15,4,30,6,0,0,6,1,-15,3,1
2,2,29,0,30,7,7,0,14,6,30,12,0,0,12,1,30,4,10,0,14,0,30,1,13,0,14,2,30,9,0,0,9,1,-15,3,1
2,4,31,1,30,8,4,0,12,3,30,8,0,0,8,3,30,12,0,0,12,0,30,3,9,0,12,1,30,2,4,0,6,1,-15,3,1
2,3,4,2,30,7,1,0,8,4,30,2,2,0,4,2,30,1,7,0,8,0,30,6,2,0,8,3,30,4,0,0,4,0,-27,3,0
2,1,5,0,30,1,4,0,5,2,30,2,2,0,4,0,30,1,4,0,5,0,30,1,4,0,5,0,30,1,1,0,2,0,-27,3,0
2,2,5,0,30,1,4,0,5,2,30,2,2,0,4,0,30,1,4,0,5,0,30,1,4,0,5,0,30,1,1,0,2,0,-27,3,0
2,0,11,2,30,5,7,0,12,3,30,4,0,0,4,0,30,2,10,0,12,3,30,7,5,0,12,3,30,4,0,0,4,1,-15,3,1
2,2,11,2,30,5,7,0,12,3,30,4,0,0,4,0,30,2,10,0,12,3,30,7,5,0,12,3,30,4,0,0,4,1,-15,3,1
2,4,15,0,30,6,7,0,13,1,30,6,0,0,6,0,30,4,9,0,13,2,30,4,9,0,13,0,30,7,2,0,9,1,-15,3,1
2,1,17,3,30,8,6,0,14,1,30,6,0,0,6,0,30,8,6,0,14,6,30,5,9,0,14,5,30,4,0,0,4,1,-15,3,1
2,2,17,3,30,8,6,0,14,1,30,6,0,0,6,0,30,8,6,0,14,6,30,5,9,0,14,5,30,4,0,0,4,1,-15,3,1
2,3,17,3,30,8,6,0,14,1,30,6,0,0,6,0,30,8,6,0,14,6,30,5,9,0,14,5,30,4,0,0,4,1,-15,3,1
2,4,17,3,30,8,6,0,14,1,30,6,0,0,6,0,30,8,6,0,14,6,30,5,9,0,14,5,30,4,0,0,4,1,-15,3,1
2,2,19,3,30,3,10,0,13,0,30,7,1,0,8,0,30,7,6,0,13,4,30,4,9,0,13,0,30,6,3,0,9,1,-15,3,1
2,4,19,3,30,3,10,0,13,0,30,7,1,0,8,0,30,7,6,0,13,4,30,4,9,0,13,0,30,6,3,0,9,1,-15,3,1
2,3,23,2,30,7,6,0,13,1,30,6,0,0,6,1,30,13,0,0,13,1,30,5,8,0,13,4,30,6,0,0,6,1,-15,3,1
2,2,25,0,30,8,6,0,14,3,30,6,0,0,6,0,30,10,4,0,14,1,30,5,9,0,14,3,30,6,0,0,6,1,-15,3,1
2,3,27,1,30,4,11,0,15,4,30,1,1,0,2,0,30,5,10,0,15,0,30,4,11,0,15,2,30,6,0,0,6,1,-15,3,1
2,4,27,1,30,4,11,0,15,4,30,1,1,0,2,0,30,5,10,0,15,0,30,4,11,0,15,2,30,6,0,0,6,1,-15,3,1
2,2,29,0,30,4,10,0,14,5,30,11,1,0,12,0,30,9,5,0,14,0,30,0,14,0,14,2,30,9,0,0,9,1,-15,3,1
2,3,29,0,30,4,10,0,14,5,30,11,1,0,12,0,30,9,5,0,14,0,30,0,14,0,14,2,30,9,0,0,9,1,-15,3,1
2,4,31,1,30,9,3,0,12,4,30,8,0,0,8,4,30,9,3,0,12,0,30,3,9,0,12,0,30,4,2,0,6,1,-15,3,1
2,4,1,0,30,7,3,0,10,4,30,2,0,0,2,1,30,3,7,0,10,4,30,4,6,0,10,5,30,6,0,0,6,0,-27,3,0
2,4,8,2,30,7,0,0,7,4,30,2,0,0,2,3,30,3,4,0,7,0,30,6,1,0,7,2,30,3,0,0,3,0,-27,3,0
2,4,15,0,30,4,9,0,13,1,30,6,0,0,6,0,30,3,10,0,13,1,30,4,9,0,13,2,30,9,0,0,9,1,-15,3,1
2,4,19,0,30,3,10,0,13,1,30,4,4,0,8,0,30,8,5,0,13,5,30,6,7,0,13,1,30,8,1,0,9,1,-15,3,1
2,2,26,0,30,9,0,0,9,4,30,4,0,0,4,2,30,2,7,0,9,0,30,2,7,0,9,5,30,3,0,0,3,1,-15,3,1
2,3,26,0,30,9,0,0,9,4,30,4,0,0,4,2,30,2,7,0,9,0,30,2,7,0,9,5,30,3,0,0,3,1,-15,3,1
2,1,27,1,30,6,9,0,15,4,30,2,0,0,2,0,30,6,9,0,15,2,30,4,11,0,15,0,30,5,1,0,6,1,-15,3,1
2,3,27,1,30,6,9,0,15,4,30,2,0,0,2,0,30,6,9,0,15,2,30,4,11,0,15,0,30,5,1,0,6,1,-15,3,1
2,4,27,1,30,6,9,0,15,4,30,2,0,0,2,0,30,6,9,0,15,2,30,4,11,0,15,0,30,5,1,0,6,1,-15,3,1
2,2,29,0,30,9,5,0,14,5,30,12,0,0,12,0,30,3,11,0,14,0,30,1,13,0,14,0,30,9,0,0,9,1,-15,3,1
2,4,29,0,30,9,5,0,14,5,30,12,0,0,12,0,30,3,11,0,14,0,30,1,13,0,14,0,30,9,0,0,9,1,-15,3,1
2,4,31,7,30,8,4,0,12,5,30,8,0,0,8,3,30,8,4,0,12,0,30,3,9,0,12,0,30,2,4,0,6,1,-15,3,1
2,1,33,3,30,2,9,0,11,5,30,4,0,0,4,3,30,11,0,0,11,2,30,3,8,0,11,4,30,4,0,0,4,1,-15,3,1
2,3,33,3,30,2,9,0,11,5,30,4,0,0,4,3,30,11,0,0,11,0,30,3,8,0,11,4,30,4,0,0,4,1,-15,3,1
2,3,39,0,30,8,3,0,11,7,30,6,0,0,6,0,30,4,7,0,11,0,30,2,9,0,11,6,30,5,0,0,5,1,-15,3,1
2,1,41,0,30,6,6,0,12,6,30,8,0,0,8,0,30,2,10,0,12,0,30,3,9,0,12,5,30,7,0,0,7,1,-15,3,1
2,2,41,0,30,6,6,0,12,6,30,8,0,0,8,0,30,2,10,0,12,0,30,3,9,0,12,5,30,7,0,0,7,1,-15,3,1
2,4,41,0,30,6,6,0,12,6,30,8,0,0,8,0,30,2,10,0,12,0,30,3,9,0,12,5,30,7,0,0,7,1,-15,3,1
2,1,5,0,30,4,1,0,5,3,30,4,0,0,4,0,30,0,5,0,5,0,30,1,4,0,5,0,30,1,1,0,2,0,-27,3,0
2,4,5,0,30,4,1,0,5,3,30,4,0,0,4,0,30,0,5,0,5,0,30,1,4,0,5,0,30,1,1,0,2,0,-27,3,0
2,4,7,0,30,1,3,0,4,2,30,2,0,0,2,0,30,1,3,0,4,0,30,1,3,0,4,1,30,1,1,0,2,0,-27,3,0
2,3,8,1,30,7,0,0,7,3,30,2,0,0,2,3,30,4,3,0,7,1,30,7,0,0,7,0,30,3,0,0,3,0,-27,3,0
2,4,8,1,30,7,0,0,7,3,30,2,0,0,2,3,30,4,3,0,7,1,30,7,0,0,7,0,30,3,0,0,3,0,-27,3,0
2,2,13,5,30,7,0,0,7,0,30,4,0,0,4,2,30,7,0,0,7,11,30,6,1,0,7,0,30,4,0,0,4,1,-15,3,1
2,0,17,2,30,9,5,0,14,3,30,6,0,0,6,0,30,4,10,0,14,5,30,5,9,0,14,2,30,4,0,0,4,1,-15,3,1
2,4,17,0,30,9,5,0,14,3,30,6,0,0,6,0,30,4,10,0,14,5,30,5,9,0,14,2,30,4,0,0,4,1,-15,3,1
2,2,25,1,30,6,8,0,14,2,30,6,0,0,6,1,30,14,0,0,14,1,30,5,9,0,14,2,30,5,1,0,6,1,-15,3,1
2,4,25,1,30,6,8,0,14,2,30,6,0,0,6,1,30,14,0,0,14,1,30,5,9,0,14,2,30,5,1,0,6,1,-15,3,1
2,0,27,1,30,4,11,0,15,2,30,2,0,0,2,0,30,5,10,0,15,2,30,3,12,0,15,5,30,6,0,0,6,1,-15,3,1
2,1,27,1,30,4,11,0,15,2,30,2,0,0,2,0,30,5,10,0,15,2,30,3,12,0,15,5,30,6,0,0,6,1,-15,3,1
2,2,27,1,30,4,11,0,15,2,30,2,0,0,2,0,30,5,10,0,15,2,30,3,12,0,15,5,30,6,0,0,6,1,-15,3,1
2,4,27,1,30,4,11,0,15,2,30,2,0,0,2,0,30,5,10,0,15,2,30,3,12,0,15,5,30,6,0,0,6,1,-15,3,1
2,1,31,5,30,6,6,0,12,4,30,8,0,0,8,5,30,12,0,0,12,0,30,6,6,0,12,0,30,4,2,0,6,1,-15,3,1
2,3,31,5,30,6,6,0,12,4,30,8,0,0,8,5,30,12,0,0,12,0,30,6,6,0,12,0,30,4,2,0,6,1,-15,3,1
2,3,32,0,30,7,2,0,9,3,30,2,0,0,2,0,30,9,0,0,9,1,30,2,7,0,9,3,30,2,0,0,2,1,-15,3,1
2,2,5,0,30,1,4,0,5,3,30,2,2,0,4,0,30,1,4,0,5,0,30,1,4,0,5,0,30,1,1,0,2,0,-27,3,0
2,3,5,0,30,1,4,0,5,3,30,2,2,0,4,0,30,1,4,0,5,0,30,1,4,0,5,0,30,1,1,0,2,0,-27,3,0
2,4,8,2,30,7,0,0,7,4,30,2,0,0,2,0,30,2,5,0,7,0,30,4,3,0,7,5,30,3,0,0,3,0,-27,3,0
2,4,15,0,30,4,9,0,13,0,30,6,0,0,6,0,30,4,9,0,13,0,30,3,10,0,13,0,30,9,0,0,9,1,-15,3,1
2,2,17,3,30,7,7,0,14,2,30,6,0,0,6,0,30,7,7,0,14,4,30,6,8,0,14,6,30,4,0,0,4,1,-15,3,1
2,3,17,3,30,7,7,0,14,2,30,6,0,0,6,0,30,7,7,0,14,4,30,6,8,0,14,6,30,4,0,0,4,1,-15,3,1
2,4,17,3,30,7,7,0,14,2,30,6,0,0,6,0,30,7,7,0,14,4,30,6,8,0,14,6,30,4,0,0,4,1,-15,3,1
2,2,25,2,30,5,9,0,14,4,30,6,0,0,6,0,30,9,5,0,14,1,30,7,7,0,14,4,30,5,1,0,6,1,-15,3,1
2,0,27,1,30,4,11,0,15,3,30,2,0,0,2,0,30,3,12,0,15,0,30,6,9,0,15,5,30,6,0,0,6,1,-15,3,1
2,4,27,1,30,4,11,0,15,3,30,2,0,0,2,0,30,3,12,0,15,0,30,6,9,0,15,5,30,6,0,0,6,1,-15,3,1
2,2,33,2,30,4,7,0,11,4,30,4,0,0,4,2,30,9,2,0,11,2,30,5,6,0,11,7,30,4,0,0,4,1,-15,3,1
2,4,2,0,30,5,5,0,10,3,30,4,0,0,4,4,30,3,7,0,10,3,30,3,7,0,10,1,30,8,0,0,8,0,-27,3,0
2,2,5,0,30,0,5,0,5,2,30,4,0,0,4,0,30,1,4,0,5,0,30,1,4,0,5,1,30,0,2,0,2,0,-27,3,0
2,3,5,0,30,0,5,0,5,2,30,4,0,0,4,0,30,1,4,0,5,0,30,1,4,0,5,1,30,0,2,0,2,0,-27,3,0
2,4,5,0,30,0,5,0,5,2,30,4,0,0,4,0,30,1,4,0,5,0,30,1,4,0,5,1,30,0,2,0,2,0,-27,3,0
2,2,6,0,30,5,4,0,9,4,30,2,0,0,2,0,30,2,7,0,9,0,30,5,4,0,9,5,30,5,0,0,5,0,-27,3,0
2,4,6,0,30,5,4,0,9,4,30,2,0,0,2,0,30,2,7,0,9,0,30,5,4,0,9,5,30,5,0,0,5,0,-27,3,0
2,3,8,1,30,7,0,0,7,4,30,2,0,0,2,5,30,4,3,0,7,2,30,7,0,0,7,0,30,2,1,0,3,0,-27,3,0
2,3,19,0,30,5,8,0,13,1,30,6,2,0,8,1,30,10,3,0,13,0,30,7,6,0,13,1,30,8,1,0,9,1,-15,3,1
2,3,25,0,30,12,2,0,14,2,30,6,0,0,6,0,30,4,10,0,14,1,30,5,9,0,14,2,30,5,1,0,6,1,-15,3,1
2,4,25,0,30,12,2,0,14,2,30,6,0,0,6,0,30,4,10,0,14,1,30,5,9,0,14,2,30,5,1,0,6,1,-15,3,1
2,4,27,2,30,5,10,0,15,4,30,2,0,0,2,0,30,6,9,0,15,2,30,4,11,0,15,1,30,4,2,0,6,1,-15,3,1
2,3,29,1,30,11,3,0,14,4,30,8,4,0,12,0,30,9,5,0,14,0,30,1,13,0,14,0,30,9,0,0,9,1,-15,3,1
2,4,31,4,30,7,5,0,12,4,30,8,0,0,8,2,30,9,3,0,12,0,30,3,9,0,12,0,30,4,2,0,6,1,-15,3,1
2,1,35,0,30,6,7,0,13,4,30,1,1,0,2,3,30,13,0,0,13,0,30,3,10,0,13,0,30,8,0,0,8,1,-15,3,1
2,3,35,0,30,6,7,0,13,4,30,1,1,0,2,3,30,13,0,0,13,0,30,3,10,0,13,0,30,8,0,0,8,1,-15,3,1
2,4,35,0,30,6,7,0,13,4,30,1,1,0,2,3,30,13,0,0,13,0,30,3,10,0,13,0,30,8,0,0,8,1,-15,3,1
2,0,1,0,30,7,3,0,10,4,30,2,0,0,2,1,30,4,6,0,10,2,30,8,2,0,10,6,30,6,0,0,6,0,-27,3,0
2,1,1,0,30,7,3,0,10,4,30,2,0,0,2,1,30,4,6,0,10,2,30,8,2,0,10,6,30,6,0,0,6,0,-27,3,0
2,3,5,0,30,3,2,0,5,3,30,2,2,0,4,0,30,0,5,0,5,0,30,1,4,0,5,0,30,0,2,0,2,0,-27,3,0
2,4,5,0,30,3,2,0,5,3,30,2,2,0,4,0,30,0,5,0,5,0,30,1,4,0,5,0,30,0,2,0,2,0,-27,3,0
2,3,7,0,30,1,3,0,4,2,30,2,0,0,2,2,30,2,2,0,4,0,30,1,3,0,4,2,30,1,1,0,2,0,-27,3,0
2,4,13,1,30,6,1,0,7,0,30,4,0,0,4,1,30,6,1,0,7,12,30,6,1,0,7,3,30,4,0,0,4,1,-15,3,1
2,2,17,3,30,10,4,0,14,2,30,6,0,0,6,0,30,7,7,0,14,5,30,4,10,0,14,4,30,4,0,0,4,1,-15,3,1
2,3,17,3,30,10,4,0,14,2,30,6,0,0,6,0,30,7,7,0,14,5,30,4,10,0,14,4,30,4,0,0,4,1,-15,3,1
2,2,19,2,30,3,10,0,13,3,30,5,3,0,8,0,30,4,9,0,13,4,30,4,9,0,13,1,30,8,1,0,9,1,-15,3,1
2,3,19,2,30,3,10,0,13,3,30,5,3,0,8,0,30,4,9,0,13,4,30,4,9,0,13,1,30,8,1,0,9,1,-15,3,1
2,4,19,2,30,3,10,0,13,3,30,5,3,0,8,0,30,4,9,0,13,4,30,4,9,0,13,1,30,8,1,0,9,1,-15,3,1
2,2,21,2,30,7,3,0,10,4,30,4,2,0,6,0,30,3,7,0,10,4,30,5,5,0,10,5,30,4,0,0,4,1,-15,3,1
2,3,23,1,30,3,10,0,13,2,30,6,0,0,6,3,30,12,1,0,13,1,30,6,7,0,13,4,30,6,0,0,6,1,-15,3,1
2,2,25,1,30,7,7,0,14,5,30,6,0,0,6,0,30,5,9,0,14,1,30,8,6,0,14,5,30,5,1,0,6,1,-15,3,1
2,3,25,1,30,7,7,0,14,5,30,6,0,0,6,0,30,5,9,0,14,1,30,8,6,0,14,5,30,5,1,0,6,1,-15,3,1
2,1,27,1,30,5,10,0,15,2,30,2,0,0,2,0,30,8,7,0,15,0,30,4,11,0,15,0,30,4,2,0,6,1,-15,3,1
2,2,27,1,30,5,10,0,15,2,30,2,0,0,2,0,30,8,7,0,15,0,30,4,11,0,15,0,30,4,2,0,6,1,-15,3,1
2,4,27,1,30,5,10,0,15,2,30,2,0,0,2,0,30,8,7,0,15,0,30,4,11,0,15,0,30,4,2,0,6,1,-15,3,1
2,0,29,0,30,5,9,0,14,6,30,11,1,0,12,0,30,6,8,0,14,0,30,1,13,0,14,4,30,9,0,0,9,1,-15,3,1
2,2,29,0,30,5,9,0,14,6,30,11,1,0,12,0,30,6,8,0,14,0,30,1,13,0,14,4,30,9,0,0,9,1,-15,3,1
2,3,29,0,30,5,9,0,14,6,30,11,1,0,12,0,30,6,8,0,14,0,30,1,13,0,14,4,30,9,0,0,9,1,-15,3,1
2,3,31,6,30,8,4,0,12,5,30,8,0,0,8,0,30,4,8,0,12,5,30,5,7,0,12,1,30,2,4,0,6,1,-15,3,1
2,4,35,1,30,7,6,0,13,2,30,2,0,0,2,1,30,10,3,0,13,3,30,2,11,0,13,0,30,8,0,0,8,1,-15,3,1
2,4,39,0,30,2,9,0,11,6,30,6,0,0,6,0,30,4,7,0,11,0,30,4,7,0,11,5,30,5,0,0,5,1,-15,3,1
2,4,4,2,30,7,1,0,8,5,30,4,0,0,4,0,30,2,6,0,8,0,30,7,1,0,8,2,30,4,0,0,4,0,-27,3,0
2,3,17,0,30,9,5,0,14,3,30,6,0,0,6,0,30,5,9,0,14,2,30,8,6,0,14,7,30,4,0,0,4,1,-15,3,1
2,2,19,0,30,4,9,0,13,2,30,7,1,0,8,0,30,7,6,0,13,0,30,4,9,0,13,2,30,9,0,0,9,1,-15,3,1
2,4,19,0,30,4,9,0,13,2,30,7,1,0,8,0,30,7,6,0,13,0,30,4,9,0,13,2,30,9,0,0,9,1,-15,3,1
2,2,25,1,30,5,9,0,14,4,30,6,0,0,6,0,30,8,6,0,14,1,30,5,9,0,14,4,30,5,1,0,6,1,-15,3,1
2,4,25,1,30,5,9,0,14,4,30,6,0,0,6,0,30,8,6,0,14,1,30,5,9,0,14,4,30,5,1,0,6,1,-15,3,1
2,2,27,3,30,9,6,0,15,5,30,2,0,0,2,4,30,4,11,0,15,0,30,3,12,0,15,0,30,2,4,0,6,1,-15,3,1
2,3,27,3,30,9,6,0,15,5,30,2,0,0,2,4,30,4,11,0,15,0,30,3,12,0,15,0,30,2,4,0,6,1,-15,3,1
2,0,5,1,30,5,0,0,5,3,30,3,1,0,4,0,30,0,5,0,5,0,30,1,4,0,5,0,30,0,2,0,2,0,-27,3,0
2,1,5,1,30,5,0,0,5,3,30,3,1,0,4,0,30,0,5,0,5,0,30,1,4,0,5,0,30,0,2,0,2,0,-27,3,0
2,2,11,6,30,4,8,0,12,1,30,4,0,0,4,0,30,8,4,0,12,3,30,5,7,0,12,4,30,3,1,0,4,1,-15,3,1
2,4,13,0,30,6,1,0,7,0,30,4,0,0,4,2,30,6,1,0,7,9,30,6,1,0,7,4,30,4,0,0,4,1,-15,3,1
2,2,19,0,30,3,10,0,13,2,30,4,4,0,8,0,30,7,6,0,13,7,30,8,5,0,13,1,30,9,0,0,9,1,-15,3,1
2,1,21,3,30,6,4,0,10,4,30,5,1,0,6,1,30,3,7,0,10,2,30,5,5,0,10,1,30,4,0,0,4,1,-15,3,1
2,3,25,1,30,6,8,0,14,4,30,6,0,0,6,0,30,5,9,0,14,4,30,8,6,0,14,4,30,6,0,0,6,1,-15,3,1
2,4,25,1,30,6,8,0,14,4,30,6,0,0,6,0,30,5,9,0,14,4,30,8,6,0,14,4,30,6,0,0,6,1,-15,3,1
2,2,27,1,30,4,11,0,15,2,30,1,1,0,2,0,30,4,11,0,15,3,30,6,9,0,15,4,30,6,0,0,6,1,-15,3,1
2,4,29,0,30,6,8,0,14,6,30,12,0,0,12,0,30,3,11,0,14,0,30,0,14,0,14,1,30,9,0,0,9,1,-15,3,1
2,2,35,3,30,10,3,0,13,2,30,2,0,0,2,1,30,10,3,0,13,4,30,2,11,0,13,4,30,8,0,0,8,1,-15,3,1
2,3,5,0,30,1,4,0,5,2,30,1,3,0,4,0,30,1,4,0,5,0,30,1,4,0,5,0,30,0,2,0,2,0,-27,3,0
2,2,8,1,30,7,0,0,7,3,30,2,0,0,2,5,30,4,3,0,7,1,30,7,0,0,7,6,30,3,0,0,3,0,-27,3,0
2,3,8,1,30,7,0,0,7,3,30,2,0,0,2,5,30,4,3,0,7,1,30,7,0,0,7,6,30,3,0,0,3,0,-27,3,0
2,4,8,1,30,7,0,0,7,3,30,2,0,0,2,5,30,4,3,0,7,1,30,7,0,0,7,6,30,3,0,0,3,0,-27,3,0
2,1,13,3,30,3,0,0,3,2,30,2,0,0,2,4,30,3,0,0,3,5,30,2,1,0,3,3,30,2,0,0,2,1,-15,3,1
2,2,13,3,30,3,0,0,3,2,30,2,0,0,2,4,30,3,0,0,3,5,30,2,1,0,3,3,30,2,0,0,2,1,-15,3,1
2,4,13,3,30,3,0,0,3,2,30,2,0,0,2,4,30,3,0,0,3,5,30,2,1,0,3,3,30,2,0,0,2,1,-15,3,1
2,1,13,3,30,7,0,0,7,0,30,4,0,0,4,5,30,7,0,0,7,7,30,6,1,0,7,2,30,4,0,0,4,1,-15,3,1
2,1,17,5,30,8,6,0,14,3,30,6,0,0,6,0,30,4,10,0,14,2,30,4,10,0,14,2,30,4,0,0,4,1,-15,3,1
2,2,17,5,30,8,6,0,14,3,30,6,0,0,6,0,30,4,10,0,14,2,30,4,10,0,14,2,30,4,0,0,4,1,-15,3,1
2,3,17,5,30,8,6,0,14,3,30,6,0,0,6,0,30,4,10,0,14,2,30,4,10,0,14,2,30,4,0,0,4,1,-15,3,1
2,0,25,0,30,5,9,0,14,5,30,6,0,0,6,0,30,6,8,0,14,1,30,8,6,0,14,6,30,6,0,0,6,1,-15,3,1
2,3,25,0,30,5,9,0,14,5,30,6,0,0,6,0,30,6,8,0,14,1,30,8,6,0,14,6,30,6,0,0,6,1,-15,3,1
2,1,27,1,30,4,11,0,15,4,30,1,1,0,2,0,30,3,12,0,15,2,30,6,9,0,15,4,30,6,0,0,6,1,-15,3,1
2,4,27,1,30,4,11,0,15,4,30,1,1,0,2,0,30,3,12,0,15,2,30,6,9,0,15,4,30,6,0,0,6,1,-15,3,1
2,4,29,0,30,6,8,0,14,6,30,12,0,0,12,0,30,3,11,0,14,0,30,0,14,0,14,0,30,9,0,0,9,1,-15,3,1
2,4,39,0,30,2,9,0,11,6,30,6,0,0,6,0,30,5,6,0,11,2,30,4,7,0,11,5,30,5,0,0,5,1,-15,3,1
2,2,43,0,30,9,5,0,14,9,30,6,0,0,6,0,30,4,10,0,14,1,30,2,12,0,14,2,30,5,0,0,5,1,-15,3,1
2,2,47,0,30,0,14,0,14,5,30,4,0,0,4,0,30,6,8,0,14,3,30,3,11,0,14,6,30,7,0,0,7,1,-15,3,1
2,3,47,0,30,0,14,0,14,5,30,4,0,0,4,0,30,6,8,0,14,3,30,3,11,0,14,6,30,7,0,0,7,1,-15,3,1
2,4,5,0,30,2,3,0,5,3,30,2,2,0,4,0,30,0,5,0,5,0,30,1,4,0,5,0,30,0,2,0,2,0,-27,3,0
2,3,6,0,30,8,1,0,9,4,30,2,0,0,2,0,30,3,6,0,9,0,30,4,5,0,9,0,30,4,1,0,5,0,-27,3,0
2,4,6,0,30,8,1,0,9,4,30,2,0,0,2,0,30,3,6,0,9,0,30,4,5,0,9,0,30,4,1,0,5,0,-27,3,0
2,3,8,3,30,7,0,0,7,3,30,2,0,0,2,3,30,4,3,0,7,1,30,7,0,0,7,1,30,3,0,0,3,0,-27,3,0
2,4,8,3,30,7,0,0,7,3,30,2,0,0,2,3,30,4,3,0,7,1,30,7,0,0,7,1,30,3,0,0,3,0,-27,3,0
2,3,13,2,30,6,1,0,7,0,30,4,0,0,4,2,30,6,1,0,7,5,30,7,0,0,7,3,30,4,0,0,4,1,-15,3,1
2,4,13,2,30,6,1,0,7,0,30,4,0,0,4,2,30,6,1,0,7,5,30,7,0,0,7,3,30,4,0,0,4,1,-15,3,1
2,2,19,0,30,5,8,0,13,0,30,7,1,0,8,0,30,6,7,0,13,3,30,4,9,0,13,0,30,8,1,0,9,1,-15,3,1
2,4,23,3,30,5,8,0,13,3,30,6,0,0,6,6,30,12,1,0,13,0,30,5,8,0,13,0,30,5,1,0,6,1,-15,3,1
2,2,25,1,30,6,8,0,14,3,30,6,0,0,6,0,30,6,8,0,14,1,30,5,9,0,14,4,30,5,1,0,6,1,-15,3,1
2,1,27,1,30,4,11,0,15,3,30,1,1,0,2,0,30,6,9,0,15,0,30,5,10,0,15,3,30,6,0,0,6,1,-15,3,1
2,2,27,1,30,4,11,0,15,3,30,1,1,0,2,0,30,6,9,0,15,0,30,5,10,0,15,3,30,6,0,0,6,1,-15,3,1
2,3,27,1,30,4,11,0,15,3,30,1,1,0,2,0,30,6,9,0,15,0,30,5,10,0,15,3,30,6,0,0,6,1,-15,3,1
2,2,29,0,30,4,10,0,14,6,30,12,0,0,12,0,30,3,11,0,14,0,30,1,13,0,14,5,30,9,0,0,9,1,-15,3,1
2,1,31,2,30,3,9,0,12,6,30,8,0,0,8,4,30,7,5,0,12,0,30,7,5,0,12,2,30,6,0,0,6,1,-15,3,1
2,4,31,2,30,3,9,0,12,6,30,8,0,0,8,0,30,7,5,0,12,0,30,7,5,0,12,2,30,6,0,0,6,1,-15,3,1
2,0,35,5,30,5,8,0,13,5,30,0,2,0,2,1,30,6,7,0,13,2,30,1,12,0,13,5,30,8,0,0,8,1,-15,3,1
2,1,35,5,30,5,8,0,13,5,30,0,2,0,2,1,30,6,7,0,13,2,30,1,12,0,13,5,30,8,0,0,8,1,-15,3,1
2,3,35,5,30,5,8,0,13,5,30,0,2,0,2,1,30,6,7,0,13,2,30,1,12,0,13,5,30,8,0,0,8,1,-15,3,1
2,4,35,5,30,5,8,0,13,5,30,0,2,0,2,1,30,6,7,0,13,2,30,1,12,0,13,5,30,8,0,0,8,1,-15,3,1
2,3,39,0,30,4,7,0,11,7,30,6,0,0,6,0,30,5,6,0,11,3,30,2,9,0,11,5,30,5,0,0,5,1,-15,3,1
2,1,5,0,30,2,3,0,5,2,30,0,4,0,4,0,30,3,2,0,5,0,30,2,3,0,5,0,30,0,2,0,2,0,-27,3,0
2,2,5,0,30,2,3,0,5,2,30,0,4,0,4,0,30,3,2,0,5,0,30,2,3,0,5,0,30,0,2,0,2,0,-27,3,0
2,4,5,0,30,2,3,0,5,2,30,0,4,0,4,0,30,3,2,0,5,0,30,2,3,0,5,0,30,0,2,0,2,0,-27,3,0
2,2,6,1,30,9,0,0,9,4,30,2,0,0,2,0,30,2,7,0,9,0,30,4,5,0,9,0,30,5,0,0,5,0,-27,3,0
2,3,6,1,30,9,0,0,9,4,30,2,0,0,2,0,30,2,7,0,9,0,30,4,5,0,9,0,30,5,0,0,5,0,-27,3,0
2,2,7,0,30,2,2,0,4,2,30,2,0,0,2,0,30,1,3,0,4,0,30,1,3,0,4,3,30,2,0,0,2,0,-27,3,0
2,4,8,3,30,7,0,0,7,4,30,2,0,0,2,6,30,5,2,0,7,0,30,4,3,0,7,0,30,3,0,0,3,0,-27,3,0
2,4,15,1,30,4,9,0,13,0,30,6,0,0,6,0,30,3,10,0,13,1,30,5,8,0,13,0,30,6,3,0,9,1,-15,3,1
2,3,17,4,30,9,5,0,14,4,30,6,0,0,6,1,30,5,9,0,14,1,30,6,8,0,14,0,30,4,0,0,4,1,-15,3,1
2,1,19,0,30,7,6,0,13,2,30,6,2,0,8,0,30,4,9,0,13,6,30,3,10,0,13,0,30,8,1,0,9,1,-15,3,1
2,3,22,1,30,5,3,0,8,2,30,2,0,0,2,0,30,5,3,0,8,1,30,4,4,0,8,1,30,3,1,0,4,1,-15,3,1
2,4,22,1,30,5,3,0,8,2,30,2,0,0,2,0,30,5,3,0,8,1,30,4,4,0,8,1,30,3,1,0,4,1,-15,3,1
2,3,23,1,30,5,8,0,13,3,30,6,0,0,6,4,30,12,1,0,13,0,30,5,8,0,13,3,30,6,0,0,6,1,-15,3,1
2,4,23,1,30,5,8,0,13,3,30,6,0,0,6,4,30,12,1,0,13,0,30,5,8,0,13,3,30,6,0,0,6,1,-15,3,1
2,1,25,1,30,8,6,0,14,5,30,6,0,0,6,0,30,3,11,0,14,5,30,9,5,0,14,5,30,5,1,0,6,1,-15,3,1
2,4,25,1,30,8,6,0,14,5,30,6,0,0,6,0,30,3,11,0,14,5,30,9,5,0,14,5,30,5,1,0,6,1,-15,3,1
2,1,27,1,30,6,9,0,15,3,30,1,1,0,2,0,30,3,12,0,15,4,30,6,9,0,15,3,30,6,0,0,6,1,-15,3,1
2,1,31,5,30,7,5,0,12,5,30,8,0,0,8,4,30,9,3,0,12,0,30,3,9,0,12,0,30,4,2,0,6,1,-15,3,1
2,4,31,5,30,7,5,0,12,5,30,8,0,0,8,4,30,9,3,0,12,0,30,3,9,0,12,0,30,4,2,0,6,1,-15,3,1
2,3,35,6,30,8,5,0,13,3,30,2,0,0,2,1,30,9,4,0,13,0,30,1,12,0,13,1,30,8,0,0,8,1,-15,3,1
2,1,43,0,30,10,4,0,14,6,30,6,0,0,6,0,30,4,10,0,14,3,30,2,12,0,14,6,30,5,0,0,5,1,-15,3,1
2,1,4,0,30,5,3,0,8,4,30,3,1,0,4,0,30,1,7,0,8,2,30,5,3,0,8,2,30,4,0,0,4,0,-27,3,0
2,2,4,0,30,5,3,0,8,4,30,3,1,0,4,0,30,1,7,0,8,2,30,5,3,0,8,2,30,4,0,0,4,0,-27,3,0
2,3,5,0,30,2,3,0,5,3,30,3,1,0,4,0,30,1,4,0,5,0,30,1,4,0,5,0,30,1,1,0,2,0,-27,3,0
2,4,11,0,30,1,3,0,4,0,30,0,0,0,0,0,30,1,3,0,4,2,30,4,0,0,4,1,30,1,0,0,1,1,-15,3,1
2,3,13,2,30,4,3,0,7,0,30,4,0,0,4,2,30,5,2,0,7,5,30,6,1,0,7,3,30,4,0,0,4,1,-15,3,1
2,2,15,0,30,5,8,0,13,0,30,6,0,0,6,0,30,3,10,0,13,1,30,5,8,0,13,3,30,9,0,0,9,1,-15,3,1
2,3,15,0,30,5,8,0,13,0,30,6,0,0,6,0,30,3,10,0,13,1,30,5,8,0,13,3,30,9,0,0,9,1,-15,3,1
2,4,15,0,30,5,8,0,13,0,30,6,0,0,6,0,30,3,10,0,13,1,30,5,8,0,13,3,30,9,0,0,9,1,-15,3,1
2,4,19,0,30,3,10,0,13,2,30,8,0,0,8,0,30,5,8,0,13,0,30,6,7,0,13,0,30,7,2,0,9,1,-15,3,1
2,3,23,1,30,8,5,0,13,2,30,5,1,0,6,6,30,10,3,0,13,0,30,4,9,0,13,0,30,5,1,0,6,1,-15,3,1
2,4,25,3,30,8,6,0,14,3,30,6,0,0,6,0,30,9,5,0,14,1,30,5,9,0,14,5,30,5,1,0,6,1,-15,3,1
2,1,27,1,30,11,4,0,15,0,30,2,0,0,2,0,30,7,8,0,15,3,30,3,12,0,15,2,30,2,4,0,6,1,-15,3,1
2,3,27,1,30,11,4,0,15,0,30,2,0,0,2,0,30,7,8,0,15,3,30,3,12,0,15,2,30,2,4,0,6,1,-15,3,1
2,4,27,1,30,11,4,0,15,0,30,2,0,0,2,0,30,7,8,0,15,3,30,3,12,0,15,2,30,2,4,0,6,1,-15,3,1
2,1,31,1,30,4,8,0,12,5,30,8,0,0,8,3,30,6,6,0,12,0,30,5,7,0,12,0,30,6,0,0,6,1,-15,3,1
2,3,4,2,30,7,1,0,8,5,30,4,0,0,4,0,30,1,7,0,8,0,30,7,1,0,8,5,30,2,2,0,4,0,-27,3,0
2,4,4,2,30,7,1,0,8,5,30,4,0,0,4,0,30,1,7,0,8,0,30,7,1,0,8,5,30,2,2,0,4,0,-27,3,0
2,0,5,0,30,2,3,0,5,3,30,3,1,0,4,0,30,0,5,0,5,0,30,1,4,0,5,2,30,2,0,0,2,0,-27,3,0
2,3,5,0,30,2,3,0,5,3,30,3,1,0,4,0,30,0,5,0,5,0,30,1,4,0,5,2,30,2,0,0,2,0,-27,3,0
2,4,5,0,30,2,3,0,5,3,30,3,1,0,4,0,30,0,5,0,5,0,30,1,4,0,5,2,30,2,0,0,2,0,-27,3,0
2,4,13,1,30,7,0,0,7,0,30,4,0,0,4,2,30,6,1,0,7,14,30,3,4,0,7,2,30,4,0,0,4,1,-15,3,1
2,2,17,4,30,11,3,0,14,2,30,6,0,0,6,0,30,6,8,0,14,1,30,5,9,0,14,3,30,4,0,0,4,1,-15,3,1
2,4,17,4,30,11,3,0,14,2,30,6,0,0,6,0,30,6,8,0,14,1,30,5,9,0,14,3,30,4,0,0,4,1,-15,3,1
2,4,19,0,30,4,9,0,13,2,30,7,1,0,8,0,30,4,9,0,13,0,30,3,10,0,13,0,30,8,1,0,9,1,-15,3,1
2,4,23,1,30,4,9,0,13,3,30,6,0,0,6,8,30,13,0,0,13,0,30,9,4,0,13,1,30,5,1,0,6,1,-15,3,1
2,3,25,1,30,7,7,0,14,3,30,6,0,0,6,0,30,5,9,0,14,1,30,5,9,0,14,0,30,5,1,0,6,1,-15,3,1
2,4,25,1,30,7,7,0,14,3,30,6,0,0,6,0,30,5,9,0,14,1,30,5,9,0,14,0,30,5,1,0,6,1,-15,3,1
2,1,27,2,30,5,10,0,15,0,30,2,0,0,2,0,30,6,9,0,15,0,30,4,11,0,15,3,30,4,2,0,6,1,-15,3,1
2,2,27,2,30,5,10,0,15,0,30,2,0,0,2,0,30,6,9,0,15,0,30,4,11,0,15,3,30,4,2,0,6,1,-15,3,1
2,3,27,2,30,5,10,0,15,0,30,2,0,0,2,0,30,6,9,0,15,0,30,4,11,0,15,3,30,4,2,0,6,1,-15,3,1
2,4,29,0,30,8,6,0,14,6,30,10,2,0,12,0,30,6,8,0,14,0,30,4,10,0,14,2,30,9,0,0,9,1,-15,3,1
2,4,2,0,30,7,3,0,10,3,30,4,0,0,4,4,30,3,7,0,10,0,30,5,5,0,10,0,30,8,0,0,8,0,-27,3,0
2,0,4,2,30,7,1,0,8,4,30,4,0,0,4,0,30,4,4,0,8,0,30,8,0,0,8,3,30,4,0,0,4,0,-27,3,0
2,0,5,0,30,3,2,0,5,3,30,2,2,0,4,0,30,0,5,0,5,0,30,1,4,0,5,0,30,2,0,0,2,0,-27,3,0
2,2,5,0,30,3,2,0,5,3,30,2,2,0,4,0,30,0,5,0,5,0,30,1,4,0,5,0,30,2,0,0,2,0,-27,3,0
2,4,5,0,30,3,2,0,5,3,30,2,2,0,4,0,30,0,5,0,5,0,30,1,4,0,5,0,30,2,0,0,2,0,-27,3,0
2,2,23,0,30,8,5,0,13,0,30,6,0,0,6,5,30,13,0,0,13,0,30,5,8,0,13,2,30,5,1,0,6,1,-15,3,1
2,3,23,0,30,8,5,0,13,0,30,6,0,0,6,5,30,13,0,0,13,0,30,5,8,0,13,2,30,5,1,0,6,1,-15,3,1
2,0,27,1,30,4,11,0,15,4,30,2,0,0,2,0,30,5,10,0,15,4,30,6,9,0,15,4,30,6,0,0,6,1,-15,3,1
2,3,27,1,30,4,11,0,15,4,30,2,0,0,2,0,30,5,10,0,15,4,30,6,9,0,15,0,30,6,0,0,6,1,-15,3,1
2,4,27,1,30,4,11,0,15,4,30,2,0,0,2,0,30,5,10,0,15,4,30,6,9,0,15,0,30,6,0,0,6,1,-15,3,1
2,2,29,0,30,7,7,0,14,5,30,12,0,0,12,0,30,6,8,0,14,0,30,1,13,0,14,1,30,9,0,0,9,1,-15,3,1
2,3,29,0,30,7,7,0,14,5,30,12,0,0,12,0,30,6,8,0,14,0,30,1,13,0,14,1,30,9,0,0,9,1,-15,3,1
2,2,35,1,30,6,7,0,13,5,30,2,0,0,2,1,30,2,11,0,13,2,30,1,12,0,13,9,30,8,0,0,8,1,-15,3,1
2,4,13,9,30,2,1,0,3,2,30,2,0,0,2,0,30,2,1,0,3,9,30,2,1,0,3,2,30,2,0,0,2,1,-15,3,1
2,2,13,9,30,6,1,0,7,1,30,4,0,0,4,2,30,5,2,0,7,5,30,6,1,0,7,2,30,4,0,0,4,1,-15,3,1
2,1,19,0,30,3,10,0,13,2,30,3,5,0,8,0,30,11,2,0,13,1,30,10,3,0,13,2,30,9,0,0,9,1,-15,3,1
2,0,21,2,30,7,3,0,10,3,30,5,1,0,6,1,30,3,7,0,10,3,30,3,7,0,10,4,30,4,0,0,4,1,-15,3,1
2,3,23,2,30,6,7,0,13,3,30,6,0,0,6,3,30,12,1,0,13,0,30,5,8,0,13,1,30,6,0,0,6,1,-15,3,1
2,2,25,1,30,10,4,0,14,2,30,6,0,0,6,0,30,10,4,0,14,1,30,5,9,0,14,4,30,5,1,0,6,1,-15,3,1
2,3,25,1,30,10,4,0,14,2,30,6,0,0,6,0,30,10,4,0,14,1,30,5,9,0,14,4,30,5,1,0,6,1,-15,3,1
2,3,29,0,30,6,8,0,14,6,30,12,0,0,12,0,30,4,10,0,14,0,30,0,14,0,14,3,30,9,0,0,9,1,-15,3,1
2,0,5,0,30,1,4,0,5,3,30,0,4,0,4,0,30,0,5,0,5,0,30,1,4,0,5,1,30,2,0,0,2,0,-27,3,0
2,2,5,0,30,1,4,0,5,3,30,0,4,0,4,0,30,0,5,0,5,0,30,1,4,0,5,0,30,2,0,0,2,0,-27,3,0
2,3,5,0,30,1,4,0,5,3,30,0,4,0,4,0,30,0,5,0,5,0,30,1,4,0,5,0,30,2,0,0,2,0,-27,3,0
2,4,5,0,30,1,4,0,5,3,30,0,4,0,4,0,30,0,5,0,5,0,30,1,4,0,5,0,30,2,0,0,2,0,-27,3,0
2,4,6,0,30,6,3,0,9,4,30,2,0,0,2,0,30,2,7,0,9,1,30,4,5,0,9,0,30,5,0,0,5,0,-27,3,0
2,4,8,0,30,7,0,0,7,4,30,2,0,0,2,0,30,4,3,0,7,1,30,4,3,0,7,3,30,3,0,0,3,0,-27,3,0
2,2,17,6,30,9,5,0,14,4,30,6,0,0,6,0,30,5,9,0,14,1,30,7,7,0,14,5,30,4,0,0,4,1,-15,3,1
2,3,17,6,30,9,5,0,14,4,30,6,0,0,6,0,30,5,9,0,14,1,30,7,7,0,14,5,30,4,0,0,4,1,-15,3,1
2,4,17,6,30,9,5,0,14,4,30,6,0,0,6,0,30,5,9,0,14,1,30,7,7,0,14,5,30,4,0,0,4,1,-15,3,1
2,2,19,0,30,4,9,0,13,2,30,8,0,0,8,4,30,8,5,0,13,0,30,3,10,0,13,1,30,7,2,0,9,1,-15,3,1
2,1,23,1,30,5,8,0,13,2,30,6,0,0,6,4,30,13,0,0,13,0,30,5,8,0,13,4,30,6,0,0,6,1,-15,3,1
2,2,23,1,30,5,8,0,13,2,30,6,0,0,6,4,30,13,0,0,13,0,30,5,8,0,13,4,30,6,0,0,6,1,-15,3,1
2,3,23,1,30,5,8,0,13,2,30,6,0,0,6,4,30,13,0,0,13,0,30,5,8,0,13,4,30,6,0,0,6,1,-15,3,1
2,1,25,0,30,4,10,0,14,4,30,6,0,0,6,0,30,4,10,0,14,2,30,8,6,0,14,9,30,5,1,0,6,1,-15,3,1
2,1,27,1,30,8,7,0,15,2,30,2,0,0,2,0,30,2,13,0,15,3,30,5,10,0,15,4,30,6,0,0,6,1,-15,3,1
2,3,29,0,30,6,8,0,14,5,30,8,4,0,12,0,30,4,10,0,14,0,30,1,13,0,14,0,30,7,2,0,9,1,-15,3,1
2,3,31,1,30,8,4,0,12,3,30,8,0,0,8,3,30,11,1,0,12,0,30,3,9,0,12,1,30,3,3,0,6,1,-15,3,1
2,2,4,2,30,8,0,0,8,5,30,2,2,0,4,1,30,3,5,0,8,1,30,8,0,0,8,1,30,4,0,0,4,0,-27,3,0
2,3,5,0,30,2,3,0,5,3,30,0,4,0,4,1,30,2,3,0,5,0,30,1,4,0,5,0,30,0,2,0,2,0,-27,3,0
2,4,5,0,30,2,3,0,5,3,30,0,4,0,4,1,30,2,3,0,5,0,30,1,4,0,5,0,30,0,2,0,2,0,-27,3,0
2,3,8,1,30,7,0,0,7,3,30,2,0,0,2,4,30,4,3,0,7,0,30,6,1,0,7,1,30,3,0,0,3,0,-27,3,0
2,4,15,0,30,3,10,0,13,0,30,6,0,0,6,0,30,3,10,0,13,1,30,6,7,0,13,2,30,9,0,0,9,1,-15,3,1
2,4,25,2,30,7,7,0,14,4,30,6,0,0,6,0,30,4,10,0,14,1,30,5,9,0,14,1,30,5,1,0,6,1,-15,3,1
2,2,27,2,30,5,10,0,15,4,30,2,0,0,2,0,30,6,9,0,15,0,30,5,10,0,15,1,30,4,2,0,6,1,-15,3,1
2,4,27,2,30,5,10,0,15,4,30,2,0,0,2,0,30,6,9,0,15,0,30,5,10,0,15,1,30,4,2,0,6,1,-15,3,1
2,2,29,0,30,5,9,0,14,3,30,12,0,0,12,0,30,6,8,0,14,0,30,1,13,0,14,0,30,8,1,0,9,1,-15,3,1
2,3,29,0,30,5,9,0,14,3,30,12,0,0,12,0,30,6,8,0,14,0,30,1,13,0,14,0,30,8,1,0,9,1,-15,3,1
2,1,4,2,30,6,2,0,8,5,30,4,0,0,4,0,30,1,7,0,8,0,30,6,2,0,8,4,30,3,1,0,4,0,-27,3,0
2,2,4,2,30,6,2,0,8,5,30,4,0,0,4,0,30,1,7,0,8,0,30,6,2,0,8,4,30,3,1,0,4,0,-27,3,0
2,3,5,0,30,2,3,0,5,3,30,3,1,0,4,0,30,1,4,0,5,0,30,1,4,0,5,1,30,2,0,0,2,0,-27,3,0
2,3,19,0,30,3,10,0,13,2,30,5,3,0,8,0,30,4,9,0,13,1,30,6,7,0,13,0,30,8,1,0,9,1,-15,3,1
2,4,19,0,30,3,10,0,13,2,30,5,3,0,8,0,30,4,9,0,13,1,30,6,7,0,13,0,30,8,1,0,9,1,-15,3,1
2,4,22,2,30,7,1,0,8,3,30,2,0,0,2,2,30,5,3,0,8,0,30,5,3,0,8,1,30,2,2,0,4,1,-15,3,1
2,1,27,0,30,7,8,0,15,4,30,2,0,0,2,0,30,3,12,0,15,2,30,4,11,0,15,3,30,6,0,0,6,1,-15,3,1
2,3,27,0,30,7,8,0,15,4,30,2,0,0,2,0,30,3,12,0,15,2,30,4,11,0,15,3,30,6,0,0,6,1,-15,3,1
2,3,29,3,30,8,6,0,14,4,30,8,4,0,12,0,30,6,8,0,14,0,30,1,13,0,14,0,30,8,1,0,9,1,-15,3,1
2,4,30,4,30,5,0,0,5,5,30,2,0,0,2,4,30,1,4,0,5,2,30,1,4,0,5,0,30,2,1,0,3,1,-15,3,1
2,1,1,0,30,7,3,0,10,4,30,2,0,0,2,1,30,4,6,0,10,8,30,9,1,0,10,6,30,6,0,0,6,0,-27,3,0
2,3,5,0,30,0,5,0,5,2,30,1,3,0,4,2,30,2,3,0,5,0,30,4,1,0,5,0,30,0,2,0,2,0,-27,3,0
2,4,5,0,30,0,5,0,5,2,30,1,3,0,4,2,30,2,3,0,5,0,30,4,1,0,5,0,30,0,2,0,2,0,-27,3,0
2,3,23,2,30,5,8,0,13,3,30,6,0,0,6,5,30,11,2,0,13,0,30,6,7,0,13,1,30,6,0,0,6,1,-15,3,1
2,4,23,2,30,5,8,0,13,3,30,6,0,0,6,5,30,11,2,0,13,0,30,6,7,0,13,1,30,6,0,0,6,1,-15,3,1
2,4,25,1,30,7,7,0,14,5,30,6,0,0,6,0,30,7,7,0,14,0,30,5,9,0,14,5,30,5,1,0,6,1,-15,3,1
2,3,33,1,30,7,4,0,11,3,30,4,0,0,4,1,30,10,1,0,11,6,30,4,7,0,11,4,30,4,0,0,4,1,-15,3,1
2,3,38,0,30,2,8,0,10,5,30,6,0,0,6,0,30,6,4,0,10,0,30,2,8,0,10,3,30,6,0,0,6,1,-15,3,1
2,0,5,0,30,3,2,0,5,3,30,1,3,0,4,0,30,0,5,0,5,0,30,2,3,0,5,0,30,1,1,0,2,0,-27,3,0
2,1,5,0,30,3,2,0,5,3,30,1,3,0,4,0,30,0,5,0,5,0,30,2,3,0,5,0,30,1,1,0,2,0,-27,3,0
2,4,5,0,30,3,2,0,5,3,30,1,3,0,4,0,30,0,5,0,5,0,30,2,3,0,5,0,30,1,1,0,2,0,-27,3,0
2,2,13,2,30,5,2,0,7,0,30,4,0,0,4,2,30,6,1,0,7,5,30,7,0,0,7,2,30,4,0,0,4,1,-15,3,1
2,4,25,1,30,8,6,0,14,4,30,6,0,0,6,0,30,5,9,0,14,2,30,7,7,0,14,6,30,6,0,0,6,1,-15,3,1
2,3,27,0,30,6,9,0,15,3,30,2,0,0,2,0,30,5,10,0,15,4,30,5,10,0,15,3,30,6,0,0,6,1,-15,3,1
2,4,29,0,30,7,7,0,14,6,30,12,0,0,12,0,30,4,10,0,14,0,30,1,13,0,14,0,30,9,0,0,9,1,-15,3,1
2,4,31,1,30,8,4,0,12,3,30,8,0,0,8,3,30,12,0,0,12,0,30,3,9,0,12,0,30,3,3,0,6,1,-15,3,1
2,3,43,0,30,6,8,0,14,8,30,6,0,0,6,0,30,4,10,0,14,1,30,8,6,0,14,3,30,5,0,0,5,1,-15,3,1
2,3,47,0,30,3,11,0,14,6,30,4,0,0,4,0,30,3,11,0,14,0,30,2,12,0,14,5,30,7,0,0,7,1,-15,3,1
2,1,13,7,30,7,0,0,7,3,30,4,0,0,4,2,30,6,1,0,7,1,30,6,1,0,7,0,30,3,1,0,4,1,-15,3,1
2,1,19,0,30,4,9,0,13,2,30,4,4,0,8,0,30,5,8,0,13,7,30,4,9,0,13,5,30,9,0,0,9,1,-15,3,1
2,2,19,0,30,4,9,0,13,2,30,4,4,0,8,0,30,5,8,0,13,7,30,4,9,0,13,5,30,9,0,0,9,1,-15,3,1
2,3,23,1,30,6,7,0,13,1,30,6,0,0,6,3,30,11,2,0,13,1,30,6,7,0,13,4,30,6,0,0,6,1,-15,3,1
2,0,27,1,30,4,11,0,15,2,30,2,0,0,2,0,30,6,9,0,15,2,30,3,12,0,15,4,30,6,0,0,6,1,-15,3,1
2,1,27,1,30,4,11,0,15,2,30,2,0,0,2,0,30,6,9,0,15,2,30,3,12,0,15,4,30,6,0,0,6,1,-15,3,1
2,3,27,1,30,4,11,0,15,2,30,2,0,0,2,0,30,6,9,0,15,2,30,3,12,0,15,4,30,6,0,0,6,1,-15,3,1
2,2,29,0,30,7,7,0,14,5,30,11,1,0,12,0,30,3,11,0,14,0,30,3,11,0,14,0,30,9,0,0,9,1,-15,3,1
2,4,29,0,30,7,7,0,14,5,30,11,1,0,12,0,30,3,11,0,14,0,30,3,11,0,14,0,30,9,0,0,9,1,-15,3,1
2,2,5,0,30,2,3,0,5,3,30,2,2,0,4,0,30,1,4,0,5,0,30,1,4,0,5,1,30,2,0,0,2,0,-27,3,0
2,4,5,0,30,2,3,0,5,3,30,2,2,0,4,0,30,1,4,0,5,0,30,1,4,0,5,1,30,2,0,0,2,0,-27,3,0
2,4,7,0,30,2,2,0,4,2,30,2,0,0,2,3,30,1,3,0,4,0,30,1,3,0,4,1,30,1,1,0,2,0,-27,3,0
2,4,11,2,30,4,0,0,4,1,30,0,0,0,0,0,30,1,3,0,4,0,30,3,1,0,4,1,30,1,0,0,1,1,-15,3,1
2,1,11,0,30,10,2,0,12,1,30,4,0,0,4,1,30,6,6,0,12,5,30,4,8,0,12,3,30,4,0,0,4,1,-15,3,1
2,1,21,3,30,8,2,0,10,4,30,6,0,0,6,1,30,3,7,0,10,3,30,5,5,0,10,0,30,4,0,0,4,1,-15,3,1
2,2,21,3,30,8,2,0,10,4,30,6,0,0,6,1,30,3,7,0,10,3,30,5,5,0,10,0,30,4,0,0,4,1,-15,3,1
2,3,21,3,30,8,2,0,10,4,30,6,0,0,6,1,30,3,7,0,10,3,30,5,5,0,10,0,30,4,0,0,4,1,-15,3,1
2,4,21,3,30,8,2,0,10,4,30,6,0,0,6,1,30,3,7,0,10,3,30,5,5,0,10,0,30,4,0,0,4,1,-15,3,1
2,4,25,0,30,8,6,0,14,1,30,6,0,0,6,0,30,12,2,0,14,1,30,4,10,0,14,1,30,6,0,0,6,1,-15,3,1
2,3,27,3,30,4,11,0,15,3,30,2,0,0,2,2,30,13,2,0,15,0,30,5,10,0,15,1,30,3,3,0,6,1,-15,3,1
2,4,27,3,30,4,11,0,15,3,30,2,0,0,2,2,30,13,2,0,15,0,30,5,10,0,15,1,30,3,3,0,6,1,-15,3,1
2,0,29,1,30,3,11,0,14,4,30,12,0,0,12,0,30,6,8,0,14,7,30,2,12,0,14,2,30,9,0,0,9,1,-15,3,1
2,2,29,1,30,3,11,0,14,4,30,12,0,0,12,0,30,6,8,0,14,7,30,2,12,0,14,2,30,9,0,0,9,1,-15,3,1
2,4,29,1,30,3,11,0,14,4,30,12,0,0,12,0,30,6,8,0,14,7,30,2,12,0,14,2,30,9,0,0,9,1,-15,3,1
2,2,31,1,30,5,7,0,12,5,30,8,0,0,8,3,30,8,4,0,12,0,30,5,7,0,12,5,30,5,1,0,6,1,-15,3,1
2,3,31,1,30,5,7,0,12,5,30,8,0,0,8,3,30,8,4,0,12,0,30,5,7,0,12,5,30,5,1,0,6,1,-15,3,1
2,3,35,0,30,6,7,0,13,3,30,2,0,0,2,1,30,13,0,0,13,0,30,3,10,0,13,3,30,7,1,0,8,1,-15,3,1
2,2,11,5,30,3,9,0,12,1,30,4,0,0,4,0,30,5,7,0,12,3,30,5,7,0,12,4,30,4,0,0,4,1,-15,3,1
2,3,17,0,30,11,3,0,14,3,30,6,0,0,6,0,30,4,10,0,14,3,30,5,9,0,14,3,30,4,0,0,4,1,-15,3,1
2,4,17,0,30,11,3,0,14,3,30,6,0,0,6,0,30,4,10,0,14,3,30,5,9,0,14,3,30,4,0,0,4,1,-15,3,1
2,1,19,0,30,3,10,0,13,2,30,8,0,0,8,0,30,5,8,0,13,5,30,5,8,0,13,0,30,9,0,0,9,1,-15,3,1
2,2,19,0,30,3,10,0,13,2,30,8,0,0,8,0,30,5,8,0,13,5,30,5,8,0,13,0,30,9,0,0,9,1,-15,3,1
2,3,19,0,30,3,10,0,13,2,30,8,0,0,8,0,30,5,8,0,13,5,30,5,8,0,13,0,30,9,0,0,9,1,-15,3,1
2,3,23,3,30,8,5,0,13,2,30,6,0,0,6,5,30,13,0,0,13,0,30,6,7,0,13,2,30,5,1,0,6,1,-15,3,1
2,2,25,2,30,8,6,0,14,3,30,6,0,0,6,0,30,9,5,0,14,1,30,5,9,0,14,4,30,5,1,0,6,1,-15,3,1
2,0,27,1,30,3,12,0,15,2,30,1,1,0,2,0,30,7,8,0,15,3,30,6,9,0,15,3,30,6,0,0,6,1,-15,3,1
2,2,27,1,30,3,12,0,15,2,30,1,1,0,2,0,30,7,8,0,15,3,30,6,9,0,15,3,30,6,0,0,6,1,-15,3,1
2,2,29,0,30,7,7,0,14,6,30,12,0,0,12,0,30,3,11,0,14,0,30,0,14,0,14,2,30,9,0,0,9,1,-15,3,1
2,3,29,0,30,7,7,0,14,6,30,12,0,0,12,0,30,3,11,0,14,0,30,0,14,0,14,2,30,9,0,0,9,1,-15,3,1
2,4,31,3,30,7,5,0,12,4,30,8,0,0,8,6,30,11,1,0,12,0,30,3,9,0,12,0,30,2,4,0,6,1,-15,3,1
2,0,4,2,30,7,1,0,8,4,30,4,0,0,4,0,30,3,5,0,8,0,30,4,4,0,8,3,30,4,0,0,4,0,-27,3,0
2,4,13,1,30,6,1,0,7,0,30,4,0,0,4,2,30,6,1,0,7,8,30,7,0,0,7,4,30,4,0,0,4,1,-15,3,1
2,2,17,2,30,9,5,0,14,3,30,6,0,0,6,4,30,6,8,0,14,1,30,3,11,0,14,3,30,4,0,0,4,1,-15,3,1
2,2,19,0,30,3,10,0,13,2,30,6,2,0,8,0,30,9,4,0,13,4,30,4,9,0,13,2,30,8,1,0,9,1,-15,3,1
2,4,19,0,30,3,10,0,13,2,30,6,2,0,8,0,30,9,4,0,13,4,30,4,9,0,13,2,30,8,1,0,9,1,-15,3,1
2,1,25,2,30,7,7,0,14,3,30,6,0,0,6,0,30,7,7,0,14,1,30,7,7,0,14,4,30,5,1,0,6,1,-15,3,1
2,2,25,2,30,7,7,0,14,3,30,6,0,0,6,0,30,7,7,0,14,1,30,7,7,0,14,4,30,5,1,0,6,1,-15,3,1
2,3,25,2,30,7,7,0,14,3,30,6,0,0,6,0,30,7,7,0,14,1,30,7,7,0,14,4,30,5,1,0,6,1,-15,3,1
2,3,1,0,30,9,1,0,10,5,30,2,0,0,2,1,30,3,7,0,10,1,30,8,2,0,10,5,30,6,0,0,6,0,-27,3,0
2,4,1,0,30,9,1,0,10,5,30,2,0,0,2,1,30,3,7,0,10,1,30,8,2,0,10,5,30,6,0,0,6,0,-27,3,0
2,0,5,0,30,2,3,0,5,3,30,1,3,0,4,0,30,0,5,0,5,0,30,1,4,0,5,2,30,2,0,0,2,0,-27,3,0
2,3,8,4,30,7,0,0,7,3,30,2,0,0,2,4,30,7,0,0,7,0,30,5,2,0,7,2,30,3,0,0,3,0,-27,3,0
2,4,8,4,30,7,0,0,7,3,30,2,0,0,2,4,30,7,0,0,7,0,30,5,2,0,7,2,30,3,0,0,3,0,-27,3,0
2,2,13,8,30,3,0,0,3,2,30,2,0,0,2,0,30,3,0,0,3,4,30,2,1,0,3,4,30,2,0,0,2,1,-15,3,1
2,2,13,7,30,7,0,0,7,0,30,4,0,0,4,2,30,6,1,0,7,2,30,6,1,0,7,4,30,4,0,0,4,1,-15,3,1
2,2,19,0,30,2,11,0,13,1,30,5,3,0,8,0,30,6,7,0,13,7,30,4,9,0,13,1,30,9,0,0,9,1,-15,3,1
2,3,23,2,30,5,8,0,13,1,30,6,0,0,6,3,30,13,0,0,13,2,30,4,9,0,13,3,30,6,0,0,6,1,-15,3,1
2,1,25,1,30,7,7,0,14,2,30,6,0,0,6,0,30,13,1,0,14,1,30,5,9,0,14,3,30,6,0,0,6,1,-15,3,1
2,2,25,1,30,7,7,0,14,2,30,6,0,0,6,0,30,13,1,0,14,1,30,5,9,0,14,3,30,6,0,0,6,1,-15,3,1
2,3,25,1,30,7,7,0,14,2,30,6,0,0,6,0,30,13,1,0,14,1,30,5,9,0,14,3,30,6,0,0,6,1,-15,3,1
2,4,25,1,30,7,7,0,14,2,30,6,0,0,6,0,30,13,1,0,14,1,30,5,9,0,14,3,30,6,0,0,6,1,-15,3,1
2,0,27,1,30,4,11,0,15,3,30,2,0,0,2,0,30,6,9,0,15,0,30,4,11,0,15,1,30,6,0,0,6,1,-15,3,1
2,2,27,1,30,4,11,0,15,3,30,2,0,0,2,0,30,6,9,0,15,0,30,4,11,0,15,1,30,6,0,0,6,1,-15,3,1
2,4,27,1,30,4,11,0,15,3,30,2,0,0,2,0,30,6,9,0,15,0,30,4,11,0,15,1,30,6,0,0,6,1,-15,3,1
2,1,4,2,30,6,2,0,8,4,30,2,2,0,4,0,30,3,5,0,8,0,30,3,5,0,8,4,30,4,0,0,4,0,-27,3,0
2,2,4,2,30,6,2,0,8,4,30,2,2,0,4,0,30,3,5,0,8,0,30,3,5,0,8,4,30,4,0,0,4,0,-27,3,0
2,2,19,1,30,5,8,0,13,2,30,3,5,0,8,0,30,8,5,0,13,3,30,4,9,0,13,3,30,9,0,0,9,1,-15,3,1
2,1,21,2,30,7,3,0,10,4,30,6,0,0,6,1,30,3,7,0,10,3,30,4,6,0,10,6,30,4,0,0,4,1,-15,3,1
2,3,25,1,30,6,8,0,14,4,30,6,0,0,6,0,30,7,7,0,14,1,30,5,9,0,14,2,30,5,1,0,6,1,-15,3,1
2,0,27,2,30,5,10,0,15,3,30,1,1,0,2,0,30,7,8,0,15,2,30,6,9,0,15,4,30,6,0,0,6,1,-15,3,1
2,4,27,2,30,5,10,0,15,3,30,1,1,0,2,0,30,7,8,0,15,2,30,6,9,0,15,4,30,6,0,0,6,1,-15,3,1
2,3,41,0,30,6,6,0,12,4,30,5,3,0,8,0,30,9,3,0,12,0,30,3,9,0,12,1,30,0,7,0,7,1,-15,3,1
2,3,4,8,30,8,0,0,8,4,30,4,0,0,4,0,30,3,5,0,8,0,30,0,8,0,8,2,30,4,0,0,4,0,-27,3,0
2,3,5,0,30,5,0,0,5,3,30,3,1,0,4,0,30,0,5,0,5,0,30,1,4,0,5,0,30,0,2,0,2,0,-27,3,0
2,4,8,1,30,7,0,0,7,3,30,2,0,0,2,7,30,2,5,0,7,1,30,7,0,0,7,4,30,3,0,0,3,0,-27,3,0
2,4,15,0,30,4,9,0,13,1,30,6,0,0,6,0,30,4,9,0,13,1,30,8,5,0,13,0,30,9,0,0,9,1,-15,3,1
2,1,19,0,30,3,10,0,13,1,30,3,5,0,8,7,30,4,9,0,13,4,30,4,9,0,13,0,30,9,0,0,9,1,-15,3,1
2,3,19,0,30,3,10,0,13,1,30,3,5,0,8,7,30,4,9,0,13,4,30,4,9,0,13,0,30,9,0,0,9,1,-15,3,1
2,4,19,0,30,3,10,0,13,1,30,3,5,0,8,7,30,4,9,0,13,4,30,4,9,0,13,0,30,9,0,0,9,1,-15,3,1
2,1,21,2,30,5,5,0,10,3,30,6,0,0,6,1,30,3,7,0,10,2,30,3,7,0,10,4,30,4,0,0,4,1,-15,3,1
2,3,21,2,30,5,5,0,10,3,30,6,0,0,6,1,30,3,7,0,10,2,30,3,7,0,10,4,30,4,0,0,4,1,-15,3,1
2,4,32,0,30,8,1,0,9,4,30,2,0,0,2,2,30,8,1,0,9,1,30,2,7,0,9,1,30,2,0,0,2,1,-15,3,1
2,2,43,0,30,5,9,0,14,10,30,6,0,0,6,0,30,4,10,0,14,2,30,8,6,0,14,7,30,5,0,0,5,1,-15,3,1
2,3,43,0,30,5,9,0,14,10,30,6,0,0,6,0,30,4,10,0,14,2,30,8,6,0,14,7,30,5,0,0,5,1,-15,3,1
2,2,13,2,30,7,0,0,7,0,30,4,0,0,4,0,30,6,1,0,7,6,30,4,3,0,7,4,30,4,0,0,4,1,-15,3,1
2,4,13,2,30,7,0,0,7,0,30,4,0,0,4,0,30,6,1,0,7,6,30,4,3,0,7,4,30,4,0,0,4,1,-15,3,1
2,4,17,4,30,9,5,0,14,2,30,6,0,0,6,0,30,7,7,0,14,0,30,6,8,0,14,2,30,4,0,0,4,1,-15,3,1
2,0,19,0,30,3,10,0,13,2,30,5,3,0,8,0,30,7,6,0,13,8,30,7,6,0,13,2,30,8,1,0,9,1,-15,3,1
2,1,19,0,30,3,10,0,13,2,30,5,3,0,8,0,30,7,6,0,13,8,30,7,6,0,13,2,30,8,1,0,9,1,-15,3,1
2,4,19,0,30,3,10,0,13,2,30,5,3,0,8,0,30,7,6,0,13,8,30,7,6,0,13,2,30,8,1,0,9,1,-15,3,1
2,2,25,2,30,5,9,0,14,2,30,6,0,0,6,0,30,12,2,0,14,1,30,4,10,0,14,3,30,5,1,0,6,1,-15,3,1
2,2,33,3,30,6,5,0,11,5,30,4,0,0,4,2,30,11,0,0,11,0,30,3,8,0,11,3,30,4,0,0,4,1,-15,3,1
2,4,35,0,30,6,7,0,13,5,30,2,0,0,2,1,30,4,9,0,13,4,30,3,10,0,13,3,30,8,0,0,8,1,-15,3,1
2,4,1,0,30,7,3,0,10,4,30,2,0,0,2,2,30,4,6,0,10,3,30,7,3,0,10,3,30,6,0,0,6,0,-27,3,0
2,0,5,0,30,2,3,0,5,3,30,3,1,0,4,0,30,0,5,0,5,0,30,1,4,0,5,0,30,2,0,0,2,0,-27,3,0
2,1,5,0,30,2,3,0,5,3,30,3,1,0,4,0,30,0,5,0,5,0,30,1,4,0,5,0,30,2,0,0,2,0,-27,3,0
2,2,11,1,30,6,6,0,12,1,30,4,0,0,4,0,30,4,8,0,12,3,30,3,9,0,12,4,30,3,1,0,4,1,-15,3,1
2,3,11,1,30,6,6,0,12,1,30,4,0,0,4,0,30,4,8,0,12,3,30,3,9,0,12,4,30,3,1,0,4,1,-15,3,1
2,4,11,1,30,6,6,0,12,1,30,4,0,0,4,0,30,4,8,0,12,3,30,3,9,0,12,4,30,3,1,0,4,1,-15,3,1
2,2,13,1,30,6,1,0,7,0,30,4,0,0,4,2,30,6,1,0,7,5,30,5,2,0,7,4,30,4,0,0,4,1,-15,3,1
2,3,13,1,30,6,1,0,7,0,30,4,0,0,4,2,30,6,1,0,7,5,30,5,2,0,7,4,30,4,0,0,4,1,-15,3,1
2,4,13,1,30,6,1,0,7,0,30,4,0,0,4,2,30,6,1,0,7,5,30,5,2,0,7,4,30,4,0,0,4,1,-15,3,1
2,4,15,1,30,5,8,0,13,1,30,5,1,0,6,0,30,4,9,0,13,1,30,7,6,0,13,0,30,7,2,0,9,1,-15,3,1
2,3,17,3,30,9,5,0,14,2,30,6,0,0,6,2,30,8,6,0,14,0,30,6,8,0,14,1,30,3,1,0,4,1,-15,3,1
2,0,19,0,30,1,12,0,13,2,30,7,1,0,8,0,30,7,6,0,13,3,30,4,9,0,13,1,30,8,1,0,9,1,-15,3,1
2,1,19,0,30,1,12,0,13,2,30,7,1,0,8,0,30,7,6,0,13,3,30,4,9,0,13,1,30,8,1,0,9,1,-15,3,1
2,3,23,2,30,5,8,0,13,1,30,6,0,0,6,4,30,11,2,0,13,0,30,6,7,0,13,4,30,6,0,0,6,1,-15,3,1
2,4,27,0,30,2,13,0,15,4,30,2,0,0,2,0,30,6,9,0,15,2,30,5,10,0,15,0,30,5,1,0,6,1,-15,3,1
2,2,29,0,30,9,5,0,14,5,30,12,0,0,12,0,30,6,8,0,14,0,30,2,12,0,14,1,30,9,0,0,9,1,-15,3,1
2,3,29,0,30,9,5,0,14,5,30,12,0,0,12,0,30,6,8,0,14,0,30,2,12,0,14,1,30,9,0,0,9,1,-15,3,1
2,4,29,0,30,9,5,0,14,5,30,12,0,0,12,0,30,6,8,0,14,0,30,2,12,0,14,1,30,9,0,0,9,1,-15,3,1
2,1,31,3,30,6,6,0,12,5,30,8,0,0,8,6,30,9,3,0,12,0,30,3,9,0,12,1,30,3,3,0,6,1,-15,3,1
2,2,31,3,30,6,6,0,12,5,30,8,0,0,8,6,30,9,3,0,12,0,30,3,9,0,12,1,30,3,3,0,6,1,-15,3,1
2,1,5,0,30,2,3,0,5,3,30,2,2,0,4,0,30,0,5,0,5,0,30,1,4,0,5,0,30,1,1,0,2,0,-27,3,0
2,2,5,0,30,2,3,0,5,3,30,2,2,0,4,0,30,0,5,0,5,0,30,1,4,0,5,0,30,1,1,0,2,0,-27,3,0
2,3,9,0,30,2,2,0,4,2,30,2,0,0,2,6,30,4,0,0,4,4,30,1,3,0,4,0,30,0,1,0,1,0,-27,3,0
2,4,9,0,30,2,2,0,4,2,30,2,0,0,2,6,30,4,0,0,4,4,30,1,3,0,4,0,30,0,1,0,1,0,-27,3,0
2,3,15,0,30,6,7,0,13,0,30,4,2,0,6,0,30,3,10,0,13,1,30,5,8,0,13,3,30,7,2,0,9,1,-15,3,1
2,4,15,0,30,6,7,0,13,0,30,4,2,0,6,0,30,3,10,0,13,1,30,5,8,0,13,3,30,7,2,0,9,1,-15,3,1
2,3,17,2,30,8,6,0,14,4,30,6,0,0,6,0,30,4,10,0,14,4,30,7,7,0,14,5,30,4,0,0,4,1,-15,3,1
2,2,19,0,30,3,10,0,13,2,30,5,3,0,8,0,30,6,7,0,13,5,30,9,4,0,13,2,30,9,0,0,9,1,-15,3,1
2,0,21,3,30,6,4,0,10,4,30,6,0,0,6,1,30,3,7,0,10,3,30,4,6,0,10,2,30,4,0,0,4,1,-15,3,1
2,1,21,3,30,6,4,0,10,4,30,6,0,0,6,1,30,3,7,0,10,3,30,4,6,0,10,2,30,4,0,0,4,1,-15,3,1
2,2,23,1,30,7,6,0,13,2,30,6,0,0,6,6,30,12,1,0,13,0,30,6,7,0,13,2,30,6,0,0,6,1,-15,3,1
2,3,23,1,30,7,6,0,13,2,30,6,0,0,6,6,30,12,1,0,13,0,30,6,7,0,13,2,30,6,0,0,6,1,-15,3,1
2,4,23,1,30,7,6,0,13,2,30,6,0,0,6,6,30,12,1,0,13,0,30,6,7,0,13,2,30,6,0,0,6,1,-15,3,1
2,4,25,1,30,9,5,0,14,2,30,6,0,0,6,0,30,7,7,0,14,0,30,7,7,0,14,3,30,6,0,0,6,1,-15,3,1
2,0,27,1,30,4,11,0,15,4,30,1,1,0,2,0,30,8,7,0,15,2,30,4,11,0,15,3,30,6,0,0,6,1,-15,3,1
2,1,27,1,30,4,11,0,15,4,30,1,1,0,2,0,30,8,7,0,15,2,30,4,11,0,15,3,30,6,0,0,6,1,-15,3,1
2,2,27,1,30,4,11,0,15,4,30,1,1,0,2,0,30,8,7,0,15,2,30,4,11,0,15,3,30,6,0,0,6,1,-15,3,1
2,1,29,0,30,4,10,0,14,5,30,11,1,0,12,0,30,8,6,0,14,0,30,0,14,0,14,4,30,9,0,0,9,1,-15,3,1
2,3,35,2,30,5,8,0,13,5,30,2,0,0,2,1,30,8,5,0,13,0,30,1,12,0,13,1,30,8,0,0,8,1,-15,3,1
2,1,5,0,30,2,3,0,5,2,30,2,2,0,4,1,30,2,3,0,5,0,30,1,4,0,5,0,30,0,2,0,2,0,-27,3,0
2,2,5,0,30,2,3,0,5,2,30,2,2,0,4,1,30,2,3,0,5,0,30,1,4,0,5,0,30,0,2,0,2,0,-27,3,0
2,3,5,0,30,2,3,0,5,2,30,2,2,0,4,1,30,2,3,0,5,0,30,1,4,0,5,0,30,0,2,0,2,0,-27,3,0
2,4,7,0,30,2,2,0,4,2,30,2,0,0,2,0,30,1,3,0,4,0,30,1,3,0,4,1,30,2,0,0,2,0,-27,3,0
2,4,8,2,30,7,0,0,7,4,30,2,0,0,2,3,30,5,2,0,7,1,30,7,0,0,7,2,30,3,0,0,3,0,-27,3,0
2,1,13,1,30,6,1,0,7,0,30,4,0,0,4,2,30,6,1,0,7,13,30,4,3,0,7,3,30,4,0,0,4,1,-15,3,1
2,4,13,1,30,6,1,0,7,0,30,4,0,0,4,2,30,6,1,0,7,13,30,4,3,0,7,3,30,4,0,0,4,1,-15,3,1
2,0,17,4,30,11,3,0,14,4,30,6,0,0,6,0,30,3,11,0,14,1,30,6,8,0,14,2,30,4,0,0,4,1,-15,3,1
2,2,17,4,30,11,3,0,14,4,30,6,0,0,6,0,30,3,11,0,14,1,30,6,8,0,14,2,30,4,0,0,4,1,-15,3,1
2,3,17,4,30,11,3,0,14,4,30,6,0,0,6,0,30,3,11,0,14,1,30,6,8,0,14,2,30,4,0,0,4,1,-15,3,1
2,3,19,0,30,8,5,0,13,2,30,7,1,0,8,4,30,4,9,0,13,1,30,2,11,0,13,1,30,8,1,0,9,1,-15,3,1
2,4,19,0,30,8,5,0,13,2,30,7,1,0,8,4,30,4,9,0,13,1,30,2,11,0,13,1,30,8,1,0,9,1,-15,3,1
2,3,23,1,30,9,4,0,13,0,30,6,0,0,6,0,30,10,3,0,13,0,30,6,7,0,13,5,30,6,0,0,6,1,-15,3,1
2,1,25,1,30,4,10,0,14,5,30,6,0,0,6,0,30,7,7,0,14,2,30,6,8,0,14,4,30,6,0,0,6,1,-15,3,1
2,2,25,1,30,4,10,0,14,5,30,6,0,0,6,0,30,7,7,0,14,2,30,6,8,0,14,4,30,6,0,0,6,1,-15,3,1
2,3,25,1,30,4,10,0,14,5,30,6,0,0,6,0,30,7,7,0,14,2,30,6,8,0,14,4,30,6,0,0,6,1,-15,3,1
2,4,27,0,30,6,9,0,15,4,30,2,0,0,2,0,30,4,11,0,15,0,30,4,11,0,15,1,30,2,4,0,6,1,-15,3,1
2,4,29,0,30,7,7,0,14,6,30,12,0,0,12,0,30,3,11,0,14,0,30,5,9,0,14,2,30,9,0,0,9,1,-15,3,1
2,3,31,1,30,7,5,0,12,5,30,8,0,0,8,3,30,8,4,0,12,0,30,3,9,0,12,1,30,6,0,0,6,1,-15,3,1
2,4,31,1,30,7,5,0,12,5,30,8,0,0,8,3,30,8,4,0,12,0,30,3,9,0,12,1,30,6,0,0,6,1,-15,3,1
2,4,39,1,30,5,6,0,11,8,30,6,0,0,6,0,30,3,8,0,11,0,30,5,6,0,11,5,30,5,0,0,5,1,-15,3,1
2,3,47,0,30,0,14,0,14,6,30,4,0,0,4,0,30,3,11,0,14,0,30,3,11,0,14,6,30,7,0,0,7,1,-15,3,1
2,2,5,3,30,1,4,0,5,3,30,1,3,0,4,0,30,1,4,0,5,0,30,1,4,0,5,1,30,2,0,0,2,0,-27,3,0
2,4,5,3,30,1,4,0,5,3,30,1,3,0,4,0,30,1,4,0,5,0,30,1,4,0,5,1,30,2,0,0,2,0,-27,3,0
2,2,8,0,30,7,0,0,7,3,30,2,0,0,2,2,30,7,0,0,7,2,30,7,0,0,7,4,30,3,0,0,3,0,-27,3,0
2,4,8,0,30,7,0,0,7,3,30,2,0,0,2,2,30,7,0,0,7,2,30,7,0,0,7,4,30,3,0,0,3,0,-27,3,0
2,2,15,1,30,7,6,0,13,0,30,6,0,0,6,0,30,4,9,0,13,1,30,3,10,0,13,2,30,8,1,0,9,1,-15,3,1
2,3,15,1,30,7,6,0,13,0,30,6,0,0,6,0,30,4,9,0,13,1,30,3,10,0,13,2,30,8,1,0,9,1,-15,3,1
2,4,15,1,30,7,6,0,13,0,30,6,0,0,6,0,30,4,9,0,13,1,30,3,10,0,13,2,30,8,1,0,9,1,-15,3,1
2,1,19,0,30,3,10,0,13,0,30,4,4,0,8,0,30,10,3,0,13,7,30,4,9,0,13,3,30,9,0,0,9,1,-15,3,1
2,2,21,2,30,7,3,0,10,2,30,6,0,0,6,1,30,7,3,0,10,2,30,4,6,0,10,1,30,4,0,0,4,1,-15,3,1
2,3,21,2,30,7,3,0,10,2,30,6,0,0,6,1,30,7,3,0,10,2,30,4,6,0,10,1,30,4,0,0,4,1,-15,3,1
2,3,23,2,30,6,7,0,13,4,30,6,0,0,6,4,30,10,3,0,13,1,30,4,9,0,13,4,30,6,0,0,6,1,-15,3,1
2,4,23,2,30,6,7,0,13,4,30,6,0,0,6,4,30,10,3,0,13,1,30,4,9,0,13,4,30,6,0,0,6,1,-15,3,1
2,2,25,1,30,5,9,0,14,5,30,6,0,0,6,2,30,5,9,0,14,1,30,8,6,0,14,4,30,5,1,0,6,1,-15,3,1
2,2,27,1,30,4,11,0,15,5,30,2,0,0,2,0,30,3,12,0,15,1,30,5,10,0,15,5,30,6,0,0,6,1,-15,3,1
2,3,27,1,30,4,11,0,15,5,30,2,0,0,2,0,30,3,12,0,15,1,30,5,10,0,15,5,30,6,0,0,6,1,-15,3,1
2,4,29,0,30,11,3,0,14,4,30,12,0,0,12,0,30,2,12,0,14,0,30,1,13,0,14,0,30,7,2,0,9,1,-15,3,1
2,3,31,0,30,7,5,0,12,4,30,8,0,0,8,3,30,8,4,0,12,0,30,3,9,0,12,0,30,2,4,0,6,1,-15,3,1
2,4,31,0,30,7,5,0,12,4,30,8,0,0,8,3,30,8,4,0,12,0,30,3,9,0,12,0,30,2,4,0,6,1,-15,3,1
2,4,35,0,30,5,8,0,13,5,30,2,0,0,2,1,30,2,11,0,13,7,30,1,12,0,13,4,30,8,0,0,8,1,-15,3,1
2,3,38,0,30,3,7,0,10,7,30,6,0,0,6,0,30,1,9,0,10,0,30,4,6,0,10,5,30,6,0,0,6,1,-15,3,1
2,4,38,0,30,3,7,0,10,7,30,6,0,0,6,0,30,1,9,0,10,0,30,4,6,0,10,5,30,6,0,0,6,1,-15,3,1
2,3,39,0,30,5,6,0,11,6,30,6,0,0,6,0,30,6,5,0,11,2,30,4,7,0,11,3,30,5,0,0,5,1,-15,3,1
2,2,43,0,30,10,4,0,14,8,30,6,0,0,6,0,30,4,10,0,14,1,30,1,13,0,14,6,30,5,0,0,5,1,-15,3,1
2,3,43,0,30,10,4,0,14,8,30,6,0,0,6,0,30,4,10,0,14,1,30,1,13,0,14,6,30,5,0,0,5,1,-15,3,1
2,4,43,0,30,10,4,0,14,8,30,6,0,0,6,0,30,4,10,0,14,1,30,1,13,0,14,6,30,5,0,0,5,1,-15,3,1
2,0,4,5,30,8,0,0,8,4,30,3,1,0,4,0,30,4,4,0,8,0,30,5,3,0,8,1,30,4,0,0,4,0,-27,3,0
2,1,4,5,30,8,0,0,8,4,30,3,1,0,4,0,30,4,4,0,8,0,30,5,3,0,8,1,30,4,0,0,4,0,-27,3,0
2,2,4,5,30,8,0,0,8,4,30,3,1,0,4,0,30,4,4,0,8,0,30,5,3,0,8,1,30,4,0,0,4,0,-27,3,0
2,4,4,5,30,8,0,0,8,4,30,3,1,0,4,0,30,4,4,0,8,0,30,5,3,0,8,1,30,4,0,0,4,0,-27,3,0
2,1,5,0,30,3,2,0,5,3,30,3,1,0,4,0,30,0,5,0,5,0,30,5,0,0,5,0,30,0,2,0,2,0,-27,3,0
2,4,5,0,30,3,2,0,5,3,30,3,1,0,4,0,30,0,5,0,5,0,30,5,0,0,5,0,30,0,2,0,2,0,-27,3,0
2,2,13,2,30,7,0,0,7,0,30,4,0,0,4,1,30,6,1,0,7,7,30,5,2,0,7,5,30,4,0,0,4,1,-15,3,1
2,1,19,0,30,2,11,0,13,2,30,7,1,0,8,0,30,7,6,0,13,8,30,5,8,0,13,0,30,7,2,0,9,1,-15,3,1
2,2,23,2,30,5,8,0,13,2,30,6,0,0,6,5,30,11,2,0,13,0,30,6,7,0,13,0,30,6,0,0,6,1,-15,3,1
2,2,25,1,30,11,3,0,14,4,30,6,0,0,6,0,30,7,7,0,14,1,30,5,9,0,14,4,30,5,1,0,6,1,-15,3,1
2,3,26,0,30,6,3,0,9,5,30,4,0,0,4,5,30,0,9,0,9,0,30,2,7,0,9,2,30,3,0,0,3,1,-15,3,1
2,2,39,2,30,7,4,0,11,7,30,6,0,0,6,0,30,4,7,0,11,0,30,2,9,0,11,1,30,5,0,0,5,1,-15,3,1
2,3,39,2,30,7,4,0,11,7,30,6,0,0,6,0,30,4,7,0,11,0,30,2,9,0,11,1,30,5,0,0,5,1,-15,3,1
2,4,3,0,30,0,4,0,4,2,30,4,0,0,4,0,30,0,4,0,4,5,30,2,2,0,4,0,30,1,2,0,3,0,-27,3,0
2,3,5,0,30,2,3,0,5,3,30,1,3,0,4,0,30,0,5,0,5,0,30,1,4,0,5,0,30,0,2,0,2,0,-27,3,0
2,3,23,1,30,8,5,0,13,1,30,6,0,0,6,0,30,12,1,0,13,0,30,6,7,0,13,5,30,6,0,0,6,1,-15,3,1
2,0,25,1,30,6,8,0,14,4,30,6,0,0,6,0,30,7,7,0,14,2,30,9,5,0,14,4,30,6,0,0,6,1,-15,3,1
2,1,25,1,30,6,8,0,14,4,30,6,0,0,6,0,30,7,7,0,14,2,30,9,5,0,14,4,30,6,0,0,6,1,-15,3,1
2,4,25,1,30,6,8,0,14,4,30,6,0,0,6,0,30,7,7,0,14,2,30,9,5,0,14,4,30,6,0,0,6,1,-15,3,1
2,0,27,1,30,6,9,0,15,4,30,2,0,0,2,0,30,3,12,0,15,2,30,4,11,0,15,2,30,6,0,0,6,1,-15,3,1
2,1,27,1,30,6,9,0,15,4,30,2,0,0,2,0,30,3,12,0,15,2,30,4,11,0,15,2,30,6,0,0,6,1,-15,3,1
2,3,27,1,30,6,9,0,15,1,30,2,0,0,2,0,30,3,12,0,15,2,30,4,11,0,15,2,30,6,0,0,6,1,-15,3,1
2,2,29,0,30,7,7,0,14,4,30,12,0,0,12,0,30,8,6,0,14,0,30,1,13,0,14,0,30,6,3,0,9,1,-15,3,1
2,3,29,0,30,7,7,0,14,4,30,12,0,0,12,0,30,8,6,0,14,0,30,1,13,0,14,0,30,6,3,0,9,1,-15,3,1
2,0,39,0,30,4,7,0,11,6,30,6,0,0,6,4,30,9,2,0,11,6,30,4,7,0,11,2,30,5,0,0,5,1,-15,3,1
2,1,39,0,30,4,7,0,11,6,30,6,0,0,6,4,30,9,2,0,11,6,30,4,7,0,11,2,30,5,0,0,5,1,-15,3,1
2,2,39,0,30,4,7,0,11,6,30,6,0,0,6,4,30,9,2,0,11,6,30,4,7,0,11,2,30,5,0,0,5,1,-15,3,1
2,3,7,0,30,3,1,0,4,2,30,2,0,0,2,1,30,3,1,0,4,0,30,1,3,0,4,1,30,1,1,0,2,0,-27,3,0
2,3,17,3,30,9,5,0,14,2,30,6,0,0,6,0,30,8,6,0,14,2,30,3,11,0,14,5,30,4,0,0,4,1,-15,3,1
2,1,19,0,30,2,11,0,13,2,30,6,2,0,8,0,30,5,8,0,13,7,30,4,9,0,13,5,30,6,3,0,9,1,-15,3,1
2,4,19,0,30,2,11,0,13,2,30,6,2,0,8,0,30,5,8,0,13,7,30,4,9,0,13,5,30,6,3,0,9,1,-15,3,1
2,0,27,1,30,4,11,0,15,3,30,2,0,0,2,0,30,5,10,0,15,3,30,7,8,0,15,7,30,6,0,0,6,1,-15,3,1
2,1,27,1,30,4,11,0,15,3,30,2,0,0,2,0,30,5,10,0,15,3,30,7,8,0,15,7,30,6,0,0,6,1,-15,3,1
2,0,31,5,30,4,8,0,12,8,30,8,0,0,8,3,30,4,8,0,12,0,30,9,3,0,12,2,30,6,0,0,6,1,-15,3,1
2,2,31,5,30,4,8,0,12,8,30,8,0,0,8,3,30,4,8,0,12,0,30,9,3,0,12,2,30,6,0,0,6,1,-15,3,1
2,3,31,5,30,4,8,0,12,8,30,8,0,0,8,3,30,4,8,0,12,0,30,9,3,0,12,2,30,6,0,0,6,1,-15,3,1
2,1,39,2,30,4,7,0,11,6,30,6,0,0,6,0,30,8,3,0,11,0,30,2,9,0,11,5,30,5,0,0,5,1,-15,3,1
2,4,1,0,30,7,3,0,10,4,30,2,0,0,2,0,30,4,6,0,10,4,30,6,4,0,10,6,30,6,0,0,6,0,-27,3,0
2,1,4,2,30,6,2,0,8,5,30,4,0,0,4,2,30,1,7,0,8,2,30,6,2,0,8,1,30,3,1,0,4,0,-27,3,0
2,2,4,2,30,6,2,0,8,5,30,4,0,0,4,2,30,1,7,0,8,2,30,6,2,0,8,1,30,3,1,0,4,0,-27,3,0
2,1,5,0,30,2,3,0,5,3,30,4,0,0,4,0,30,0,5,0,5,0,30,3,2,0,5,0,30,0,2,0,2,0,-27,3,0
2,0,13,2,30,7,0,0,7,1,30,4,0,0,4,2,30,5,2,0,7,8,30,6,1,0,7,6,30,4,0,0,4,1,-15,3,1
2,1,13,2,30,7,0,0,7,1,30,4,0,0,4,2,30,5,2,0,7,8,30,6,1,0,7,6,30,4,0,0,4,1,-15,3,1
2,4,23,1,30,8,5,0,13,1,30,6,0,0,6,3,30,10,3,0,13,0,30,5,8,0,13,1,30,6,0,0,6,1,-15,3,1
2,4,25,1,30,6,8,0,14,4,30,6,0,0,6,1,30,4,10,0,14,1,30,5,9,0,14,4,30,5,1,0,6,1,-15,3,1
2,0,27,1,30,4,11,0,15,3,30,2,0,0,2,0,30,12,3,0,15,0,30,4,11,0,15,3,30,6,0,0,6,1,-15,3,1
2,1,27,1,30,4,11,0,15,3,30,2,0,0,2,0,30,12,3,0,15,0,30,4,11,0,15,3,30,6,0,0,6,1,-15,3,1
2,3,27,1,30,4,11,0,15,2,30,2,0,0,2,0,30,12,3,0,15,0,30,4,11,0,15,3,30,6,0,0,6,1,-15,3,1
2,4,27,1,30,4,11,0,15,2,30,2,0,0,2,0,30,12,3,0,15,0,30,4,11,0,15,3,30,6,0,0,6,1,-15,3,1
2,3,33,0,30,6,5,0,11,4,30,4,0,0,4,5,30,9,2,0,11,2,30,5,6,0,11,6,30,4,0,0,4,1,-15,3,1
2,2,35,0,30,9,4,0,13,6,30,2,0,0,2,1,30,2,11,0,13,0,30,2,11,0,13,5,30,8,0,0,8,1,-15,3,1
2,4,35,0,30,9,4,0,13,6,30,2,0,0,2,1,30,2,11,0,13,0,30,2,11,0,13,5,30,8,0,0,8,1,-15,3,1
2,4,5,0,30,2,3,0,5,3,30,2,2,0,4,0,30,2,3,0,5,0,30,2,3,0,5,1,30,0,2,0,2,0,-27,3,0
2,3,13,4,30,7,0,0,7,2,30,4,0,0,4,3,30,6,1,0,7,3,30,4,3,0,7,2,30,4,0,0,4,1,-15,3,1
2,4,13,4,30,7,0,0,7,2,30,4,0,0,4,3,30,6,1,0,7,3,30,4,3,0,7,2,30,4,0,0,4,1,-15,3,1
2,2,17,3,30,9,5,0,14,3,30,6,0,0,6,0,30,6,8,0,14,1,30,6,8,0,14,2,30,4,0,0,4,1,-15,3,1
2,3,23,1,30,4,9,0,13,1,30,6,0,0,6,4,30,11,2,0,13,0,30,5,8,0,13,2,30,6,0,0,6,1,-15,3,1
2,2,25,1,30,6,8,0,14,3,30,6,0,0,6,0,30,8,6,0,14,2,30,6,8,0,14,4,30,5,1,0,6,1,-15,3,1
2,4,25,1,30,6,8,0,14,3,30,6,0,0,6,0,30,8,6,0,14,2,30,6,8,0,14,4,30,5,1,0,6,1,-15,3,1
2,1,29,0,30,6,8,0,14,5,30,12,0,0,12,0,30,6,8,0,14,0,30,0,14,0,14,3,30,9,0,0,9,1,-15,3,1
2,2,29,0,30,6,8,0,14,5,30,12,0,0,12,0,30,6,8,0,14,0,30,0,14,0,14,3,30,9,0,0,9,1,-15,3,1
2,3,29,0,30,6,8,0,14,5,30,12,0,0,12,0,30,6,8,0,14,0,30,0,14,0,14,3,30,9,0,0,9,1,-15,3,1
2,2,31,1,30,6,6,0,12,5,30,8,0,0,8,6,30,9,3,0,12,0,30,3,9,0,12,1,30,4,2,0,6,1,-15,3,1
2,3,39,0,30,2,9,0,11,6,30,6,0,0,6,0,30,6,5,0,11,0,30,2,9,0,11,6,30,5,0,0,5,1,-15,3,1
2,4,39,0,30,2,9,0,11,6,30,6,0,0,6,0,30,6,5,0,11,0,30,2,9,0,11,6,30,5,0,0,5,1,-15,3,1
2,0,5,0,30,4,1,0,5,3,30,2,2,0,4,1,30,2,3,0,5,0,30,1,4,0,5,0,30,0,2,0,2,0,-27,3,0
2,4,5,0,30,4,1,0,5,3,30,2,2,0,4,1,30,2,3,0,5,0,30,1,4,0,5,0,30,0,2,0,2,0,-27,3,0
2,2,17,3,30,9,5,0,14,3,30,6,0,0,6,0,30,3,11,0,14,1,30,6,8,0,14,0,30,4,0,0,4,1,-15,3,1
2,4,17,0,30,9,5,0,14,3,30,6,0,0,6,0,30,3,11,0,14,1,30,6,8,0,14,0,30,4,0,0,4,1,-15,3,1
2,3,19,0,30,4,9,0,13,3,30,4,4,0,8,4,30,5,8,0,13,0,30,7,6,0,13,2,30,8,1,0,9,1,-15,3,1
2,4,19,0,30,4,9,0,13,3,30,4,4,0,8,4,30,5,8,0,13,0,30,7,6,0,13,2,30,8,1,0,9,1,-15,3,1
2,4,23,2,30,5,8,0,13,3,30,6,0,0,6,1,30,13,0,0,13,0,30,6,7,0,13,3,30,6,0,0,6,1,-15,3,1
2,2,1,0,30,7,3,0,10,4,30,2,0,0,2,1,30,4,6,0,10,6,30,8,2,0,10,5,30,6,0,0,6,0,-27,3,0
2,3,1,0,30,7,3,0,10,4,30,2,0,0,2,1,30,4,6,0,10,6,30,8,2,0,10,5,30,6,0,0,6,0,-27,3,0
2,2,13,1,30,4,3,0,7,0,30,4,0,0,4,4,30,7,0,0,7,14,30,6,1,0,7,5,30,4,0,0,4,1,-15,3,1
2,2,17,3,30,10,4,0,14,2,30,6,0,0,6,0,30,5,9,0,14,1,30,4,10,0,14,6,30,4,0,0,4,1,-15,3,1
2,3,23,1,30,4,9,0,13,4,30,6,0,0,6,7,30,12,1,0,13,0,30,6,7,0,13,2,30,6,0,0,6,1,-15,3,1
2,2,27,0,30,4,11,0,15,3,30,2,0,0,2,0,30,4,11,0,15,0,30,5,10,0,15,5,30,6,0,0,6,1,-15,3,1
2,4,27,0,30,4,11,0,15,3,30,2,0,0,2,0,30,4,11,0,15,0,30,5,10,0,15,5,30,6,0,0,6,1,-15,3,1
2,1,31,1,30,6,6,0,12,5,30,8,0,0,8,4,30,7,5,0,12,0,30,7,5,0,12,1,30,4,2,0,6,1,-15,3,1
2,3,5,0,30,3,2,0,5,3,30,4,0,0,4,2,30,0,5,0,5,0,30,1,4,0,5,0,30,0,2,0,2,0,-27,3,0
2,3,7,0,30,1,3,0,4,2,30,2,0,0,2,0,30,1,3,0,4,0,30,1,3,0,4,1,30,1,1,0,2,0,-27,3,0
2,1,23,2,30,6,7,0,13,4,30,6,0,0,6,5,30,9,4,0,13,0,30,9,4,0,13,2,30,6,0,0,6,1,-15,3,1
2,3,23,2,30,6,7,0,13,4,30,6,0,0,6,5,30,9,4,0,13,0,30,9,4,0,13,2,30,6,0,0,6,1,-15,3,1
2,4,23,2,30,6,7,0,13,4,30,6,0,0,6,5,30,9,4,0,13,0,30,9,4,0,13,2,30,6,0,0,6,1,-15,3,1
2,0,27,1,30,5,10,0,15,5,30,2,0,0,2,0,30,3,12,0,15,0,30,6,9,0,15,8,30,6,0,0,6,1,-15,3,1
2,2,31,1,30,5,7,0,12,8,30,8,0,0,8,3,30,3,9,0,12,0,30,7,5,0,12,8,30,6,0,0,6,1,-15,3,1
2,3,31,1,30,5,7,0,12,8,30,8,0,0,8,3,30,3,9,0,12,0,30,7,5,0,12,8,30,6,0,0,6,1,-15,3,1
2,2,4,3,30,6,2,0,8,4,30,4,0,0,4,2,30,2,6,0,8,0,30,5,3,0,8,1,30,3,1,0,4,0,-27,3,0
2,4,4,3,30,6,2,0,8,4,30,4,0,0,4,2,30,2,6,0,8,0,30,5,3,0,8,1,30,3,1,0,4,0,-27,3,0
2,2,7,0,30,1,3,0,4,2,30,2,0,0,2,0,30,1,3,0,4,0,30,0,4,0,4,0,30,2,0,0,2,0,-27,3,0
2,3,13,3,30,7,0,0,7,1,30,4,0,0,4,0,30,6,1,0,7,1,30,5,2,0,7,2,30,4,0,0,4,1,-15,3,1
2,4,15,2,30,3,10,0,13,0,30,6,0,0,6,0,30,5,8,0,13,1,30,4,9,0,13,0,30,5,4,0,9,1,-15,3,1
2,1,17,1,30,11,3,0,14,3,30,6,0,0,6,0,30,4,10,0,14,3,30,5,9,0,14,2,30,4,0,0,4,1,-15,3,1
2,3,17,1,30,11,3,0,14,3,30,6,0,0,6,0,30,4,10,0,14,3,30,5,9,0,14,2,30,4,0,0,4,1,-15,3,1
2,2,47,0,30,0,14,0,14,7,30,4,0,0,4,0,30,3,11,0,14,0,30,2,12,0,14,10,30,7,0,0,7,1,-15,3,1
2,1,4,6,30,7,1,0,8,4,30,2,2,0,4,1,30,5,3,0,8,0,30,4,4,0,8,3,30,3,1,0,4,0,-27,3,0
2,3,4,6,30,7,1,0,8,4,30,2,2,0,4,1,30,5,3,0,8,0,30,4,4,0,8,3,30,3,1,0,4,0,-27,3,0
2,0,5,0,30,5,0,0,5,3,30,3,1,0,4,0,30,0,5,0,5,0,30,1,4,0,5,2,30,2,0,0,2,0,-27,3,0
2,1,5,0,30,5,0,0,5,3,30,3,1,0,4,0,30,0,5,0,5,0,30,1,4,0,5,2,30,2,0,0,2,0,-27,3,0
2,2,9,7,30,3,1,0,4,3,30,2,0,0,2,4,30,2,2,0,4,0,30,1,3,0,4,0,30,1,0,0,1,0,-27,3,0
2,4,9,0,30,10,1,0,11,2,30,6,0,0,6,0,30,8,3,0,11,0,30,3,8,0,11,2,30,2,2,0,4,0,-27,3,0
2,2,17,3,30,9,5,0,14,2,30,6,0,0,6,1,30,8,6,0,14,1,30,2,12,0,14,2,30,4,0,0,4,1,-15,3,1
2,3,17,3,30,9,5,0,14,2,30,6,0,0,6,1,30,8,6,0,14,1,30,2,12,0,14,2,30,4,0,0,4,1,-15,3,1
2,4,17,3,30,9,5,0,14,2,30,6,0,0,6,1,30,8,6,0,14,1,30,2,12,0,14,2,30,4,0,0,4,1,-15,3,1
2,4,19,0,30,2,11,0,13,2,30,8,0,0,8,0,30,4,9,0,13,1,30,7,6,0,13,3,30,8,1,0,9,1,-15,3,1
2,3,21,2,30,6,4,0,10,3,30,4,2,0,6,0,30,3,7,0,10,5,30,5,5,0,10,5,30,4,0,0,4,1,-15,3,1
2,2,25,1,30,8,6,0,14,5,30,6,0,0,6,0,30,7,7,0,14,1,30,7,7,0,14,4,30,5,1,0,6,1,-15,3,1
2,3,25,1,30,8,6,0,14,5,30,6,0,0,6,0,30,7,7,0,14,1,30,7,7,0,14,4,30,5,1,0,6,1,-15,3,1
2,4,25,1,30,8,6,0,14,5,30,6,0,0,6,0,30,7,7,0,14,1,30,7,7,0,14,4,30,5,1,0,6,1,-15,3,1
2,1,27,1,30,3,12,0,15,2,30,1,1,0,2,0,30,5,10,0,15,4,30,4,11,0,15,4,30,6,0,0,6,1,-15,3,1
2,4,27,1,30,3,12,0,15,2,30,1,1,0,2,0,30,5,10,0,15,0,30,4,11,0,15,4,30,6,0,0,6,1,-15,3,1
2,3,29,0,30,4,10,0,14,6,30,10,2,0,12,0,30,4,10,0,14,0,30,0,14,0,14,2,30,9,0,0,9,1,-15,3,1
2,4,29,0,30,4,10,0,14,6,30,10,2,0,12,0,30,4,10,0,14,0,30,0,14,0,14,2,30,9,0,0,9,1,-15,3,1
2,2,4,2,30,8,0,0,8,4,30,4,0,0,4,0,30,5,3,0,8,0,30,6,2,0,8,1,30,3,1,0,4,0,-27,3,0
2,1,5,0,30,2,3,0,5,2,30,3,1,0,4,0,30,1,4,0,5,0,30,1,4,0,5,0,30,0,2,0,2,0,-27,3,0
2,4,8,2,30,7,0,0,7,5,30,2,0,0,2,4,30,2,5,0,7,0,30,6,1,0,7,3,30,3,0,0,3,0,-27,3,0
2,4,15,0,30,9,4,0,13,0,30,5,1,0,6,0,30,3,10,0,13,0,30,2,11,0,13,0,30,9,0,0,9,1,-15,3,1
2,4,17,0,30,7,7,0,14,2,30,6,0,0,6,0,30,7,7,0,14,2,30,4,10,0,14,5,30,4,0,0,4,1,-15,3,1
2,2,19,0,30,2,11,0,13,2,30,4,4,0,8,0,30,7,6,0,13,11,30,4,9,0,13,1,30,9,0,0,9,1,-15,3,1
2,3,25,1,30,9,5,0,14,5,30,6,0,0,6,0,30,5,9,0,14,1,30,5,9,0,14,4,30,5,1,0,6,1,-15,3,1
2,0,26,0,30,6,3,0,9,6,30,4,0,0,4,2,30,0,9,0,9,0,30,2,7,0,9,6,30,3,0,0,3,1,-15,3,1
2,1,26,0,30,6,3,0,9,6,30,4,0,0,4,2,30,0,9,0,9,0,30,2,7,0,9,6,30,3,0,0,3,1,-15,3,1
2,2,26,0,30,6,3,0,9,6,30,4,0,0,4,2,30,0,9,0,9,0,30,2,7,0,9,6,30,3,0,0,3,1,-15,3,1
2,4,26,0,30,6,3,0,9,6,30,4,0,0,4,2,30,0,9,0,9,0,30,2,7,0,9,6,30,3,0,0,3,1,-15,3,1
2,2,27,1,30,5,10,0,15,2,30,1,1,0,2,0,30,6,9,0,15,3,30,5,10,0,15,2,30,6,0,0,6,1,-15,3,1
2,3,27,1,30,5,10,0,15,2,30,1,1,0,2,0,30,6,9,0,15,3,30,5,10,0,15,2,30,6,0,0,6,1,-15,3,1
2,0,41,0,30,7,5,0,12,8,30,8,0,0,8,0,30,3,9,0,12,2,30,5,7,0,12,6,30,7,0,0,7,1,-15,3,1
2,3,41,0,30,7,5,0,12,8,30,8,0,0,8,0,30,3,9,0,12,2,30,5,7,0,12,6,30,7,0,0,7,1,-15,3,1
2,0,5,0,30,1,4,0,5,3,30,1,3,0,4,0,30,0,5,0,5,0,30,2,3,0,5,2,30,2,0,0,2,0,-27,3,0
2,2,5,0,30,1,4,0,5,3,30,1,3,0,4,0,30,0,5,0,5,0,30,2,3,0,5,2,30,2,0,0,2,0,-27,3,0
2,4,5,0,30,1,4,0,5,3,30,1,3,0,4,0,30,0,5,0,5,0,30,2,3,0,5,2,30,2,0,0,2,0,-27,3,0
2,2,8,1,30,7,0,0,7,4,30,2,0,0,2,0,30,5,2,0,7,1,30,7,0,0,7,4,30,3,0,0,3,0,-27,3,0
2,3,8,1,30,7,0,0,7,4,30,2,0,0,2,0,30,5,2,0,7,1,30,7,0,0,7,4,30,3,0,0,3,0,-27,3,0
2,1,13,1,30,5,2,0,7,0,30,4,0,0,4,2,30,5,2,0,7,7,30,7,0,0,7,6,30,4,0,0,4,1,-15,3,1
2,2,13,1,30,5,2,0,7,0,30,4,0,0,4,2,30,5,2,0,7,7,30,7,0,0,7,6,30,4,0,0,4,1,-15,3,1
2,3,17,6,30,11,3,0,14,4,30,6,0,0,6,0,30,3,11,0,14,2,30,6,8,0,14,0,30,4,0,0,4,1,-15,3,1
2,4,17,6,30,11,3,0,14,4,30,6,0,0,6,0,30,3,11,0,14,2,30,6,8,0,14,0,30,4,0,0,4,1,-15,3,1
2,3,33,2,30,5,6,0,11,4,30,4,0,0,4,0,30,10,1,0,11,1,30,4,7,0,11,5,30,4,0,0,4,1,-15,3,1
2,3,39,0,30,6,5,0,11,7,30,6,0,0,6,0,30,4,7,0,11,0,30,2,9,0,11,4,30,5,0,0,5,1,-15,3,1
2,3,47,0,30,0,14,0,14,7,30,4,0,0,4,0,30,5,9,0,14,0,30,2,12,0,14,10,30,7,0,0,7,1,-15,3,1
2,1,5,0,30,2,3,0,5,3,30,2,2,0,4,0,30,0,5,0,5,0,30,1,4,0,5,1,30,2,0,0,2,0,-27,3,0
2,3,5,0,30,2,3,0,5,3,30,2,2,0,4,0,30,0,5,0,5,0,30,1,4,0,5,1,30,2,0,0,2,0,-27,3,0
2,2,11,0,30,1,3,0,4,0,30,0,0,0,0,0,30,2,2,0,4,3,30,3,1,0,4,1,30,1,0,0,1,1,-15,3,1
2,4,15,0,30,5,8,0,13,1,30,6,0,0,6,0,30,3,10,0,13,0,30,5,8,0,13,2,30,7,2,0,9,1,-15,3,1
2,4,17,3,30,9,5,0,14,2,30,6,0,0,6,0,30,5,9,0,14,2,30,7,7,0,14,1,30,4,0,0,4,1,-15,3,1
2,4,19,0,30,3,10,0,13,2,30,5,3,0,8,0,30,8,5,0,13,9,30,5,8,0,13,1,30,8,1,0,9,1,-15,3,1
2,4,27,2,30,6,9,0,15,5,30,1,1,0,2,0,30,8,7,0,15,0,30,6,9,0,15,2,30,6,0,0,6,1,-15,3,1
2,2,29,0,30,7,7,0,14,5,30,11,1,0,12,0,30,7,7,0,14,0,30,0,14,0,14,3,30,9,0,0,9,1,-15,3,1
2,1,4,2,30,7,1,0,8,4,30,4,0,0,4,2,30,5,3,0,8,0,30,5,3,0,8,1,30,3,1,0,4,0,-27,3,0
2,1,5,0,30,2,3,0,5,3,30,1,3,0,4,2,30,1,4,0,5,0,30,1,4,0,5,0,30,1,1,0,2,0,-27,3,0
2,2,5,0,30,2,3,0,5,3,30,1,3,0,4,2,30,1,4,0,5,0,30,1,4,0,5,0,30,1,1,0,2,0,-27,3,0
2,3,5,0,30,2,3,0,5,3,30,1,3,0,4,2,30,1,4,0,5,0,30,1,4,0,5,0,30,1,1,0,2,0,-27,3,0
2,4,5,0,30,2,3,0,5,3,30,1,3,0,4,2,30,1,4,0,5,0,30,1,4,0,5,0,30,1,1,0,2,0,-27,3,0
2,2,13,6,30,7,0,0,7,0,30,4,0,0,4,2,30,5,2,0,7,12,30,5,2,0,7,2,30,4,0,0,4,1,-15,3,1
2,2,17,3,30,10,4,0,14,2,30,6,0,0,6,0,30,6,8,0,14,1,30,6,8,0,14,2,30,2,2,0,4,1,-15,3,1
2,3,27,3,30,11,4,0,15,0,30,2,0,0,2,0,30,9,6,0,15,0,30,3,12,0,15,1,30,3,3,0,6,1,-15,3,1
2,0,43,0,30,9,5,0,14,8,30,6,0,0,6,0,30,4,10,0,14,1,30,5,9,0,14,4,30,5,0,0,5,1,-15,3,1
2,2,43,0,30,9,5,0,14,8,30,6,0,0,6,0,30,4,10,0,14,1,30,5,9,0,14,4,30,5,0,0,5,1,-15,3,1
2,3,43,0,30,9,5,0,14,8,30,6,0,0,6,0,30,4,10,0,14,1,30,5,9,0,14,4,30,5,0,0,5,1,-15,3,1
2,4,43,0,30,9,5,0,14,8,30,6,0,0,6,0,30,4,10,0,14,1,30,5,9,0,14,4,30,5,0,0,5,1,-15,3,1
2,4,47,0,30,1,13,0,14,9,30,4,0,0,4,0,30,4,10,0,14,0,30,10,4,0,14,4,30,7,0,0,7,1,-15,3,1
2,4,10,5,30,5,4,0,9,2,30,2,2,0,4,0,30,3,6,0,9,0,30,1,8,0,9,2,30,5,0,0,5,1,-15,3,1
2,4,15,0,30,7,6,0,13,0,30,5,1,0,6,0,30,7,6,0,13,1,30,4,9,0,13,1,30,5,4,0,9,1,-15,3,1
2,4,23,1,30,5,8,0,13,3,30,6,0,0,6,5,30,9,4,0,13,2,30,7,6,0,13,0,30,5,1,0,6,1,-15,3,1
2,1,27,1,30,3,12,0,15,3,30,1,1,0,2,0,30,6,9,0,15,2,30,4,11,0,15,4,30,6,0,0,6,1,-15,3,1
2,2,27,1,30,3,12,0,15,3,30,1,1,0,2,0,30,6,9,0,15,2,30,4,11,0,15,4,30,6,0,0,6,1,-15,3,1
2,3,27,1,30,3,12,0,15,3,30,1,1,0,2,0,30,6,9,0,15,2,30,4,11,0,15,4,30,6,0,0,6,1,-15,3,1
2,3,31,5,30,4,8,0,12,5,30,8,0,0,8,3,30,9,3,0,12,0,30,7,5,0,12,1,30,4,2,0,6,1,-15,3,1
2,4,31,5,30,4,8,0,12,5,30,8,0,0,8,3,30,9,3,0,12,0,30,7,5,0,12,1,30,4,2,0,6,1,-15,3,1
2,4,32,0,30,8,1,0,9,5,30,2,0,0,2,1,30,7,2,0,9,1,30,3,6,0,9,2,30,2,0,0,2,1,-15,3,1
2,0,4,2,30,8,0,0,8,4,30,4,0,0,4,0,30,5,3,0,8,1,30,7,1,0,8,2,30,4,0,0,4,0,-27,3,0
2,3,5,0,30,2,3,0,5,3,30,2,2,0,4,0,30,0,5,0,5,0,30,1,4,0,5,0,30,1,1,0,2,0,-27,3,0
2,1,13,1,30,6,1,0,7,0,30,4,0,0,4,3,30,7,0,0,7,9,30,6,1,0,7,5,30,4,0,0,4,1,-15,3,1
2,2,13,1,30,6,1,0,7,0,30,4,0,0,4,3,30,7,0,0,7,9,30,6,1,0,7,5,30,4,0,0,4,1,-15,3,1
2,4,13,1,30,6,1,0,7,0,30,4,0,0,4,3,30,7,0,0,7,9,30,6,1,0,7,5,30,4,0,0,4,1,-15,3,1
2,4,23,1,30,6,7,0,13,1,30,6,0,0,6,3,30,11,2,0,13,0,30,3,10,0,13,2,30,6,0,0,6,1,-15,3,1
2,3,25,0,30,8,6,0,14,1,30,6,0,0,6,0,30,12,2,0,14,1,30,5,9,0,14,2,30,5,1,0,6,1,-15,3,1
2,1,26,0,30,6,3,0,9,4,30,2,2,0,4,5,30,2,7,0,9,0,30,2,7,0,9,4,30,2,1,0,3,1,-15,3,1
2,4,26,0,30,6,3,0,9,4,30,2,2,0,4,5,30,2,7,0,9,0,30,2,7,0,9,4,30,2,1,0,3,1,-15,3,1
2,2,27,1,30,5,10,0,15,2,30,2,0,0,2,0,30,6,9,0,15,2,30,6,9,0,15,0,30,6,0,0,6,1,-15,3,1
2,1,29,0,30,8,6,0,14,6,30,10,2,0,12,0,30,3,11,0,14,0,30,1,13,0,14,3,30,9,0,0,9,1,-15,3,1
2,2,29,0,30,8,6,0,14,6,30,10,2,0,12,0,30,3,11,0,14,0,30,1,13,0,14,3,30,9,0,0,9,1,-15,3,1
2,4,29,0,30,8,6,0,14,6,30,10,2,0,12,0,30,3,11,0,14,0,30,1,13,0,14,3,30,9,0,0,9,1,-15,3,1
2,3,1,0,30,7,3,0,10,4,30,2,0,0,2,1,30,4,6,0,10,4,30,8,2,0,10,6,30,6,0,0,6,0,-27,3,0
2,0,5,0,30,0,5,0,5,3,30,1,3,0,4,0,30,0,5,0,5,0,30,1,4,0,5,0,30,2,0,0,2,0,-27,3,0
2,1,5,0,30,0,5,0,5,3,30,1,3,0,4,0,30,0,5,0,5,0,30,1,4,0,5,0,30,2,0,0,2,0,-27,3,0
2,3,5,0,30,0,5,0,5,3,30,1,3,0,4,0,30,0,5,0,5,0,30,1,4,0,5,0,30,2,0,0,2,0,-27,3,0
2,2,8,0,30,7,0,0,7,2,30,2,0,0,2,4,30,2,5,0,7,0,30,5,2,0,7,3,30,3,0,0,3,0,-27,3,0
2,4,17,3,30,9,5,0,14,3,30,6,0,0,6,0,30,6,8,0,14,1,30,7,7,0,14,4,30,4,0,0,4,1,-15,3,1
2,1,19,0,30,4,9,0,13,1,30,6,2,0,8,6,30,12,1,0,13,0,30,6,7,0,13,1,30,6,3,0,9,1,-15,3,1
2,2,19,0,30,4,9,0,13,1,30,6,2,0,8,6,30,12,1,0,13,0,30,6,7,0,13,1,30,6,3,0,9,1,-15,3,1
2,3,19,0,30,4,9,0,13,1,30,6,2,0,8,6,30,12,1,0,13,0,30,6,7,0,13,1,30,6,3,0,9,1,-15,3,1
2,1,21,3,30,7,3,0,10,3,30,4,2,0,6,0,30,3,7,0,10,6,30,5,5,0,10,4,30,4,0,0,4,1,-15,3,1
2,3,25,0,30,8,6,0,14,4,30,6,0,0,6,0,30,6,8,0,14,0,30,5,9,0,14,4,30,6,0,0,6,1,-15,3,1
2,4,25,0,30,8,6,0,14,4,30,6,0,0,6,0,30,6,8,0,14,0,30,5,9,0,14,4,30,6,0,0,6,1,-15,3,1
2,1,27,0,30,3,12,0,15,4,30,1,1,0,2,0,30,3,12,0,15,0,30,4,11,0,15,4,30,6,0,0,6,1,-15,3,1
2,2,27,0,30,3,12,0,15,4,30,1,1,0,2,0,30,3,12,0,15,0,30,4,11,0,15,4,30,6,0,0,6,1,-15,3,1
2,4,27,0,30,3,12,0,15,4,30,1,1,0,2,0,30,3,12,0,15,0,30,4,11,0,15,4,30,6,0,0,6,1,-15,3,1
2,3,29,0,30,4,10,0,14,5,30,11,1,0,12,0,30,9,5,0,14,0,30,0,14,0,14,0,30,9,0,0,9,1,-15,3,1
2,3,31,2,30,6,6,0,12,4,30,8,0,0,8,3,30,10,2,0,12,0,30,3,9,0,12,1,30,3,3,0,6,1,-15,3,1
2,4,31,2,30,6,6,0,12,4,30,8,0,0,8,3,30,10,2,0,12,0,30,3,9,0,12,1,30,3,3,0,6,1,-15,3,1
2,3,35,0,30,7,6,0,13,5,30,2,0,0,2,1,30,2,11,0,13,4,30,1,12,0,13,10,30,8,0,0,8,1,-15,3,1
2,2,5,0,30,2,3,0,5,3,30,3,1,0,4,0,30,0,5,0,5,1,30,2,3,0,5,1,30,0,2,0,2,0,-27,3,0
2,1,13,4,30,7,0,0,7,0,30,4,0,0,4,1,30,6,1,0,7,9,30,7,0,0,7,5,30,4,0,0,4,1,-15,3,1
2,2,13,4,30,7,0,0,7,0,30,4,0,0,4,1,30,6,1,0,7,9,30,7,0,0,7,5,30,4,0,0,4,1,-15,3,1
2,4,15,0,30,5,8,0,13,1,30,6,0,0,6,0,30,3,10,0,13,1,30,4,9,0,13,1,30,8,1,0,9,1,-15,3,1
2,2,17,4,30,8,6,0,14,3,30,6,0,0,6,0,30,5,9,0,14,2,30,6,8,0,14,4,30,4,0,0,4,1,-15,3,1
2,4,17,4,30,8,6,0,14,3,30,6,0,0,6,0,30,5,9,0,14,2,30,6,8,0,14,4,30,4,0,0,4,1,-15,3,1
2,2,27,1,30,3,12,0,15,3,30,2,0,0,2,0,30,4,11,0,15,5,30,4,11,0,15,3,30,6,0,0,6,1,-15,3,1
2,4,27,1,30,3,12,0,15,3,30,2,0,0,2,0,30,4,11,0,15,5,30,4,11,0,15,3,30,6,0,0,6,1,-15,3,1
2,4,29,0,30,6,8,0,14,6,30,10,2,0,12,0,30,5,9,0,14,0,30,1,13,0,14,2,30,9,0,0,9,1,-15,3,1
2,3,38,0,30,2,8,0,10,6,30,6,0,0,6,0,30,3,7,0,10,0,30,4,6,0,10,8,30,6,0,0,6,1,-15,3,1
2,3,39,0,30,3,8,0,11,6,30,6,0,0,6,0,30,7,4,0,11,2,30,2,9,0,11,3,30,5,0,0,5,1,-15,3,1
2,3,43,0,30,6,8,0,14,6,30,6,0,0,6,0,30,4,10,0,14,1,30,3,11,0,14,6,30,5,0,0,5,1,-15,3,1
2,4,43,0,30,6,8,0,14,6,30,6,0,0,6,0,30,4,10,0,14,1,30,3,11,0,14,6,30,5,0,0,5,1,-15,3,1
2,4,6,0,30,8,1,0,9,3,30,2,0,0,2,0,30,5,4,0,9,0,30,3,6,0,9,0,30,4,1,0,5,0,-27,3,0
2,3,7,0,30,2,2,0,4,2,30,2,0,0,2,0,30,2,2,0,4,0,30,1,3,0,4,1,30,1,1,0,2,0,-27,3,0
2,0,17,2,30,10,4,0,14,4,30,6,0,0,6,0,30,3,11,0,14,4,30,7,7,0,14,3,30,4,0,0,4,1,-15,3,1
2,1,17,2,30,10,4,0,14,4,30,6,0,0,6,0,30,3,11,0,14,4,30,7,7,0,14,3,30,4,0,0,4,1,-15,3,1
2,3,17,2,30,10,4,0,14,4,30,6,0,0,6,0,30,3,11,0,14,4,30,7,7,0,14,3,30,4,0,0,4,1,-15,3,1
2,4,17,2,30,10,4,0,14,4,30,6,0,0,6,0,30,3,11,0,14,4,30,7,7,0,14,3,30,4,0,0,4,1,-15,3,1
2,2,25,1,30,4,10,0,14,5,30,6,0,0,6,0,30,6,8,0,14,1,30,8,6,0,14,3,30,5,1,0,6,1,-15,3,1
2,4,25,1,30,4,10,0,14,5,30,6,0,0,6,0,30,6,8,0,14,1,30,8,6,0,14,3,30,5,1,0,6,1,-15,3,1
2,2,11,1,30,4,0,0,4,1,30,0,0,0,0,0,30,2,2,0,4,0,30,1,3,0,4,1,30,1,0,0,1,1,-15,3,1
2,1,19,0,30,7,6,0,13,2,30,4,4,0,8,0,30,5,8,0,13,2,30,6,7,0,13,1,30,9,0,0,9,1,-15,3,1
2,3,19,0,30,7,6,0,13,2,30,4,4,0,8,0,30,5,8,0,13,2,30,6,7,0,13,1,30,9,0,0,9,1,-15,3,1
2,3,21,2,30,7,3,0,10,4,30,6,0,0,6,1,30,3,7,0,10,5,30,6,4,0,10,1,30,4,0,0,4,1,-15,3,1
2,2,27,2,30,5,10,0,15,3,30,2,0,0,2,0,30,6,9,0,15,0,30,4,11,0,15,0,30,5,1,0,6,1,-15,3,1
2,3,27,2,30,5,10,0,15,3,30,2,0,0,2,0,30,6,9,0,15,0,30,4,11,0,15,0,30,5,1,0,6,1,-15,3,1
2,4,27,2,30,5,10,0,15,3,30,2,0,0,2,0,30,6,9,0,15,0,30,4,11,0,15,0,30,5,1,0,6,1,-15,3,1
2,0,4,4,30,6,2,0,8,4,30,2,2,0,4,0,30,3,5,0,8,0,30,7,1,0,8,2,30,4,0,0,4,0,-27,3,0
2,2,5,0,30,2,3,0,5,3,30,4,0,0,4,0,30,0,5,0,5,0,30,1,4,0,5,0,30,1,1,0,2,0,-27,3,0
2,3,8,1,30,7,0,0,7,3,30,2,0,0,2,0,30,5,2,0,7,1,30,4,3,0,7,3,30,3,0,0,3,0,-27,3,0
2,2,13,1,30,4,3,0,7,0,30,4,0,0,4,2,30,6,1,0,7,8,30,3,4,0,7,4,30,4,0,0,4,1,-15,3,1
2,4,13,1,30,4,3,0,7,0,30,4,0,0,4,2,30,6,1,0,7,8,30,3,4,0,7,4,30,4,0,0,4,1,-15,3,1
2,1,17,5,30,11,3,0,14,2,30,6,0,0,6,0,30,3,11,0,14,2,30,5,9,0,14,5,30,4,0,0,4,1,-15,3,1
2,4,17,5,30,11,3,0,14,2,30,6,0,0,6,0,30,3,11,0,14,2,30,5,9,0,14,5,30,4,0,0,4,1,-15,3,1
2,2,25,1,30,9,5,0,14,1,30,6,0,0,6,0,30,8,6,0,14,1,30,4,10,0,14,5,30,6,0,0,6,1,-15,3,1
2,3,25,1,30,9,5,0,14,1,30,6,0,0,6,0,30,8,6,0,14,1,30,4,10,0,14,5,30,6,0,0,6,1,-15,3,1
2,0,27,1,30,3,12,0,15,2,30,2,0,0,2,0,30,6,9,0,15,1,30,3,12,0,15,2,30,6,0,0,6,1,-15,3,1
2,2,27,1,30,3,12,0,15,2,30,2,0,0,2,0,30,6,9,0,15,1,30,3,12,0,15,2,30,6,0,0,6,1,-15,3,1
2,4,27,1,30,3,12,0,15,2,30,2,0,0,2,0,30,6,9,0,15,1,30,3,12,0,15,2,30,6,0,0,6,1,-15,3,1
2,4,29,0,30,8,6,0,14,6,30,10,2,0,12,0,30,2,12,0,14,0,30,1,13,0,14,0,30,9,0,0,9,1,-15,3,1
2,4,31,0,30,7,5,0,12,4,30,8,0,0,8,3,30,9,3,0,12,0,30,3,9,0,12,0,30,3,3,0,6,1,-15,3,1
2,3,33,1,30,2,9,0,11,6,30,4,0,0,4,2,30,8,3,0,11,0,30,5,6,0,11,5,30,4,0,0,4,1,-15,3,1
2,3,37,1,30,5,6,0,11,7,30,8,0,0,8,0,30,3,8,0,11,4,30,3,8,0,11,2,30,6,0,0,6,1,-15,3,1
2,1,41,0,30,8,4,0,12,5,30,3,5,0,8,0,30,8,4,0,12,0,30,3,9,0,12,3,30,4,3,0,7,1,-15,3,1
2,3,8,3,30,7,0,0,7,5,30,2,0,0,2,0,30,1,6,0,7,1,30,7,0,0,7,0,30,3,0,0,3,0,-27,3,0
2,4,8,3,30,7,0,0,7,5,30,2,0,0,2,0,30,1,6,0,7,1,30,7,0,0,7,0,30,3,0,0,3,0,-27,3,0
2,4,19,1,30,5,8,0,13,2,30,5,3,0,8,4,30,7,6,0,13,0,30,3,10,0,13,1,30,8,1,0,9,1,-15,3,1
2,3,22,1,30,4,4,0,8,2,30,2,0,0,2,0,30,6,2,0,8,3,30,5,3,0,8,3,30,4,0,0,4,1,-15,3,1
2,4,22,1,30,4,4,0,8,2,30,2,0,0,2,0,30,6,2,0,8,3,30,5,3,0,8,3,30,4,0,0,4,1,-15,3,1
2,3,23,2,30,3,10,0,13,3,30,6,0,0,6,3,30,11,2,0,13,0,30,6,7,0,13,2,30,6,0,0,6,1,-15,3,1
2,4,23,2,30,3,10,0,13,3,30,6,0,0,6,3,30,11,2,0,13,0,30,6,7,0,13,2,30,6,0,0,6,1,-15,3,1
2,0,25,2,30,8,6,0,14,4,30,6,0,0,6,0,30,9,5,0,14,1,30,5,9,0,14,3,30,5,1,0,6,1,-15,3,1
2,1,25,2,30,8,6,0,14,4,30,6,0,0,6,0,30,9,5,0,14,1,30,5,9,0,14,3,30,5,1,0,6,1,-15,3,1
2,0,26,0,30,9,0,0,9,5,30,4,0,0,4,2,30,0,9,0,9,0,30,2,7,0,9,7,30,3,0,0,3,1,-15,3,1
2,2,26,0,30,9,0,0,9,5,30,4,0,0,4,2,30,0,9,0,9,0,30,2,7,0,9,7,30,3,0,0,3,1,-15,3,1
2,3,26,0,30,9,0,0,9,5,30,4,0,0,4,2,30,0,9,0,9,0,30,2,7,0,9,7,30,3,0,0,3,1,-15,3,1
2,0,27,1,30,4,11,0,15,2,30,2,0,0,2,0,30,3,12,0,15,2,30,6,9,0,15,2,30,6,0,0,6,1,-15,3,1
2,1,27,1,30,4,11,0,15,2,30,2,0,0,2,0,30,3,12,0,15,2,30,6,9,0,15,2,30,6,0,0,6,1,-15,3,1
2,3,29,0,30,8,6,0,14,6,30,12,0,0,12,0,30,3,11,0,14,0,30,1,13,0,14,0,30,8,1,0,9,1,-15,3,1
2,4,29,0,30,8,6,0,14,6,30,12,0,0,12,0,30,3,11,0,14,0,30,1,13,0,14,0,30,8,1,0,9,1,-15,3,1
2,4,31,1,30,7,5,0,12,3,30,8,0,0,8,5,30,12,0,0,12,0,30,3,9,0,12,0,30,1,5,0,6,1,-15,3,1
2,3,32,0,30,7,2,0,9,4,30,2,0,0,2,3,30,9,0,0,9,1,30,3,6,0,9,3,30,2,0,0,2,1,-15,3,1
2,4,32,0,30,7,2,0,9,4,30,2,0,0,2,3,30,9,0,0,9,1,30,3,6,0,9,3,30,2,0,0,2,1,-15,3,1
2,3,35,0,30,8,5,0,13,6,30,2,0,0,2,1,30,2,11,0,13,2,30,6,7,0,13,8,30,8,0,0,8,1,-15,3,1
2,0,41,0,30,7,5,0,12,7,30,8,0,0,8,0,30,3,9,0,12,0,30,4,8,0,12,6,30,7,0,0,7,1,-15,3,1
2,2,41,0,30,7,5,0,12,7,30,8,0,0,8,0,30,3,9,0,12,0,30,4,8,0,12,6,30,7,0,0,7,1,-15,3,1
2,4,41,0,30,7,5,0,12,7,30,8,0,0,8,0,30,3,9,0,12,0,30,4,8,0,12,6,30,7,0,0,7,1,-15,3,1
2,3,5,0,30,1,4,0,5,3,30,2,2,0,4,0,30,0,5,0,5,0,30,1,4,0,5,1,30,2,0,0,2,0,-27,3,0
2,3,11,3,30,7,5,0,12,1,30,4,0,0,4,0,30,5,7,0,12,6,30,5,7,0,12,7,30,4,0,0,4,1,-15,3,1
2,0,19,0,30,2,11,0,13,1,30,6,2,0,8,0,30,5,8,0,13,7,30,5,8,0,13,4,30,9,0,0,9,1,-15,3,1
2,2,19,0,30,2,11,0,13,1,30,6,2,0,8,0,30,5,8,0,13,7,30,5,8,0,13,4,30,9,0,0,9,1,-15,3,1
2,4,19,0,30,2,11,0,13,1,30,6,2,0,8,0,30,5,8,0,13,7,30,5,8,0,13,4,30,9,0,0,9,1,-15,3,1
2,2,25,1,30,3,11,0,14,5,30,6,0,0,6,0,30,10,4,0,14,1,30,5,9,0,14,5,30,5,1,0,6,1,-15,3,1
2,2,33,5,30,10,1,0,11,5,30,4,0,0,4,0,30,6,5,0,11,0,30,3,8,0,11,5,30,4,0,0,4,1,-15,3,1
2,4,33,5,30,10,1,0,11,5,30,4,0,0,4,0,30,6,5,0,11,0,30,3,8,0,11,5,30,4,0,0,4,1,-15,3,1
2,4,8,3,30,7,0,0,7,3,30,2,0,0,2,3,30,5,2,0,7,0,30,4,3,0,7,0,30,3,0,0,3,0,-27,3,0
2,4,11,0,30,4,8,0,12,1,30,4,0,0,4,0,30,7,5,0,12,2,30,6,6,0,12,0,30,4,0,0,4,1,-15,3,1
2,2,13,3,30,7,0,0,7,0,30,4,0,0,4,2,30,6,1,0,7,4,30,7,0,0,7,6,30,4,0,0,4,1,-15,3,1
2,4,13,3,30,7,0,0,7,0,30,4,0,0,4,2,30,6,1,0,7,4,30,7,0,0,7,6,30,4,0,0,4,1,-15,3,1
2,1,17,3,30,8,6,0,14,3,30,6,0,0,6,0,30,6,8,0,14,2,30,9,5,0,14,3,30,4,0,0,4,1,-15,3,1
2,3,19,0,30,6,7,0,13,0,30,5,3,0,8,0,30,6,7,0,13,4,30,5,8,0,13,0,30,7,2,0,9,1,-15,3,1
2,4,19,0,30,6,7,0,13,0,30,5,3,0,8,0,30,6,7,0,13,4,30,5,8,0,13,0,30,7,2,0,9,1,-15,3,1
2,3,21,4,30,8,2,0,10,4,30,4,2,0,6,0,30,3,7,0,10,2,30,5,5,0,10,0,30,4,0,0,4,1,-15,3,1
2,2,25,1,30,4,10,0,14,4,30,6,0,0,6,0,30,6,8,0,14,1,30,4,10,0,14,5,30,6,0,0,6,1,-15,3,1
2,4,25,1,30,4,10,0,14,4,30,6,0,0,6,0,30,6,8,0,14,1,30,4,10,0,14,5,30,6,0,0,6,1,-15,3,1
2,3,31,1,30,5,7,0,12,5,30,8,0,0,8,3,30,11,1,0,12,0,30,5,7,0,12,3,30,6,0,0,6,1,-15,3,1
2,2,4,3,30,7,1,0,8,4,30,2,2,0,4,4,30,3,5,0,8,0,30,8,0,0,8,1,30,4,0,0,4,0,-27,3,0
2,3,4,3,30,7,1,0,8,4,30,2,2,0,4,4,30,3,5,0,8,0,30,8,0,0,8,1,30,4,0,0,4,0,-27,3,0
2,4,11,0,30,1,3,0,4,0,30,0,0,0,0,0,30,3,1,0,4,4,30,1,3,0,4,2,30,1,0,0,1,1,-15,3,1
2,1,13,1,30,7,0,0,7,0,30,4,0,0,4,2,30,6,1,0,7,4,30,7,0,0,7,5,30,4,0,0,4,1,-15,3,1
2,4,15,0,30,5,8,0,13,0,30,6,0,0,6,0,30,3,10,0,13,1,30,4,9,0,13,2,30,8,1,0,9,1,-15,3,1
2,4,19,0,30,2,11,0,13,2,30,6,2,0,8,0,30,7,6,0,13,1,30,5,8,0,13,2,30,8,1,0,9,1,-15,3,1
2,4,23,1,30,6,7,0,13,4,30,6,0,0,6,5,30,10,3,0,13,0,30,4,9,0,13,3,30,6,0,0,6,1,-15,3,1
2,2,27,1,30,4,11,0,15,0,30,2,0,0,2,0,30,11,4,0,15,3,30,5,10,0,15,4,30,6,0,0,6,1,-15,3,1
2,4,35,1,30,5,8,0,13,4,30,2,0,0,2,1,30,5,8,0,13,0,30,1,12,0,13,1,30,7,1,0,8,1,-15,3,1
2,4,43,0,30,6,8,0,14,6,30,6,0,0,6,4,30,6,8,0,14,0,30,1,13,0,14,1,30,5,0,0,5,1,-15,3,1
2,2,5,1,30,5,0,0,5,3,30,1,3,0,4,0,30,0,5,0,5,0,30,1,4,0,5,0,30,0,2,0,2,0,-27,3,0
2,4,5,1,30,5,0,0,5,3,30,1,3,0,4,0,30,0,5,0,5,0,30,1,4,0,5,0,30,0,2,0,2,0,-27,3,0
2,4,13,2,30,6,1,0,7,0,30,4,0,0,4,1,30,5,2,0,7,7,30,6,1,0,7,5,30,4,0,0,4,1,-15,3,1
2,2,21,1,30,5,5,0,10,4,30,4,2,0,6,0,30,3,7,0,10,3,30,6,4,0,10,6,30,4,0,0,4,1,-15,3,1
2,3,21,1,30,5,5,0,10,4,30,4,2,0,6,0,30,3,7,0,10,3,30,6,4,0,10,6,30,4,0,0,4,1,-15,3,1
2,4,21,1,30,5,5,0,10,4,30,4,2,0,6,0,30,3,7,0,10,3,30,6,4,0,10,6,30,4,0,0,4,1,-15,3,1
2,2,25,1,30,7,7,0,14,1,30,6,0,0,6,0,30,11,3,0,14,1,30,9,5,0,14,1,30,5,1,0,6,1,-15,3,1
2,4,29,1,30,6,8,0,14,5,30,11,1,0,12,0,30,6,8,0,14,0,30,1,13,0,14,0,30,6,3,0,9,1,-15,3,1
2,1,31,3,30,6,6,0,12,4,30,8,0,0,8,5,30,10,2,0,12,0,30,3,9,0,12,2,30,2,4,0,6,1,-15,3,1
2,4,31,1,30,6,6,0,12,4,30,8,0,0,8,5,30,10,2,0,12,0,30,3,9,0,12,2,30,2,4,0,6,1,-15,3,1
2,0,4,2,30,8,0,0,8,5,30,4,0,0,4,1,30,2,6,0,8,3,30,8,0,0,8,2,30,3,1,0,4,0,-27,3,0
2,2,7,2,30,4,5,0,9,3,30,4,0,0,4,0,30,6,3,0,9,5,30,5,4,0,9,1,30,4,2,0,6,0,-27,3,0
2,4,7,2,30,4,5,0,9,3,30,4,0,0,4,0,30,6,3,0,9,5,30,5,4,0,9,1,30,4,2,0,6,0,-27,3,0
2,4,8,3,30,7,0,0,7,4,30,2,0,0,2,0,30,2,5,0,7,0,30,6,1,0,7,0,30,3,0,0,3,0,-27,3,0
2,2,9,5,30,4,0,0,4,4,30,2,0,0,2,2,30,1,3,0,4,0,30,1,3,0,4,0,30,1,0,0,1,0,-27,3,0
2,3,11,8,30,4,8,0,12,2,30,4,0,0,4,0,30,5,7,0,12,3,30,2,10,0,12,3,30,3,1,0,4,1,-15,3,1
2,3,15,2,30,4,9,0,13,0,30,6,0,0,6,0,30,6,7,0,13,1,30,4,9,0,13,2,30,8,1,0,9,1,-15,3,1
2,4,15,2,30,4,9,0,13,0,30,6,0,0,6,0,30,6,7,0,13,1,30,4,9,0,13,2,30,8,1,0,9,1,-15,3,1
2,3,22,2,30,8,0,0,8,2,30,2,0,0,2,0,30,4,4,0,8,0,30,1,7,0,8,1,30,4,0,0,4,1,-15,3,1
2,2,25,1,30,4,10,0,14,4,30,6,0,0,6,0,30,10,4,0,14,2,30,7,7,0,14,2,30,6,0,0,6,1,-15,3,1
2,3,25,1,30,4,10,0,14,4,30,6,0,0,6,0,30,10,4,0,14,2,30,7,7,0,14,2,30,6,0,0,6,1,-15,3,1
2,4,25,1,30,4,10,0,14,4,30,6,0,0,6,0,30,10,4,0,14,2,30,7,7,0,14,2,30,6,0,0,6,1,-15,3,1
2,1,27,1,30,5,10,0,15,1,30,1,1,0,2,0,30,10,5,0,15,0,30,6,9,0,15,1,30,5,1,0,6,1,-15,3,1
2,2,27,1,30,5,10,0,15,1,30,1,1,0,2,0,30,10,5,0,15,0,30,6,9,0,15,1,30,5,1,0,6,1,-15,3,1
2,3,27,1,30,5,10,0,15,1,30,1,1,0,2,0,30,10,5,0,15,0,30,6,9,0,15,1,30,5,1,0,6,1,-15,3,1
2,4,27,1,30,5,10,0,15,1,30,1,1,0,2,0,30,10,5,0,15,0,30,6,9,0,15,1,30,5,1,0,6,1,-15,3,1
2,0,31,1,30,3,9,0,12,8,30,8,0,0,8,3,30,4,8,0,12,3,30,9,3,0,12,4,30,6,0,0,6,1,-15,3,1
2,2,33,2,30,7,4,0,11,4,30,4,0,0,4,2,30,10,1,0,11,4,30,5,6,0,11,5,30,4,0,0,4,1,-15,3,1
2,3,33,2,30,7,4,0,11,4,30,4,0,0,4,2,30,10,1,0,11,4,30,5,6,0,11,5,30,4,0,0,4,1,-15,3,1
2,0,37,1,30,8,3,0,11,5,30,7,1,0,8,0,30,8,3,0,11,4,30,3,8,0,11,6,30,6,0,0,6,1,-15,3,1
2,2,37,1,30,8,3,0,11,5,30,7,1,0,8,0,30,8,3,0,11,4,30,3,8,0,11,6,30,6,0,0,6,1,-15,3,1
2,4,37,1,30,8,3,0,11,5,30,7,1,0,8,0,30,8,3,0,11,4,30,3,8,0,11,6,30,6,0,0,6,1,-15,3,1
2,0,4,3,30,8,0,0,8,4,30,4,0,0,4,0,30,1,7,0,8,0,30,4,4,0,8,1,30,3,1,0,4,0,-27,3,0
2,2,5,0,30,1,4,0,5,2,30,4,0,0,4,0,30,0,5,0,5,0,30,1,4,0,5,0,30,0,2,0,2,0,-27,3,0
2,4,5,0,30,1,4,0,5,2,30,4,0,0,4,0,30,0,5,0,5,0,30,1,4,0,5,0,30,0,2,0,2,0,-27,3,0
2,4,9,0,30,6,5,0,11,3,30,6,0,0,6,2,30,7,4,0,11,5,30,4,7,0,11,4,30,4,0,0,4,0,-27,3,0
2,0,17,3,30,9,5,0,14,3,30,6,0,0,6,0,30,6,8,0,14,4,30,8,6,0,14,3,30,4,0,0,4,1,-15,3,1
2,2,17,3,30,9,5,0,14,3,30,6,0,0,6,0,30,6,8,0,14,4,30,8,6,0,14,3,30,4,0,0,4,1,-15,3,1
2,3,17,3,30,9,5,0,14,3,30,6,0,0,6,0,30,6,8,0,14,4,30,8,6,0,14,3,30,4,0,0,4,1,-15,3,1
2,2,19,1,30,4,9,0,13,2,30,6,2,0,8,0,30,4,9,0,13,1,30,7,6,0,13,1,30,8,1,0,9,1,-15,3,1
2,4,23,3,30,5,8,0,13,2,30,6,0,0,6,3,30,12,1,0,13,0,30,6,7,0,13,2,30,6,0,0,6,1,-15,3,1
2,4,25,2,30,5,9,0,14,5,30,6,0,0,6,0,30,3,11,0,14,1,30,9,5,0,14,5,30,6,0,0,6,1,-15,3,1
2,0,26,0,30,8,1,0,9,5,30,4,0,0,4,2,30,0,9,0,9,0,30,2,7,0,9,7,30,3,0,0,3,1,-15,3,1
2,2,27,1,30,6,9,0,15,3,30,2,0,0,2,0,30,3,12,0,15,4,30,6,9,0,15,2,30,6,0,0,6,1,-15,3,1
2,3,31,1,30,6,6,0,12,6,30,8,0,0,8,3,30,4,8,0,12,0,30,6,6,0,12,4,30,6,0,0,6,1,-15,3,1
2,4,31,1,30,6,6,0,12,6,30,8,0,0,8,3,30,4,8,0,12,0,30,6,6,0,12,4,30,6,0,0,6,1,-15,3,1
2,0,41,1,30,9,3,0,12,7,30,8,0,0,8,0,30,3,9,0,12,0,30,5,7,0,12,6,30,7,0,0,7,1,-15,3,1
2,2,41,1,30,9,3,0,12,7,30,8,0,0,8,0,30,3,9,0,12,0,30,5,7,0,12,6,30,7,0,0,7,1,-15,3,1
2,3,41,1,30,9,3,0,12,7,30,8,0,0,8,0,30,3,9,0,12,0,30,5,7,0,12,6,30,7,0,0,7,1,-15,3,1
2,3,47,0,30,1,13,0,14,7,30,4,0,0,4,0,30,3,11,0,14,0,30,2,12,0,14,7,30,7,0,0,7,1,-15,3,1
2,2,5,0,30,2,3,0,5,3,30,0,4,0,4,0,30,1,4,0,5,0,30,1,4,0,5,3,30,2,0,0,2,0,-27,3,0
2,4,5,0,30,2,3,0,5,3,30,0,4,0,4,0,30,1,4,0,5,0,30,1,4,0,5,3,30,2,0,0,2,0,-27,3,0
2,3,17,6,30,11,3,0,14,3,30,6,0,0,6,0,30,4,10,0,14,2,30,5,9,0,14,1,30,4,0,0,4,1,-15,3,1
2,0,18,4,30,8,0,0,8,3,30,4,0,0,4,0,30,0,8,0,8,0,30,3,5,0,8,0,30,3,2,0,5,1,-15,3,1
2,1,19,0,30,5,8,0,13,2,30,8,0,0,8,4,30,6,7,0,13,0,30,4,9,0,13,0,30,7,2,0,9,1,-15,3,1
2,2,19,0,30,5,8,0,13,2,30,8,0,0,8,4,30,6,7,0,13,0,30,4,9,0,13,0,30,7,2,0,9,1,-15,3,1
2,4,19,0,30,5,8,0,13,2,30,8,0,0,8,4,30,6,7,0,13,0,30,4,9,0,13,0,30,7,2,0,9,1,-15,3,1
2,2,25,2,30,10,4,0,14,5,30,6,0,0,6,0,30,4,10,0,14,1,30,8,6,0,14,4,30,5,1,0,6,1,-15,3,1
2,3,25,2,30,10,4,0,14,5,30,6,0,0,6,0,30,4,10,0,14,1,30,8,6,0,14,4,30,5,1,0,6,1,-15,3,1
2,0,27,1,30,5,10,0,15,3,30,2,0,0,2,4,30,4,11,0,15,0,30,8,7,0,15,0,30,4,2,0,6,1,-15,3,1
2,1,27,1,30,5,10,0,15,3,30,2,0,0,2,4,30,4,11,0,15,0,30,8,7,0,15,0,30,4,2,0,6,1,-15,3,1
2,2,27,1,30,5,10,0,15,3,30,2,0,0,2,4,30,4,11,0,15,0,30,8,7,0,15,0,30,4,2,0,6,1,-15,3,1
2,4,27,1,30,5,10,0,15,3,30,2,0,0,2,4,30,4,11,0,15,0,30,8,7,0,15,0,30,4,2,0,6,1,-15,3,1
2,3,29,1,30,6,8,0,14,6,30,11,1,0,12,0,30,6,8,0,14,0,30,1,13,0,14,0,30,9,0,0,9,1,-15,3,1
2,4,29,1,30,6,8,0,14,6,30,11,1,0,12,0,30,6,8,0,14,0,30,1,13,0,14,0,30,9,0,0,9,1,-15,3,1
2,3,38,0,30,2,8,0,10,7,30,6,0,0,6,2,30,3,7,0,10,0,30,4,6,0,10,8,30,6,0,0,6,1,-15,3,1
2,3,3,0,30,0,4,0,4,2,30,4,0,0,4,0,30,2,2,0,4,3,30,0,4,0,4,0,30,1,2,0,3,0,-27,3,0
2,1,4,3,30,6,2,0,8,4,30,2,2,0,4,0,30,2,6,0,8,0,30,3,5,0,8,4,30,4,0,0,4,0,-27,3,0
2,3,4,3,30,6,2,0,8,4,30,2,2,0,4,0,30,2,6,0,8,0,30,3,5,0,8,4,30,4,0,0,4,0,-27,3,0
2,4,4,3,30,6,2,0,8,4,30,2,2,0,4,0,30,2,6,0,8,0,30,3,5,0,8,4,30,4,0,0,4,0,-27,3,0
2,2,5,0,30,2,3,0,5,3,30,2,2,0,4,0,30,0,5,0,5,0,30,1,4,0,5,2,30,2,0,0,2,0,-27,3,0
2,3,19,0,30,3,10,0,13,0,30,5,3,0,8,0,30,7,6,0,13,4,30,4,9,0,13,0,30,9,0,0,9,1,-15,3,1
2,0,25,0,30,3,11,0,14,4,30,6,0,0,6,0,30,9,5,0,14,2,30,10,4,0,14,7,30,6,0,0,6,1,-15,3,1
2,1,27,1,30,6,9,0,15,3,30,2,0,0,2,0,30,2,13,0,15,0,30,6,9,0,15,7,30,6,0,0,6,1,-15,3,1
2,3,27,1,30,6,9,0,15,3,30,2,0,0,2,0,30,2,13,0,15,0,30,6,9,0,15,7,30,6,0,0,6,1,-15,3,1
2,4,29,0,30,5,9,0,14,6,30,12,0,0,12,0,30,6,8,0,14,0,30,1,13,0,14,0,30,9,0,0,9,1,-15,3,1
2,0,41,0,30,9,3,0,12,6,30,4,4,0,8,0,30,3,9,0,12,0,30,4,8,0,12,5,30,7,0,0,7,1,-15,3,1
2,1,5,0,30,1,4,0,5,2,30,4,0,0,4,0,30,3,2,0,5,0,30,1,4,0,5,0,30,0,2,0,2,0,-27,3,0
2,2,5,0,30,1,4,0,5,2,30,4,0,0,4,0,30,3,2,0,5,0,30,1,4,0,5,0,30,0,2,0,2,0,-27,3,0
2,1,21,3,30,9,1,0,10,4,30,6,0,0,6,1,30,3,7,0,10,3,30,5,5,0,10,2,30,4,0,0,4,1,-15,3,1
2,4,23,2,30,8,5,0,13,3,30,6,0,0,6,7,30,10,3,0,13,0,30,4,9,0,13,1,30,6,0,0,6,1,-15,3,1
2,2,27,2,30,3,12,0,15,3,30,1,1,0,2,0,30,7,8,0,15,1,30,7,8,0,15,5,30,6,0,0,6,1,-15,3,1
2,0,31,1,30,5,7,0,12,8,30,8,0,0,8,3,30,4,8,0,12,3,30,8,4,0,12,3,30,6,0,0,6,1,-15,3,1
2,2,31,1,30,5,7,0,12,8,30,8,0,0,8,3,30,4,8,0,12,3,30,8,4,0,12,3,30,6,0,0,6,1,-15,3,1
2,3,43,0,30,5,9,0,14,7,30,6,0,0,6,0,30,5,9,0,14,1,30,1,13,0,14,2,30,5,0,0,5,1,-15,3,1
2,3,13,1,30,3,0,0,3,0,30,2,0,0,2,0,30,3,0,0,3,6,30,2,1,0,3,3,30,2,0,0,2,1,-15,3,1
2,2,13,1,30,5,2,0,7,1,30,4,0,0,4,4,30,6,1,0,7,4,30,6,1,0,7,4,30,4,0,0,4,1,-15,3,1
2,4,13,1,30,5,2,0,7,1,30,4,0,0,4,4,30,6,1,0,7,4,30,6,1,0,7,4,30,4,0,0,4,1,-15,3,1
2,1,19,1,30,7,6,0,13,2,30,8,0,0,8,7,30,7,6,0,13,0,30,3,10,0,13,0,30,5,4,0,9,1,-15,3,1
2,3,25,1,30,7,7,0,14,4,30,6,0,0,6,0,30,10,4,0,14,1,30,10,4,0,14,0,30,5,1,0,6,1,-15,3,1
2,0,27,3,30,6,9,0,15,5,30,2,0,0,2,4,30,3,12,0,15,0,30,3,12,0,15,2,30,4,2,0,6,1,-15,3,1
2,1,27,3,30,6,9,0,15,5,30,2,0,0,2,4,30,3,12,0,15,0,30,3,12,0,15,2,30,4,2,0,6,1,-15,3,1
2,2,27,3,30,6,9,0,15,5,30,2,0,0,2,4,30,3,12,0,15,0,30,3,12,0,15,2,30,4,2,0,6,1,-15,3,1
2,3,39,0,30,4,7,0,11,6,30,6,0,0,6,0,30,6,5,0,11,0,30,5,6,0,11,4,30,5,0,0,5,1,-15,3,1
2,3,1,0,30,7,3,0,10,4,30,2,0,0,2,0,30,4,6,0,10,6,30,8,2,0,10,6,30,6,0,0,6,0,-27,3,0
2,4,1,0,30,7,3,0,10,4,30,2,0,0,2,0,30,4,6,0,10,6,30,8,2,0,10,6,30,6,0,0,6,0,-27,3,0
2,0,5,0,30,1,4,0,5,3,30,1,3,0,4,0,30,0,5,0,5,0,30,1,4,0,5,1,30,0,2,0,2,0,-27,3,0
2,2,5,0,30,1,4,0,5,3,30,1,3,0,4,0,30,0,5,0,5,0,30,1,4,0,5,1,30,0,2,0,2,0,-27,3,0
2,4,5,0,30,1,4,0,5,3,30,1,3,0,4,0,30,0,5,0,5,0,30,1,4,0,5,1,30,0,2,0,2,0,-27,3,0
2,3,8,1,30,7,0,0,7,4,30,2,0,0,2,1,30,2,5,0,7,0,30,4,3,0,7,3,30,3,0,0,3,0,-27,3,0
2,0,11,0,30,9,3,0,12,2,30,4,0,0,4,0,30,4,8,0,12,8,30,4,8,0,12,3,30,4,0,0,4,1,-15,3,1
2,1,11,0,30,9,3,0,12,2,30,4,0,0,4,0,30,4,8,0,12,8,30,4,8,0,12,3,30,4,0,0,4,1,-15,3,1
2,2,11,0,30,9,3,0,12,2,30,4,0,0,4,0,30,4,8,0,12,8,30,4,8,0,12,3,30,4,0,0,4,1,-15,3,1
2,4,11,0,30,9,3,0,12,2,30,4,0,0,4,0,30,4,8,0,12,8,30,4,8,0,12,3,30,4,0,0,4,1,-15,3,1
2,3,21,1,30,6,4,0,10,4,30,6,0,0,6,1,30,3,7,0,10,5,30,6,4,0,10,2,30,4,0,0,4,1,-15,3,1
2,4,27,0,30,7,8,0,15,3,30,2,0,0,2,3,30,3,12,0,15,0,30,7,8,0,15,1,30,5,1,0,6,1,-15,3,1
2,0,29,1,30,6,8,0,14,5,30,12,0,0,12,0,30,7,7,0,14,0,30,1,13,0,14,0,30,9,0,0,9,1,-15,3,1
2,4,35,1,30,9,4,0,13,3,30,2,0,0,2,1,30,9,4,0,13,0,30,1,12,0,13,1,30,7,1,0,8,1,-15,3,1
2,0,47,0,30,0,14,0,14,5,30,4,0,0,4,2,30,14,0,0,14,8,30,3,11,0,14,4,30,7,0,0,7,1,-15,3,1
2,2,47,0,30,0,14,0,14,5,30,4,0,0,4,2,30,14,0,0,14,8,30,3,11,0,14,1,30,7,0,0,7,1,-15,3,1
2,3,1,0,30,7,3,0,10,4,30,2,0,0,2,1,30,4,6,0,10,0,30,8,2,0,10,6,30,6,0,0,6,0,-27,3,0
2,0,5,0,30,2,3,0,5,3,30,2,2,0,4,2,30,1,4,0,5,0,30,1,4,0,5,0,30,0,2,0,2,0,-27,3,0
2,2,5,0,30,2,3,0,5,3,30,2,2,0,4,2,30,1,4,0,5,0,30,1,4,0,5,0,30,0,2,0,2,0,-27,3,0
2,3,5,0,30,2,3,0,5,3,30,2,2,0,4,2,30,1,4,0,5,0,30,1,4,0,5,0,30,0,2,0,2,0,-27,3,0
2,4,5,0,30,2,3,0,5,3,30,2,2,0,4,2,30,1,4,0,5,0,30,1,4,0,5,0,30,0,2,0,2,0,-27,3,0
2,4,11,1,30,4,8,0,12,0,30,4,0,0,4,0,30,9,3,0,12,3,30,5,7,0,12,3,30,4,0,0,4,1,-15,3,1
2,1,13,5,30,7,0,0,7,2,30,4,0,0,4,2,30,5,2,0,7,10,30,6,1,0,7,4,30,4,0,0,4,1,-15,3,1
2,4,13,5,30,7,0,0,7,2,30,4,0,0,4,1,30,5,2,0,7,10,30,6,1,0,7,4,30,4,0,0,4,1,-15,3,1
2,1,17,2,30,9,5,0,14,3,30,6,0,0,6,0,30,5,9,0,14,5,30,5,9,0,14,5,30,4,0,0,4,1,-15,3,1
2,2,17,2,30,9,5,0,14,3,30,6,0,0,6,0,30,5,9,0,14,5,30,5,9,0,14,5,30,4,0,0,4,1,-15,3,1
2,4,17,2,30,9,5,0,14,3,30,6,0,0,6,0,30,5,9,0,14,5,30,5,9,0,14,5,30,4,0,0,4,1,-15,3,1
2,1,5,0,30,3,2,0,5,3,30,2,2,0,4,0,30,0,5,0,5,0,30,1,4,0,5,0,30,0,2,0,2,0,-27,3,0
2,2,5,0,30,3,2,0,5,3,30,2,2,0,4,0,30,0,5,0,5,0,30,1,4,0,5,0,30,0,2,0,2,0,-27,3,0
2,4,7,0,30,4,5,0,9,2,30,4,0,0,4,0,30,8,1,0,9,7,30,3,6,0,9,1,30,3,3,0,6,0,-27,3,0
2,3,13,0,30,5,2,0,7,1,30,4,0,0,4,2,30,5,2,0,7,5,30,6,1,0,7,3,30,4,0,0,4,1,-15,3,1
2,3,17,2,30,9,5,0,14,3,30,6,0,0,6,0,30,4,10,0,14,2,30,6,8,0,14,3,30,4,0,0,4,1,-15,3,1
2,2,23,1,30,4,9,0,13,4,30,6,0,0,6,3,30,12,1,0,13,0,30,5,8,0,13,5,30,6,0,0,6,1,-15,3,1
2,4,23,1,30,4,9,0,13,4,30,6,0,0,6,3,30,12,1,0,13,0,30,5,8,0,13,5,30,6,0,0,6,1,-15,3,1
2,0,25,1,30,6,8,0,14,6,30,6,0,0,6,0,30,3,11,0,14,1,30,11,3,0,14,8,30,6,0,0,6,1,-15,3,1
2,0,27,1,30,5,10,0,15,3,30,1,1,0,2,0,30,2,13,0,15,3,30,8,7,0,15,3,30,6,0,0,6,1,-15,3,1
2,3,27,1,30,5,10,0,15,3,30,1,1,0,2,0,30,2,13,0,15,3,30,8,7,0,15,3,30,6,0,0,6,1,-15,3,1
2,3,29,0,30,11,3,0,14,5,30,9,3,0,12,0,30,3,11,0,14,0,30,4,10,0,14,0,30,5,4,0,9,1,-15,3,1
2,4,31,0,30,9,3,0,12,3,30,8,0,0,8,3,30,10,2,0,12,0,30,3,9,0,12,0,30,2,4,0,6,1,-15,3,1
2,3,32,0,30,5,4,0,9,4,30,2,0,0,2,0,30,8,1,0,9,1,30,2,7,0,9,3,30,2,0,0,2,1,-15,3,1
2,1,41,5,30,12,0,0,12,5,30,8,0,0,8,0,30,9,3,0,12,0,30,3,9,0,12,1,30,0,7,0,7,1,-15,3,1
2,3,41,5,30,12,0,0,12,5,30,8,0,0,8,0,30,9,3,0,12,0,30,3,9,0,12,1,30,0,7,0,7,1,-15,3,1
2,2,5,0,30,0,5,0,5,2,30,3,1,0,4,0,30,0,5,0,5,0,30,1,4,0,5,1,30,2,0,0,2,0,-27,3,0
2,3,5,0,30,0,5,0,5,2,30,3,1,0,4,0,30,0,5,0,5,0,30,1,4,0,5,1,30,2,0,0,2,0,-27,3,0
2,4,5,0,30,0,5,0,5,2,30,3,1,0,4,0,30,0,5,0,5,0,30,1,4,0,5,1,30,2,0,0,2,0,-27,3,0
2,2,13,3,30,5,2,0,7,0,30,4,0,0,4,2,30,6,1,0,7,7,30,6,1,0,7,3,30,4,0,0,4,1,-15,3,1
2,1,17,3,30,11,3,0,14,2,30,6,0,0,6,0,30,4,10,0,14,2,30,5,9,0,14,1,30,4,0,0,4,1,-15,3,1
2,4,17,3,30,11,3,0,14,2,30,6,0,0,6,0,30,4,10,0,14,0,30,5,9,0,14,1,30,4,0,0,4,1,-15,3,1
2,2,19,0,30,3,10,0,13,1,30,5,3,0,8,0,30,8,5,0,13,5,30,5,8,0,13,2,30,8,1,0,9,1,-15,3,1
2,3,19,0,30,3,10,0,13,1,30,5,3,0,8,0,30,8,5,0,13,5,30,5,8,0,13,2,30,8,1,0,9,1,-15,3,1
2,4,23,1,30,4,9,0,13,4,30,6,0,0,6,6,30,11,2,0,13,0,30,4,9,0,13,3,30,6,0,0,6,1,-15,3,1
2,2,25,1,30,5,9,0,14,4,30,6,0,0,6,0,30,7,7,0,14,1,30,7,7,0,14,4,30,5,1,0,6,1,-15,3,1
2,4,25,1,30,5,9,0,14,4,30,6,0,0,6,0,30,7,7,0,14,1,30,7,7,0,14,4,30,5,1,0,6,1,-15,3,1
2,0,27,2,30,5,10,0,15,5,30,1,1,0,2,0,30,6,9,0,15,4,30,6,9,0,15,3,30,6,0,0,6,1,-15,3,1
2,1,27,2,30,5,10,0,15,5,30,1,1,0,2,0,30,6,9,0,15,4,30,6,9,0,15,3,30,6,0,0,6,1,-15,3,1
2,2,27,2,30,5,10,0,15,5,30,1,1,0,2,0,30,6,9,0,15,4,30,6,9,0,15,3,30,6,0,0,6,1,-15,3,1
2,3,27,2,30,5,10,0,15,5,30,1,1,0,2,0,30,6,9,0,15,4,30,6,9,0,15,3,30,6,0,0,6,1,-15,3,1
2,3,31,5,30,7,5,0,12,5,30,8,0,0,8,0,30,6,6,0,12,0,30,3,9,0,12,0,30,2,4,0,6,1,-15,3,1
2,4,31,5,30,7,5,0,12,5,30,8,0,0,8,0,30,6,6,0,12,0,30,3,9,0,12,0,30,2,4,0,6,1,-15,3,1
2,2,35,0,30,7,6,0,13,3,30,2,0,0,2,1,30,7,6,0,13,4,30,3,10,0,13,0,30,7,1,0,8,1,-15,3,1
2,1,4,2,30,6,2,0,8,4,30,4,0,0,4,1,30,2,6,0,8,0,30,4,4,0,8,2,30,4,0,0,4,0,-27,3,0
2,2,4,2,30,6,2,0,8,4,30,4,0,0,4,1,30,2,6,0,8,0,30,4,4,0,8,2,30,4,0,0,4,0,-27,3,0
2,4,4,2,30,6,2,0,8,4,30,4,0,0,4,1,30,2,6,0,8,0,30,4,4,0,8,2,30,4,0,0,4,0,-27,3,0
2,2,5,0,30,1,4,0,5,2,30,4,0,0,4,0,30,0,5,0,5,0,30,1,4,0,5,0,30,1,1,0,2,0,-27,3,0
2,3,5,0,30,1,4,0,5,2,30,4,0,0,4,0,30,0,5,0,5,0,30,1,4,0,5,0,30,1,1,0,2,0,-27,3,0
2,3,6,0,30,6,3,0,9,4,30,2,0,0,2,0,30,3,6,0,9,0,30,4,5,0,9,1,30,5,0,0,5,0,-27,3,0
2,4,8,1,30,7,0,0,7,3,30,2,0,0,2,6,30,5,2,0,7,1,30,7,0,0,7,1,30,3,0,0,3,0,-27,3,0
2,2,11,1,30,4,8,0,12,1,30,4,0,0,4,0,30,5,7,0,12,5,30,5,7,0,12,6,30,4,0,0,4,1,-15,3,1
2,3,11,1,30,4,8,0,12,1,30,4,0,0,4,0,30,5,7,0,12,5,30,5,7,0,12,6,30,4,0,0,4,1,-15,3,1
2,4,11,1,30,4,8,0,12,1,30,4,0,0,4,0,30,5,7,0,12,5,30,5,7,0,12,6,30,4,0,0,4,1,-15,3,1
2,2,16,0,30,6,3,0,9,2,30,8,0,0,8,0,30,1,8,0,9,1,30,0,9,0,9,0,30,4,0,0,4,1,-15,3,1
2,1,17,3,30,9,5,0,14,3,30,6,0,0,6,0,30,6,8,0,14,7,30,6,8,0,14,2,30,4,0,0,4,1,-15,3,1
2,3,19,0,30,3,10,0,13,2,30,5,3,0,8,0,30,6,7,0,13,4,30,6,7,0,13,0,30,8,1,0,9,1,-15,3,1
2,0,21,6,30,10,0,0,10,4,30,5,1,0,6,1,30,3,7,0,10,1,30,4,6,0,10,1,30,4,0,0,4,1,-15,3,1
2,2,21,6,30,10,0,0,10,4,30,5,1,0,6,1,30,3,7,0,10,1,30,4,6,0,10,1,30,4,0,0,4,1,-15,3,1
2,3,21,6,30,10,0,0,10,4,30,5,1,0,6,1,30,3,7,0,10,1,30,4,6,0,10,1,30,4,0,0,4,1,-15,3,1
2,2,25,1,30,5,9,0,14,4,30,6,0,0,6,0,30,5,9,0,14,1,30,9,5,0,14,4,30,6,0,0,6,1,-15,3,1
2,3,25,1,30,5,9,0,14,4,30,6,0,0,6,0,30,5,9,0,14,1,30,9,5,0,14,4,30,6,0,0,6,1,-15,3,1
2,1,27,1,30,5,10,0,15,3,30,2,0,0,2,0,30,5,10,0,15,0,30,4,11,0,15,3,30,6,0,0,6,1,-15,3,1
2,4,27,0,30,5,10,0,15,3,30,2,0,0,2,0,30,5,10,0,15,0,30,4,11,0,15,3,30,6,0,0,6,1,-15,3,1
2,4,29,0,30,7,7,0,14,5,30,12,0,0,12,0,30,3,11,0,14,0,30,1,13,0,14,0,30,7,2,0,9,1,-15,3,1
2,2,35,0,30,11,2,0,13,5,30,2,0,0,2,1,30,3,10,0,13,0,30,1,12,0,13,8,30,8,0,0,8,1,-15,3,1
2,3,39,0,30,3,8,0,11,6,30,6,0,0,6,0,30,5,6,0,11,2,30,2,9,0,11,4,30,5,0,0,5,1,-15,3,1
2,4,39,0,30,3,8,0,11,6,30,6,0,0,6,0,30,5,6,0,11,2,30,2,9,0,11,4,30,5,0,0,5,1,-15,3,1
2,2,4,2,30,5,3,0,8,4,30,4,0,0,4,0,30,3,5,0,8,0,30,4,4,0,8,2,30,3,1,0,4,0,-27,3,0
2,3,4,2,30,5,3,0,8,4,30,4,0,0,4,0,30,3,5,0,8,0,30,4,4,0,8,2,30,3,1,0,4,0,-27,3,0
2,3,23,2,30,5,8,0,13,1,30,6,0,0,6,6,30,11,2,0,13,0,30,5,8,0,13,3,30,5,1,0,6,1,-15,3,1
2,3,26,0,30,8,1,0,9,5,30,4,0,0,4,2,30,0,9,0,9,0,30,2,7,0,9,6,30,3,0,0,3,1,-15,3,1
2,4,26,0,30,8,1,0,9,5,30,4,0,0,4,2,30,0,9,0,9,0,30,2,7,0,9,6,30,3,0,0,3,1,-15,3,1
2,4,27,1,30,3,12,0,15,4,30,2,0,0,2,0,30,2,13,0,15,0,30,3,12,0,15,4,30,6,0,0,6,1,-15,3,1
2,2,35,0,30,8,5,0,13,5,30,2,0,0,2,1,30,2,11,0,13,0,30,1,12,0,13,7,30,8,0,0,8,1,-15,3,1
2,0,43,0,30,7,7,0,14,7,30,6,0,0,6,0,30,4,10,0,14,1,30,6,8,0,14,9,30,5,0,0,5,1,-15,3,1
2,3,43,0,30,7,7,0,14,7,30,6,0,0,6,0,30,4,10,0,14,1,30,6,8,0,14,9,30,5,0,0,5,1,-15,3,1
2,4,1,0,30,7,3,0,10,4,30,2,0,0,2,1,30,4,6,0,10,6,30,8,2,0,10,1,30,6,0,0,6,0,-27,3,0
2,0,4,2,30,7,1,0,8,4,30,3,1,0,4,1,30,1,7,0,8,0,30,5,3,0,8,4,30,3,1,0,4,0,-27,3,0
2,1,4,2,30,7,1,0,8,4,30,3,1,0,4,1,30,1,7,0,8,0,30,5,3,0,8,4,30,3,1,0,4,0,-27,3,0
2,2,4,2,30,7,1,0,8,4,30,3,1,0,4,1,30,1,7,0,8,0,30,5,3,0,8,4,30,3,1,0,4,0,-27,3,0
2,3,4,2,30,7,1,0,8,4,30,3,1,0,4,1,30,1,7,0,8,0,30,5,3,0,8,4,30,3,1,0,4,0,-27,3,0
2,3,8,2,30,7,0,0,7,4,30,2,0,0,2,0,30,4,3,0,7,1,30,7,0,0,7,1,30,3,0,0,3,0,-27,3,0
2,1,19,0,30,6,7,0,13,2,30,7,1,0,8,0,30,4,9,0,13,5,30,4,9,0,13,0,30,7,2,0,9,1,-15,3,1
2,3,19,0,30,6,7,0,13,2,30,7,1,0,8,0,30,4,9,0,13,5,30,4,9,0,13,0,30,7,2,0,9,1,-15,3,1
2,4,19,0,30,6,7,0,13,2,30,7,1,0,8,0,30,4,9,0,13,5,30,4,9,0,13,0,30,7,2,0,9,1,-15,3,1
2,4,22,1,30,7,1,0,8,3,30,2,0,0,2,2,30,5,3,0,8,1,30,4,4,0,8,2,30,1,3,0,4,1,-15,3,1
2,3,23,2,30,5,8,0,13,4,30,6,0,0,6,6,30,9,4,0,13,1,30,7,6,0,13,1,30,6,0,0,6,1,-15,3,1
2,1,25,1,30,7,7,0,14,3,30,6,0,0,6,0,30,8,6,0,14,1,30,7,7,0,14,3,30,4,2,0,6,1,-15,3,1
2,2,25,1,30,7,7,0,14,3,30,6,0,0,6,0,30,8,6,0,14,1,30,7,7,0,14,3,30,4,2,0,6,1,-15,3,1
2,3,25,1,30,7,7,0,14,3,30,6,0,0,6,0,30,8,6,0,14,1,30,7,7,0,14,3,30,4,2,0,6,1,-15,3,1
2,4,25,1,30,7,7,0,14,3,30,6,0,0,6,0,30,8,6,0,14,1,30,7,7,0,14,3,30,4,2,0,6,1,-15,3,1
2,1,26,2,30,8,1,0,9,4,30,3,1,0,4,4,30,1,8,0,9,0,30,2,7,0,9,6,30,3,0,0,3,1,-15,3,1
2,3,26,2,30,8,1,0,9,4,30,3,1,0,4,4,30,1,8,0,9,0,30,2,7,0,9,6,30,3,0,0,3,1,-15,3,1
2,4,26,2,30,8,1,0,9,4,30,3,1,0,4,4,30,1,8,0,9,0,30,2,7,0,9,6,30,3,0,0,3,1,-15,3,1
2,0,27,1,30,4,11,0,15,3,30,1,1,0,2,0,30,5,10,0,15,2,30,4,11,0,15,3,30,6,0,0,6,1,-15,3,1
2,3,27,1,30,4,11,0,15,3,30,1,1,0,2,0,30,5,10,0,15,2,30,4,11,0,15,3,30,6,0,0,6,1,-15,3,1
2,3,29,0,30,7,7,0,14,6,30,11,1,0,12,0,30,3,11,0,14,0,30,0,14,0,14,1,30,9,0,0,9,1,-15,3,1
2,3,32,0,30,6,3,0,9,4,30,2,0,0,2,1,30,9,0,0,9,6,30,4,5,0,9,3,30,2,0,0,2,1,-15,3,1
2,4,32,0,30,6,3,0,9,4,30,2,0,0,2,1,30,9,0,0,9,6,30,4,5,0,9,3,30,2,0,0,2,1,-15,3,1
2,3,38,1,30,3,7,0,10,7,30,6,0,0,6,0,30,1,9,0,10,0,30,3,7,0,10,7,30,6,0,0,6,1,-15,3,1
2,3,47,0,30,2,12,0,14,7,30,4,0,0,4,0,30,3,11,0,14,0,30,2,12,0,14,10,30,7,0,0,7,1,-15,3,1
2,3,4,2,30,7,1,0,8,5,30,4,0,0,4,0,30,3,5,0,8,0,30,8,0,0,8,1,30,3,1,0,4,0,-27,3,0
2,2,11,0,30,1,3,0,4,0,30,0,0,0,0,1,30,1,3,0,4,6,30,4,0,0,4,2,30,1,0,0,1,1,-15,3,1
2,0,25,1,30,6,8,0,14,5,30,6,0,0,6,0,30,8,6,0,14,1,30,9,5,0,14,4,30,6,0,0,6,1,-15,3,1
2,1,27,1,30,5,10,0,15,5,30,2,0,0,2,0,30,3,12,0,15,0,30,6,9,0,15,2,30,6,0,0,6,1,-15,3,1
2,3,27,1,30,5,10,0,15,5,30,2,0,0,2,0,30,3,12,0,15,0,30,6,9,0,15,2,30,6,0,0,6,1,-15,3,1
2,3,29,0,30,7,7,0,14,5,30,12,0,0,12,0,30,4,10,0,14,0,30,1,13,0,14,0,30,7,2,0,9,1,-15,3,1
2,2,35,0,30,6,7,0,13,5,30,2,0,0,2,1,30,2,11,0,13,1,30,4,9,0,13,8,30,8,0,0,8,1,-15,3,1
2,2,4,2,30,8,0,0,8,5,30,2,2,0,4,0,30,1,7,0,8,1,30,7,1,0,8,1,30,3,1,0,4,0,-27,3,0
2,1,13,3,30,6,1,0,7,0,30,4,0,0,4,4,30,7,0,0,7,4,30,6,1,0,7,3,30,4,0,0,4,1,-15,3,1
2,2,13,3,30,6,1,0,7,0,30,4,0,0,4,4,30,7,0,0,7,4,30,6,1,0,7,3,30,4,0,0,4,1,-15,3,1
2,3,19,1,30,4,9,0,13,0,30,6,2,0,8,2,30,11,2,0,13,3,30,4,9,0,13,1,30,6,3,0,9,1,-15,3,1
2,0,29,0,30,9,5,0,14,4,30,11,1,0,12,0,30,5,9,0,14,0,30,1,13,0,14,5,30,9,0,0,9,1,-15,3,1
2,2,29,0,30,9,5,0,14,4,30,11,1,0,12,0,30,5,9,0,14,0,30,1,13,0,14,5,30,9,0,0,9,1,-15,3,1
2,3,8,2,30,7,0,0,7,5,30,2,0,0,2,0,30,1,6,0,7,0,30,4,3,0,7,1,30,3,0,0,3,0,-27,3,0
2,4,8,2,30,7,0,0,7,5,30,2,0,0,2,0,30,1,6,0,7,0,30,4,3,0,7,1,30,3,0,0,3,0,-27,3,0
2,4,13,1,30,3,4,0,7,0,30,4,0,0,4,2,30,6,1,0,7,9,30,6,1,0,7,0,30,4,0,0,4,1,-15,3,1
2,2,17,4,30,11,3,0,14,2,30,6,0,0,6,0,30,7,7,0,14,1,30,6,8,0,14,3,30,4,0,0,4,1,-15,3,1
2,3,17,4,30,11,3,0,14,2,30,6,0,0,6,0,30,7,7,0,14,1,30,6,8,0,14,3,30,4,0,0,4,1,-15,3,1
2,1,19,2,30,8,5,0,13,2,30,4,4,0,8,4,30,6,7,0,13,0,30,3,10,0,13,0,30,8,1,0,9,1,-15,3,1
2,2,19,2,30,8,5,0,13,2,30,4,4,0,8,4,30,6,7,0,13,0,30,3,10,0,13,0,30,8,1,0,9,1,-15,3,1
2,3,23,3,30,4,9,0,13,4,30,6,0,0,6,4,30,12,1,0,13,0,30,6,7,0,13,2,30,6,0,0,6,1,-15,3,1
2,4,23,3,30,4,9,0,13,4,30,6,0,0,6,4,30,12,1,0,13,0,30,6,7,0,13,2,30,6,0,0,6,1,-15,3,1
2,0,25,3,30,3,11,0,14,3,30,6,0,0,6,0,30,6,8,0,14,3,30,9,5,0,14,7,30,6,0,0,6,1,-15,3,1
2,3,25,3,30,3,11,0,14,3,30,6,0,0,6,0,30,6,8,0,14,3,30,9,5,0,14,7,30,6,0,0,6,1,-15,3,1
2,0,27,1,30,5,10,0,15,4,30,2,0,0,2,0,30,3,12,0,15,0,30,7,8,0,15,4,30,6,0,0,6,1,-15,3,1
2,2,27,1,30,5,10,0,15,4,30,2,0,0,2,0,30,3,12,0,15,0,30,7,8,0,15,4,30,6,0,0,6,1,-15,3,1
2,4,29,0,30,9,5,0,14,5,30,12,0,0,12,0,30,3,11,0,14,0,30,1,13,0,14,0,30,8,1,0,9,1,-15,3,1
2,4,32,0,30,6,3,0,9,4,30,2,0,0,2,0,30,7,2,0,9,1,30,3,6,0,9,3,30,2,0,0,2,1,-15,3,1
2,1,5,0,30,1,4,0,5,3,30,0,4,0,4,2,30,1,4,0,5,0,30,1,4,0,5,0,30,0,2,0,2,0,-27,3,0
2,3,5,0,30,1,4,0,5,3,30,0,4,0,4,2,30,1,4,0,5,0,30,1,4,0,5,0,30,0,2,0,2,0,-27,3,0
2,4,5,0,30,1,4,0,5,3,30,0,4,0,4,2,30,1,4,0,5,0,30,1,4,0,5,0,30,0,2,0,2,0,-27,3,0
2,2,13,0,30,5,2,0,7,0,30,4,0,0,4,5,30,7,0,0,7,9,30,6,1,0,7,5,30,4,0,0,4,1,-15,3,1
2,3,15,0,30,4,9,0,13,1,30,5,1,0,6,0,30,3,10,0,13,1,30,6,7,0,13,4,30,9,0,0,9,1,-15,3,1
2,1,17,3,30,9,5,0,14,4,30,6,0,0,6,0,30,2,12,0,14,3,30,8,6,0,14,4,30,4,0,0,4,1,-15,3,1
2,4,17,3,30,9,5,0,14,4,30,6,0,0,6,0,30,2,12,0,14,3,30,8,6,0,14,4,30,4,0,0,4,1,-15,3,1
2,3,19,1,30,6,7,0,13,2,30,7,1,0,8,4,30,4,9,0,13,0,30,4,9,0,13,0,30,7,2,0,9,1,-15,3,1
2,3,23,2,30,4,9,0,13,2,30,6,0,0,6,7,30,13,0,0,13,0,30,5,8,0,13,4,30,6,0,0,6,1,-15,3,1
2,4,23,2,30,4,9,0,13,2,30,6,0,0,6,7,30,13,0,0,13,0,30,5,8,0,13,4,30,6,0,0,6,1,-15,3,1
2,2,35,0,30,5,8,0,13,2,30,2,0,0,2,1,30,10,3,0,13,1,30,2,11,0,13,1,30,8,0,0,8,1,-15,3,1
2,3,35,0,30,5,8,0,13,2,30,2,0,0,2,1,30,10,3,0,13,1,30,2,11,0,13,1,30,8,0,0,8,1,-15,3,1
2,4,39,0,30,3,8,0,11,6,30,6,0,0,6,0,30,7,4,0,11,1,30,4,7,0,11,3,30,5,0,0,5,1,-15,3,1
2,4,5,0,30,2,3,0,5,3,30,3,1,0,4,2,30,0,5,0,5,0,30,1,4,0,5,0,30,0,2,0,2,0,-27,3,0
2,4,13,1,30,6,1,0,7,0,30,4,0,0,4,2,30,7,0,0,7,5,30,6,1,0,7,3,30,4,0,0,4,1,-15,3,1
2,3,17,2,30,9,5,0,14,3,30,6,0,0,6,0,30,6,8,0,14,0,30,8,6,0,14,2,30,4,0,0,4,1,-15,3,1
2,4,17,2,30,9,5,0,14,3,30,6,0,0,6,0,30,6,8,0,14,0,30,8,6,0,14,2,30,4,0,0,4,1,-15,3,1
2,4,22,1,30,5,3,0,8,2,30,2,0,0,2,0,30,4,4,0,8,1,30,4,4,0,8,2,30,2,2,0,4,1,-15,3,1
2,1,25,3,30,5,9,0,14,1,30,6,0,0,6,0,30,12,2,0,14,1,30,4,10,0,14,2,30,6,0,0,6,1,-15,3,1
2,2,25,3,30,5,9,0,14,1,30,6,0,0,6,0,30,12,2,0,14,1,30,4,10,0,14,2,30,6,0,0,6,1,-15,3,1
2,4,25,3,30,5,9,0,14,0,30,6,0,0,6,0,30,12,2,0,14,1,30,4,10,0,14,2,30,6,0,0,6,1,-15,3,1
2,2,27,1,30,4,11,0,15,2,30,1,1,0,2,0,30,9,6,0,15,1,30,5,10,0,15,1,30,6,0,0,6,1,-15,3,1
2,2,31,3,30,5,7,0,12,6,30,8,0,0,8,3,30,7,5,0,12,0,30,9,3,0,12,2,30,6,0,0,6,1,-15,3,1
2,4,31,3,30,5,7,0,12,6,30,8,0,0,8,3,30,7,5,0,12,0,30,9,3,0,12,2,30,6,0,0,6,1,-15,3,1
2,3,33,2,30,5,6,0,11,5,30,4,0,0,4,3,30,9,2,0,11,0,30,5,6,0,11,6,30,4,0,0,4,1,-15,3,1
2,0,35,0,30,6,7,0,13,5,30,2,0,0,2,1,30,2,11,0,13,2,30,1,12,0,13,6,30,8,0,0,8,1,-15,3,1
2,1,35,0,30,6,7,0,13,5,30,2,0,0,2,1,30,2,11,0,13,2,30,1,12,0,13,6,30,8,0,0,8,1,-15,3,1
2,3,39,2,30,4,7,0,11,7,30,6,0,0,6,0,30,5,6,0,11,0,30,4,7,0,11,0,30,5,0,0,5,1,-15,3,1
2,3,43,0,30,6,8,0,14,7,30,6,0,0,6,0,30,4,10,0,14,1,30,3,11,0,14,5,30,5,0,0,5,1,-15,3,1
2,2,4,2,30,7,1,0,8,5,30,4,0,0,4,3,30,1,7,0,8,0,30,6,2,0,8,1,30,3,1,0,4,0,-27,3,0
2,3,4,2,30,7,1,0,8,5,30,4,0,0,4,3,30,1,7,0,8,0,30,6,2,0,8,1,30,3,1,0,4,0,-27,3,0
2,3,6,1,30,6,3,0,9,4,30,2,0,0,2,0,30,2,7,0,9,0,30,4,5,0,9,4,30,5,0,0,5,0,-27,3,0
2,1,13,1,30,7,0,0,7,0,30,4,0,0,4,2,30,6,1,0,7,12,30,7,0,0,7,5,30,4,0,0,4,1,-15,3,1
2,4,13,1,30,7,0,0,7,0,30,4,0,0,4,2,30,6,1,0,7,12,30,7,0,0,7,1,30,4,0,0,4,1,-15,3,1
2,3,25,0,30,3,11,0,14,5,30,6,0,0,6,0,30,6,8,0,14,1,30,8,6,0,14,7,30,6,0,0,6,1,-15,3,1
2,2,27,1,30,4,11,0,15,4,30,2,0,0,2,0,30,3,12,0,15,2,30,4,11,0,15,5,30,6,0,0,6,1,-15,3,1
2,4,27,1,30,4,11,0,15,4,30,2,0,0,2,0,30,3,12,0,15,2,30,4,11,0,15,5,30,6,0,0,6,1,-15,3,1
2,3,1,0,30,7,3,0,10,4,30,2,0,0,2,0,30,4,6,0,10,3,30,7,3,0,10,6,30,6,0,0,6,0,-27,3,0
2,2,6,1,30,8,1,0,9,4,30,2,0,0,2,0,30,2,7,0,9,0,30,4,5,0,9,0,30,4,1,0,5,0,-27,3,0
2,2,9,0,30,2,2,0,4,2,30,2,0,0,2,0,30,1,3,0,4,0,30,1,3,0,4,0,30,1,0,0,1,0,-27,3,0
2,4,13,1,30,6,1,0,7,0,30,4,0,0,4,2,30,5,2,0,7,10,30,6,1,0,7,2,30,4,0,0,4,1,-15,3,1
2,4,15,1,30,5,8,0,13,1,30,6,0,0,6,0,30,3,10,0,13,1,30,4,9,0,13,2,30,7,2,0,9,1,-15,3,1
2,2,17,3,30,9,5,0,14,3,30,6,0,0,6,0,30,6,8,0,14,1,30,4,10,0,14,0,30,4,0,0,4,1,-15,3,1
2,4,19,0,30,2,11,0,13,2,30,6,2,0,8,2,30,12,1,0,13,4,30,5,8,0,13,0,30,8,1,0,9,1,-15,3,1
2,3,23,1,30,5,8,0,13,2,30,6,0,0,6,5,30,11,2,0,13,0,30,5,8,0,13,3,30,6,0,0,6,1,-15,3,1
2,1,27,1,30,8,7,0,15,4,30,2,0,0,2,0,30,2,13,0,15,1,30,3,12,0,15,4,30,6,0,0,6,1,-15,3,1
2,3,27,1,30,8,7,0,15,4,30,2,0,0,2,0,30,2,13,0,15,1,30,3,12,0,15,4,30,6,0,0,6,1,-15,3,1
2,4,27,1,30,8,7,0,15,4,30,2,0,0,2,0,30,2,13,0,15,1,30,3,12,0,15,4,30,6,0,0,6,1,-15,3,1
2,2,11,0,30,1,3,0,4,0,30,0,0,0,0,0,30,1,3,0,4,12,30,2,2,0,4,4,30,1,0,0,1,1,-15,3,1
2,4,11,0,30,1,3,0,4,0,30,0,0,0,0,0,30,1,3,0,4,12,30,2,2,0,4,4,30,1,0,0,1,1,-15,3,1
2,3,17,3,30,9,5,0,14,0,30,6,0,0,6,1,30,11,3,0,14,1,30,5,9,0,14,1,30,4,0,0,4,1,-15,3,1
2,4,23,3,30,6,7,0,13,3,30,6,0,0,6,0,30,12,1,0,13,0,30,3,10,0,13,2,30,6,0,0,6,1,-15,3,1
2,1,25,0,30,4,10,0,14,5,30,6,0,0,6,0,30,7,7,0,14,1,30,11,3,0,14,4,30,6,0,0,6,1,-15,3,1
2,2,25,0,30,4,10,0,14,5,30,6,0,0,6,0,30,7,7,0,14,1,30,11,3,0,14,4,30,6,0,0,6,1,-15,3,1
2,3,25,0,30,4,10,0,14,5,30,6,0,0,6,0,30,7,7,0,14,1,30,11,3,0,14,4,30,6,0,0,6,1,-15,3,1
2,2,27,1,30,6,9,0,15,4,30,2,0,0,2,0,30,4,11,0,15,0,30,5,10,0,15,2,30,6,0,0,6,1,-15,3,1
2,3,27,1,30,6,9,0,15,4,30,2,0,0,2,0,30,4,11,0,15,0,30,5,10,0,15,2,30,6,0,0,6,1,-15,3,1
2,2,29,0,30,8,6,0,14,6,30,12,0,0,12,0,30,5,9,0,14,0,30,2,12,0,14,0,30,9,0,0,9,1,-15,3,1
2,3,29,0,30,8,6,0,14,6,30,12,0,0,12,0,30,5,9,0,14,0,30,2,12,0,14,0,30,9,0,0,9,1,-15,3,1
2,4,29,0,30,8,6,0,14,6,30,12,0,0,12,0,30,5,9,0,14,0,30,2,12,0,14,0,30,9,0,0,9,1,-15,3,1
2,3,31,5,30,7,5,0,12,5,30,8,0,0,8,6,30,9,3,0,12,0,30,3,9,0,12,1,30,1,5,0,6,1,-15,3,1
2,1,13,5,30,7,0,0,7,0,30,4,0,0,4,2,30,6,1,0,7,3,30,4,3,0,7,1,30,4,0,0,4,1,-15,3,1
2,2,13,5,30,7,0,0,7,0,30,4,0,0,4,2,30,6,1,0,7,3,30,4,3,0,7,1,30,4,0,0,4,1,-15,3,1
2,3,13,5,30,7,0,0,7,0,30,4,0,0,4,2,30,6,1,0,7,3,30,4,3,0,7,1,30,4,0,0,4,1,-15,3,1
2,4,13,5,30,7,0,0,7,0,30,4,0,0,4,2,30,6,1,0,7,3,30,4,3,0,7,1,30,4,0,0,4,1,-15,3,1
2,3,27,1,30,4,11,0,15,4,30,1,1,0,2,0,30,6,9,0,15,2,30,2,13,0,15,2,30,5,1,0,6,1,-15,3,1
2,2,35,0,30,10,3,0,13,6,30,2,0,0,2,1,30,2,11,0,13,2,30,1,12,0,13,4,30,8,0,0,8,1,-15,3,1
2,0,4,3,30,7,1,0,8,4,30,2,2,0,4,0,30,2,6,0,8,0,30,5,3,0,8,2,30,4,0,0,4,0,-27,3,0
2,1,4,3,30,7,1,0,8,4,30,2,2,0,4,0,30,2,6,0,8,0,30,5,3,0,8,2,30,4,0,0,4,0,-27,3,0
2,4,5,0,30,3,2,0,5,3,30,0,4,0,4,0,30,0,5,0,5,0,30,1,4,0,5,0,30,0,2,0,2,0,-27,3,0
2,4,17,3,30,11,3,0,14,2,30,6,0,0,6,0,30,7,7,0,14,2,30,5,9,0,14,2,30,3,1,0,4,1,-15,3,1
2,4,19,0,30,2,11,0,13,2,30,5,3,0,8,0,30,5,8,0,13,1,30,6,7,0,13,2,30,8,1,0,9,1,-15,3,1
2,3,27,1,30,5,10,0,15,0,30,1,1,0,2,0,30,6,9,0,15,2,30,6,9,0,15,3,30,6,0,0,6,1,-15,3,1
2,4,32,0,30,5,4,0,9,4,30,2,0,0,2,0,30,7,2,0,9,1,30,3,6,0,9,4,30,2,0,0,2,1,-15,3,1
2,2,39,0,30,2,9,0,11,6,30,6,0,0,6,0,30,4,7,0,11,0,30,4,7,0,11,6,30,5,0,0,5,1,-15,3,1
2,0,41,0,30,7,5,0,12,6,30,8,0,0,8,0,30,6,6,0,12,2,30,3,9,0,12,5,30,7,0,0,7,1,-15,3,1
2,1,41,0,30,7,5,0,12,6,30,8,0,0,8,0,30,6,6,0,12,2,30,3,9,0,12,5,30,7,0,0,7,1,-15,3,1
2,3,8,2,30,7,0,0,7,4,30,2,0,0,2,7,30,2,5,0,7,0,30,4,3,0,7,5,30,3,0,0,3,0,-27,3,0
2,4,8,2,30,7,0,0,7,4,30,2,0,0,2,7,30,2,5,0,7,0,30,4,3,0,7,5,30,3,0,0,3,0,-27,3,0
2,4,13,0,30,3,0,0,3,0,30,2,0,0,2,0,30,2,1,0,3,9,30,3,0,0,3,2,30,2,0,0,2,1,-15,3,1
2,2,13,0,30,6,1,0,7,0,30,4,0,0,4,6,30,5,2,0,7,10,30,7,0,0,7,2,30,4,0,0,4,1,-15,3,1
2,3,17,4,30,10,4,0,14,0,30,6,0,0,6,0,30,7,7,0,14,0,30,5,9,0,14,4,30,4,0,0,4,1,-15,3,1
2,4,22,2,30,7,1,0,8,3,30,2,0,0,2,0,30,4,4,0,8,1,30,4,4,0,8,1,30,4,0,0,4,1,-15,3,1
2,1,27,1,30,3,12,0,15,2,30,2,0,0,2,0,30,6,9,0,15,4,30,5,10,0,15,6,30,6,0,0,6,1,-15,3,1
2,3,33,0,30,7,4,0,11,5,30,4,0,0,4,5,30,9,2,0,11,0,30,3,8,0,11,3,30,4,0,0,4,1,-15,3,1
2,3,41,0,30,8,4,0,12,6,30,8,0,0,8,0,30,7,5,0,12,0,30,4,8,0,12,3,30,5,2,0,7,1,-15,3,1
2,3,5,0,30,2,3,0,5,3,30,1,3,0,4,0,30,0,5,0,5,0,30,1,4,0,5,0,30,1,1,0,2,0,-27,3,0
2,4,5,0,30,2,3,0,5,3,30,1,3,0,4,0,30,0,5,0,5,0,30,1,4,0,5,0,30,1,1,0,2,0,-27,3,0
2,4,13,3,30,3,0,0,3,0,30,2,0,0,2,0,30,3,0,0,3,10,30,2,1,0,3,3,30,2,0,0,2,1,-15,3,1
2,1,13,3,30,7,0,0,7,0,30,4,0,0,4,8,30,6,1,0,7,6,30,6,1,0,7,3,30,4,0,0,4,1,-15,3,1
2,4,13,3,30,7,0,0,7,0,30,4,0,0,4,8,30,6,1,0,7,6,30,6,1,0,7,3,30,4,0,0,4,1,-15,3,1
2,4,15,0,30,5,8,0,13,0,30,5,1,0,6,0,30,6,7,0,13,1,30,4,9,0,13,2,30,6,3,0,9,1,-15,3,1
2,3,17,3,30,9,5,0,14,3,30,6,0,0,6,0,30,6,8,0,14,0,30,6,8,0,14,0,30,4,0,0,4,1,-15,3,1
2,1,19,1,30,5,8,0,13,2,30,2,6,0,8,0,30,5,8,0,13,1,30,6,7,0,13,2,30,8,1,0,9,1,-15,3,1
2,2,19,1,30,5,8,0,13,2,30,2,6,0,8,0,30,5,8,0,13,1,30,6,7,0,13,2,30,8,1,0,9,1,-15,3,1
2,3,19,1,30,5,8,0,13,2,30,2,6,0,8,0,30,5,8,0,13,1,30,6,7,0,13,2,30,8,1,0,9,1,-15,3,1
2,4,19,1,30,5,8,0,13,2,30,2,6,0,8,0,30,5,8,0,13,1,30,6,7,0,13,2,30,8,1,0,9,1,-15,3,1
2,4,22,1,30,6,2,0,8,2,30,2,0,0,2,0,30,5,3,0,8,0,30,6,2,0,8,5,30,4,0,0,4,1,-15,3,1
2,3,25,1,30,7,7,0,14,5,30,6,0,0,6,0,30,6,8,0,14,1,30,9,5,0,14,3,30,5,1,0,6,1,-15,3,1
2,3,27,1,30,9,6,0,15,4,30,2,0,0,2,0,30,5,10,0,15,0,30,7,8,0,15,2,30,6,0,0,6,1,-15,3,1
2,0,31,2,30,8,4,0,12,3,30,8,0,0,8,3,30,9,3,0,12,0,30,3,9,0,12,1,30,3,3,0,6,1,-15,3,1
2,3,31,2,30,8,4,0,12,3,30,8,0,0,8,3,30,9,3,0,12,0,30,3,9,0,12,0,30,3,3,0,6,1,-15,3,1
2,4,31,2,30,8,4,0,12,3,30,8,0,0,8,3,30,9,3,0,12,0,30,3,9,0,12,0,30,3,3,0,6,1,-15,3,1
2,0,4,2,30,7,1,0,8,5,30,4,0,0,4,0,30,1,7,0,8,1,30,8,0,0,8,2,30,3,1,0,4,0,-27,3,0
2,0,9,6,30,2,2,0,4,4,30,2,0,0,2,0,30,2,2,0,4,0,30,1,3,0,4,0,30,1,0,0,1,0,-27,3,0
2,1,9,6,30,2,2,0,4,4,30,2,0,0,2,0,30,2,2,0,4,0,30,1,3,0,4,0,30,1,0,0,1,0,-27,3,0
2,2,9,6,30,2,2,0,4,4,30,2,0,0,2,0,30,2,2,0,4,0,30,1,3,0,4,0,30,1,0,0,1,0,-27,3,0
2,3,9,6,30,2,2,0,4,4,30,2,0,0,2,0,30,2,2,0,4,0,30,1,3,0,4,0,30,1,0,0,1,0,-27,3,0
2,4,9,6,30,2,2,0,4,4,30,2,0,0,2,0,30,2,2,0,4,0,30,1,3,0,4,0,30,1,0,0,1,0,-27,3,0
2,2,11,0,30,5,7,0,12,1,30,3,1,0,4,1,30,5,7,0,12,3,30,6,6,0,12,4,30,4,0,0,4,1,-15,3,1
2,3,11,0,30,5,7,0,12,1,30,3,1,0,4,1,30,5,7,0,12,3,30,6,6,0,12,4,30,4,0,0,4,1,-15,3,1
2,4,11,0,30,5,7,0,12,1,30,3,1,0,4,1,30,5,7,0,12,3,30,6,6,0,12,4,30,4,0,0,4,1,-15,3,1
2,4,13,3,30,7,0,0,7,0,30,4,0,0,4,2,30,6,1,0,7,11,30,6,1,0,7,5,30,4,0,0,4,1,-15,3,1
2,4,15,0,30,3,10,0,13,1,30,5,1,0,6,0,30,3,10,0,13,1,30,5,8,0,13,2,30,9,0,0,9,1,-15,3,1
2,4,17,3,30,9,5,0,14,2,30,6,0,0,6,0,30,8,6,0,14,1,30,7,7,0,14,6,30,4,0,0,4,1,-15,3,1
2,4,19,0,30,4,9,0,13,2,30,5,3,0,8,0,30,5,8,0,13,10,30,4,9,0,13,1,30,9,0,0,9,1,-15,3,1
2,0,25,1,30,4,10,0,14,5,30,6,0,0,6,0,30,5,9,0,14,3,30,7,7,0,14,6,30,5,1,0,6,1,-15,3,1
2,1,25,1,30,4,10,0,14,5,30,6,0,0,6,0,30,5,9,0,14,3,30,7,7,0,14,6,30,5,1,0,6,1,-15,3,1
2,2,25,1,30,4,10,0,14,5,30,6,0,0,6,0,30,5,9,0,14,3,30,7,7,0,14,6,30,5,1,0,6,1,-15,3,1
2,3,25,1,30,4,10,0,14,5,30,6,0,0,6,0,30,5,9,0,14,3,30,7,7,0,14,6,30,5,1,0,6,1,-15,3,1
2,2,29,0,30,10,4,0,14,5,30,10,2,0,12,0,30,3,11,0,14,0,30,1,13,0,14,1,30,9,0,0,9,1,-15,3,1
2,1,38,0,30,1,9,0,10,6,30,6,0,0,6,0,30,4,6,0,10,0,30,4,6,0,10,8,30,6,0,0,6,1,-15,3,1
2,2,38,0,30,1,9,0,10,6,30,6,0,0,6,0,30,4,6,0,10,0,30,4,6,0,10,8,30,6,0,0,6,1,-15,3,1
2,3,38,0,30,1,9,0,10,6,30,6,0,0,6,0,30,4,6,0,10,0,30,4,6,0,10,8,30,6,0,0,6,1,-15,3,1
2,0,6,0,30,7,2,0,9,4,30,2,0,0,2,0,30,2,7,0,9,2,30,5,4,0,9,1,30,4,1,0,5,0,-27,3,0
2,2,15,0,30,8,5,0,13,1,30,6,0,0,6,0,30,3,10,0,13,1,30,4,9,0,13,1,30,5,4,0,9,1,-15,3,1
2,3,15,0,30,8,5,0,13,1,30,6,0,0,6,0,30,3,10,0,13,1,30,4,9,0,13,1,30,5,4,0,9,1,-15,3,1
2,4,15,0,30,8,5,0,13,1,30,6,0,0,6,0,30,3,10,0,13,1,30,4,9,0,13,1,30,5,4,0,9,1,-15,3,1
2,4,17,3,30,9,5,0,14,3,30,6,0,0,6,0,30,7,7,0,14,1,30,5,9,0,14,0,30,4,0,0,4,1,-15,3,1
2,4,19,6,30,4,9,0,13,2,30,3,5,0,8,0,30,10,3,0,13,0,30,3,10,0,13,0,30,8,1,0,9,1,-15,3,1
2,0,21,2,30,7,3,0,10,3,30,6,0,0,6,1,30,3,7,0,10,8,30,4,6,0,10,4,30,4,0,0,4,1,-15,3,1
2,2,21,2,30,7,3,0,10,3,30,6,0,0,6,1,30,3,7,0,10,8,30,4,6,0,10,4,30,4,0,0,4,1,-15,3,1
2,4,21,2,30,7,3,0,10,3,30,6,0,0,6,1,30,3,7,0,10,8,30,4,6,0,10,4,30,4,0,0,4,1,-15,3,1
2,2,27,5,30,9,6,0,15,2,30,2,0,0,2,2,30,6,9,0,15,0,30,4,11,0,15,1,30,2,4,0,6,1,-15,3,1
2,3,27,5,30,9,6,0,15,2,30,2,0,0,2,2,30,6,9,0,15,0,30,4,11,0,15,1,30,2,4,0,6,1,-15,3,1
2,3,29,0,30,5,9,0,14,6,30,11,1,0,12,0,30,5,9,0,14,0,30,1,13,0,14,2,30,9,0,0,9,1,-15,3,1
2,2,37,0,30,5,6,0,11,7,30,8,0,0,8,4,30,5,6,0,11,2,30,6,5,0,11,6,30,6,0,0,6,1,-15,3,1
2,4,37,0,30,5,6,0,11,7,30,8,0,0,8,4,30,5,6,0,11,2,30,6,5,0,11,6,30,6,0,0,6,1,-15,3,1
2,2,17,4,30,11,3,0,14,4,30,6,0,0,6,0,30,3,11,0,14,3,30,4,10,0,14,4,30,4,0,0,4,1,-15,3,1
2,4,19,0,30,3,10,0,13,2,30,5,3,0,8,0,30,6,7,0,13,8,30,6,7,0,13,2,30,8,1,0,9,1,-15,3,1
2,1,21,5,30,9,1,0,10,4,30,5,1,0,6,1,30,3,7,0,10,1,30,5,5,0,10,1,30,3,1,0,4,1,-15,3,1
2,2,25,1,30,4,10,0,14,3,30,6,0,0,6,0,30,10,4,0,14,1,30,4,10,0,14,3,30,5,1,0,6,1,-15,3,1
2,3,25,1,30,4,10,0,14,3,30,6,0,0,6,0,30,10,4,0,14,1,30,4,10,0,14,3,30,5,1,0,6,1,-15,3,1
2,2,27,1,30,4,11,0,15,3,30,2,0,0,2,0,30,6,9,0,15,1,30,5,10,0,15,2,30,6,0,0,6,1,-15,3,1
2,4,27,1,30,4,11,0,15,3,30,2,0,0,2,0,30,6,9,0,15,1,30,5,10,0,15,2,30,6,0,0,6,1,-15,3,1
2,0,47,0,30,1,13,0,14,6,30,4,0,0,4,0,30,3,11,0,14,0,30,4,10,0,14,4,30,7,0,0,7,1,-15,3,1
2,2,47,0,30,1,13,0,14,6,30,4,0,0,4,0,30,3,11,0,14,0,30,4,10,0,14,4,30,7,0,0,7,1,-15,3,1
2,4,47,0,30,1,13,0,14,6,30,4,0,0,4,0,30,3,11,0,14,0,30,4,10,0,14,4,30,7,0,0,7,1,-15,3,1
2,4,17,5,30,10,4,0,14,2,30,6,0,0,6,0,30,6,8,0,14,2,30,3,11,0,14,5,30,4,0,0,4,1,-15,3,1
2,1,27,1,30,4,11,0,15,5,30,1,1,0,2,0,30,3,12,0,15,2,30,6,9,0,15,2,30,6,0,0,6,1,-15,3,1
2,2,27,1,30,4,11,0,15,5,30,1,1,0,2,0,30,3,12,0,15,2,30,6,9,0,15,2,30,6,0,0,6,1,-15,3,1
2,1,4,6,30,6,2,0,8,5,30,4,0,0,4,1,30,2,6,0,8,0,30,5,3,0,8,1,30,3,1,0,4,0,-27,3,0
2,0,5,1,30,5,0,0,5,3,30,4,0,0,4,0,30,0,5,0,5,0,30,1,4,0,5,0,30,0,2,0,2,0,-27,3,0
2,3,8,1,30,7,0,0,7,4,30,2,0,0,2,2,30,3,4,0,7,0,30,7,0,0,7,1,30,3,0,0,3,0,-27,3,0
2,1,23,1,30,4,9,0,13,4,30,6,0,0,6,6,30,9,4,0,13,2,30,7,6,0,13,3,30,6,0,0,6,1,-15,3,1
2,2,23,1,30,4,9,0,13,4,30,6,0,0,6,6,30,9,4,0,13,2,30,7,6,0,13,3,30,6,0,0,6,1,-15,3,1
2,3,27,0,30,4,11,0,15,4,30,1,1,0,2,0,30,5,10,0,15,0,30,3,12,0,15,1,30,5,1,0,6,1,-15,3,1
2,1,31,2,30,8,4,0,12,5,30,8,0,0,8,3,30,9,3,0,12,0,30,3,9,0,12,2,30,5,1,0,6,1,-15,3,1
2,2,31,2,30,8,4,0,12,5,30,8,0,0,8,3,30,9,3,0,12,0,30,3,9,0,12,2,30,5,1,0,6,1,-15,3,1
2,4,32,0,30,4,5,0,9,4,30,2,0,0,2,0,30,7,2,0,9,1,30,3,6,0,9,2,30,2,0,0,2,1,-15,3,1
2,0,39,5,30,6,5,0,11,8,30,6,0,0,6,0,30,4,7,0,11,0,30,2,9,0,11,2,30,4,1,0,5,1,-15,3,1
2,2,39,5,30,6,5,0,11,8,30,6,0,0,6,0,30,4,7,0,11,0,30,2,9,0,11,2,30,4,1,0,5,1,-15,3,1
2,0,47,0,30,4,10,0,14,7,30,4,0,0,4,0,30,6,8,0,14,0,30,2,12,0,14,8,30,7,0,0,7,1,-15,3,1
2,1,4,11,30,8,0,0,8,6,30,4,0,0,4,0,30,1,7,0,8,0,30,0,8,0,8,1,30,4,0,0,4,0,-27,3,0
2,3,4,11,30,8,0,0,8,6,30,4,0,0,4,0,30,1,7,0,8,0,30,0,8,0,8,1,30,4,0,0,4,0,-27,3,0
2,1,5,3,30,5,0,0,5,4,30,4,0,0,4,0,30,0,5,0,5,0,30,1,4,0,5,0,30,1,1,0,2,0,-27,3,0
2,2,6,0,30,6,3,0,9,4,30,2,0,0,2,0,30,2,7,0,9,0,30,4,5,0,9,1,30,4,1,0,5,0,-27,3,0
2,3,6,0,30,6,3,0,9,4,30,2,0,0,2,0,30,2,7,0,9,0,30,4,5,0,9,1,30,4,1,0,5,0,-27,3,0
2,4,6,0,30,6,3,0,9,4,30,2,0,0,2,0,30,2,7,0,9,0,30,4,5,0,9,1,30,4,1,0,5,0,-27,3,0
2,4,8,0,30,7,0,0,7,4,30,2,0,0,2,6,30,4,3,0,7,3,30,7,0,0,7,0,30,3,0,0,3,0,-27,3,0
2,4,17,3,30,10,4,0,14,2,30,6,0,0,6,0,30,7,7,0,14,1,30,4,10,0,14,4,30,4,0,0,4,1,-15,3,1
2,4,25,3,30,10,4,0,14,4,30,6,0,0,6,0,30,6,8,0,14,1,30,5,9,0,14,4,30,5,1,0,6,1,-15,3,1
2,0,26,0,30,7,2,0,9,6,30,4,0,0,4,5,30,0,9,0,9,0,30,2,7,0,9,6,30,3,0,0,3,1,-15,3,1
2,2,26,0,30,7,2,0,9,6,30,4,0,0,4,5,30,0,9,0,9,0,30,2,7,0,9,6,30,3,0,0,3,1,-15,3,1
2,4,26,0,30,7,2,0,9,6,30,4,0,0,4,5,30,0,9,0,9,0,30,2,7,0,9,6,30,3,0,0,3,1,-15,3,1
2,1,27,1,30,4,11,0,15,3,30,2,0,0,2,0,30,6,9,0,15,0,30,4,11,0,15,3,30,6,0,0,6,1,-15,3,1
2,2,27,1,30,4,11,0,15,3,30,2,0,0,2,0,30,6,9,0,15,0,30,4,11,0,15,3,30,6,0,0,6,1,-15,3,1
2,2,29,0,30,6,8,0,14,6,30,11,1,0,12,0,30,3,11,0,14,0,30,1,13,0,14,2,30,9,0,0,9,1,-15,3,1
2,2,31,6,30,5,7,0,12,8,30,8,0,0,8,3,30,4,8,0,12,0,30,9,3,0,12,0,30,5,1,0,6,1,-15,3,1
2,3,35,1,30,11,2,0,13,5,30,2,0,0,2,1,30,2,11,0,13,0,30,6,7,0,13,5,30,8,0,0,8,1,-15,3,1
2,4,35,1,30,11,2,0,13,5,30,2,0,0,2,1,30,2,11,0,13,0,30,6,7,0,13,5,30,8,0,0,8,1,-15,3,1
2,3,4,2,30,8,0,0,8,4,30,4,0,0,4,0,30,6,2,0,8,0,30,8,0,0,8,2,30,3,1,0,4,0,-27,3,0
2,4,8,1,30,7,0,0,7,3,30,2,0,0,2,0,30,4,3,0,7,0,30,4,3,0,7,1,30,3,0,0,3,0,-27,3,0
2,1,13,2,30,5,2,0,7,0,30,4,0,0,4,2,30,5,2,0,7,9,30,6,1,0,7,4,30,4,0,0,4,1,-15,3,1
2,2,13,2,30,5,2,0,7,0,30,4,0,0,4,2,30,5,2,0,7,9,30,6,1,0,7,4,30,4,0,0,4,1,-15,3,1
2,2,17,4,30,10,4,0,14,3,30,6,0,0,6,0,30,5,9,0,14,0,30,5,9,0,14,2,30,4,0,0,4,1,-15,3,1
2,3,17,4,30,10,4,0,14,3,30,6,0,0,6,0,30,5,9,0,14,0,30,5,9,0,14,2,30,4,0,0,4,1,-15,3,1
2,4,17,4,30,10,4,0,14,3,30,6,0,0,6,0,30,5,9,0,14,0,30,5,9,0,14,2,30,4,0,0,4,1,-15,3,1
2,4,19,0,30,3,10,0,13,2,30,5,3,0,8,0,30,8,5,0,13,1,30,5,8,0,13,2,30,8,1,0,9,1,-15,3,1
2,4,23,3,30,5,8,0,13,3,30,6,0,0,6,4,30,12,1,0,13,0,30,6,7,0,13,3,30,6,0,0,6,1,-15,3,1
2,2,25,3,30,7,7,0,14,4,30,6,0,0,6,0,30,6,8,0,14,1,30,5,9,0,14,5,30,5,1,0,6,1,-15,3,1
2,1,27,1,30,5,10,0,15,3,30,2,0,0,2,0,30,6,9,0,15,2,30,6,9,0,15,3,30,6,0,0,6,1,-15,3,1
2,3,27,1,30,5,10,0,15,3,30,2,0,0,2,0,30,6,9,0,15,2,30,6,9,0,15,3,30,6,0,0,6,1,-15,3,1
2,3,29,0,30,9,5,0,14,6,30,9,3,0,12,0,30,3,11,0,14,0,30,1,13,0,14,3,30,9,0,0,9,1,-15,3,1
2,4,29,0,30,9,5,0,14,6,30,9,3,0,12,0,30,3,11,0,14,0,30,1,13,0,14,3,30,9,0,0,9,1,-15,3,1
2,3,31,1,30,9,3,0,12,3,30,8,0,0,8,3,30,12,0,0,12,0,30,3,9,0,12,0,30,4,2,0,6,1,-15,3,1
2,4,31,1,30,9,3,0,12,3,30,8,0,0,8,3,30,12,0,0,12,0,30,3,9,0,12,0,30,4,2,0,6,1,-15,3,1
2,4,39,4,30,5,6,0,11,6,30,6,0,0,6,0,30,8,3,0,11,0,30,2,9,0,11,0,30,5,0,0,5,1,-15,3,1
2,3,13,3,30,7,0,0,7,1,30,4,0,0,4,2,30,6,1,0,7,1,30,5,2,0,7,0,30,4,0,0,4,1,-15,3,1
2,4,13,3,30,7,0,0,7,1,30,4,0,0,4,2,30,6,1,0,7,1,30,5,2,0,7,0,30,4,0,0,4,1,-15,3,1
2,3,17,3,30,9,5,0,14,4,30,6,0,0,6,0,30,4,10,0,14,0,30,7,7,0,14,1,30,4,0,0,4,1,-15,3,1
2,4,17,3,30,9,5,0,14,4,30,6,0,0,6,0,30,4,10,0,14,0,30,7,7,0,14,1,30,4,0,0,4,1,-15,3,1
2,1,19,7,30,4,9,0,13,3,30,3,5,0,8,0,30,5,8,0,13,1,30,6,7,0,13,0,30,6,3,0,9,1,-15,3,1
2,2,19,7,30,4,9,0,13,3,30,3,5,0,8,0,30,5,8,0,13,1,30,6,7,0,13,0,30,6,3,0,9,1,-15,3,1
2,3,19,7,30,4,9,0,13,3,30,3,5,0,8,0,30,5,8,0,13,1,30,6,7,0,13,0,30,6,3,0,9,1,-15,3,1
2,3,23,1,30,5,8,0,13,3,30,6,0,0,6,6,30,10,3,0,13,0,30,6,7,0,13,1,30,6,0,0,6,1,-15,3,1
2,4,23,1,30,5,8,0,13,3,30,6,0,0,6,6,30,10,3,0,13,0,30,6,7,0,13,1,30,6,0,0,6,1,-15,3,1
2,4,25,2,30,5,9,0,14,5,30,6,0,0,6,0,30,7,7,0,14,1,30,5,9,0,14,3,30,5,1,0,6,1,-15,3,1
2,0,26,1,30,7,2,0,9,5,30,4,0,0,4,2,30,0,9,0,9,0,30,2,7,0,9,6,30,3,0,0,3,1,-15,3,1
2,3,26,1,30,7,2,0,9,5,30,4,0,0,4,2,30,0,9,0,9,0,30,2,7,0,9,6,30,3,0,0,3,1,-15,3,1
2,4,26,1,30,7,2,0,9,5,30,4,0,0,4,2,30,0,9,0,9,0,30,2,7,0,9,6,30,3,0,0,3,1,-15,3,1
2,2,27,1,30,4,11,0,15,4,30,1,1,0,2,0,30,6,9,0,15,0,30,4,11,0,15,3,30,6,0,0,6,1,-15,3,1
2,2,29,0,30,6,8,0,14,5,30,9,3,0,12,0,30,4,10,0,14,0,30,0,14,0,14,3,30,9,0,0,9,1,-15,3,1
2,1,35,0,30,8,5,0,13,3,30,2,0,0,2,1,30,9,4,0,13,0,30,6,7,0,13,6,30,8,0,0,8,1,-15,3,1
2,0,41,0,30,6,6,0,12,5,30,7,1,0,8,0,30,5,7,0,12,0,30,2,10,0,12,3,30,7,0,0,7,1,-15,3,1
2,1,41,0,30,6,6,0,12,5,30,7,1,0,8,0,30,5,7,0,12,0,30,2,10,0,12,3,30,7,0,0,7,1,-15,3,1
2,2,1,0,30,7,3,0,10,4,30,2,0,0,2,1,30,4,6,0,10,6,30,8,2,0,10,3,30,6,0,0,6,0,-27,3,0
2,3,1,0,30,7,3,0,10,4,30,2,0,0,2,1,30,4,6,0,10,6,30,8,2,0,10,3,30,6,0,0,6,0,-27,3,0
2,4,1,0,30,7,3,0,10,4,30,2,0,0,2,1,30,4,6,0,10,6,30,8,2,0,10,3,30,6,0,0,6,0,-27,3,0
2,3,8,2,30,7,0,0,7,4,30,2,0,0,2,3,30,5,2,0,7,0,30,6,1,0,7,0,30,3,0,0,3,0,-27,3,0
2,2,17,4,30,10,4,0,14,2,30,6,0,0,6,0,30,6,8,0,14,1,30,5,9,0,14,6,30,4,0,0,4,1,-15,3,1
2,4,17,4,30,10,4,0,14,2,30,6,0,0,6,0,30,6,8,0,14,1,30,5,9,0,14,5,30,4,0,0,4,1,-15,3,1
2,2,25,2,30,11,3,0,14,3,30,6,0,0,6,1,30,10,4,0,14,1,30,9,5,0,14,0,30,5,1,0,6,1,-15,3,1
2,0,26,0,30,6,3,0,9,5,30,4,0,0,4,2,30,1,8,0,9,0,30,2,7,0,9,5,30,2,1,0,3,1,-15,3,1
2,2,26,0,30,6,3,0,9,4,30,4,0,0,4,2,30,1,8,0,9,0,30,2,7,0,9,5,30,2,1,0,3,1,-15,3,1
2,3,29,1,30,10,4,0,14,6,30,10,2,0,12,0,30,3,11,0,14,0,30,2,12,0,14,0,30,9,0,0,9,1,-15,3,1
2,2,13,5,30,6,1,0,7,2,30,4,0,0,4,2,30,7,0,0,7,3,30,7,0,0,7,5,30,4,0,0,4,1,-15,3,1
2,4,13,5,30,6,1,0,7,2,30,4,0,0,4,0,30,7,0,0,7,3,30,7,0,0,7,5,30,4,0,0,4,1,-15,3,1
2,2,17,4,30,9,5,0,14,3,30,6,0,0,6,0,30,7,7,0,14,2,30,7,7,0,14,0,30,2,2,0,4,1,-15,3,1
2,3,17,4,30,9,5,0,14,3,30,6,0,0,6,0,30,7,7,0,14,2,30,7,7,0,14,0,30,2,2,0,4,1,-15,3,1
2,4,17,4,30,9,5,0,14,3,30,6,0,0,6,0,30,7,7,0,14,2,30,7,7,0,14,0,30,2,2,0,4,1,-15,3,1
2,3,19,0,30,4,9,0,13,2,30,5,3,0,8,0,30,7,6,0,13,3,30,4,9,0,13,2,30,9,0,0,9,1,-15,3,1
2,4,23,2,30,5,8,0,13,3,30,6,0,0,6,5,30,9,4,0,13,0,30,6,7,0,13,4,30,6,0,0,6,1,-15,3,1
2,2,27,1,30,4,11,0,15,0,30,2,0,0,2,0,30,10,5,0,15,0,30,6,9,0,15,2,30,6,0,0,6,1,-15,3,1
2,3,27,1,30,4,11,0,15,0,30,2,0,0,2,0,30,10,5,0,15,0,30,6,9,0,15,2,30,6,0,0,6,1,-15,3,1
2,4,29,0,30,5,9,0,14,6,30,8,4,0,12,0,30,4,10,0,14,0,30,1,13,0,14,0,30,9,0,0,9,1,-15,3,1
2,2,31,1,30,6,6,0,12,4,30,8,0,0,8,5,30,12,0,0,12,0,30,3,9,0,12,2,30,2,4,0,6,1,-15,3,1
2,3,31,1,30,6,6,0,12,4,30,8,0,0,8,5,30,12,0,0,12,0,30,3,9,0,12,2,30,2,4,0,6,1,-15,3,1
2,4,31,1,30,6,6,0,12,4,30,8,0,0,8,5,30,12,0,0,12,0,30,3,9,0,12,2,30,2,4,0,6,1,-15,3,1
2,1,37,6,30,10,1,0,11,6,30,6,2,0,8,0,30,6,5,0,11,2,30,3,8,0,11,4,30,5,1,0,6,1,-15,3,1
2,2,37,6,30,10,1,0,11,6,30,6,2,0,8,0,30,6,5,0,11,2,30,3,8,0,11,4,30,5,1,0,6,1,-15,3,1
2,4,37,6,30,10,1,0,11,6,30,6,2,0,8,0,30,6,5,0,11,2,30,3,8,0,11,4,30,5,1,0,6,1,-15,3,1
2,2,39,0,30,4,7,0,11,5,30,6,0,0,6,0,30,8,3,0,11,0,30,2,9,0,11,4,30,5,0,0,5,1,-15,3,1
2,4,39,0,30,4,7,0,11,5,30,6,0,0,6,0,30,8,3,0,11,0,30,2,9,0,11,4,30,5,0,0,5,1,-15,3,1
2,2,4,2,30,5,3,0,8,4,30,4,0,0,4,0,30,1,7,0,8,0,30,0,8,0,8,2,30,3,1,0,4,0,-27,3,0
2,3,4,2,30,5,3,0,8,4,30,4,0,0,4,0,30,1,7,0,8,0,30,0,8,0,8,2,30,3,1,0,4,0,-27,3,0
2,1,11,1,30,5,7,0,12,0,30,4,0,0,4,0,30,7,5,0,12,6,30,6,6,0,12,5,30,4,0,0,4,1,-15,3,1
2,2,11,1,30,5,7,0,12,0,30,4,0,0,4,0,30,7,5,0,12,6,30,6,6,0,12,5,30,4,0,0,4,1,-15,3,1
2,2,13,1,30,5,2,0,7,0,30,4,0,0,4,4,30,7,0,0,7,6,30,5,2,0,7,5,30,4,0,0,4,1,-15,3,1
2,3,13,1,30,5,2,0,7,0,30,4,0,0,4,4,30,7,0,0,7,6,30,5,2,0,7,5,30,4,0,0,4,1,-15,3,1
2,4,13,1,30,5,2,0,7,0,30,4,0,0,4,4,30,7,0,0,7,6,30,5,2,0,7,5,30,4,0,0,4,1,-15,3,1
2,3,17,4,30,10,4,0,14,2,30,6,0,0,6,0,30,6,8,0,14,2,30,5,9,0,14,1,30,3,1,0,4,1,-15,3,1
2,4,17,4,30,10,4,0,14,2,30,6,0,0,6,0,30,6,8,0,14,2,30,5,9,0,14,1,30,3,1,0,4,1,-15,3,1
2,2,19,0,30,4,9,0,13,2,30,6,2,0,8,0,30,6,7,0,13,4,30,4,9,0,13,0,30,8,1,0,9,1,-15,3,1
2,4,23,2,30,6,7,0,13,4,30,6,0,0,6,3,30,7,6,0,13,0,30,5,8,0,13,0,30,6,0,0,6,1,-15,3,1
2,0,27,1,30,6,9,0,15,2,30,2,0,0,2,0,30,6,9,0,15,0,30,4,11,0,15,1,30,5,1,0,6,1,-15,3,1
2,2,27,1,30,6,9,0,15,2,30,2,0,0,2,0,30,6,9,0,15,0,30,4,11,0,15,1,30,5,1,0,6,1,-15,3,1
2,4,27,1,30,6,9,0,15,2,30,2,0,0,2,0,30,6,9,0,15,0,30,4,11,0,15,1,30,5,1,0,6,1,-15,3,1
2,2,35,1,30,11,2,0,13,6,30,2,0,0,2,5,30,2,11,0,13,0,30,1,12,0,13,2,30,8,0,0,8,1,-15,3,1
2,0,39,0,30,4,7,0,11,5,30,6,0,0,6,0,30,11,0,0,11,0,30,3,8,0,11,2,30,5,0,0,5,1,-15,3,1
2,1,47,0,30,1,13,0,14,5,30,4,0,0,4,0,30,3,11,0,14,0,30,2,12,0,14,7,30,7,0,0,7,1,-15,3,1
2,3,4,2,30,5,3,0,8,5,30,4,0,0,4,0,30,1,7,0,8,0,30,5,3,0,8,4,30,3,1,0,4,0,-27,3,0
2,3,5,0,30,2,3,0,5,3,30,4,0,0,4,0,30,0,5,0,5,0,30,1,4,0,5,3,30,2,0,0,2,0,-27,3,0
2,2,13,2,30,6,1,0,7,0,30,4,0,0,4,3,30,7,0,0,7,11,30,6,1,0,7,3,30,4,0,0,4,1,-15,3,1
2,4,15,0,30,4,9,0,13,0,30,5,1,0,6,0,30,6,7,0,13,1,30,4,9,0,13,2,30,7,2,0,9,1,-15,3,1
2,3,17,3,30,9,5,0,14,3,30,6,0,0,6,0,30,5,9,0,14,1,30,8,6,0,14,7,30,4,0,0,4,1,-15,3,1
2,2,25,1,30,6,8,0,14,3,30,6,0,0,6,0,30,4,10,0,14,1,30,8,6,0,14,7,30,6,0,0,6,1,-15,3,1
2,4,39,0,30,3,8,0,11,6,30,6,0,0,6,0,30,4,7,0,11,0,30,2,9,0,11,3,30,4,1,0,5,1,-15,3,1
2,4,3,0,30,0,4,0,4,2,30,4,0,0,4,0,30,2,2,0,4,4,30,2,2,0,4,0,30,1,2,0,3,0,-27,3,0
2,2,5,0,30,1,4,0,5,3,30,1,3,0,4,0,30,1,4,0,5,0,30,1,4,0,5,0,30,0,2,0,2,0,-27,3,0
2,3,5,0,30,1,4,0,5,3,30,1,3,0,4,0,30,1,4,0,5,0,30,1,4,0,5,0,30,0,2,0,2,0,-27,3,0
2,3,8,1,30,7,0,0,7,5,30,2,0,0,2,4,30,2,5,0,7,1,30,7,0,0,7,4,30,3,0,0,3,0,-27,3,0
2,4,8,1,30,7,0,0,7,5,30,2,0,0,2,4,30,2,5,0,7,1,30,7,0,0,7,4,30,3,0,0,3,0,-27,3,0
2,3,11,3,30,4,8,0,12,0,30,4,0,0,4,0,30,8,4,0,12,4,30,4,8,0,12,2,30,3,1,0,4,1,-15,3,1
2,4,11,3,30,4,8,0,12,0,30,4,0,0,4,0,30,8,4,0,12,4,30,4,8,0,12,2,30,3,1,0,4,1,-15,3,1
2,1,13,1,30,5,2,0,7,1,30,4,0,0,4,2,30,5,2,0,7,7,30,5,2,0,7,2,30,4,0,0,4,1,-15,3,1
2,4,13,1,30,5,2,0,7,1,30,4,0,0,4,2,30,5,2,0,7,7,30,5,2,0,7,2,30,4,0,0,4,1,-15,3,1
2,0,21,2,30,6,4,0,10,4,30,5,1,0,6,1,30,3,7,0,10,2,30,5,5,0,10,4,30,4,0,0,4,1,-15,3,1
2,2,21,2,30,6,4,0,10,4,30,5,1,0,6,1,30,3,7,0,10,2,30,5,5,0,10,4,30,4,0,0,4,1,-15,3,1
2,4,23,2,30,8,5,0,13,1,30,6,0,0,6,6,30,11,2,0,13,0,30,3,10,0,13,3,30,6,0,0,6,1,-15,3,1
2,2,25,2,30,5,9,0,14,5,30,6,0,0,6,0,30,6,8,0,14,1,30,7,7,0,14,3,30,5,1,0,6,1,-15,3,1
2,1,27,0,30,4,11,0,15,4,30,1,1,0,2,0,30,6,9,0,15,2,30,6,9,0,15,2,30,6,0,0,6,1,-15,3,1
2,3,27,0,30,4,11,0,15,4,30,1,1,0,2,0,30,6,9,0,15,2,30,6,9,0,15,2,30,6,0,0,6,1,-15,3,1
2,4,27,0,30,4,11,0,15,4,30,1,1,0,2,0,30,6,9,0,15,2,30,6,9,0,15,2,30,6,0,0,6,1,-15,3,1
2,2,29,0,30,6,8,0,14,6,30,12,0,0,12,0,30,4,10,0,14,0,30,0,14,0,14,2,30,9,0,0,9,1,-15,3,1
2,4,29,0,30,6,8,0,14,6,30,12,0,0,12,0,30,4,10,0,14,0,30,0,14,0,14,2,30,9,0,0,9,1,-15,3,1
2,3,39,0,30,3,8,0,11,8,30,6,0,0,6,0,30,4,7,0,11,1,30,8,3,0,11,8,30,5,0,0,5,1,-15,3,1
2,3,1,0,30,7,3,0,10,4,30,2,0,0,2,1,30,3,7,0,10,0,30,6,4,0,10,5,30,6,0,0,6,0,-27,3,0
2,2,6,1,30,8,1,0,9,4,30,2,0,0,2,0,30,2,7,0,9,0,30,4,5,0,9,0,30,5,0,0,5,0,-27,3,0
2,3,6,1,30,8,1,0,9,4,30,2,0,0,2,0,30,2,7,0,9,0,30,4,5,0,9,0,30,5,0,0,5,0,-27,3,0
2,4,6,1,30,8,1,0,9,4,30,2,0,0,2,0,30,2,7,0,9,0,30,4,5,0,9,0,30,5,0,0,5,0,-27,3,0
2,0,17,4,30,9,5,0,14,4,30,6,0,0,6,0,30,4,10,0,14,5,30,6,8,0,14,2,30,4,0,0,4,1,-15,3,1
2,0,29,1,30,6,8,0,14,6,30,11,1,0,12,0,30,7,7,0,14,0,30,0,14,0,14,2,30,9,0,0,9,1,-15,3,1
2,2,29,1,30,6,8,0,14,6,30,11,1,0,12,0,30,7,7,0,14,0,30,0,14,0,14,2,30,9,0,0,9,1,-15,3,1
2,3,29,1,30,6,8,0,14,6,30,11,1,0,12,0,30,7,7,0,14,0,30,0,14,0,14,2,30,9,0,0,9,1,-15,3,1
2,3,7,0,30,2,2,0,4,2,30,2,0,0,2,0,30,1,3,0,4,0,30,0,4,0,4,2,30,1,1,0,2,0,-27,3,0
2,4,7,0,30,2,2,0,4,2,30,2,0,0,2,0,30,1,3,0,4,0,30,0,4,0,4,2,30,1,1,0,2,0,-27,3,0
2,1,11,1,30,7,5,0,12,1,30,4,0,0,4,0,30,6,6,0,12,7,30,5,7,0,12,4,30,4,0,0,4,1,-15,3,1
2,4,11,1,30,7,5,0,12,1,30,4,0,0,4,0,30,6,6,0,12,7,30,5,7,0,12,4,30,4,0,0,4,1,-15,3,1
2,4,17,2,30,8,6,0,14,2,30,6,0,0,6,0,30,7,7,0,14,1,30,5,9,0,14,3,30,4,0,0,4,1,-15,3,1
2,3,19,0,30,2,11,0,13,1,30,8,0,0,8,0,30,7,6,0,13,4,30,5,8,0,13,1,30,5,4,0,9,1,-15,3,1
2,4,23,1,30,6,7,0,13,0,30,6,0,0,6,3,30,13,0,0,13,0,30,3,10,0,13,2,30,5,1,0,6,1,-15,3,1
2,0,27,4,30,5,10,0,15,3,30,1,1,0,2,0,30,6,9,0,15,0,30,8,7,0,15,2,30,2,4,0,6,1,-15,3,1
2,3,29,1,30,6,8,0,14,6,30,12,0,0,12,0,30,6,8,0,14,0,30,0,14,0,14,3,30,9,0,0,9,1,-15,3,1
2,2,5,0,30,2,3,0,5,2,30,2,2,0,4,0,30,2,3,0,5,0,30,1,4,0,5,1,30,0,2,0,2,0,-27,3,0
2,4,5,0,30,2,3,0,5,2,30,2,2,0,4,0,30,2,3,0,5,0,30,1,4,0,5,1,30,0,2,0,2,0,-27,3,0
2,2,13,3,30,7,0,0,7,0,30,4,0,0,4,2,30,5,2,0,7,11,30,6,1,0,7,4,30,4,0,0,4,1,-15,3,1
2,4,13,3,30,7,0,0,7,0,30,4,0,0,4,2,30,5,2,0,7,11,30,6,1,0,7,4,30,4,0,0,4,1,-15,3,1
2,2,21,1,30,6,4,0,10,4,30,6,0,0,6,1,30,3,7,0,10,6,30,5,5,0,10,1,30,4,0,0,4,1,-15,3,1
2,4,23,2,30,4,9,0,13,2,30,6,0,0,6,9,30,13,0,0,13,0,30,5,8,0,13,2,30,5,1,0,6,1,-15,3,1
2,2,25,1,30,7,7,0,14,2,30,6,0,0,6,0,30,12,2,0,14,1,30,5,9,0,14,4,30,5,1,0,6,1,-15,3,1
2,3,25,1,30,7,7,0,14,2,30,6,0,0,6,0,30,12,2,0,14,1,30,5,9,0,14,4,30,5,1,0,6,1,-15,3,1
2,0,27,1,30,4,11,0,15,4,30,2,0,0,2,3,30,3,12,0,15,2,30,4,11,0,15,6,30,6,0,0,6,1,-15,3,1
2,3,27,1,30,4,11,0,15,4,30,2,0,0,2,3,30,3,12,0,15,2,30,4,11,0,15,6,30,6,0,0,6,1,-15,3,1
2,4,27,1,30,4,11,0,15,4,30,2,0,0,2,3,30,3,12,0,15,2,30,4,11,0,15,6,30,6,0,0,6,1,-15,3,1
2,1,4,4,30,8,0,0,8,4,30,3,1,0,4,1,30,1,7,0,8,0,30,3,5,0,8,2,30,4,0,0,4,0,-27,3,0
2,3,4,4,30,8,0,0,8,4,30,3,1,0,4,1,30,1,7,0,8,0,30,3,5,0,8,2,30,4,0,0,4,0,-27,3,0
2,4,4,4,30,8,0,0,8,4,30,3,1,0,4,1,30,1,7,0,8,0,30,3,5,0,8,2,30,4,0,0,4,0,-27,3,0
2,4,8,1,30,7,0,0,7,3,30,2,0,0,2,0,30,6,1,0,7,3,30,7,0,0,7,0,30,3,0,0,3,0,-27,3,0
2,4,11,2,30,3,9,0,12,1,30,4,0,0,4,0,30,6,6,0,12,0,30,5,7,0,12,2,30,4,0,0,4,1,-15,3,1
2,3,17,1,30,9,5,0,14,3,30,6,0,0,6,1,30,5,9,0,14,1,30,5,9,0,14,0,30,3,1,0,4,1,-15,3,1
2,0,27,1,30,5,10,0,15,4,30,2,0,0,2,0,30,5,10,0,15,1,30,5,10,0,15,7,30,6,0,0,6,1,-15,3,1
2,3,37,0,30,7,4,0,11,7,30,8,0,0,8,0,30,3,8,0,11,2,30,3,8,0,11,7,30,6,0,0,6,1,-15,3,1
2,2,5,0,30,2,3,0,5,3,30,2,2,0,4,0,30,1,4,0,5,0,30,1,4,0,5,0,30,0,2,0,2,0,-27,3,0
2,3,5,0,30,2,3,0,5,3,30,2,2,0,4,0,30,1,4,0,5,0,30,1,4,0,5,0,30,0,2,0,2,0,-27,3,0
2,4,17,1,30,6,8,0,14,1,30,6,0,0,6,0,30,10,4,0,14,2,30,5,9,0,14,4,30,4,0,0,4,1,-15,3,1
2,1,19,0,30,2,11,0,13,2,30,8,0,0,8,0,30,9,4,0,13,0,30,5,8,0,13,1,30,8,1,0,9,1,-15,3,1
2,2,19,0,30,2,11,0,13,2,30,8,0,0,8,0,30,9,4,0,13,0,30,5,8,0,13,1,30,8,1,0,9,1,-15,3,1
2,4,19,0,30,2,11,0,13,2,30,8,0,0,8,0,30,9,4,0,13,0,30,5,8,0,13,1,30,8,1,0,9,1,-15,3,1
2,3,23,2,30,7,6,0,13,2,30,6,0,0,6,3,30,12,1,0,13,0,30,5,8,0,13,2,30,6,0,0,6,1,-15,3,1
2,2,25,1,30,7,7,0,14,4,30,6,0,0,6,0,30,6,8,0,14,1,30,6,8,0,14,4,30,5,1,0,6,1,-15,3,1
2,3,25,1,30,7,7,0,14,4,30,6,0,0,6,0,30,6,8,0,14,1,30,6,8,0,14,4,30,5,1,0,6,1,-15,3,1
2,2,27,0,30,5,10,0,15,2,30,2,0,0,2,0,30,5,10,0,15,3,30,6,9,0,15,1,30,4,2,0,6,1,-15,3,1
2,3,27,0,30,5,10,0,15,2,30,2,0,0,2,0,30,5,10,0,15,3,30,6,9,0,15,1,30,4,2,0,6,1,-15,3,1
2,3,29,0,30,8,6,0,14,5,30,11,1,0,12,0,30,3,11,0,14,0,30,1,13,0,14,0,30,7,2,0,9,1,-15,3,1
2,4,29,0,30,8,6,0,14,5,30,11,1,0,12,0,30,3,11,0,14,0,30,1,13,0,14,0,30,7,2,0,9,1,-15,3,1
2,0,33,1,30,2,9,0,11,5,30,4,0,0,4,0,30,6,5,0,11,5,30,4,7,0,11,9,30,4,0,0,4,1,-15,3,1
2,1,33,1,30,2,9,0,11,5,30,4,0,0,4,0,30,6,5,0,11,5,30,4,7,0,11,9,30,4,0,0,4,1,-15,3,1
2,2,33,1,30,2,9,0,11,5,30,4,0,0,4,0,30,6,5,0,11,5,30,4,7,0,11,9,30,4,0,0,4,1,-15,3,1
2,1,35,0,30,8,5,0,13,6,30,2,0,0,2,5,30,2,11,0,13,0,30,5,8,0,13,9,30,8,0,0,8,1,-15,3,1
2,1,37,1,30,6,5,0,11,5,30,6,2,0,8,2,30,8,3,0,11,6,30,3,8,0,11,6,30,6,0,0,6,1,-15,3,1
2,3,37,1,30,6,5,0,11,5,30,6,2,0,8,2,30,8,3,0,11,6,30,3,8,0,11,6,30,6,0,0,6,1,-15,3,1
2,4,37,1,30,6,5,0,11,5,30,6,2,0,8,2,30,8,3,0,11,6,30,3,8,0,11,6,30,6,0,0,6,1,-15,3,1
2,0,41,2,30,9,3,0,12,7,30,8,0,0,8,0,30,4,8,0,12,7,30,4,8,0,12,1,30,1,6,0,7,1,-15,3,1
2,0,45,5,30,10,3,0,13,10,30,10,0,0,10,0,30,0,13,0,13,0,30,4,9,0,13,9,30,5,0,0,5,1,-15,3,1
2,3,45,0,30,10,3,0,13,10,30,10,0,0,10,0,30,0,13,0,13,0,30,4,9,0,13,9,30,5,0,0,5,1,-15,3,1
2,4,1,0,30,7,3,0,10,5,30,2,0,0,2,1,30,3,7,0,10,6,30,8,2,0,10,6,30,6,0,0,6,0,-27,3,0
2,4,3,0,30,0,4,0,4,2,30,4,0,0,4,0,30,0,4,0,4,1,30,2,2,0,4,0,30,1,2,0,3,0,-27,3,0
2,4,7,0,30,4,5,0,9,3,30,4,0,0,4,3,30,6,3,0,9,8,30,3,6,0,9,1,30,5,1,0,6,0,-27,3,0
2,4,8,0,30,7,0,0,7,3,30,2,0,0,2,2,30,6,1,0,7,1,30,7,0,0,7,0,30,3,0,0,3,0,-27,3,0
2,2,15,0,30,4,9,0,13,0,30,6,0,0,6,0,30,3,10,0,13,1,30,3,10,0,13,2,30,6,3,0,9,1,-15,3,1
2,1,17,4,30,9,5,0,14,3,30,6,0,0,6,0,30,4,10,0,14,5,30,5,9,0,14,1,30,3,1,0,4,1,-15,3,1
2,3,17,4,30,9,5,0,14,3,30,6,0,0,6,0,30,4,10,0,14,5,30,5,9,0,14,1,30,3,1,0,4,1,-15,3,1
2,4,17,4,30,9,5,0,14,3,30,6,0,0,6,0,30,4,10,0,14,5,30,5,9,0,14,1,30,3,1,0,4,1,-15,3,1
2,4,25,2,30,5,9,0,14,5,30,6,0,0,6,0,30,3,11,0,14,1,30,6,8,0,14,5,30,6,0,0,6,1,-15,3,1
2,0,26,1,30,6,3,0,9,6,30,4,0,0,4,2,30,0,9,0,9,0,30,4,5,0,9,7,30,3,0,0,3,1,-15,3,1
2,2,26,1,30,6,3,0,9,6,30,4,0,0,4,2,30,0,9,0,9,0,30,4,5,0,9,7,30,3,0,0,3,1,-15,3,1
2,4,29,0,30,6,8,0,14,5,30,9,3,0,12,1,30,5,9,0,14,0,30,1,13,0,14,1,30,9,0,0,9,1,-15,3,1
2,0,37,3,30,8,3,0,11,5,30,4,4,0,8,2,30,11,0,0,11,0,30,3,8,0,11,3,30,6,0,0,6,1,-15,3,1
2,1,37,3,30,8,3,0,11,5,30,4,4,0,8,2,30,11,0,0,11,0,30,3,8,0,11,3,30,6,0,0,6,1,-15,3,1
2,3,37,3,30,8,3,0,11,5,30,4,4,0,8,2,30,11,0,0,11,0,30,3,8,0,11,3,30,6,0,0,6,1,-15,3,1
2,4,37,3,30,8,3,0,11,5,30,4,4,0,8,2,30,11,0,0,11,0,30,3,8,0,11,3,30,6,0,0,6,1,-15,3,1
2,3,45,8,30,5,8,0,13,12,30,10,0,0,10,0,30,4,9,0,13,0,30,4,9,0,13,2,30,5,0,0,5,1,-15,3,1
2,4,45,8,30,5,8,0,13,12,30,10,0,0,10,0,30,4,9,0,13,0,30,4,9,0,13,2,30,5,0,0,5,1,-15,3,1
2,3,47,0,30,0,14,0,14,6,30,4,0,0,4,0,30,7,7,0,14,0,30,2,12,0,14,1,30,5,2,0,7,1,-15,3,1
2,2,5,0,30,2,3,0,5,3,30,3,1,0,4,0,30,0,5,0,5,0,30,1,4,0,5,1,30,2,0,0,2,0,-27,3,0
2,3,11,0,30,1,3,0,4,0,30,0,0,0,0,0,30,3,1,0,4,3,30,3,1,0,4,1,30,1,0,0,1,1,-15,3,1
2,1,13,5,30,7,0,0,7,0,30,4,0,0,4,1,30,6,1,0,7,6,30,4,3,0,7,0,30,4,0,0,4,1,-15,3,1
2,3,13,5,30,7,0,0,7,0,30,4,0,0,4,1,30,6,1,0,7,6,30,4,3,0,7,0,30,4,0,0,4,1,-15,3,1
2,4,13,5,30,7,0,0,7,0,30,4,0,0,4,1,30,6,1,0,7,6,30,4,3,0,7,0,30,4,0,0,4,1,-15,3,1
2,2,17,3,30,8,6,0,14,2,30,6,0,0,6,0,30,7,7,0,14,1,30,4,10,0,14,6,30,4,0,0,4,1,-15,3,1
2,3,17,3,30,8,6,0,14,2,30,6,0,0,6,0,30,7,7,0,14,1,30,4,10,0,14,6,30,4,0,0,4,1,-15,3,1
2,4,17,3,30,8,6,0,14,2,30,6,0,0,6,0,30,7,7,0,14,1,30,4,10,0,14,6,30,4,0,0,4,1,-15,3,1
2,4,25,1,30,8,6,0,14,3,30,6,0,0,6,0,30,9,5,0,14,0,30,5,9,0,14,3,30,5,1,0,6,1,-15,3,1
2,4,27,1,30,3,12,0,15,3,30,1,1,0,2,0,30,5,10,0,15,0,30,6,9,0,15,4,30,6,0,0,6,1,-15,3,1
2,4,29,0,30,6,8,0,14,6,30,10,2,0,12,0,30,3,11,0,14,0,30,0,14,0,14,3,30,9,0,0,9,1,-15,3,1
2,2,37,0,30,8,3,0,11,6,30,8,0,0,8,0,30,4,7,0,11,4,30,3,8,0,11,8,30,6,0,0,6,1,-15,3,1
2,3,37,0,30,8,3,0,11,6,30,8,0,0,8,0,30,4,7,0,11,4,30,3,8,0,11,8,30,6,0,0,6,1,-15,3,1
2,3,6,0,30,7,2,0,9,4,30,2,0,0,2,0,30,2,7,0,9,1,30,3,6,0,9,3,30,5,0,0,5,0,-27,3,0
2,3,8,1,30,7,0,0,7,3,30,2,0,0,2,5,30,5,2,0,7,1,30,7,0,0,7,0,30,3,0,0,3,0,-27,3,0
2,4,8,1,30,7,0,0,7,3,30,2,0,0,2,5,30,5,2,0,7,1,30,7,0,0,7,0,30,3,0,0,3,0,-27,3,0
2,2,9,0,30,3,1,0,4,2,30,2,0,0,2,0,30,1,3,0,4,0,30,1,3,0,4,0,30,0,1,0,1,0,-27,3,0
2,3,9,0,30,3,1,0,4,2,30,2,0,0,2,0,30,1,3,0,4,0,30,1,3,0,4,0,30,0,1,0,1,0,-27,3,0
2,2,11,0,30,1,3,0,4,0,30,0,0,0,0,0,30,1,3,0,4,7,30,3,1,0,4,2,30,1,0,0,1,1,-15,3,1
2,3,13,10,30,7,0,0,7,3,30,4,0,0,4,2,30,6,1,0,7,2,30,6,1,0,7,2,30,4,0,0,4,1,-15,3,1
2,2,19,0,30,3,10,0,13,1,30,6,2,0,8,0,30,10,3,0,13,0,30,3,10,0,13,1,30,9,0,0,9,1,-15,3,1
2,1,25,1,30,5,9,0,14,2,30,6,0,0,6,0,30,11,3,0,14,1,30,5,9,0,14,3,30,5,1,0,6,1,-15,3,1
2,2,25,1,30,5,9,0,14,2,30,6,0,0,6,0,30,11,3,0,14,1,30,5,9,0,14,3,30,5,1,0,6,1,-15,3,1
2,4,25,1,30,5,9,0,14,2,30,6,0,0,6,0,30,11,3,0,14,1,30,5,9,0,14,3,30,5,1,0,6,1,-15,3,1
2,1,27,3,30,4,11,0,15,4,30,2,0,0,2,0,30,9,6,0,15,0,30,8,7,0,15,2,30,5,1,0,6,1,-15,3,1
2,2,27,3,30,4,11,0,15,4,30,2,0,0,2,0,30,9,6,0,15,0,30,8,7,0,15,2,30,5,1,0,6,1,-15,3,1
2,4,29,1,30,6,8,0,14,6,30,11,1,0,12,0,30,5,9,0,14,0,30,1,13,0,14,2,30,9,0,0,9,1,-15,3,1
2,3,35,0,30,11,2,0,13,6,30,2,0,0,2,1,30,2,11,0,13,0,30,1,12,0,13,5,30,8,0,0,8,1,-15,3,1
2,0,37,4,30,8,3,0,11,5,30,7,1,0,8,0,30,11,0,0,11,8,30,3,8,0,11,3,30,5,1,0,6,1,-15,3,1
2,1,37,4,30,8,3,0,11,5,30,7,1,0,8,0,30,11,0,0,11,8,30,3,8,0,11,3,30,5,1,0,6,1,-15,3,1
2,3,39,0,30,2,9,0,11,6,30,6,0,0,6,0,30,4,7,0,11,0,30,2,9,0,11,7,30,5,0,0,5,1,-15,3,1
2,3,2,5,30,10,0,0,10,3,30,3,1,0,4,3,30,6,4,0,10,0,30,5,5,0,10,1,30,2,6,0,8,0,-27,3,0
2,4,2,5,30,10,0,0,10,3,30,3,1,0,4,3,30,6,4,0,10,0,30,5,5,0,10,1,30,2,6,0,8,0,-27,3,0
2,3,8,0,30,7,0,0,7,4,30,2,0,0,2,3,30,4,3,0,7,3,30,6,1,0,7,2,30,3,0,0,3,0,-27,3,0
2,4,8,0,30,7,0,0,7,4,30,2,0,0,2,3,30,4,3,0,7,3,30,6,1,0,7,2,30,3,0,0,3,0,-27,3,0
2,2,13,1,30,6,1,0,7,1,30,4,0,0,4,2,30,6,1,0,7,2,30,6,1,0,7,0,30,4,0,0,4,1,-15,3,1
2,3,13,1,30,6,1,0,7,1,30,4,0,0,4,2,30,6,1,0,7,2,30,6,1,0,7,0,30,4,0,0,4,1,-15,3,1
2,0,17,2,30,10,4,0,14,3,30,6,0,0,6,0,30,4,10,0,14,1,30,6,8,0,14,5,30,4,0,0,4,1,-15,3,1
2,1,17,2,30,10,4,0,14,3,30,6,0,0,6,0,30,4,10,0,14,1,30,6,8,0,14,5,30,4,0,0,4,1,-15,3,1
2,2,17,2,30,10,4,0,14,3,30,6,0,0,6,0,30,4,10,0,14,1,30,6,8,0,14,5,30,4,0,0,4,1,-15,3,1
2,3,17,2,30,10,4,0,14,3,30,6,0,0,6,0,30,4,10,0,14,1,30,6,8,0,14,5,30,4,0,0,4,1,-15,3,1
2,4,17,2,30,10,4,0,14,3,30,6,0,0,6,0,30,4,10,0,14,1,30,6,8,0,14,5,30,4,0,0,4,1,-15,3,1
2,2,19,0,30,3,10,0,13,2,30,6,2,0,8,0,30,4,9,0,13,4,30,7,6,0,13,1,30,9,0,0,9,1,-15,3,1
2,3,19,0,30,3,10,0,13,2,30,6,2,0,8,0,30,4,9,0,13,4,30,7,6,0,13,1,30,9,0,0,9,1,-15,3,1
2,4,19,0,30,3,10,0,13,2,30,6,2,0,8,0,30,4,9,0,13,4,30,7,6,0,13,1,30,9,0,0,9,1,-15,3,1
2,2,25,2,30,4,10,0,14,5,30,6,0,0,6,0,30,7,7,0,14,1,30,5,9,0,14,4,30,5,1,0,6,1,-15,3,1
2,3,25,2,30,4,10,0,14,5,30,6,0,0,6,0,30,7,7,0,14,1,30,5,9,0,14,4,30,5,1,0,6,1,-15,3,1
2,2,27,1,30,4,11,0,15,5,30,2,0,0,2,0,30,2,13,0,15,0,30,4,11,0,15,6,30,6,0,0,6,1,-15,3,1
2,3,29,0,30,4,10,0,14,5,30,10,2,0,12,0,30,9,5,0,14,0,30,2,12,0,14,2,30,9,0,0,9,1,-15,3,1
2,4,31,3,30,4,8,0,12,5,30,8,0,0,8,3,30,7,5,0,12,0,30,7,5,0,12,1,30,5,1,0,6,1,-15,3,1
2,0,39,0,30,2,9,0,11,5,30,4,2,0,6,0,30,4,7,0,11,7,30,2,9,0,11,8,30,5,0,0,5,1,-15,3,1
2,1,39,0,30,2,9,0,11,5,30,4,2,0,6,0,30,4,7,0,11,7,30,2,9,0,11,8,30,5,0,0,5,1,-15,3,1
2,3,5,1,30,3,2,0,5,3,30,3,1,0,4,0,30,0,5,0,5,0,30,1,4,0,5,0,30,1,1,0,2,0,-27,3,0
2,4,9,0,30,2,2,0,4,2,30,2,0,0,2,1,30,4,0,0,4,6,30,1,3,0,4,1,30,1,0,0,1,0,-27,3,0
2,2,17,0,30,8,6,0,14,2,30,6,0,0,6,0,30,6,8,0,14,4,30,8,6,0,14,8,30,4,0,0,4,1,-15,3,1
2,3,17,0,30,8,6,0,14,2,30,6,0,0,6,0,30,6,8,0,14,4,30,8,6,0,14,8,30,4,0,0,4,1,-15,3,1
2,4,21,2,30,8,2,0,10,4,30,6,0,0,6,1,30,3,7,0,10,3,30,4,6,0,10,0,30,4,0,0,4,1,-15,3,1
2,3,25,2,30,9,5,0,14,4,30,6,0,0,6,0,30,9,5,0,14,1,30,6,8,0,14,4,30,5,1,0,6,1,-15,3,1
2,4,25,2,30,9,5,0,14,4,30,6,0,0,6,0,30,9,5,0,14,1,30,6,8,0,14,4,30,5,1,0,6,1,-15,3,1
2,2,27,1,30,3,12,0,15,2,30,2,0,0,2,2,30,8,7,0,15,0,30,3,12,0,15,2,30,2,4,0,6,1,-15,3,1
2,4,35,1,30,11,2,0,13,5,30,1,1,0,2,1,30,2,11,0,13,0,30,3,10,0,13,4,30,8,0,0,8,1,-15,3,1
2,2,5,0,30,2,3,0,5,3,30,2,2,0,4,1,30,1,4,0,5,0,30,1,4,0,5,0,30,1,1,0,2,0,-27,3,0
2,1,7,0,30,3,1,0,4,2,30,2,0,0,2,0,30,1,3,0,4,0,30,0,4,0,4,1,30,1,1,0,2,0,-27,3,0
2,4,7,0,30,3,1,0,4,2,30,2,0,0,2,0,30,1,3,0,4,0,30,0,4,0,4,1,30,1,1,0,2,0,-27,3,0
2,2,11,0,30,9,3,0,12,2,30,4,0,0,4,0,30,5,7,0,12,4,30,7,5,0,12,4,30,4,0,0,4,1,-15,3,1
2,3,11,0,30,9,3,0,12,2,30,4,0,0,4,0,30,5,7,0,12,4,30,7,5,0,12,4,30,4,0,0,4,1,-15,3,1
2,4,11,0,30,9,3,0,12,2,30,4,0,0,4,0,30,5,7,0,12,4,30,7,5,0,12,4,30,4,0,0,4,1,-15,3,1
2,4,13,1,30,6,1,0,7,0,30,4,0,0,4,2,30,6,1,0,7,5,30,4,3,0,7,0,30,4,0,0,4,1,-15,3,1
2,0,17,4,30,7,7,0,14,2,30,6,0,0,6,0,30,6,8,0,14,2,30,5,9,0,14,5,30,4,0,0,4,1,-15,3,1
2,2,17,4,30,7,7,0,14,2,30,6,0,0,6,0,30,6,8,0,14,2,30,5,9,0,14,5,30,4,0,0,4,1,-15,3,1
2,3,17,4,30,7,7,0,14,2,30,6,0,0,6,0,30,6,8,0,14,2,30,5,9,0,14,5,30,4,0,0,4,1,-15,3,1
2,2,19,0,30,3,10,0,13,2,30,6,2,0,8,0,30,8,5,0,13,5,30,5,8,0,13,3,30,9,0,0,9,1,-15,3,1
2,3,19,0,30,3,10,0,13,2,30,6,2,0,8,0,30,8,5,0,13,5,30,5,8,0,13,3,30,9,0,0,9,1,-15,3,1
2,4,23,1,30,7,6,0,13,2,30,6,0,0,6,3,30,12,1,0,13,0,30,4,9,0,13,2,30,6,0,0,6,1,-15,3,1
2,0,27,1,30,6,9,0,15,5,30,2,0,0,2,1,30,6,9,0,15,2,30,6,9,0,15,1,30,6,0,0,6,1,-15,3,1
2,3,27,1,30,6,9,0,15,5,30,2,0,0,2,1,30,6,9,0,15,2,30,6,9,0,15,1,30,6,0,0,6,1,-15,3,1
2,4,29,0,30,7,7,0,14,6,30,12,0,0,12,0,30,5,9,0,14,0,30,2,12,0,14,0,30,9,0,0,9,1,-15,3,1
2,3,47,0,30,0,14,0,14,5,30,4,0,0,4,0,30,3,11,0,14,0,30,2,12,0,14,5,30,7,0,0,7,1,-15,3,1
2,1,11,0,30,4,8,0,12,2,30,4,0,0,4,0,30,4,8,0,12,11,30,4,8,0,12,6,30,4,0,0,4,1,-15,3,1
2,2,11,0,30,4,8,0,12,2,30,4,0,0,4,0,30,4,8,0,12,11,30,4,8,0,12,6,30,4,0,0,4,1,-15,3,1
2,4,11,0,30,4,8,0,12,2,30,4,0,0,4,0,30,4,8,0,12,11,30,4,8,0,12,6,30,4,0,0,4,1,-15,3,1
2,4,13,1,30,3,0,0,3,0,30,2,0,0,2,0,30,3,0,0,3,8,30,3,0,0,3,3,30,2,0,0,2,1,-15,3,1
2,3,17,0,30,8,6,0,14,3,30,6,0,0,6,0,30,3,11,0,14,3,30,6,8,0,14,4,30,4,0,0,4,1,-15,3,1
2,4,17,0,30,8,6,0,14,3,30,6,0,0,6,0,30,3,11,0,14,3,30,6,8,0,14,4,30,4,0,0,4,1,-15,3,1
2,1,21,6,30,8,2,0,10,4,30,6,0,0,6,1,30,3,7,0,10,3,30,5,5,0,10,1,30,3,1,0,4,1,-15,3,1
2,4,25,3,30,9,5,0,14,0,30,6,0,0,6,0,30,10,4,0,14,1,30,6,8,0,14,3,30,5,1,0,6,1,-15,3,1
2,4,3,0,30,0,4,0,4,2,30,4,0,0,4,0,30,1,3,0,4,1,30,2,2,0,4,0,30,1,2,0,3,0,-27,3,0
2,3,6,2,30,9,0,0,9,4,30,2,0,0,2,0,30,2,7,0,9,0,30,3,6,0,9,0,30,3,2,0,5,0,-27,3,0
2,4,6,2,30,9,0,0,9,4,30,2,0,0,2,0,30,2,7,0,9,0,30,3,6,0,9,0,30,3,2,0,5,0,-27,3,0
2,3,8,1,30,7,0,0,7,4,30,2,0,0,2,6,30,3,4,0,7,0,30,4,3,0,7,3,30,3,0,0,3,0,-27,3,0
2,4,8,1,30,7,0,0,7,4,30,2,0,0,2,6,30,3,4,0,7,0,30,4,3,0,7,3,30,3,0,0,3,0,-27,3,0
2,1,11,0,30,5,7,0,12,1,30,4,0,0,4,0,30,4,8,0,12,5,30,6,6,0,12,5,30,4,0,0,4,1,-15,3,1
2,2,19,1,30,3,10,0,13,2,30,6,2,0,8,0,30,7,6,0,13,2,30,5,8,0,13,3,30,9,0,0,9,1,-15,3,1
2,4,19,1,30,3,10,0,13,2,30,6,2,0,8,0,30,7,6,0,13,2,30,5,8,0,13,3,30,9,0,0,9,1,-15,3,1
2,4,23,1,30,7,6,0,13,3,30,6,0,0,6,5,30,13,0,0,13,0,30,6,7,0,13,3,30,5,1,0,6,1,-15,3,1
2,3,25,3,30,6,8,0,14,4,30,6,0,0,6,0,30,7,7,0,14,1,30,6,8,0,14,4,30,5,1,0,6,1,-15,3,1
2,1,27,1,30,5,10,0,15,5,30,2,0,0,2,0,30,4,11,0,15,4,30,4,11,0,15,3,30,6,0,0,6,1,-15,3,1
2,3,27,1,30,5,10,0,15,5,30,2,0,0,2,0,30,4,11,0,15,4,30,4,11,0,15,3,30,6,0,0,6,1,-15,3,1
2,4,27,1,30,5,10,0,15,5,30,2,0,0,2,0,30,4,11,0,15,4,30,4,11,0,15,3,30,6,0,0,6,1,-15,3,1
2,3,29,0,30,8,6,0,14,6,30,12,0,0,12,0,30,4,10,0,14,0,30,1,13,0,14,0,30,8,1,0,9,1,-15,3,1
2,4,29,0,30,8,6,0,14,6,30,12,0,0,12,0,30,4,10,0,14,0,30,1,13,0,14,0,30,8,1,0,9,1,-15,3,1
2,4,8,5,30,7,0,0,7,4,30,2,0,0,2,4,30,3,4,0,7,1,30,7,0,0,7,2,30,3,0,0,3,0,-27,3,0
2,2,17,3,30,9,5,0,14,2,30,6,0,0,6,0,30,8,6,0,14,3,30,5,9,0,14,6,30,4,0,0,4,1,-15,3,1
2,2,19,0,30,6,7,0,13,1,30,5,3,0,8,0,30,4,9,0,13,3,30,4,9,0,13,1,30,8,1,0,9,1,-15,3,1
2,4,27,1,30,4,11,0,15,4,30,1,1,0,2,0,30,10,5,0,15,0,30,6,9,0,15,0,30,4,2,0,6,1,-15,3,1
2,1,13,2,30,7,0,0,7,0,30,4,0,0,4,1,30,5,2,0,7,7,30,6,1,0,7,6,30,4,0,0,4,1,-15,3,1
2,2,13,2,30,7,0,0,7,0,30,4,0,0,4,1,30,5,2,0,7,7,30,6,1,0,7,6,30,4,0,0,4,1,-15,3,1
2,4,13,2,30,7,0,0,7,0,30,4,0,0,4,1,30,5,2,0,7,7,30,6,1,0,7,6,30,4,0,0,4,1,-15,3,1
2,4,19,0,30,4,9,0,13,2,30,8,0,0,8,0,30,7,6,0,13,7,30,5,8,0,13,0,30,8,1,0,9,1,-15,3,1
2,3,23,1,30,5,8,0,13,2,30,6,0,0,6,0,30,12,1,0,13,2,30,9,4,0,13,3,30,6,0,0,6,1,-15,3,1
2,3,25,1,30,6,8,0,14,4,30,6,0,0,6,0,30,5,9,0,14,2,30,10,4,0,14,2,30,5,1,0,6,1,-15,3,1
2,4,25,1,30,6,8,0,14,4,30,6,0,0,6,0,30,5,9,0,14,2,30,10,4,0,14,2,30,5,1,0,6,1,-15,3,1
2,0,27,3,30,7,8,0,15,4,30,2,0,0,2,0,30,4,11,0,15,0,30,4,11,0,15,1,30,5,1,0,6,1,-15,3,1
2,3,29,0,30,7,7,0,14,6,30,12,0,0,12,0,30,5,9,0,14,0,30,1,13,0,14,2,30,9,0,0,9,1,-15,3,1
2,4,29,0,30,7,7,0,14,6,30,12,0,0,12,0,30,5,9,0,14,0,30,1,13,0,14,2,30,9,0,0,9,1,-15,3,1
2,4,31,2,30,6,6,0,12,4,30,8,0,0,8,3,30,10,2,0,12,0,30,3,9,0,12,1,30,4,2,0,6,1,-15,3,1
2,3,33,0,30,2,9,0,11,5,30,4,0,0,4,2,30,9,2,0,11,3,30,4,7,0,11,5,30,4,0,0,4,1,-15,3,1
2,3,36,0,30,4,5,0,9,5,30,1,1,0,2,7,30,4,5,0,9,0,30,3,6,0,9,7,30,3,0,0,3,1,-15,3,1
2,1,4,4,30,8,0,0,8,3,30,4,0,0,4,0,30,5,3,0,8,0,30,3,5,0,8,1,30,4,0,0,4,0,-27,3,0
2,4,8,1,30,7,0,0,7,3,30,2,0,0,2,1,30,4,3,0,7,0,30,5,2,0,7,5,30,3,0,0,3,0,-27,3,0
2,4,13,2,30,6,1,0,7,0,30,4,0,0,4,2,30,5,2,0,7,12,30,6,1,0,7,0,30,4,0,0,4,1,-15,3,1
2,0,17,4,30,10,4,0,14,3,30,6,0,0,6,0,30,6,8,0,14,5,30,6,8,0,14,7,30,4,0,0,4,1,-15,3,1
2,1,17,4,30,10,4,0,14,3,30,6,0,0,6,0,30,6,8,0,14,5,30,6,8,0,14,7,30,4,0,0,4,1,-15,3,1
2,2,19,0,30,2,11,0,13,2,30,7,1,0,8,0,30,8,5,0,13,4,30,3,10,0,13,2,30,9,0,0,9,1,-15,3,1
2,3,19,0,30,2,11,0,13,2,30,7,1,0,8,0,30,8,5,0,13,4,30,3,10,0,13,2,30,9,0,0,9,1,-15,3,1
2,4,19,0,30,2,11,0,13,2,30,7,1,0,8,0,30,8,5,0,13,4,30,3,10,0,13,2,30,9,0,0,9,1,-15,3,1
2,0,27,0,30,6,9,0,15,2,30,1,1,0,2,0,30,7,8,0,15,2,30,6,9,0,15,2,30,6,0,0,6,1,-15,3,1
2,4,27,0,30,6,9,0,15,2,30,1,1,0,2,0,30,7,8,0,15,2,30,6,9,0,15,2,30,6,0,0,6,1,-15,3,1
2,0,29,0,30,7,7,0,14,5,30,11,1,0,12,0,30,3,11,0,14,0,30,0,14,0,14,0,30,8,1,0,9,1,-15,3,1
2,2,35,0,30,7,6,0,13,7,30,2,0,0,2,4,30,6,7,0,13,0,30,12,1,0,13,0,30,8,0,0,8,1,-15,3,1
2,3,35,0,30,7,6,0,13,7,30,2,0,0,2,4,30,6,7,0,13,0,30,12,1,0,13,0,30,8,0,0,8,1,-15,3,1
2,2,43,2,30,10,4,0,14,7,30,6,0,0,6,0,30,4,10,0,14,1,30,1,13,0,14,5,30,5,0,0,5,1,-15,3,1
2,4,7,0,30,3,6,0,9,3,30,3,1,0,4,0,30,5,4,0,9,7,30,3,6,0,9,3,30,5,1,0,6,0,-27,3,0
2,2,17,3,30,9,5,0,14,3,30,6,0,0,6,0,30,5,9,0,14,2,30,4,10,0,14,3,30,4,0,0,4,1,-15,3,1
2,3,19,0,30,2,11,0,13,0,30,6,2,0,8,0,30,7,6,0,13,3,30,4,9,0,13,0,30,7,2,0,9,1,-15,3,1
2,4,19,0,30,2,11,0,13,0,30,6,2,0,8,0,30,7,6,0,13,3,30,4,9,0,13,0,30,7,2,0,9,1,-15,3,1
2,4,22,1,30,5,3,0,8,1,30,2,0,0,2,0,30,4,4,0,8,1,30,0,8,0,8,4,30,2,2,0,4,1,-15,3,1
2,4,23,1,30,5,8,0,13,3,30,6,0,0,6,7,30,11,2,0,13,0,30,4,9,0,13,4,30,6,0,0,6,1,-15,3,1
2,4,25,1,30,6,8,0,14,1,30,5,1,0,6,0,30,10,4,0,14,2,30,7,7,0,14,3,30,5,1,0,6,1,-15,3,1
2,0,27,0,30,5,10,0,15,5,30,2,0,0,2,0,30,5,10,0,15,2,30,5,10,0,15,2,30,5,1,0,6,1,-15,3,1
2,1,27,0,30,5,10,0,15,5,30,2,0,0,2,0,30,5,10,0,15,2,30,5,10,0,15,2,30,5,1,0,6,1,-15,3,1
2,3,27,0,30,5,10,0,15,5,30,2,0,0,2,0,30,5,10,0,15,2,30,5,10,0,15,2,30,5,1,0,6,1,-15,3,1
2,4,27,0,30,5,10,0,15,5,30,2,0,0,2,0,30,5,10,0,15,2,30,5,10,0,15,2,30,5,1,0,6,1,-15,3,1
2,0,29,0,30,6,8,0,14,6,30,10,2,0,12,0,30,3,11,0,14,0,30,1,13,0,14,5,30,9,0,0,9,1,-15,3,1
2,3,31,0,30,5,7,0,12,5,30,8,0,0,8,3,30,8,4,0,12,0,30,8,4,0,12,1,30,5,1,0,6,1,-15,3,1
2,2,33,2,30,5,6,0,11,5,30,4,0,0,4,3,30,9,2,0,11,1,30,4,7,0,11,7,30,4,0,0,4,1,-15,3,1
2,3,33,2,30,5,6,0,11,5,30,4,0,0,4,3,30,9,2,0,11,1,30,4,7,0,11,7,30,4,0,0,4,1,-15,3,1
2,3,3,7,30,7,4,0,11,4,30,8,0,0,8,0,30,2,9,0,11,2,30,3,8,0,11,3,30,2,5,0,7,0,-27,3,0
2,3,8,0,30,7,0,0,7,4,30,2,0,0,2,3,30,2,5,0,7,0,30,4,3,0,7,2,30,3,0,0,3,0,-27,3,0
2,4,8,0,30,7,0,0,7,4,30,2,0,0,2,3,30,2,5,0,7,0,30,4,3,0,7,2,30,3,0,0,3,0,-27,3,0
2,4,9,1,30,4,7,0,11,2,30,6,0,0,6,1,30,11,0,0,11,5,30,3,8,0,11,3,30,4,0,0,4,0,-27,3,0
2,1,13,3,30,7,0,0,7,0,30,4,0,0,4,2,30,5,2,0,7,2,30,6,1,0,7,4,30,4,0,0,4,1,-15,3,1
2,2,13,3,30,7,0,0,7,0,30,4,0,0,4,2,30,5,2,0,7,2,30,6,1,0,7,4,30,4,0,0,4,1,-15,3,1
2,3,13,3,30,7,0,0,7,0,30,4,0,0,4,2,30,5,2,0,7,2,30,6,1,0,7,4,30,4,0,0,4,1,-15,3,1
2,4,19,0,30,3,10,0,13,2,30,5,3,0,8,0,30,6,7,0,13,7,30,7,6,0,13,3,30,9,0,0,9,1,-15,3,1
2,2,25,3,30,9,5,0,14,5,30,6,0,0,6,0,30,7,7,0,14,1,30,5,9,0,14,4,30,5,1,0,6,1,-15,3,1
2,3,25,3,30,9,5,0,14,5,30,6,0,0,6,0,30,7,7,0,14,1,30,5,9,0,14,4,30,5,1,0,6,1,-15,3,1
2,0,26,0,30,7,2,0,9,6,30,4,0,0,4,2,30,0,9,0,9,0,30,2,7,0,9,7,30,3,0,0,3,1,-15,3,1
2,1,26,0,30,7,2,0,9,6,30,4,0,0,4,2,30,0,9,0,9,0,30,2,7,0,9,7,30,3,0,0,3,1,-15,3,1
2,0,27,1,30,4,11,0,15,4,30,2,0,0,2,0,30,6,9,0,15,1,30,5,10,0,15,3,30,6,0,0,6,1,-15,3,1
2,0,29,0,30,7,7,0,14,5,30,11,1,0,12,0,30,5,9,0,14,0,30,1,13,0,14,3,30,9,0,0,9,1,-15,3,1
2,2,31,1,30,8,4,0,12,4,30,8,0,0,8,3,30,10,2,0,12,0,30,3,9,0,12,1,30,3,3,0,6,1,-15,3,1
2,3,39,0,30,4,7,0,11,6,30,6,0,0,6,0,30,5,6,0,11,0,30,2,9,0,11,2,30,5,0,0,5,1,-15,3,1
2,2,8,2,30,7,0,0,7,3,30,2,0,0,2,0,30,5,2,0,7,0,30,5,2,0,7,3,30,3,0,0,3,0,-27,3,0
2,3,8,2,30,7,0,0,7,3,30,2,0,0,2,0,30,5,2,0,7,0,30,5,2,0,7,3,30,3,0,0,3,0,-27,3,0
2,4,8,2,30,7,0,0,7,3,30,2,0,0,2,0,30,5,2,0,7,0,30,5,2,0,7,3,30,3,0,0,3,0,-27,3,0
2,1,13,2,30,7,0,0,7,0,30,4,0,0,4,3,30,6,1,0,7,7,30,6,1,0,7,7,30,4,0,0,4,1,-15,3,1
2,0,17,4,30,9,5,0,14,3,30,6,0,0,6,0,30,6,8,0,14,2,30,10,4,0,14,6,30,4,0,0,4,1,-15,3,1
2,1,17,4,30,9,5,0,14,3,30,6,0,0,6,0,30,6,8,0,14,2,30,10,4,0,14,6,30,4,0,0,4,1,-15,3,1
2,2,17,4,30,9,5,0,14,3,30,6,0,0,6,0,30,6,8,0,14,2,30,10,4,0,14,6,30,4,0,0,4,1,-15,3,1
2,4,17,4,30,9,5,0,14,3,30,6,0,0,6,0,30,6,8,0,14,2,30,10,4,0,14,6,30,4,0,0,4,1,-15,3,1
2,4,22,2,30,8,0,0,8,3,30,2,0,0,2,0,30,5,3,0,8,1,30,3,5,0,8,1,30,3,1,0,4,1,-15,3,1
2,3,25,4,30,11,3,0,14,5,30,6,0,0,6,0,30,3,11,0,14,1,30,4,10,0,14,3,30,5,1,0,6,1,-15,3,1
2,4,25,4,30,11,3,0,14,5,30,6,0,0,6,0,30,3,11,0,14,1,30,4,10,0,14,3,30,5,1,0,6,1,-15,3,1
2,1,26,0,30,7,2,0,9,5,30,4,0,0,4,2,30,2,7,0,9,0,30,3,6,0,9,5,30,3,0,0,3,1,-15,3,1
2,4,26,0,30,7,2,0,9,5,30,4,0,0,4,2,30,2,7,0,9,0,30,3,6,0,9,5,30,3,0,0,3,1,-15,3,1
2,0,27,5,30,5,10,0,15,4,30,1,1,0,2,0,30,6,9,0,15,0,30,4,11,0,15,1,30,3,3,0,6,1,-15,3,1
2,3,27,5,30,5,10,0,15,4,30,1,1,0,2,0,30,6,9,0,15,0,30,4,11,0,15,1,30,3,3,0,6,1,-15,3,1
2,4,31,3,30,5,7,0,12,5,30,8,0,0,8,3,30,10,2,0,12,0,30,3,9,0,12,3,30,2,4,0,6,1,-15,3,1
2,4,43,0,30,11,3,0,14,8,30,6,0,0,6,0,30,4,10,0,14,0,30,1,13,0,14,6,30,5,0,0,5,1,-15,3,1
2,4,13,4,30,5,2,0,7,0,30,4,0,0,4,2,30,6,1,0,7,4,30,6,1,0,7,5,30,4,0,0,4,1,-15,3,1
2,3,23,2,30,8,5,0,13,2,30,6,0,0,6,1,30,13,0,0,13,0,30,4,9,0,13,2,30,6,0,0,6,1,-15,3,1
2,1,27,1,30,4,11,0,15,4,30,2,0,0,2,0,30,7,8,0,15,0,30,4,11,0,15,0,30,6,0,0,6,1,-15,3,1
2,2,27,1,30,4,11,0,15,4,30,2,0,0,2,0,30,7,8,0,15,0,30,4,11,0,15,0,30,6,0,0,6,1,-15,3,1
2,3,27,1,30,4,11,0,15,4,30,2,0,0,2,0,30,7,8,0,15,0,30,4,11,0,15,0,30,6,0,0,6,1,-15,3,1
2,4,27,1,30,4,11,0,15,4,30,2,0,0,2,0,30,7,8,0,15,0,30,4,11,0,15,0,30,6,0,0,6,1,-15,3,1
2,3,29,0,30,8,6,0,14,6,30,11,1,0,12,0,30,3,11,0,14,0,30,1,13,0,14,6,30,9,0,0,9,1,-15,3,1
2,4,29,0,30,8,6,0,14,6,30,11,1,0,12,0,30,3,11,0,14,0,30,1,13,0,14,6,30,9,0,0,9,1,-15,3,1
2,3,31,1,30,7,5,0,12,5,30,8,0,0,8,3,30,8,4,0,12,0,30,7,5,0,12,0,30,6,0,0,6,1,-15,3,1
2,4,39,0,30,6,5,0,11,7,30,6,0,0,6,0,30,4,7,0,11,0,30,4,7,0,11,5,30,5,0,0,5,1,-15,3,1
2,0,47,0,30,1,13,0,14,6,30,4,0,0,4,0,30,14,0,0,14,0,30,2,12,0,14,4,30,5,2,0,7,1,-15,3,1
2,1,47,0,30,1,13,0,14,6,30,4,0,0,4,0,30,14,0,0,14,0,30,2,12,0,14,4,30,5,2,0,7,1,-15,3,1
2,2,47,0,30,1,13,0,14,6,30,4,0,0,4,0,30,14,0,0,14,0,30,2,12,0,14,4,30,5,2,0,7,1,-15,3,1
2,4,47,0,30,1,13,0,14,6,30,4,0,0,4,0,30,14,0,0,14,0,30,2,12,0,14,4,30,5,2,0,7,1,-15,3,1
2,0,4,0,30,5,3,0,8,4,30,4,0,0,4,0,30,1,7,0,8,0,30,6,2,0,8,3,30,4,0,0,4,0,-27,3,0
2,1,4,0,30,5,3,0,8,4,30,4,0,0,4,0,30,1,7,0,8,0,30,6,2,0,8,3,30,4,0,0,4,0,-27,3,0
2,2,17,2,30,14,0,0,14,2,30,6,0,0,6,0,30,7,7,0,14,2,30,6,8,0,14,5,30,4,0,0,4,1,-15,3,1
2,2,19,5,30,3,10,0,13,2,30,8,0,0,8,0,30,6,7,0,13,0,30,2,11,0,13,0,30,8,1,0,9,1,-15,3,1
2,3,25,3,30,6,8,0,14,3,30,6,0,0,6,0,30,6,8,0,14,1,30,5,9,0,14,1,30,5,1,0,6,1,-15,3,1
2,0,27,1,30,4,11,0,15,5,30,2,0,0,2,0,30,7,8,0,15,2,30,7,8,0,15,2,30,6,0,0,6,1,-15,3,1
2,1,27,1,30,4,11,0,15,5,30,2,0,0,2,0,30,7,8,0,15,2,30,7,8,0,15,2,30,6,0,0,6,1,-15,3,1
2,2,27,1,30,4,11,0,15,5,30,2,0,0,2,0,30,7,8,0,15,2,30,7,8,0,15,2,30,6,0,0,6,1,-15,3,1
2,0,29,0,30,6,8,0,14,6,30,11,1,0,12,0,30,4,10,0,14,0,30,1,13,0,14,4,30,9,0,0,9,1,-15,3,1
2,3,29,0,30,6,8,0,14,6,30,11,1,0,12,0,30,4,10,0,14,0,30,1,13,0,14,4,30,9,0,0,9,1,-15,3,1
2,4,31,3,30,4,8,0,12,5,30,8,0,0,8,3,30,10,2,0,12,0,30,5,7,0,12,1,30,6,0,0,6,1,-15,3,1
2,2,35,0,30,5,8,0,13,5,30,2,0,0,2,1,30,2,11,0,13,0,30,1,12,0,13,5,30,8,0,0,8,1,-15,3,1
2,2,37,0,30,9,2,0,11,6,30,8,0,0,8,1,30,8,3,0,11,0,30,3,8,0,11,4,30,6,0,0,6,1,-15,3,1
2,4,6,0,30,5,4,0,9,4,30,2,0,0,2,0,30,2,7,0,9,0,30,4,5,0,9,4,30,5,0,0,5,0,-27,3,0
2,3,13,1,30,4,3,0,7,0,30,4,0,0,4,2,30,7,0,0,7,5,30,7,0,0,7,4,30,4,0,0,4,1,-15,3,1
2,2,17,3,30,8,6,0,14,3,30,6,0,0,6,0,30,5,9,0,14,5,30,6,8,0,14,5,30,4,0,0,4,1,-15,3,1
2,3,17,3,30,8,6,0,14,3,30,6,0,0,6,0,30,5,9,0,14,5,30,6,8,0,14,5,30,4,0,0,4,1,-15,3,1
2,2,19,1,30,3,10,0,13,0,30,7,1,0,8,0,30,4,9,0,13,5,30,3,10,0,13,0,30,9,0,0,9,1,-15,3,1
2,2,25,0,30,2,12,0,14,5,30,6,0,0,6,4,30,8,6,0,14,0,30,6,8,0,14,5,30,6,0,0,6,1,-15,3,1
2,3,27,1,30,4,11,0,15,3,30,2,0,0,2,0,30,4,11,0,15,0,30,5,10,0,15,2,30,6,0,0,6,1,-15,3,1
2,4,29,0,30,4,10,0,14,6,30,12,0,0,12,0,30,2,12,0,14,0,30,1,13,0,14,4,30,9,0,0,9,1,-15,3,1
2,3,35,0,30,8,5,0,13,6,30,2,0,0,2,3,30,4,9,0,13,0,30,8,5,0,13,1,30,7,1,0,8,1,-15,3,1
2,0,4,2,30,7,1,0,8,5,30,4,0,0,4,1,30,2,6,0,8,1,30,7,1,0,8,1,30,3,1,0,4,0,-27,3,0
2,1,4,2,30,7,1,0,8,5,30,4,0,0,4,1,30,2,6,0,8,1,30,7,1,0,8,1,30,3,1,0,4,0,-27,3,0
2,4,4,2,30,7,1,0,8,5,30,4,0,0,4,1,30,2,6,0,8,1,30,7,1,0,8,1,30,3,1,0,4,0,-27,3,0
2,2,13,2,30,7,0,0,7,0,30,4,0,0,4,2,30,7,0,0,7,11,30,5,2,0,7,2,30,4,0,0,4,1,-15,3,1
2,4,13,2,30,7,0,0,7,0,30,4,0,0,4,2,30,7,0,0,7,11,30,5,2,0,7,2,30,4,0,0,4,1,-15,3,1
2,4,15,0,30,3,10,0,13,1,30,5,1,0,6,1,30,4,9,0,13,1,30,3,10,0,13,2,30,6,3,0,9,1,-15,3,1
2,2,17,2,30,10,4,0,14,2,30,6,0,0,6,0,30,5,9,0,14,1,30,5,9,0,14,4,30,4,0,0,4,1,-15,3,1
2,3,17,2,30,10,4,0,14,2,30,6,0,0,6,0,30,5,9,0,14,1,30,5,9,0,14,4,30,4,0,0,4,1,-15,3,1
2,1,19,0,30,4,9,0,13,1,30,7,1,0,8,0,30,6,7,0,13,1,30,4,9,0,13,2,30,6,3,0,9,1,-15,3,1
2,3,19,0,30,4,9,0,13,1,30,7,1,0,8,0,30,6,7,0,13,1,30,4,9,0,13,2,30,6,3,0,9,1,-15,3,1
2,4,19,0,30,4,9,0,13,1,30,7,1,0,8,0,30,6,7,0,13,1,30,4,9,0,13,2,30,6,3,0,9,1,-15,3,1
2,4,22,2,30,8,0,0,8,3,30,2,0,0,2,0,30,4,4,0,8,1,30,2,6,0,8,4,30,4,0,0,4,1,-15,3,1
2,4,23,1,30,5,8,0,13,0,30,6,0,0,6,3,30,12,1,0,13,0,30,5,8,0,13,2,30,6,0,0,6,1,-15,3,1
2,2,25,1,30,6,8,0,14,5,30,6,0,0,6,0,30,7,7,0,14,1,30,4,10,0,14,4,30,5,1,0,6,1,-15,3,1
2,0,27,1,30,6,9,0,15,3,30,2,0,0,2,0,30,5,10,0,15,0,30,6,9,0,15,2,30,6,0,0,6,1,-15,3,1
2,4,31,2,30,8,4,0,12,5,30,8,0,0,8,3,30,8,4,0,12,0,30,3,9,0,12,2,30,3,3,0,6,1,-15,3,1
2,3,39,0,30,3,8,0,11,7,30,6,0,0,6,0,30,4,7,0,11,3,30,5,6,0,11,3,30,5,0,0,5,1,-15,3,1
2,4,39,0,30,3,8,0,11,7,30,6,0,0,6,0,30,4,7,0,11,3,30,5,6,0,11,3,30,5,0,0,5,1,-15,3,1
2,2,45,0,30,5,8,0,13,8,30,10,0,0,10,0,30,5,8,0,13,0,30,4,9,0,13,6,30,5,0,0,5,1,-15,3,1
2,4,45,0,30,5,8,0,13,8,30,10,0,0,10,0,30,5,8,0,13,0,30,4,9,0,13,6,30,5,0,0,5,1,-15,3,1
2,4,4,2,30,3,5,0,8,4,30,4,0,0,4,0,30,4,4,0,8,3,30,8,0,0,8,1,30,4,0,0,4,0,-27,3,0
2,2,13,1,30,6,1,0,7,0,30,4,0,0,4,2,30,5,2,0,7,7,30,7,0,0,7,3,30,4,0,0,4,1,-15,3,1
2,3,17,3,30,9,5,0,14,0,30,6,0,0,6,0,30,6,8,0,14,1,30,5,9,0,14,5,30,4,0,0,4,1,-15,3,1
2,0,19,0,30,4,9,0,13,2,30,8,0,0,8,0,30,4,9,0,13,7,30,4,9,0,13,0,30,8,1,0,9,1,-15,3,1
2,1,25,2,30,6,8,0,14,1,30,6,0,0,6,0,30,13,1,0,14,1,30,5,9,0,14,3,30,6,0,0,6,1,-15,3,1
2,4,27,0,30,5,10,0,15,2,30,1,1,0,2,0,30,6,9,0,15,0,30,3,12,0,15,1,30,5,1,0,6,1,-15,3,1
2,3,29,0,30,4,10,0,14,6,30,12,0,0,12,0,30,6,8,0,14,0,30,0,14,0,14,5,30,9,0,0,9,1,-15,3,1
2,3,33,4,30,5,6,0,11,5,30,4,0,0,4,3,30,11,0,0,11,0,30,3,8,0,11,6,30,4,0,0,4,1,-15,3,1
2,4,33,4,30,5,6,0,11,5,30,4,0,0,4,3,30,11,0,0,11,0,30,3,8,0,11,6,30,4,0,0,4,1,-15,3,1
2,3,35,1,30,9,4,0,13,4,30,2,0,0,2,1,30,4,9,0,13,3,30,2,11,0,13,3,30,8,0,0,8,1,-15,3,1
2,2,39,0,30,3,8,0,11,6,30,6,0,0,6,3,30,9,2,0,11,0,30,4,7,0,11,3,30,5,0,0,5,1,-15,3,1
2,3,39,0,30,3,8,0,11,6,30,6,0,0,6,3,30,9,2,0,11,0,30,4,7,0,11,3,30,5,0,0,5,1,-15,3,1
2,3,7,0,30,3,1,0,4,2,30,2,0,0,2,0,30,1,3,0,4,3,30,2,2,0,4,0,30,2,0,0,2,0,-27,3,0
2,4,9,0,30,2,2,0,4,2,30,2,0,0,2,0,30,0,4,0,4,2,30,3,1,0,4,0,30,0,1,0,1,0,-27,3,0
2,1,13,3,30,7,0,0,7,1,30,4,0,0,4,4,30,7,0,0,7,3,30,6,1,0,7,2,30,4,0,0,4,1,-15,3,1
2,3,13,3,30,7,0,0,7,1,30,4,0,0,4,4,30,7,0,0,7,3,30,6,1,0,7,2,30,4,0,0,4,1,-15,3,1
2,4,13,3,30,7,0,0,7,1,30,4,0,0,4,4,30,7,0,0,7,3,30,6,1,0,7,2,30,4,0,0,4,1,-15,3,1
2,4,15,2,30,4,9,0,13,1,30,6,0,0,6,0,30,4,9,0,13,1,30,3,10,0,13,3,30,8,1,0,9,1,-15,3,1
2,1,19,0,30,4,9,0,13,2,30,5,3,0,8,0,30,7,6,0,13,0,30,4,9,0,13,2,30,8,1,0,9,1,-15,3,1
2,4,23,0,30,4,9,0,13,2,30,6,0,0,6,4,30,11,2,0,13,0,30,5,8,0,13,2,30,5,1,0,6,1,-15,3,1
2,2,26,0,30,6,3,0,9,4,30,0,4,0,4,1,30,0,9,0,9,2,30,2,7,0,9,4,30,2,1,0,3,1,-15,3,1
2,3,26,0,30,6,3,0,9,4,30,0,4,0,4,1,30,0,9,0,9,2,30,2,7,0,9,4,30,2,1,0,3,1,-15,3,1
2,4,26,0,30,6,3,0,9,4,30,0,4,0,4,1,30,0,9,0,9,2,30,2,7,0,9,4,30,2,1,0,3,1,-15,3,1
2,4,27,1,30,5,10,0,15,2,30,2,0,0,2,0,30,8,7,0,15,0,30,7,8,0,15,0,30,6,0,0,6,1,-15,3,1
2,2,5,1,30,2,3,0,5,3,30,3,1,0,4,0,30,0,5,0,5,0,30,1,4,0,5,0,30,0,2,0,2,0,-27,3,0
2,4,13,2,30,7,0,0,7,0,30,4,0,0,4,3,30,5,2,0,7,9,30,5,2,0,7,3,30,4,0,0,4,1,-15,3,1
2,4,17,2,30,9,5,0,14,3,30,6,0,0,6,0,30,5,9,0,14,0,30,7,7,0,14,3,30,4,0,0,4,1,-15,3,1
2,4,23,2,30,5,8,0,13,1,30,6,0,0,6,3,30,13,0,0,13,0,30,6,7,0,13,4,30,6,0,0,6,1,-15,3,1
2,3,25,0,30,6,8,0,14,4,30,6,0,0,6,0,30,7,7,0,14,1,30,5,9,0,14,4,30,5,1,0,6,1,-15,3,1
2,0,27,1,30,4,11,0,15,5,30,2,0,0,2,0,30,6,9,0,15,3,30,5,10,0,15,3,30,6,0,0,6,1,-15,3,1
2,1,27,1,30,4,11,0,15,5,30,2,0,0,2,0,30,6,9,0,15,3,30,5,10,0,15,3,30,6,0,0,6,1,-15,3,1
2,2,27,1,30,4,11,0,15,5,30,2,0,0,2,0,30,6,9,0,15,3,30,5,10,0,15,3,30,6,0,0,6,1,-15,3,1
2,4,31,3,30,8,4,0,12,3,30,8,0,0,8,4,30,11,1,0,12,0,30,3,9,0,12,0,30,3,3,0,6,1,-15,3,1
2,3,33,0,30,2,9,0,11,4,30,4,0,0,4,1,30,9,2,0,11,0,30,3,8,0,11,6,30,4,0,0,4,1,-15,3,1
2,2,38,0,30,1,9,0,10,5,30,6,0,0,6,0,30,4,6,0,10,0,30,3,7,0,10,6,30,6,0,0,6,1,-15,3,1
2,3,39,0,30,3,8,0,11,6,30,6,0,0,6,0,30,4,7,0,11,1,30,3,8,0,11,6,30,5,0,0,5,1,-15,3,1
2,4,1,0,30,7,3,0,10,4,30,2,0,0,2,1,30,4,6,0,10,1,30,6,4,0,10,6,30,6,0,0,6,0,-27,3,0
2,1,5,0,30,2,3,0,5,3,30,0,4,0,4,0,30,2,3,0,5,2,30,3,2,0,5,1,30,0,2,0,2,0,-27,3,0
2,2,5,0,30,2,3,0,5,3,30,0,4,0,4,0,30,2,3,0,5,2,30,3,2,0,5,1,30,0,2,0,2,0,-27,3,0
2,4,6,0,30,8,1,0,9,4,30,2,0,0,2,0,30,3,6,0,9,0,30,4,5,0,9,0,30,5,0,0,5,0,-27,3,0
2,3,8,1,30,7,0,0,7,4,30,2,0,0,2,4,30,2,5,0,7,0,30,5,2,0,7,3,30,3,0,0,3,0,-27,3,0
2,4,8,1,30,7,0,0,7,4,30,2,0,0,2,4,30,2,5,0,7,0,30,5,2,0,7,3,30,3,0,0,3,0,-27,3,0
2,2,13,3,30,6,1,0,7,0,30,4,0,0,4,2,30,7,0,0,7,4,30,6,1,0,7,4,30,4,0,0,4,1,-15,3,1
2,3,13,3,30,6,1,0,7,0,30,4,0,0,4,2,30,7,0,0,7,4,30,6,1,0,7,4,30,4,0,0,4,1,-15,3,1
2,4,13,3,30,6,1,0,7,0,30,4,0,0,4,2,30,7,0,0,7,4,30,6,1,0,7,4,30,4,0,0,4,1,-15,3,1
2,4,17,1,30,8,6,0,14,1,30,6,0,0,6,0,30,9,5,0,14,2,30,6,8,0,14,6,30,4,0,0,4,1,-15,3,1
2,4,19,0,30,4,9,0,13,2,30,6,2,0,8,2,30,7,6,0,13,0,30,10,3,0,13,0,30,5,4,0,9,1,-15,3,1
2,1,25,0,30,5,9,0,14,4,30,6,0,0,6,0,30,9,5,0,14,1,30,7,7,0,14,3,30,5,1,0,6,1,-15,3,1
2,3,25,0,30,5,9,0,14,4,30,6,0,0,6,0,30,9,5,0,14,1,30,7,7,0,14,3,30,5,1,0,6,1,-15,3,1
2,4,25,0,30,5,9,0,14,4,30,6,0,0,6,0,30,9,5,0,14,1,30,7,7,0,14,3,30,5,1,0,6,1,-15,3,1
2,3,31,3,30,5,7,0,12,7,30,8,0,0,8,3,30,6,6,0,12,0,30,8,4,0,12,2,30,6,0,0,6,1,-15,3,1
2,4,31,3,30,5,7,0,12,7,30,8,0,0,8,3,30,6,6,0,12,0,30,8,4,0,12,2,30,6,0,0,6,1,-15,3,1
2,3,7,2,30,4,5,0,9,3,30,4,0,0,4,3,30,6,3,0,9,5,30,3,6,0,9,1,30,5,1,0,6,0,-27,3,0
2,4,7,2,30,4,5,0,9,3,30,4,0,0,4,3,30,6,3,0,9,5,30,3,6,0,9,1,30,5,1,0,6,0,-27,3,0
2,3,8,4,30,7,0,0,7,4,30,2,0,0,2,3,30,6,1,0,7,0,30,6,1,0,7,1,30,3,0,0,3,0,-27,3,0
2,4,8,4,30,7,0,0,7,4,30,2,0,0,2,3,30,6,1,0,7,0,30,6,1,0,7,1,30,3,0,0,3,0,-27,3,0
2,1,13,2,30,5,2,0,7,0,30,4,0,0,4,2,30,5,2,0,7,7,30,7,0,0,7,4,30,4,0,0,4,1,-15,3,1
2,4,13,2,30,5,2,0,7,0,30,4,0,0,4,2,30,5,2,0,7,7,30,7,0,0,7,4,30,4,0,0,4,1,-15,3,1
2,1,17,4,30,10,4,0,14,2,30,6,0,0,6,0,30,6,8,0,14,3,30,6,8,0,14,1,30,4,0,0,4,1,-15,3,1
2,4,19,0,30,7,6,0,13,1,30,8,0,0,8,0,30,6,7,0,13,0,30,3,10,0,13,3,30,6,3,0,9,1,-15,3,1
2,1,23,1,30,7,6,0,13,2,30,6,0,0,6,4,30,13,0,0,13,0,30,5,8,0,13,4,30,6,0,0,6,1,-15,3,1
2,2,23,1,30,7,6,0,13,2,30,6,0,0,6,4,30,13,0,0,13,0,30,5,8,0,13,4,30,6,0,0,6,1,-15,3,1
2,4,23,0,30,7,6,0,13,2,30,6,0,0,6,4,30,13,0,0,13,0,30,5,8,0,13,4,30,6,0,0,6,1,-15,3,1
2,2,27,1,30,3,12,0,15,5,30,2,0,0,2,0,30,5,10,0,15,0,30,3,12,0,15,4,30,6,0,0,6,1,-15,3,1
2,4,27,1,30,3,12,0,15,5,30,2,0,0,2,0,30,5,10,0,15,0,30,3,12,0,15,3,30,6,0,0,6,1,-15,3,1
2,2,31,3,30,6,6,0,12,5,30,8,0,0,8,3,30,8,4,0,12,0,30,3,9,0,12,0,30,5,1,0,6,1,-15,3,1
2,3,31,3,30,6,6,0,12,5,30,8,0,0,8,3,30,8,4,0,12,0,30,3,9,0,12,0,30,5,1,0,6,1,-15,3,1
2,4,31,3,30,6,6,0,12,5,30,8,0,0,8,3,30,8,4,0,12,0,30,3,9,0,12,0,30,5,1,0,6,1,-15,3,1
2,2,35,0,30,6,7,0,13,5,30,2,0,0,2,1,30,3,10,0,13,1,30,5,8,0,13,9,30,8,0,0,8,1,-15,3,1
2,2,13,1,30,4,3,0,7,0,30,4,0,0,4,2,30,5,2,0,7,12,30,6,1,0,7,1,30,4,0,0,4,1,-15,3,1
2,4,13,1,30,4,3,0,7,0,30,4,0,0,4,2,30,5,2,0,7,12,30,6,1,0,7,1,30,4,0,0,4,1,-15,3,1
2,3,17,4,30,10,4,0,14,4,30,6,0,0,6,0,30,4,10,0,14,2,30,6,8,0,14,1,30,4,0,0,4,1,-15,3,1
2,4,17,4,30,10,4,0,14,4,30,6,0,0,6,0,30,4,10,0,14,2,30,6,8,0,14,1,30,4,0,0,4,1,-15,3,1
2,4,25,1,30,4,10,0,14,5,30,6,0,0,6,0,30,8,6,0,14,1,30,5,9,0,14,0,30,6,0,0,6,1,-15,3,1
2,1,27,1,30,5,10,0,15,5,30,1,1,0,2,0,30,5,10,0,15,0,30,4,11,0,15,1,30,6,0,0,6,1,-15,3,1
2,2,27,1,30,5,10,0,15,5,30,1,1,0,2,0,30,5,10,0,15,0,30,4,11,0,15,1,30,6,0,0,6,1,-15,3,1
2,3,27,1,30,5,10,0,15,5,30,1,1,0,2,0,30,5,10,0,15,0,30,4,11,0,15,1,30,6,0,0,6,1,-15,3,1
2,4,27,1,30,5,10,0,15,5,30,1,1,0,2,0,30,5,10,0,15,0,30,4,11,0,15,1,30,6,0,0,6,1,-15,3,1
2,0,5,0,30,1,4,0,5,3,30,2,2,0,4,0,30,0,5,0,5,0,30,3,2,0,5,0,30,0,2,0,2,0,-27,3,0
2,4,5,0,30,1,4,0,5,2,30,2,2,0,4,0,30,0,5,0,5,0,30,3,2,0,5,0,30,0,2,0,2,0,-27,3,0
2,4,8,4,30,7,0,0,7,4,30,2,0,0,2,0,30,4,3,0,7,0,30,5,2,0,7,3,30,3,0,0,3,0,-27,3,0
2,1,19,0,30,3,10,0,13,2,30,5,3,0,8,0,30,5,8,0,13,4,30,5,8,0,13,0,30,9,0,0,9,1,-15,3,1
2,2,19,0,30,3,10,0,13,2,30,5,3,0,8,0,30,5,8,0,13,4,30,5,8,0,13,0,30,9,0,0,9,1,-15,3,1
2,3,25,1,30,5,9,0,14,1,30,6,0,0,6,0,30,10,4,0,14,1,30,5,9,0,14,4,30,4,2,0,6,1,-15,3,1
2,0,27,2,30,5,10,0,15,3,30,1,1,0,2,0,30,5,10,0,15,0,30,4,11,0,15,5,30,6,0,0,6,1,-15,3,1
2,1,27,2,30,5,10,0,15,3,30,1,1,0,2,0,30,5,10,0,15,0,30,4,11,0,15,5,30,6,0,0,6,1,-15,3,1
2,2,27,2,30,5,10,0,15,3,30,1,1,0,2,0,30,5,10,0,15,0,30,4,11,0,15,5,30,6,0,0,6,1,-15,3,1
2,3,27,2,30,5,10,0,15,3,30,1,1,0,2,0,30,5,10,0,15,0,30,4,11,0,15,5,30,6,0,0,6,1,-15,3,1
2,4,27,2,30,5,10,0,15,3,30,1,1,0,2,0,30,5,10,0,15,0,30,4,11,0,15,5,30,6,0,0,6,1,-15,3,1
2,2,31,3,30,6,6,0,12,5,30,8,0,0,8,5,30,10,2,0,12,0,30,5,7,0,12,0,30,6,0,0,6,1,-15,3,1
2,3,47,0,30,0,14,0,14,6,30,4,0,0,4,0,30,3,11,0,14,0,30,2,12,0,14,9,30,7,0,0,7,1,-15,3,1
2,2,4,2,30,6,2,0,8,4,30,4,0,0,4,3,30,2,6,0,8,0,30,4,4,0,8,1,30,3,1,0,4,0,-27,3,0
2,3,4,2,30,6,2,0,8,4,30,4,0,0,4,3,30,2,6,0,8,0,30,4,4,0,8,1,30,3,1,0,4,0,-27,3,0
2,0,5,0,30,2,3,0,5,3,30,0,4,0,4,0,30,0,5,0,5,0,30,1,4,0,5,3,30,0,2,0,2,0,-27,3,0
2,2,5,0,30,2,3,0,5,3,30,0,4,0,4,0,30,0,5,0,5,0,30,1,4,0,5,3,30,0,2,0,2,0,-27,3,0
2,3,5,0,30,2,3,0,5,3,30,0,4,0,4,0,30,0,5,0,5,0,30,1,4,0,5,3,30,0,2,0,2,0,-27,3,0
2,4,5,0,30,2,3,0,5,3,30,0,4,0,4,0,30,0,5,0,5,0,30,1,4,0,5,3,30,0,2,0,2,0,-27,3,0
2,4,8,0,30,7,0,0,7,4,30,2,0,0,2,7,30,2,5,0,7,2,30,7,0,0,7,2,30,3,0,0,3,0,-27,3,0
2,3,13,4,30,7,0,0,7,2,30,4,0,0,4,1,30,6,1,0,7,0,30,7,0,0,7,3,30,4,0,0,4,1,-15,3,1
2,4,13,4,30,7,0,0,7,2,30,4,0,0,4,1,30,6,1,0,7,0,30,7,0,0,7,3,30,4,0,0,4,1,-15,3,1
2,2,17,3,30,12,2,0,14,2,30,6,0,0,6,0,30,4,10,0,14,2,30,6,8,0,14,3,30,4,0,0,4,1,-15,3,1
2,4,17,3,30,12,2,0,14,2,30,6,0,0,6,0,30,4,10,0,14,0,30,6,8,0,14,3,30,4,0,0,4,1,-15,3,1
2,2,23,1,30,5,8,0,13,3,30,6,0,0,6,6,30,12,1,0,13,0,30,5,8,0,13,2,30,6,0,0,6,1,-15,3,1
2,1,25,1,30,9,5,0,14,3,30,6,0,0,6,0,30,6,8,0,14,1,30,6,8,0,14,2,30,6,0,0,6,1,-15,3,1
2,3,25,1,30,9,5,0,14,3,30,6,0,0,6,0,30,6,8,0,14,1,30,6,8,0,14,2,30,6,0,0,6,1,-15,3,1
2,4,25,1,30,9,5,0,14,3,30,6,0,0,6,0,30,6,8,0,14,1,30,6,8,0,14,2,30,6,0,0,6,1,-15,3,1
2,3,27,0,30,6,9,0,15,0,30,2,0,0,2,0,30,8,7,0,15,1,30,5,10,0,15,0,30,4,2,0,6,1,-15,3,1
2,4,27,0,30,6,9,0,15,0,30,2,0,0,2,0,30,8,7,0,15,1,30,5,10,0,15,0,30,4,2,0,6,1,-15,3,1
2,4,39,0,30,5,6,0,11,7,30,6,0,0,6,0,30,4,7,0,11,5,30,2,9,0,11,0,30,3,2,0,5,1,-15,3,1
2,3,1,0,30,7,3,0,10,5,30,2,0,0,2,1,30,3,7,0,10,3,30,9,1,0,10,5,30,6,0,0,6,0,-27,3,0
2,4,1,0,30,7,3,0,10,5,30,2,0,0,2,1,30,3,7,0,10,3,30,9,1,0,10,5,30,6,0,0,6,0,-27,3,0
2,2,4,2,30,4,4,0,8,5,30,4,0,0,4,3,30,2,6,0,8,0,30,7,1,0,8,1,30,4,0,0,4,0,-27,3,0
2,3,4,2,30,4,4,0,8,5,30,4,0,0,4,3,30,2,6,0,8,0,30,7,1,0,8,1,30,4,0,0,4,0,-27,3,0
2,0,5,0,30,2,3,0,5,3,30,0,4,0,4,0,30,0,5,0,5,0,30,1,4,0,5,0,30,0,2,0,2,0,-27,3,0
2,2,13,1,30,7,0,0,7,0,30,4,0,0,4,2,30,5,2,0,7,13,30,5,2,0,7,1,30,4,0,0,4,1,-15,3,1
2,1,15,0,30,1,3,0,4,0,30,5,1,0,6,0,30,2,2,0,4,10,30,4,0,0,4,0,30,3,1,0,4,1,-15,3,1
2,2,15,0,30,1,3,0,4,0,30,5,1,0,6,0,30,2,2,0,4,10,30,4,0,0,4,0,30,3,1,0,4,1,-15,3,1
2,4,19,0,30,2,11,0,13,3,30,4,4,0,8,0,30,4,9,0,13,3,30,6,7,0,13,3,30,9,0,0,9,1,-15,3,1
2,0,27,2,30,5,10,0,15,5,30,1,1,0,2,0,30,6,9,0,15,0,30,6,9,0,15,1,30,5,1,0,6,1,-15,3,1
2,2,27,2,30,5,10,0,15,5,30,1,1,0,2,0,30,6,9,0,15,0,30,6,9,0,15,1,30,5,1,0,6,1,-15,3,1
2,3,27,2,30,5,10,0,15,5,30,1,1,0,2,0,30,6,9,0,15,0,30,6,9,0,15,1,30,5,1,0,6,1,-15,3,1
2,4,29,0,30,7,7,0,14,6,30,12,0,0,12,0,30,3,11,0,14,0,30,3,11,0,14,0,30,8,1,0,9,1,-15,3,1
2,2,31,3,30,7,5,0,12,3,30,8,0,0,8,5,30,11,1,0,12,0,30,3,9,0,12,0,30,1,5,0,6,1,-15,3,1
2,4,31,3,30,7,5,0,12,3,30,8,0,0,8,5,30,11,1,0,12,0,30,3,9,0,12,0,30,1,5,0,6,1,-15,3,1
2,3,35,0,30,7,6,0,13,5,30,2,0,0,2,1,30,5,8,0,13,2,30,1,12,0,13,4,30,8,0,0,8,1,-15,3,1
2,2,4,2,30,6,2,0,8,5,30,4,0,0,4,0,30,1,7,0,8,0,30,5,3,0,8,0,30,4,0,0,4,0,-27,3,0
2,4,4,2,30,6,2,0,8,5,30,4,0,0,4,0,30,1,7,0,8,0,30,5,3,0,8,0,30,4,0,0,4,0,-27,3,0
2,3,5,0,30,2,3,0,5,3,30,4,0,0,4,0,30,0,5,0,5,0,30,1,4,0,5,0,30,0,2,0,2,0,-27,3,0
2,4,5,0,30,2,3,0,5,3,30,4,0,0,4,0,30,0,5,0,5,0,30,1,4,0,5,0,30,0,2,0,2,0,-27,3,0
2,1,17,3,30,11,3,0,14,3,30,6,0,0,6,0,30,4,10,0,14,0,30,8,6,0,14,3,30,4,0,0,4,1,-15,3,1
2,3,19,0,30,5,8,0,13,0,30,8,0,0,8,0,30,8,5,0,13,6,30,3,10,0,13,1,30,5,4,0,9,1,-15,3,1
2,2,25,4,30,4,10,0,14,5,30,6,0,0,6,0,30,7,7,0,14,0,30,10,4,0,14,4,30,5,1,0,6,1,-15,3,1
2,4,19,0,30,3,10,0,13,0,30,8,0,0,8,4,30,4,9,0,13,0,30,4,9,0,13,1,30,6,3,0,9,1,-15,3,1
2,4,22,2,30,8,0,0,8,3,30,2,0,0,2,0,30,4,4,0,8,1,30,2,6,0,8,0,30,4,0,0,4,1,-15,3,1
2,4,23,1,30,6,7,0,13,1,30,6,0,0,6,6,30,9,4,0,13,0,30,4,9,0,13,1,30,6,0,0,6,1,-15,3,1
2,3,27,6,30,5,10,0,15,2,30,2,0,0,2,0,30,8,7,0,15,0,30,4,11,0,15,2,30,5,1,0,6,1,-15,3,1
2,1,4,3,30,8,0,0,8,4,30,4,0,0,4,1,30,5,3,0,8,0,30,4,4,0,8,1,30,4,0,0,4,0,-27,3,0
2,2,4,3,30,8,0,0,8,4,30,4,0,0,4,1,30,5,3,0,8,0,30,4,4,0,8,1,30,4,0,0,4,0,-27,3,0
2,1,5,0,30,4,1,0,5,3,30,3,1,0,4,0,30,1,4,0,5,0,30,2,3,0,5,0,30,0,2,0,2,0,-27,3,0
2,3,6,0,30,7,2,0,9,3,30,2,0,0,2,0,30,2,7,0,9,0,30,3,6,0,9,0,30,3,2,0,5,0,-27,3,0
2,4,13,1,30,5,2,0,7,1,30,4,0,0,4,2,30,6,1,0,7,7,30,5,2,0,7,2,30,4,0,0,4,1,-15,3,1
2,1,17,4,30,9,5,0,14,3,30,6,0,0,6,0,30,4,10,0,14,2,30,6,8,0,14,3,30,4,0,0,4,1,-15,3,1
2,2,17,4,30,9,5,0,14,3,30,6,0,0,6,0,30,4,10,0,14,2,30,6,8,0,14,3,30,4,0,0,4,1,-15,3,1
2,2,29,1,30,7,7,0,14,6,30,9,3,0,12,0,30,5,9,0,14,0,30,0,14,0,14,3,30,9,0,0,9,1,-15,3,1
2,4,29,1,30,7,7,0,14,6,30,9,3,0,12,0,30,5,9,0,14,0,30,0,14,0,14,3,30,9,0,0,9,1,-15,3,1
2,4,31,3,30,5,7,0,12,5,30,8,0,0,8,3,30,11,1,0,12,0,30,3,9,0,12,2,30,6,0,0,6,1,-15,3,1
2,0,5,1,30,3,2,0,5,3,30,0,4,0,4,1,30,2,3,0,5,0,30,3,2,0,5,0,30,0,2,0,2,0,-27,3,0
2,1,5,1,30,3,2,0,5,3,30,0,4,0,4,1,30,2,3,0,5,0,30,3,2,0,5,0,30,0,2,0,2,0,-27,3,0
2,3,9,0,30,7,4,0,11,2,30,6,0,0,6,1,30,9,2,0,11,1,30,3,8,0,11,4,30,4,0,0,4,0,-27,3,0
2,4,9,0,30,7,4,0,11,2,30,6,0,0,6,1,30,9,2,0,11,1,30,3,8,0,11,4,30,4,0,0,4,0,-27,3,0
2,1,13,1,30,7,0,0,7,0,30,4,0,0,4,3,30,7,0,0,7,8,30,6,1,0,7,6,30,4,0,0,4,1,-15,3,1
2,2,13,1,30,7,0,0,7,0,30,4,0,0,4,3,30,7,0,0,7,8,30,6,1,0,7,6,30,4,0,0,4,1,-15,3,1
2,0,17,3,30,10,4,0,14,3,30,6,0,0,6,0,30,6,8,0,14,4,30,5,9,0,14,4,30,4,0,0,4,1,-15,3,1
2,4,17,3,30,10,4,0,14,2,30,6,0,0,6,0,30,6,8,0,14,0,30,5,9,0,14,4,30,4,0,0,4,1,-15,3,1
2,4,22,2,30,8,0,0,8,3,30,2,0,0,2,3,30,4,4,0,8,0,30,3,5,0,8,1,30,1,3,0,4,1,-15,3,1
2,3,23,2,30,6,7,0,13,3,30,6,0,0,6,4,30,11,2,0,13,0,30,6,7,0,13,1,30,5,1,0,6,1,-15,3,1
2,4,31,1,30,4,8,0,12,7,30,8,0,0,8,0,30,4,8,0,12,0,30,8,4,0,12,5,30,6,0,0,6,1,-15,3,1
2,3,35,0,30,10,3,0,13,6,30,2,0,0,2,1,30,2,11,0,13,2,30,1,12,0,13,5,30,8,0,0,8,1,-15,3,1
2,2,38,0,30,4,6,0,10,6,30,6,0,0,6,0,30,3,7,0,10,0,30,2,8,0,10,5,30,6,0,0,6,1,-15,3,1
2,3,38,0,30,4,6,0,10,6,30,6,0,0,6,0,30,3,7,0,10,0,30,2,8,0,10,5,30,6,0,0,6,1,-15,3,1
2,2,6,1,30,7,2,0,9,4,30,2,0,0,2,0,30,2,7,0,9,0,30,4,5,0,9,0,30,4,1,0,5,0,-27,3,0
2,3,6,1,30,7,2,0,9,4,30,2,0,0,2,0,30,2,7,0,9,0,30,4,5,0,9,0,30,4,1,0,5,0,-27,3,0
2,2,13,1,30,6,1,0,7,1,30,4,0,0,4,2,30,5,2,0,7,3,30,6,1,0,7,2,30,4,0,0,4,1,-15,3,1
2,3,15,1,30,4,9,0,13,0,30,6,0,0,6,0,30,4,9,0,13,1,30,3,10,0,13,2,30,6,3,0,9,1,-15,3,1
2,1,17,2,30,9,5,0,14,4,30,6,0,0,6,0,30,3,11,0,14,3,30,7,7,0,14,3,30,4,0,0,4,1,-15,3,1
2,2,19,0,30,4,9,0,13,1,30,8,0,0,8,0,30,8,5,0,13,4,30,4,9,0,13,2,30,7,2,0,9,1,-15,3,1
2,3,23,2,30,6,7,0,13,0,30,6,0,0,6,6,30,13,0,0,13,0,30,4,9,0,13,4,30,6,0,0,6,1,-15,3,1
2,1,25,1,30,5,9,0,14,2,30,6,0,0,6,0,30,11,3,0,14,1,30,4,10,0,14,4,30,5,1,0,6,1,-15,3,1
2,2,25,1,30,5,9,0,14,2,30,6,0,0,6,0,30,11,3,0,14,1,30,4,10,0,14,4,30,5,1,0,6,1,-15,3,1
2,3,25,1,30,5,9,0,14,2,30,6,0,0,6,0,30,11,3,0,14,1,30,4,10,0,14,4,30,5,1,0,6,1,-15,3,1
2,2,27,2,30,6,9,0,15,5,30,2,0,0,2,2,30,5,10,0,15,0,30,3,12,0,15,6,30,4,2,0,6,1,-15,3,1
2,4,27,2,30,6,9,0,15,5,30,2,0,0,2,2,30,5,10,0,15,0,30,3,12,0,15,6,30,4,2,0,6,1,-15,3,1
2,4,30,3,30,1,4,0,5,4,30,2,0,0,2,1,30,1,4,0,5,6,30,1,4,0,5,4,30,3,0,0,3,1,-15,3,1
2,3,31,2,30,4,8,0,12,5,30,8,0,0,8,6,30,9,3,0,12,0,30,5,7,0,12,2,30,5,1,0,6,1,-15,3,1
2,4,31,2,30,4,8,0,12,5,30,8,0,0,8,6,30,9,3,0,12,0,30,5,7,0,12,2,30,5,1,0,6,1,-15,3,1
2,1,13,1,30,6,1,0,7,1,30,4,0,0,4,2,30,6,1,0,7,9,30,7,0,0,7,4,30,4,0,0,4,1,-15,3,1
2,4,13,1,30,6,1,0,7,1,30,4,0,0,4,2,30,6,1,0,7,9,30,7,0,0,7,4,30,4,0,0,4,1,-15,3,1
2,3,19,1,30,8,5,0,13,1,30,8,0,0,8,5,30,8,5,0,13,0,30,3,10,0,13,1,30,5,4,0,9,1,-15,3,1
2,4,19,1,30,8,5,0,13,1,30,8,0,0,8,5,30,8,5,0,13,0,30,3,10,0,13,1,30,5,4,0,9,1,-15,3,1
2,0,25,1,30,3,11,0,14,6,30,6,0,0,6,0,30,4,10,0,14,4,30,10,4,0,14,7,30,6,0,0,6,1,-15,3,1
2,1,25,1,30,3,11,0,14,6,30,6,0,0,6,0,30,4,10,0,14,4,30,10,4,0,14,7,30,6,0,0,6,1,-15,3,1
2,2,29,0,30,7,7,0,14,6,30,12,0,0,12,0,30,3,11,0,14,0,30,0,14,0,14,0,30,9,0,0,9,1,-15,3,1
2,4,29,0,30,7,7,0,14,6,30,12,0,0,12,0,30,3,11,0,14,0,30,0,14,0,14,0,30,9,0,0,9,1,-15,3,1
2,1,31,6,30,8,4,0,12,4,30,8,0,0,8,4,30,11,1,0,12,0,30,3,9,0,12,0,30,3,3,0,6,1,-15,3,1
2,2,45,0,30,6,7,0,13,10,30,10,0,0,10,0,30,0,13,0,13,0,30,4,9,0,13,6,30,5,0,0,5,1,-15,3,1
2,4,3,0,30,0,4,0,4,3,30,4,0,0,4,0,30,0,4,0,4,6,30,0,4,0,4,0,30,3,0,0,3,0,-27,3,0
2,1,4,2,30,6,2,0,8,4,30,2,2,0,4,0,30,5,3,0,8,1,30,4,4,0,8,1,30,4,0,0,4,0,-27,3,0
2,1,5,0,30,2,3,0,5,3,30,2,2,0,4,0,30,1,4,0,5,0,30,1,4,0,5,1,30,0,2,0,2,0,-27,3,0
2,4,13,3,30,7,0,0,7,2,30,4,0,0,4,0,30,5,2,0,7,8,30,7,0,0,7,0,30,4,0,0,4,1,-15,3,1
2,2,17,3,30,10,4,0,14,2,30,6,0,0,6,0,30,7,7,0,14,2,30,5,9,0,14,2,30,4,0,0,4,1,-15,3,1
2,4,17,3,30,10,4,0,14,2,30,6,0,0,6,0,30,7,7,0,14,2,30,5,9,0,14,2,30,4,0,0,4,1,-15,3,1
2,4,19,0,30,3,10,0,13,2,30,4,4,0,8,0,30,5,8,0,13,3,30,5,8,0,13,0,30,9,0,0,9,1,-15,3,1
2,3,21,2,30,7,3,0,10,4,30,6,0,0,6,1,30,3,7,0,10,2,30,5,5,0,10,1,30,4,0,0,4,1,-15,3,1
2,4,21,2,30,7,3,0,10,4,30,6,0,0,6,1,30,3,7,0,10,2,30,5,5,0,10,1,30,4,0,0,4,1,-15,3,1
2,3,23,1,30,5,8,0,13,3,30,6,0,0,6,4,30,11,2,0,13,0,30,7,6,0,13,2,30,5,1,0,6,1,-15,3,1
2,4,23,1,30,5,8,0,13,3,30,6,0,0,6,4,30,11,2,0,13,0,30,7,6,0,13,2,30,5,1,0,6,1,-15,3,1
2,2,25,1,30,6,8,0,14,5,30,6,0,0,6,0,30,4,10,0,14,1,30,7,7,0,14,4,30,5,1,0,6,1,-15,3,1
2,3,25,1,30,6,8,0,14,5,30,6,0,0,6,0,30,4,10,0,14,1,30,7,7,0,14,4,30,5,1,0,6,1,-15,3,1
2,4,26,0,30,8,1,0,9,5,30,4,0,0,4,2,30,0,9,0,9,0,30,2,7,0,9,0,30,3,0,0,3,1,-15,3,1
2,3,27,2,30,6,9,0,15,4,30,2,0,0,2,0,30,8,7,0,15,0,30,4,11,0,15,0,30,3,3,0,6,1,-15,3,1
2,2,33,1,30,2,9,0,11,5,30,4,0,0,4,0,30,9,2,0,11,3,30,4,7,0,11,6,30,4,0,0,4,1,-15,3,1
2,3,39,0,30,4,7,0,11,7,30,6,0,0,6,0,30,4,7,0,11,3,30,3,8,0,11,3,30,5,0,0,5,1,-15,3,1
2,4,39,0,30,4,7,0,11,7,30,6,0,0,6,0,30,4,7,0,11,3,30,3,8,0,11,3,30,5,0,0,5,1,-15,3,1
2,3,19,0,30,6,7,0,13,1,30,7,1,0,8,0,30,9,4,0,13,0,30,4,9,0,13,1,30,8,1,0,9,1,-15,3,1
2,3,23,2,30,4,9,0,13,3,30,6,0,0,6,8,30,13,0,0,13,0,30,7,6,0,13,2,30,5,1,0,6,1,-15,3,1
2,0,27,1,30,7,8,0,15,4,30,1,1,0,2,0,30,3,12,0,15,1,30,6,9,0,15,6,30,6,0,0,6,1,-15,3,1
2,1,27,1,30,7,8,0,15,4,30,1,1,0,2,0,30,3,12,0,15,1,30,6,9,0,15,6,30,6,0,0,6,1,-15,3,1
2,3,27,1,30,7,8,0,15,4,30,1,1,0,2,0,30,3,12,0,15,1,30,6,9,0,15,6,30,6,0,0,6,1,-15,3,1
2,4,27,1,30,7,8,0,15,4,30,1,1,0,2,0,30,3,12,0,15,1,30,6,9,0,15,6,30,6,0,0,6,1,-15,3,1
2,3,31,3,30,6,6,0,12,4,30,8,0,0,8,6,30,10,2,0,12,0,30,3,9,0,12,0,30,1,5,0,6,1,-15,3,1
2,3,39,0,30,3,8,0,11,7,30,6,0,0,6,0,30,4,7,0,11,0,30,4,7,0,11,8,30,5,0,0,5,1,-15,3,1
2,2,13,2,30,7,0,0,7,0,30,4,0,0,4,2,30,6,1,0,7,10,30,5,2,0,7,2,30,4,0,0,4,1,-15,3,1
2,3,17,3,30,10,4,0,14,2,30,6,0,0,6,0,30,6,8,0,14,2,30,5,9,0,14,2,30,4,0,0,4,1,-15,3,1
2,4,17,3,30,10,4,0,14,2,30,6,0,0,6,0,30,6,8,0,14,2,30,5,9,0,14,2,30,4,0,0,4,1,-15,3,1
2,3,25,1,30,6,8,0,14,5,30,6,0,0,6,0,30,6,8,0,14,1,30,7,7,0,14,4,30,6,0,0,6,1,-15,3,1
2,0,27,1,30,5,10,0,15,4,30,2,0,0,2,0,30,8,7,0,15,0,30,8,7,0,15,1,30,3,3,0,6,1,-15,3,1
2,1,27,1,30,5,10,0,15,4,30,2,0,0,2,0,30,8,7,0,15,0,30,8,7,0,15,1,30,3,3,0,6,1,-15,3,1
2,0,29,1,30,7,7,0,14,6,30,10,2,0,12,0,30,3,11,0,14,0,30,2,12,0,14,4,30,9,0,0,9,1,-15,3,1
2,0,39,0,30,5,6,0,11,6,30,6,0,0,6,0,30,4,7,0,11,0,30,2,9,0,11,4,30,5,0,0,5,1,-15,3,1
2,1,39,0,30,5,6,0,11,6,30,6,0,0,6,0,30,4,7,0,11,0,30,2,9,0,11,4,30,5,0,0,5,1,-15,3,1
2,4,39,0,30,5,6,0,11,6,30,6,0,0,6,0,30,4,7,0,11,0,30,2,9,0,11,4,30,5,0,0,5,1,-15,3,1
2,0,6,0,30,8,1,0,9,3,30,2,0,0,2,0,30,2,7,0,9,0,30,3,6,0,9,0,30,3,2,0,5,0,-27,3,0
2,1,6,0,30,8,1,0,9,3,30,2,0,0,2,0,30,2,7,0,9,0,30,3,6,0,9,0,30,3,2,0,5,0,-27,3,0
2,3,6,0,30,8,1,0,9,3,30,2,0,0,2,0,30,2,7,0,9,0,30,3,6,0,9,0,30,3,2,0,5,0,-27,3,0
2,4,6,0,30,8,1,0,9,3,30,2,0,0,2,0,30,2,7,0,9,0,30,3,6,0,9,0,30,3,2,0,5,0,-27,3,0
2,4,8,2,30,7,0,0,7,4,30,2,0,0,2,0,30,2,5,0,7,2,30,7,0,0,7,0,30,2,1,0,3,0,-27,3,0
2,3,13,9,30,5,2,0,7,0,30,4,0,0,4,2,30,5,2,0,7,3,30,6,1,0,7,5,30,4,0,0,4,1,-15,3,1
2,3,17,2,30,7,7,0,14,2,30,6,0,0,6,0,30,7,7,0,14,0,30,6,8,0,14,5,30,4,0,0,4,1,-15,3,1
2,0,19,0,30,3,10,0,13,2,30,4,4,0,8,0,30,6,7,0,13,11,30,4,9,0,13,2,30,9,0,0,9,1,-15,3,1
2,1,19,0,30,3,10,0,13,2,30,4,4,0,8,0,30,6,7,0,13,11,30,4,9,0,13,2,30,9,0,0,9,1,-15,3,1
2,3,23,1,30,4,9,0,13,3,30,6,0,0,6,5,30,11,2,0,13,0,30,5,8,0,13,2,30,6,0,0,6,1,-15,3,1
2,4,23,1,30,4,9,0,13,3,30,6,0,0,6,5,30,11,2,0,13,0,30,5,8,0,13,2,30,6,0,0,6,1,-15,3,1
2,3,25,1,30,7,7,0,14,3,30,6,0,0,6,0,30,5,9,0,14,0,30,6,8,0,14,6,30,6,0,0,6,1,-15,3,1
2,1,27,1,30,3,12,0,15,3,30,1,1,0,2,0,30,5,10,0,15,0,30,5,10,0,15,5,30,6,0,0,6,1,-15,3,1
2,2,27,1,30,3,12,0,15,3,30,1,1,0,2,0,30,5,10,0,15,0,30,5,10,0,15,5,30,6,0,0,6,1,-15,3,1
2,4,29,0,30,4,10,0,14,6,30,12,0,0,12,0,30,7,7,0,14,0,30,0,14,0,14,2,30,9,0,0,9,1,-15,3,1
2,0,4,2,30,7,1,0,8,4,30,2,2,0,4,0,30,2,6,0,8,1,30,6,2,0,8,3,30,4,0,0,4,0,-27,3,0
2,1,4,2,30,7,1,0,8,4,30,2,2,0,4,0,30,2,6,0,8,1,30,6,2,0,8,3,30,4,0,0,4,0,-27,3,0
2,3,7,0,30,2,2,0,4,2,30,2,0,0,2,0,30,1,3,0,4,0,30,1,3,0,4,1,30,1,1,0,2,0,-27,3,0
2,1,9,3,30,2,2,0,4,3,30,2,0,0,2,0,30,1,3,0,4,0,30,1,3,0,4,0,30,0,1,0,1,0,-27,3,0
2,2,9,3,30,2,2,0,4,3,30,2,0,0,2,0,30,1,3,0,4,0,30,1,3,0,4,0,30,0,1,0,1,0,-27,3,0
2,3,9,3,30,2,2,0,4,3,30,2,0,0,2,0,30,1,3,0,4,0,30,1,3,0,4,0,30,0,1,0,1,0,-27,3,0
2,4,9,3,30,2,2,0,4,3,30,2,0,0,2,0,30,1,3,0,4,0,30,1,3,0,4,0,30,0,1,0,1,0,-27,3,0
2,4,11,4,30,5,7,0,12,1,30,4,0,0,4,0,30,7,5,0,12,3,30,2,10,0,12,0,30,3,1,0,4,1,-15,3,1
2,3,13,1,30,5,2,0,7,0,30,4,0,0,4,2,30,6,1,0,7,6,30,6,1,0,7,8,30,4,0,0,4,1,-15,3,1
2,3,17,4,30,10,4,0,14,2,30,6,0,0,6,0,30,5,9,0,14,1,30,6,8,0,14,0,30,4,0,0,4,1,-15,3,1
2,3,19,0,30,5,8,0,13,1,30,7,1,0,8,0,30,7,6,0,13,2,30,5,8,0,13,2,30,8,1,0,9,1,-15,3,1
2,4,19,0,30,5,8,0,13,1,30,7,1,0,8,0,30,7,6,0,13,2,30,5,8,0,13,2,30,8,1,0,9,1,-15,3,1
2,2,25,1,30,5,9,0,14,3,30,6,0,0,6,0,30,7,7,0,14,2,30,6,8,0,14,5,30,6,0,0,6,1,-15,3,1
2,1,27,1,30,5,10,0,15,3,30,2,0,0,2,0,30,5,10,0,15,2,30,3,12,0,15,4,30,6,0,0,6,1,-15,3,1
2,2,27,1,30,5,10,0,15,3,30,2,0,0,2,0,30,5,10,0,15,2,30,3,12,0,15,4,30,6,0,0,6,1,-15,3,1
2,3,27,1,30,5,10,0,15,3,30,2,0,0,2,0,30,5,10,0,15,2,30,3,12,0,15,4,30,6,0,0,6,1,-15,3,1
2,3,31,0,30,6,6,0,12,4,30,8,0,0,8,4,30,9,3,0,12,0,30,3,9,0,12,0,30,4,2,0,6,1,-15,3,1
2,3,38,0,30,0,10,0,10,6,30,6,0,0,6,0,30,2,8,0,10,3,30,3,7,0,10,3,30,6,0,0,6,1,-15,3,1
2,0,39,0,30,5,6,0,11,6,30,6,0,0,6,0,30,4,7,0,11,0,30,2,9,0,11,3,30,5,0,0,5,1,-15,3,1
2,1,39,0,30,5,6,0,11,6,30,6,0,0,6,0,30,4,7,0,11,0,30,2,9,0,11,3,30,5,0,0,5,1,-15,3,1
2,4,39,0,30,5,6,0,11,6,30,6,0,0,6,0,30,4,7,0,11,0,30,2,9,0,11,3,30,5,0,0,5,1,-15,3,1
2,3,8,1,30,7,0,0,7,4,30,2,0,0,2,0,30,2,5,0,7,0,30,2,5,0,7,1,30,3,0,0,3,0,-27,3,0
2,2,13,2,30,3,0,0,3,0,30,2,0,0,2,0,30,2,1,0,3,11,30,2,1,0,3,4,30,2,0,0,2,1,-15,3,1
2,1,13,6,30,7,0,0,7,0,30,4,0,0,4,8,30,5,2,0,7,3,30,6,1,0,7,4,30,4,0,0,4,1,-15,3,1
2,3,13,6,30,7,0,0,7,0,30,4,0,0,4,8,30,5,2,0,7,3,30,6,1,0,7,4,30,4,0,0,4,1,-15,3,1
2,1,19,0,30,3,10,0,13,2,30,3,5,0,8,0,30,7,6,0,13,5,30,5,8,0,13,4,30,8,1,0,9,1,-15,3,1
2,2,19,0,30,3,10,0,13,2,30,3,5,0,8,0,30,7,6,0,13,5,30,5,8,0,13,4,30,8,1,0,9,1,-15,3,1
2,3,19,0,30,3,10,0,13,2,30,3,5,0,8,0,30,7,6,0,13,5,30,5,8,0,13,4,30,8,1,0,9,1,-15,3,1
2,4,19,0,30,3,10,0,13,2,30,3,5,0,8,0,30,7,6,0,13,5,30,5,8,0,13,4,30,8,1,0,9,1,-15,3,1
2,4,23,2,30,6,7,0,13,2,30,6,0,0,6,6,30,11,2,0,13,1,30,5,8,0,13,0,30,5,1,0,6,1,-15,3,1
2,1,27,4,30,5,10,0,15,2,30,2,0,0,2,0,30,2,13,0,15,0,30,5,10,0,15,6,30,6,0,0,6,1,-15,3,1
2,3,27,4,30,5,10,0,15,2,30,2,0,0,2,0,30,2,13,0,15,0,30,5,10,0,15,6,30,6,0,0,6,1,-15,3,1
2,1,4,2,30,6,2,0,8,4,30,1,3,0,4,0,30,1,7,0,8,0,30,7,1,0,8,4,30,4,0,0,4,0,-27,3,0
2,1,11,2,30,5,7,0,12,2,30,4,0,0,4,0,30,5,7,0,12,5,30,7,5,0,12,4,30,4,0,0,4,1,-15,3,1
2,3,11,2,30,5,7,0,12,2,30,4,0,0,4,0,30,5,7,0,12,5,30,7,5,0,12,4,30,4,0,0,4,1,-15,3,1
2,4,11,2,30,5,7,0,12,2,30,4,0,0,4,0,30,5,7,0,12,5,30,7,5,0,12,4,30,4,0,0,4,1,-15,3,1
2,4,13,2,30,7,0,0,7,0,30,4,0,0,4,2,30,6,1,0,7,9,30,7,0,0,7,2,30,4,0,0,4,1,-15,3,1
2,4,15,1,30,4,9,0,13,0,30,6,0,0,6,0,30,7,6,0,13,1,30,5,8,0,13,3,30,3,6,0,9,1,-15,3,1
2,2,17,0,30,9,5,0,14,3,30,6,0,0,6,0,30,4,10,0,14,3,30,8,6,0,14,5,30,4,0,0,4,1,-15,3,1
2,3,19,0,30,3,10,0,13,2,30,4,4,0,8,0,30,8,5,0,13,3,30,5,8,0,13,3,30,9,0,0,9,1,-15,3,1
2,3,23,1,30,6,7,0,13,3,30,6,0,0,6,3,30,10,3,0,13,2,30,5,8,0,13,4,30,6,0,0,6,1,-15,3,1
2,1,27,1,30,5,10,0,15,1,30,2,0,0,2,0,30,9,6,0,15,3,30,5,10,0,15,4,30,6,0,0,6,1,-15,3,1
2,2,27,1,30,5,10,0,15,1,30,2,0,0,2,0,30,9,6,0,15,3,30,5,10,0,15,4,30,6,0,0,6,1,-15,3,1
2,4,27,1,30,5,10,0,15,1,30,2,0,0,2,0,30,9,6,0,15,3,30,5,10,0,15,4,30,6,0,0,6,1,-15,3,1
2,2,31,3,30,8,4,0,12,8,30,8,0,0,8,3,30,4,8,0,12,2,30,7,5,0,12,3,30,6,0,0,6,1,-15,3,1
2,3,31,3,30,8,4,0,12,8,30,8,0,0,8,3,30,4,8,0,12,2,30,7,5,0,12,3,30,6,0,0,6,1,-15,3,1
2,2,41,0,30,9,3,0,12,6,30,8,0,0,8,0,30,7,5,0,12,0,30,3,9,0,12,1,30,5,2,0,7,1,-15,3,1
2,4,41,0,30,9,3,0,12,6,30,8,0,0,8,0,30,7,5,0,12,0,30,3,9,0,12,1,30,5,2,0,7,1,-15,3,1
2,1,4,2,30,6,2,0,8,5,30,4,0,0,4,0,30,2,6,0,8,0,30,6,2,0,8,3,30,4,0,0,4,0,-27,3,0
2,2,4,2,30,6,2,0,8,5,30,4,0,0,4,0,30,2,6,0,8,0,30,6,2,0,8,3,30,4,0,0,4,0,-27,3,0
2,3,4,2,30,6,2,0,8,5,30,4,0,0,4,0,30,2,6,0,8,0,30,6,2,0,8,3,30,4,0,0,4,0,-27,3,0
2,4,4,2,30,6,2,0,8,5,30,4,0,0,4,0,30,2,6,0,8,0,30,6,2,0,8,3,30,4,0,0,4,0,-27,3,0
2,1,5,0,30,2,3,0,5,3,30,4,0,0,4,0,30,0,5,0,5,0,30,1,4,0,5,0,30,1,1,0,2,0,-27,3,0
2,2,11,1,30,4,8,0,12,0,30,4,0,0,4,0,30,6,6,0,12,3,30,5,7,0,12,4,30,4,0,0,4,1,-15,3,1
2,3,11,1,30,4,8,0,12,0,30,4,0,0,4,0,30,6,6,0,12,3,30,5,7,0,12,4,30,4,0,0,4,1,-15,3,1
2,4,11,1,30,4,8,0,12,0,30,4,0,0,4,0,30,6,6,0,12,3,30,5,7,0,12,4,30,4,0,0,4,1,-15,3,1
2,3,21,7,30,10,0,0,10,5,30,6,0,0,6,1,30,3,7,0,10,1,30,5,5,0,10,0,30,3,1,0,4,1,-15,3,1
2,4,21,7,30,10,0,0,10,5,30,6,0,0,6,1,30,3,7,0,10,1,30,5,5,0,10,0,30,3,1,0,4,1,-15,3,1
2,4,22,5,30,8,0,0,8,3,30,2,0,0,2,0,30,4,4,0,8,0,30,1,7,0,8,1,30,1,3,0,4,1,-15,3,1
2,1,29,0,30,6,8,0,14,4,30,11,1,0,12,0,30,4,10,0,14,0,30,1,13,0,14,3,30,9,0,0,9,1,-15,3,1
2,3,29,0,30,6,8,0,14,4,30,11,1,0,12,0,30,4,10,0,14,0,30,1,13,0,14,0,30,9,0,0,9,1,-15,3,1
2,4,29,0,30,6,8,0,14,4,30,11,1,0,12,0,30,4,10,0,14,0,30,1,13,0,14,0,30,9,0,0,9,1,-15,3,1
2,3,47,0,30,0,14,0,14,7,30,4,0,0,4,0,30,3,11,0,14,0,30,4,10,0,14,9,30,7,0,0,7,1,-15,3,1
2,1,5,0,30,0,5,0,5,2,30,3,1,0,4,1,30,1,4,0,5,0,30,1,4,0,5,0,30,0,2,0,2,0,-27,3,0
2,2,19,0,30,3,10,0,13,2,30,5,3,0,8,0,30,5,8,0,13,3,30,6,7,0,13,0,30,8,1,0,9,1,-15,3,1
2,2,21,2,30,7,3,0,10,2,30,5,1,0,6,1,30,7,3,0,10,5,30,5,5,0,10,1,30,4,0,0,4,1,-15,3,1
2,4,23,1,30,6,7,0,13,1,30,6,0,0,6,5,30,11,2,0,13,0,30,5,8,0,13,2,30,6,0,0,6,1,-15,3,1
2,2,27,1,30,4,11,0,15,4,30,2,0,0,2,0,30,6,9,0,15,0,30,6,9,0,15,2,30,6,0,0,6,1,-15,3,1
2,0,29,0,30,7,7,0,14,6,30,10,2,0,12,0,30,6,8,0,14,0,30,1,13,0,14,2,30,9,0,0,9,1,-15,3,1
2,3,29,0,30,7,7,0,14,6,30,10,2,0,12,0,30,6,8,0,14,0,30,1,13,0,14,2,30,9,0,0,9,1,-15,3,1
2,3,31,4,30,5,7,0,12,3,30,8,0,0,8,0,30,12,0,0,12,0,30,3,9,0,12,2,30,5,1,0,6,1,-15,3,1
2,4,3,0,30,1,3,0,4,2,30,4,0,0,4,0,30,0,4,0,4,2,30,2,2,0,4,0,30,1,2,0,3,0,-27,3,0
2,2,5,0,30,2,3,0,5,3,30,3,1,0,4,2,30,0,5,0,5,0,30,2,3,0,5,0,30,2,0,0,2,0,-27,3,0
2,4,5,0,30,2,3,0,5,3,30,3,1,0,4,2,30,0,5,0,5,0,30,2,3,0,5,0,30,2,0,0,2,0,-27,3,0
2,4,6,1,30,7,2,0,9,4,30,2,0,0,2,0,30,2,7,0,9,0,30,4,5,0,9,0,30,5,0,0,5,0,-27,3,0
2,2,13,3,30,6,1,0,7,1,30,4,0,0,4,2,30,6,1,0,7,3,30,7,0,0,7,4,30,4,0,0,4,1,-15,3,1
2,4,25,3,30,7,7,0,14,5,30,6,0,0,6,0,30,8,6,0,14,1,30,4,10,0,14,3,30,5,1,0,6,1,-15,3,1
2,0,26,0,30,7,2,0,9,5,30,4,0,0,4,4,30,1,8,0,9,0,30,2,7,0,9,6,30,3,0,0,3,1,-15,3,1
2,4,26,0,30,7,2,0,9,5,30,4,0,0,4,4,30,1,8,0,9,0,30,2,7,0,9,6,30,3,0,0,3,1,-15,3,1
2,0,27,1,30,4,11,0,15,4,30,2,0,0,2,0,30,5,10,0,15,2,30,4,11,0,15,2,30,6,0,0,6,1,-15,3,1
2,2,27,1,30,4,11,0,15,4,30,2,0,0,2,0,30,5,10,0,15,2,30,4,11,0,15,2,30,6,0,0,6,1,-15,3,1
2,3,27,1,30,4,11,0,15,4,30,2,0,0,2,0,30,5,10,0,15,2,30,4,11,0,15,2,30,6,0,0,6,1,-15,3,1
2,4,27,1,30,4,11,0,15,4,30,2,0,0,2,0,30,5,10,0,15,2,30,4,11,0,15,2,30,6,0,0,6,1,-15,3,1
2,4,29,0,30,9,5,0,14,6,30,10,2,0,12,0,30,3,11,0,14,0,30,1,13,0,14,1,30,9,0,0,9,1,-15,3,1
2,1,41,0,30,7,5,0,12,6,30,8,0,0,8,0,30,4,8,0,12,2,30,5,7,0,12,7,30,7,0,0,7,1,-15,3,1
2,2,41,0,30,7,5,0,12,6,30,8,0,0,8,0,30,4,8,0,12,2,30,5,7,0,12,7,30,7,0,0,7,1,-15,3,1
2,2,6,0,30,5,4,0,9,4,30,2,0,0,2,0,30,2,7,0,9,0,30,5,4,0,9,1,30,5,0,0,5,0,-27,3,0
2,3,6,0,30,5,4,0,9,4,30,2,0,0,2,0,30,2,7,0,9,0,30,5,4,0,9,1,30,5,0,0,5,0,-27,3,0
2,4,8,2,30,7,0,0,7,3,30,2,0,0,2,0,30,4,3,0,7,0,30,4,3,0,7,3,30,3,0,0,3,0,-27,3,0
2,2,13,2,30,6,1,0,7,0,30,4,0,0,4,2,30,5,2,0,7,12,30,5,2,0,7,5,30,4,0,0,4,1,-15,3,1
2,4,15,1,30,4,9,0,13,1,30,6,0,0,6,0,30,4,9,0,13,1,30,5,8,0,13,3,30,9,0,0,9,1,-15,3,1
2,4,17,2,30,10,4,0,14,2,30,6,0,0,6,0,30,7,7,0,14,1,30,5,9,0,14,3,30,3,1,0,4,1,-15,3,1
2,1,23,2,30,5,8,0,13,2,30,6,0,0,6,1,30,12,1,0,13,6,30,6,7,0,13,2,30,6,0,0,6,1,-15,3,1
2,2,23,2,30,5,8,0,13,2,30,6,0,0,6,1,30,12,1,0,13,6,30,6,7,0,13,2,30,6,0,0,6,1,-15,3,1
2,2,27,1,30,6,9,0,15,5,30,2,0,0,2,0,30,5,10,0,15,3,30,5,10,0,15,3,30,6,0,0,6,1,-15,3,1
2,4,27,0,30,6,9,0,15,5,30,2,0,0,2,0,30,5,10,0,15,3,30,5,10,0,15,3,30,6,0,0,6,1,-15,3,1
2,2,29,0,30,6,8,0,14,5,30,12,0,0,12,0,30,6,8,0,14,0,30,1,13,0,14,0,30,8,1,0,9,1,-15,3,1
2,4,29,0,30,6,8,0,14,5,30,12,0,0,12,0,30,6,8,0,14,0,30,1,13,0,14,0,30,8,1,0,9,1,-15,3,1
2,4,13,3,30,6,1,0,7,0,30,4,0,0,4,0,30,5,2,0,7,10,30,5,2,0,7,5,30,4,0,0,4,1,-15,3,1
2,1,19,0,30,4,9,0,13,2,30,4,4,0,8,0,30,7,6,0,13,8,30,4,9,0,13,2,30,9,0,0,9,1,-15,3,1
2,4,19,0,30,4,9,0,13,2,30,4,4,0,8,0,30,7,6,0,13,8,30,4,9,0,13,2,30,9,0,0,9,1,-15,3,1
2,3,23,3,30,5,8,0,13,3,30,6,0,0,6,7,30,13,0,0,13,0,30,6,7,0,13,2,30,5,1,0,6,1,-15,3,1
2,4,27,1,30,3,12,0,15,1,30,1,1,0,2,0,30,6,9,0,15,2,30,4,11,0,15,0,30,6,0,0,6,1,-15,3,1
2,2,31,1,30,7,5,0,12,3,30,8,0,0,8,3,30,11,1,0,12,0,30,3,9,0,12,0,30,2,4,0,6,1,-15,3,1
2,3,31,1,30,7,5,0,12,3,30,8,0,0,8,3,30,11,1,0,12,0,30,3,9,0,12,0,30,2,4,0,6,1,-15,3,1
2,4,7,1,30,2,2,0,4,2,30,2,0,0,2,0,30,1,3,0,4,0,30,0,4,0,4,1,30,2,0,0,2,0,-27,3,0
2,2,11,0,30,5,7,0,12,2,30,4,0,0,4,0,30,3,9,0,12,0,30,7,5,0,12,4,30,4,0,0,4,1,-15,3,1
2,4,19,0,30,3,10,0,13,0,30,4,4,0,8,0,30,5,8,0,13,3,30,7,6,0,13,3,30,9,0,0,9,1,-15,3,1
2,3,21,1,30,6,4,0,10,4,30,6,0,0,6,1,30,3,7,0,10,1,30,3,7,0,10,5,30,4,0,0,4,1,-15,3,1
2,2,25,1,30,6,8,0,14,5,30,6,0,0,6,0,30,4,10,0,14,2,30,10,4,0,14,4,30,6,0,0,6,1,-15,3,1
2,4,25,1,30,6,8,0,14,5,30,6,0,0,6,0,30,4,10,0,14,2,30,10,4,0,14,4,30,6,0,0,6,1,-15,3,1
2,3,27,1,30,9,6,0,15,3,30,1,1,0,2,0,30,2,13,0,15,2,30,5,10,0,15,4,30,6,0,0,6,1,-15,3,1
2,2,31,8,30,6,6,0,12,5,30,8,0,0,8,3,30,9,3,0,12,0,30,4,8,0,12,0,30,2,4,0,6,1,-15,3,1
2,4,31,8,30,6,6,0,12,5,30,8,0,0,8,3,30,9,3,0,12,0,30,4,8,0,12,0,30,2,4,0,6,1,-15,3,1
2,1,1,0,30,7,3,0,10,4,30,2,0,0,2,1,30,4,6,0,10,0,30,7,3,0,10,6,30,6,0,0,6,0,-27,3,0
2,3,1,0,30,7,3,0,10,4,30,2,0,0,2,1,30,4,6,0,10,0,30,7,3,0,10,6,30,6,0,0,6,0,-27,3,0
2,4,1,0,30,7,3,0,10,4,30,2,0,0,2,1,30,4,6,0,10,0,30,7,3,0,10,6,30,6,0,0,6,0,-27,3,0
2,0,5,3,30,1,4,0,5,3,30,2,2,0,4,0,30,0,5,0,5,0,30,1,4,0,5,0,30,0,2,0,2,0,-27,3,0
2,3,5,3,30,1,4,0,5,3,30,2,2,0,4,0,30,0,5,0,5,0,30,1,4,0,5,0,30,0,2,0,2,0,-27,3,0
2,4,11,0,30,5,7,0,12,1,30,4,0,0,4,0,30,6,6,0,12,3,30,7,5,0,12,6,30,4,0,0,4,1,-15,3,1
2,4,13,3,30,6,1,0,7,0,30,4,0,0,4,2,30,5,2,0,7,11,30,5,2,0,7,0,30,4,0,0,4,1,-15,3,1
2,3,17,0,30,10,4,0,14,2,30,6,0,0,6,0,30,4,10,0,14,0,30,6,8,0,14,5,30,4,0,0,4,1,-15,3,1
2,4,17,0,30,10,4,0,14,2,30,6,0,0,6,0,30,4,10,0,14,0,30,6,8,0,14,5,30,4,0,0,4,1,-15,3,1
2,1,19,0,30,3,10,0,13,3,30,6,2,0,8,0,30,4,9,0,13,7,30,5,8,0,13,1,30,9,0,0,9,1,-15,3,1
2,3,27,1,30,5,10,0,15,2,30,2,0,0,2,0,30,6,9,0,15,2,30,4,11,0,15,0,30,6,0,0,6,1,-15,3,1
2,0,39,0,30,4,7,0,11,6,30,6,0,0,6,0,30,7,4,0,11,2,30,2,9,0,11,3,30,5,0,0,5,1,-15,3,1
2,1,39,0,30,4,7,0,11,6,30,6,0,0,6,0,30,7,4,0,11,2,30,2,9,0,11,3,30,5,0,0,5,1,-15,3,1
2,3,39,0,30,4,7,0,11,6,30,6,0,0,6,0,30,7,4,0,11,2,30,2,9,0,11,3,30,5,0,0,5,1,-15,3,1
2,4,19,0,30,2,11,0,13,2,30,4,4,0,8,0,30,8,5,0,13,0,30,4,9,0,13,1,30,9,0,0,9,1,-15,3,1
2,4,22,1,30,6,2,0,8,3,30,2,0,0,2,0,30,4,4,0,8,0,30,7,1,0,8,5,30,4,0,0,4,1,-15,3,1
2,2,25,0,30,9,5,0,14,4,30,6,0,0,6,0,30,7,7,0,14,1,30,7,7,0,14,4,30,6,0,0,6,1,-15,3,1
2,3,29,0,30,7,7,0,14,6,30,12,0,0,12,0,30,4,10,0,14,0,30,0,14,0,14,0,30,9,0,0,9,1,-15,3,1
2,3,38,0,30,2,8,0,10,8,30,6,0,0,6,0,30,1,9,0,10,0,30,6,4,0,10,10,30,6,0,0,6,1,-15,3,1
2,0,4,2,30,7,1,0,8,4,30,2,2,0,4,1,30,5,3,0,8,0,30,6,2,0,8,1,30,4,0,0,4,0,-27,3,0
2,1,5,0,30,2,3,0,5,3,30,2,2,0,4,0,30,0,5,0,5,0,30,1,4,0,5,3,30,0,2,0,2,0,-27,3,0
2,2,5,0,30,2,3,0,5,3,30,2,2,0,4,0,30,0,5,0,5,0,30,1,4,0,5,3,30,0,2,0,2,0,-27,3,0
2,4,5,0,30,2,3,0,5,3,30,2,2,0,4,0,30,0,5,0,5,0,30,1,4,0,5,3,30,0,2,0,2,0,-27,3,0
2,2,13,3,30,3,0,0,3,1,30,2,0,0,2,0,30,3,0,0,3,5,30,2,1,0,3,2,30,2,0,0,2,1,-15,3,1
2,4,15,2,30,4,9,0,13,1,30,6,0,0,6,0,30,3,10,0,13,1,30,2,11,0,13,2,30,4,5,0,9,1,-15,3,1
2,3,17,2,30,10,4,0,14,1,30,6,0,0,6,0,30,8,6,0,14,1,30,5,9,0,14,5,30,4,0,0,4,1,-15,3,1
2,4,17,2,30,10,4,0,14,1,30,6,0,0,6,0,30,8,6,0,14,1,30,5,9,0,14,5,30,4,0,0,4,1,-15,3,1
2,2,23,4,30,7,6,0,13,3,30,6,0,0,6,3,30,12,1,0,13,0,30,6,7,0,13,2,30,5,1,0,6,1,-15,3,1
2,3,23,4,30,7,6,0,13,3,30,6,0,0,6,3,30,12,1,0,13,0,30,6,7,0,13,2,30,5,1,0,6,1,-15,3,1
2,4,23,4,30,7,6,0,13,3,30,6,0,0,6,3,30,12,1,0,13,0,30,6,7,0,13,2,30,5,1,0,6,1,-15,3,1
2,0,25,3,30,6,8,0,14,4,30,6,0,0,6,0,30,6,8,0,14,1,30,5,9,0,14,4,30,5,1,0,6,1,-15,3,1
2,3,25,3,30,6,8,0,14,4,30,6,0,0,6,0,30,6,8,0,14,1,30,5,9,0,14,4,30,5,1,0,6,1,-15,3,1
2,0,27,1,30,4,11,0,15,3,30,2,0,0,2,0,30,3,12,0,15,2,30,6,9,0,15,1,30,6,0,0,6,1,-15,3,1
2,2,27,1,30,4,11,0,15,3,30,2,0,0,2,0,30,3,12,0,15,2,30,6,9,0,15,1,30,6,0,0,6,1,-15,3,1
2,3,27,1,30,4,11,0,15,3,30,2,0,0,2,0,30,3,12,0,15,2,30,6,9,0,15,1,30,6,0,0,6,1,-15,3,1
2,4,31,0,30,11,1,0,12,4,30,8,0,0,8,3,30,9,3,0,12,0,30,3,9,0,12,0,30,3,3,0,6,1,-15,3,1
2,4,7,0,30,2,2,0,4,2,30,2,0,0,2,0,30,1,3,0,4,0,30,0,4,0,4,1,30,1,1,0,2,0,-27,3,0
2,4,7,1,30,4,5,0,9,3,30,4,0,0,4,0,30,5,4,0,9,3,30,4,5,0,9,1,30,4,2,0,6,0,-27,3,0
2,4,8,0,30,7,0,0,7,4,30,2,0,0,2,4,30,3,4,0,7,1,30,7,0,0,7,2,30,3,0,0,3,0,-27,3,0
2,4,11,7,30,4,8,0,12,2,30,4,0,0,4,2,30,5,7,0,12,0,30,5,7,0,12,3,30,3,1,0,4,1,-15,3,1
2,3,19,0,30,2,11,0,13,2,30,6,2,0,8,0,30,7,6,0,13,2,30,4,9,0,13,2,30,8,1,0,9,1,-15,3,1
2,4,19,0,30,2,11,0,13,2,30,6,2,0,8,0,30,7,6,0,13,2,30,4,9,0,13,2,30,8,1,0,9,1,-15,3,1
2,3,47,0,30,2,12,0,14,7,30,4,0,0,4,0,30,3,11,0,14,0,30,2,12,0,14,6,30,7,0,0,7,1,-15,3,1
2,2,4,2,30,8,0,0,8,4,30,4,0,0,4,1,30,2,6,0,8,0,30,3,5,0,8,1,30,2,2,0,4,0,-27,3,0
2,3,4,2,30,8,0,0,8,4,30,4,0,0,4,1,30,2,6,0,8,0,30,3,5,0,8,1,30,2,2,0,4,0,-27,3,0
2,4,4,2,30,8,0,0,8,4,30,4,0,0,4,1,30,2,6,0,8,0,30,3,5,0,8,1,30,2,2,0,4,0,-27,3,0
2,4,11,0,30,0,4,0,4,0,30,0,0,0,0,0,30,1,3,0,4,4,30,2,2,0,4,2,30,1,0,0,1,1,-15,3,1
2,0,17,4,30,9,5,0,14,3,30,6,0,0,6,0,30,5,9,0,14,1,30,6,8,0,14,4,30,4,0,0,4,1,-15,3,1
2,2,19,0,30,2,11,0,13,1,30,7,1,0,8,0,30,4,9,0,13,0,30,8,5,0,13,1,30,6,3,0,9,1,-15,3,1
2,3,19,0,30,2,11,0,13,1,30,7,1,0,8,0,30,4,9,0,13,0,30,8,5,0,13,1,30,6,3,0,9,1,-15,3,1
2,3,25,0,30,5,9,0,14,4,30,6,0,0,6,0,30,9,5,0,14,1,30,5,9,0,14,4,30,6,0,0,6,1,-15,3,1
2,4,25,0,30,5,9,0,14,4,30,6,0,0,6,0,30,9,5,0,14,1,30,5,9,0,14,4,30,6,0,0,6,1,-15,3,1
2,0,27,1,30,4,11,0,15,4,30,1,1,0,2,0,30,3,12,0,15,3,30,5,10,0,15,5,30,6,0,0,6,1,-15,3,1
2,1,27,1,30,4,11,0,15,4,30,1,1,0,2,0,30,3,12,0,15,3,30,5,10,0,15,5,30,6,0,0,6,1,-15,3,1
2,3,32,0,30,7,2,0,9,5,30,2,0,0,2,3,30,8,1,0,9,1,30,3,6,0,9,1,30,2,0,0,2,1,-15,3,1
2,0,39,0,30,4,7,0,11,6,30,6,0,0,6,0,30,5,6,0,11,0,30,2,9,0,11,5,30,5,0,0,5,1,-15,3,1
2,1,39,0,30,4,7,0,11,6,30,6,0,0,6,0,30,5,6,0,11,0,30,2,9,0,11,5,30,5,0,0,5,1,-15,3,1
2,4,5,0,30,2,3,0,5,3,30,1,3,0,4,3,30,0,5,0,5,0,30,1,4,0,5,0,30,0,2,0,2,0,-27,3,0
2,3,17,4,30,8,6,0,14,3,30,6,0,0,6,0,30,6,8,0,14,2,30,6,8,0,14,1,30,4,0,0,4,1,-15,3,1
2,0,21,2,30,8,2,0,10,4,30,6,0,0,6,1,30,3,7,0,10,3,30,6,4,0,10,2,30,4,0,0,4,1,-15,3,1
2,0,27,1,30,4,11,0,15,3,30,1,1,0,2,0,30,7,8,0,15,0,30,4,11,0,15,3,30,6,0,0,6,1,-15,3,1
2,3,27,1,30,4,11,0,15,3,30,1,1,0,2,0,30,7,8,0,15,0,30,4,11,0,15,3,30,6,0,0,6,1,-15,3,1
2,0,29,0,30,6,8,0,14,6,30,11,1,0,12,0,30,3,11,0,14,0,30,0,14,0,14,3,30,9,0,0,9,1,-15,3,1
2,1,29,0,30,6,8,0,14,6,30,11,1,0,12,0,30,3,11,0,14,0,30,0,14,0,14,3,30,9,0,0,9,1,-15,3,1
2,1,5,1,30,2,3,0,5,3,30,2,2,0,4,0,30,0,5,0,5,0,30,1,4,0,5,0,30,0,2,0,2,0,-27,3,0
2,3,5,1,30,2,3,0,5,3,30,2,2,0,4,0,30,0,5,0,5,0,30,1,4,0,5,0,30,0,2,0,2,0,-27,3,0
2,4,5,1,30,2,3,0,5,3,30,2,2,0,4,0,30,0,5,0,5,0,30,1,4,0,5,0,30,0,2,0,2,0,-27,3,0
2,2,17,4,30,10,4,0,14,2,30,6,0,0,6,0,30,8,6,0,14,1,30,5,9,0,14,4,30,4,0,0,4,1,-15,3,1
2,2,19,0,30,2,11,0,13,2,30,8,0,0,8,0,30,5,8,0,13,4,30,5,8,0,13,1,30,7,2,0,9,1,-15,3,1
2,4,35,3,30,8,5,0,13,3,30,2,0,0,2,0,30,6,7,0,13,0,30,2,11,0,13,3,30,6,2,0,8,1,-15,3,1
2,3,36,0,30,4,5,0,9,5,30,2,0,0,2,4,30,6,3,0,9,1,30,1,8,0,9,4,30,3,0,0,3,1,-15,3,1
2,4,36,0,30,4,5,0,9,5,30,2,0,0,2,4,30,6,3,0,9,1,30,1,8,0,9,4,30,3,0,0,3,1,-15,3,1
2,1,4,2,30,8,0,0,8,5,30,4,0,0,4,0,30,1,7,0,8,4,30,8,0,0,8,2,30,3,1,0,4,0,-27,3,0
2,2,11,1,30,4,8,0,12,0,30,4,0,0,4,0,30,7,5,0,12,6,30,4,8,0,12,4,30,4,0,0,4,1,-15,3,1
2,2,13,1,30,7,0,0,7,1,30,4,0,0,4,2,30,5,2,0,7,8,30,6,1,0,7,3,30,4,0,0,4,1,-15,3,1
2,4,13,1,30,7,0,0,7,1,30,4,0,0,4,2,30,5,2,0,7,8,30,6,1,0,7,3,30,4,0,0,4,1,-15,3,1
2,3,17,3,30,10,4,0,14,1,30,6,0,0,6,0,30,8,6,0,14,1,30,5,9,0,14,5,30,4,0,0,4,1,-15,3,1
2,3,19,0,30,2,11,0,13,2,30,7,1,0,8,0,30,4,9,0,13,3,30,4,9,0,13,0,30,9,0,0,9,1,-15,3,1
2,4,19,0,30,2,11,0,13,2,30,7,1,0,8,0,30,4,9,0,13,3,30,4,9,0,13,0,30,9,0,0,9,1,-15,3,1
2,4,23,1,30,5,8,0,13,2,30,5,1,0,6,8,30,10,3,0,13,0,30,3,10,0,13,3,30,5,1,0,6,1,-15,3,1
2,0,27,3,30,5,10,0,15,1,30,2,0,0,2,0,30,12,3,0,15,0,30,3,12,0,15,1,30,4,2,0,6,1,-15,3,1
2,1,27,3,30,5,10,0,15,1,30,2,0,0,2,0,30,12,3,0,15,0,30,3,12,0,15,1,30,4,2,0,6,1,-15,3,1
2,0,4,6,30,8,0,0,8,4,30,4,0,0,4,0,30,1,7,0,8,0,30,4,4,0,8,1,30,3,1,0,4,0,-27,3,0
2,3,4,0,30,8,0,0,8,4,30,4,0,0,4,0,30,1,7,0,8,0,30,4,4,0,8,1,30,3,1,0,4,0,-27,3,0
2,2,11,2,30,3,9,0,12,2,30,4,0,0,4,0,30,4,8,0,12,2,30,7,5,0,12,5,30,4,0,0,4,1,-15,3,1
2,3,11,2,30,3,9,0,12,2,30,4,0,0,4,0,30,4,8,0,12,2,30,7,5,0,12,5,30,4,0,0,4,1,-15,3,1
2,3,13,2,30,7,0,0,7,0,30,4,0,0,4,2,30,6,1,0,7,5,30,6,1,0,7,4,30,4,0,0,4,1,-15,3,1
2,4,15,0,30,4,9,0,13,0,30,6,0,0,6,0,30,7,6,0,13,1,30,4,9,0,13,2,30,8,1,0,9,1,-15,3,1
2,2,17,3,30,11,3,0,14,3,30,6,0,0,6,0,30,4,10,0,14,2,30,7,7,0,14,6,30,4,0,0,4,1,-15,3,1
2,2,19,0,30,5,8,0,13,2,30,8,0,0,8,0,30,4,9,0,13,4,30,4,9,0,13,0,30,6,3,0,9,1,-15,3,1
2,4,19,0,30,5,8,0,13,2,30,8,0,0,8,0,30,4,9,0,13,4,30,4,9,0,13,0,30,6,3,0,9,1,-15,3,1
2,1,27,2,30,6,9,0,15,5,30,1,1,0,2,6,30,3,12,0,15,0,30,12,3,0,15,0,30,2,4,0,6,1,-15,3,1
2,3,27,2,30,6,9,0,15,5,30,1,1,0,2,0,30,3,12,0,15,0,30,12,3,0,15,0,30,2,4,0,6,1,-15,3,1
2,4,27,2,30,6,9,0,15,5,30,1,1,0,2,0,30,3,12,0,15,0,30,12,3,0,15,0,30,2,4,0,6,1,-15,3,1
2,2,31,1,30,8,4,0,12,4,30,8,0,0,8,3,30,9,3,0,12,0,30,3,9,0,12,1,30,2,4,0,6,1,-15,3,1
2,3,31,1,30,8,4,0,12,4,30,8,0,0,8,3,30,9,3,0,12,0,30,3,9,0,12,1,30,2,4,0,6,1,-15,3,1
2,3,5,0,30,2,3,0,5,3,30,0,4,0,4,0,30,1,4,0,5,0,30,1,4,0,5,2,30,0,2,0,2,0,-27,3,0
2,4,8,1,30,7,0,0,7,4,30,2,0,0,2,0,30,3,4,0,7,0,30,6,1,0,7,6,30,3,0,0,3,0,-27,3,0
2,1,19,0,30,2,11,0,13,3,30,4,4,0,8,0,30,5,8,0,13,7,30,8,5,0,13,3,30,9,0,0,9,1,-15,3,1
2,2,19,0,30,2,11,0,13,3,30,4,4,0,8,0,30,5,8,0,13,7,30,8,5,0,13,3,30,9,0,0,9,1,-15,3,1
2,4,19,0,30,2,11,0,13,3,30,4,4,0,8,0,30,5,8,0,13,7,30,8,5,0,13,3,30,9,0,0,9,1,-15,3,1
2,2,23,4,30,6,7,0,13,3,30,6,0,0,6,2,30,12,1,0,13,0,30,5,8,0,13,1,30,5,1,0,6,1,-15,3,1
2,3,23,4,30,6,7,0,13,3,30,6,0,0,6,2,30,12,1,0,13,0,30,5,8,0,13,1,30,5,1,0,6,1,-15,3,1
2,4,23,4,30,6,7,0,13,3,30,6,0,0,6,2,30,12,1,0,13,0,30,5,8,0,13,1,30,5,1,0,6,1,-15,3,1
2,4,25,1,30,6,8,0,14,5,30,6,0,0,6,0,30,5,9,0,14,1,30,5,9,0,14,4,30,5,1,0,6,1,-15,3,1
2,4,27,1,30,4,11,0,15,3,30,2,0,0,2,0,30,7,8,0,15,4,30,5,10,0,15,3,30,6,0,0,6,1,-15,3,1
2,4,29,0,30,7,7,0,14,6,30,11,1,0,12,0,30,3,11,0,14,0,30,2,12,0,14,0,30,9,0,0,9,1,-15,3,1
2,3,47,0,30,0,14,0,14,7,30,4,0,0,4,0,30,4,10,0,14,0,30,2,12,0,14,8,30,7,0,0,7,1,-15,3,1
2,2,5,0,30,2,3,0,5,3,30,2,2,0,4,0,30,0,5,0,5,0,30,1,4,0,5,3,30,2,0,0,2,0,-27,3,0
2,4,7,0,30,1,3,0,4,2,30,2,0,0,2,1,30,2,2,0,4,0,30,0,4,0,4,1,30,1,1,0,2,0,-27,3,0
2,1,13,4,30,6,1,0,7,0,30,4,0,0,4,2,30,6,1,0,7,4,30,6,1,0,7,6,30,4,0,0,4,1,-15,3,1
2,2,13,4,30,6,1,0,7,0,30,4,0,0,4,2,30,6,1,0,7,4,30,6,1,0,7,6,30,4,0,0,4,1,-15,3,1
2,3,13,4,30,6,1,0,7,0,30,4,0,0,4,2,30,6,1,0,7,4,30,6,1,0,7,6,30,4,0,0,4,1,-15,3,1
2,4,23,2,30,11,2,0,13,2,30,6,0,0,6,2,30,11,2,0,13,0,30,5,8,0,13,0,30,5,1,0,6,1,-15,3,1
2,0,27,1,30,4,11,0,15,2,30,1,1,0,2,0,30,7,8,0,15,5,30,4,11,0,15,5,30,6,0,0,6,1,-15,3,1
2,4,27,1,30,4,11,0,15,2,30,1,1,0,2,0,30,7,8,0,15,5,30,4,11,0,15,5,30,6,0,0,6,1,-15,3,1
2,1,33,4,30,5,6,0,11,4,30,4,0,0,4,3,30,11,0,0,11,0,30,3,8,0,11,6,30,4,0,0,4,1,-15,3,1
2,4,33,4,30,5,6,0,11,4,30,4,0,0,4,3,30,11,0,0,11,0,30,3,8,0,11,6,30,4,0,0,4,1,-15,3,1
2,3,35,1,30,7,6,0,13,6,30,2,0,0,2,1,30,2,11,0,13,5,30,2,11,0,13,5,30,8,0,0,8,1,-15,3,1
2,0,45,0,30,4,9,0,13,10,30,10,0,0,10,4,30,0,13,0,13,0,30,4,9,0,13,10,30,5,0,0,5,1,-15,3,1
2,3,45,0,30,4,9,0,13,10,30,10,0,0,10,4,30,0,13,0,13,0,30,4,9,0,13,10,30,5,0,0,5,1,-15,3,1
2,2,17,3,30,10,4,0,14,2,30,6,0,0,6,0,30,7,7,0,14,1,30,5,9,0,14,6,30,4,0,0,4,1,-15,3,1
2,1,27,1,30,7,8,0,15,4,30,1,1,0,2,0,30,6,9,0,15,0,30,4,11,0,15,2,30,6,0,0,6,1,-15,3,1
2,2,27,1,30,7,8,0,15,4,30,1,1,0,2,0,30,6,9,0,15,0,30,4,11,0,15,2,30,6,0,0,6,1,-15,3,1
2,0,31,4,30,8,4,0,12,4,30,8,0,0,8,3,30,11,1,0,12,0,30,3,9,0,12,0,30,4,2,0,6,1,-15,3,1
2,1,5,0,30,2,3,0,5,3,30,0,4,0,4,0,30,0,5,0,5,0,30,1,4,0,5,0,30,1,1,0,2,0,-27,3,0
2,2,13,10,30,7,0,0,7,0,30,4,0,0,4,1,30,6,1,0,7,6,30,3,4,0,7,2,30,4,0,0,4,1,-15,3,1
2,4,13,10,30,7,0,0,7,0,30,4,0,0,4,1,30,6,1,0,7,6,30,3,4,0,7,2,30,4,0,0,4,1,-15,3,1
2,1,21,1,30,8,2,0,10,3,30,6,0,0,6,1,30,5,5,0,10,4,30,5,5,0,10,2,30,4,0,0,4,1,-15,3,1
2,4,21,1,30,8,2,0,10,3,30,6,0,0,6,1,30,5,5,0,10,4,30,5,5,0,10,2,30,4,0,0,4,1,-15,3,1
2,4,25,0,30,8,6,0,14,3,30,6,0,0,6,0,30,9,5,0,14,1,30,5,9,0,14,0,30,5,1,0,6,1,-15,3,1
2,2,27,0,30,4,11,0,15,5,30,2,0,0,2,0,30,5,10,0,15,3,30,8,7,0,15,1,30,5,1,0,6,1,-15,3,1
2,3,27,0,30,4,11,0,15,5,30,2,0,0,2,0,30,5,10,0,15,3,30,8,7,0,15,1,30,5,1,0,6,1,-15,3,1
2,2,35,1,30,7,6,0,13,5,30,2,0,0,2,1,30,2,11,0,13,0,30,3,10,0,13,9,30,8,0,0,8,1,-15,3,1
2,3,35,1,30,7,6,0,13,5,30,2,0,0,2,1,30,2,11,0,13,0,30,3,10,0,13,9,30,8,0,0,8,1,-15,3,1
2,2,43,0,30,8,6,0,14,6,30,6,0,0,6,0,30,9,5,0,14,1,30,1,13,0,14,3,30,5,0,0,5,1,-15,3,1
2,2,47,0,30,1,13,0,14,8,30,4,0,0,4,0,30,3,11,0,14,0,30,7,7,0,14,9,30,7,0,0,7,1,-15,3,1
2,1,5,0,30,1,4,0,5,2,30,1,3,0,4,1,30,2,3,0,5,0,30,1,4,0,5,1,30,0,2,0,2,0,-27,3,0
2,2,5,0,30,1,4,0,5,2,30,1,3,0,4,1,30,2,3,0,5,0,30,1,4,0,5,1,30,0,2,0,2,0,-27,3,0
2,3,5,0,30,1,4,0,5,2,30,1,3,0,4,1,30,2,3,0,5,0,30,1,4,0,5,1,30,0,2,0,2,0,-27,3,0
2,2,13,2,30,6,1,0,7,1,30,4,0,0,4,2,30,6,1,0,7,10,30,5,2,0,7,2,30,4,0,0,4,1,-15,3,1
2,4,13,2,30,6,1,0,7,1,30,4,0,0,4,2,30,6,1,0,7,10,30,5,2,0,7,2,30,4,0,0,4,1,-15,3,1
2,1,17,4,30,11,3,0,14,3,30,6,0,0,6,0,30,5,9,0,14,5,30,5,9,0,14,3,30,4,0,0,4,1,-15,3,1
2,2,17,4,30,11,3,0,14,3,30,6,0,0,6,0,30,5,9,0,14,5,30,5,9,0,14,3,30,4,0,0,4,1,-15,3,1
2,3,21,1,30,5,5,0,10,3,30,6,0,0,6,1,30,3,7,0,10,4,30,3,7,0,10,5,30,4,0,0,4,1,-15,3,1
2,4,21,1,30,5,5,0,10,3,30,6,0,0,6,1,30,3,7,0,10,4,30,3,7,0,10,5,30,4,0,0,4,1,-15,3,1
2,2,25,1,30,6,8,0,14,5,30,6,0,0,6,0,30,8,6,0,14,2,30,6,8,0,14,4,30,5,1,0,6,1,-15,3,1
2,4,25,1,30,6,8,0,14,5,30,6,0,0,6,0,30,8,6,0,14,2,30,6,8,0,14,4,30,5,1,0,6,1,-15,3,1
2,0,26,0,30,7,2,0,9,5,30,4,0,0,4,4,30,1,8,0,9,0,30,3,6,0,9,6,30,3,0,0,3,1,-15,3,1
2,1,26,0,30,7,2,0,9,5,30,4,0,0,4,4,30,1,8,0,9,0,30,3,6,0,9,6,30,3,0,0,3,1,-15,3,1
2,2,26,0,30,7,2,0,9,5,30,4,0,0,4,4,30,1,8,0,9,0,30,3,6,0,9,6,30,3,0,0,3,1,-15,3,1
2,2,27,1,30,5,10,0,15,3,30,2,0,0,2,0,30,5,10,0,15,0,30,6,9,0,15,4,30,6,0,0,6,1,-15,3,1
2,4,27,1,30,5,10,0,15,3,30,2,0,0,2,0,30,5,10,0,15,0,30,6,9,0,15,4,30,6,0,0,6,1,-15,3,1
2,4,31,1,30,8,4,0,12,3,30,8,0,0,8,4,30,11,1,0,12,0,30,3,9,0,12,0,30,2,4,0,6,1,-15,3,1
2,1,35,2,30,10,3,0,13,2,30,2,0,0,2,1,30,10,3,0,13,2,30,1,12,0,13,3,30,8,0,0,8,1,-15,3,1
2,3,35,2,30,10,3,0,13,2,30,2,0,0,2,1,30,10,3,0,13,2,30,1,12,0,13,3,30,8,0,0,8,1,-15,3,1
2,4,35,2,30,10,3,0,13,2,30,2,0,0,2,1,30,10,3,0,13,2,30,1,12,0,13,3,30,8,0,0,8,1,-15,3,1
2,1,39,0,30,2,9,0,11,6,30,6,0,0,6,0,30,8,3,0,11,1,30,5,6,0,11,2,30,5,0,0,5,1,-15,3,1
2,4,39,0,30,2,9,0,11,6,30,6,0,0,6,0,30,8,3,0,11,1,30,5,6,0,11,2,30,5,0,0,5,1,-15,3,1
2,2,5,0,30,1,4,0,5,2,30,3,1,0,4,0,30,0,5,0,5,0,30,1,4,0,5,3,30,2,0,0,2,0,-27,3,0
2,3,5,0,30,1,4,0,5,2,30,3,1,0,4,0,30,0,5,0,5,0,30,1,4,0,5,3,30,2,0,0,2,0,-27,3,0
2,4,5,0,30,1,4,0,5,2,30,3,1,0,4,0,30,0,5,0,5,0,30,1,4,0,5,3,30,2,0,0,2,0,-27,3,0
2,1,13,9,30,7,0,0,7,3,30,4,0,0,4,3,30,7,0,0,7,2,30,6,1,0,7,5,30,4,0,0,4,1,-15,3,1
2,2,13,9,30,7,0,0,7,3,30,4,0,0,4,3,30,7,0,0,7,2,30,6,1,0,7,5,30,4,0,0,4,1,-15,3,1
2,3,13,9,30,7,0,0,7,3,30,4,0,0,4,3,30,7,0,0,7,2,30,6,1,0,7,5,30,4,0,0,4,1,-15,3,1
2,4,13,9,30,7,0,0,7,3,30,4,0,0,4,3,30,7,0,0,7,2,30,6,1,0,7,5,30,4,0,0,4,1,-15,3,1
2,4,19,0,30,5,8,0,13,2,30,8,0,0,8,4,30,4,9,0,13,0,30,4,9,0,13,0,30,7,2,0,9,1,-15,3,1
2,2,25,1,30,2,12,0,14,3,30,6,0,0,6,0,30,9,5,0,14,1,30,8,6,0,14,4,30,5,1,0,6,1,-15,3,1
2,3,25,1,30,2,12,0,14,3,30,6,0,0,6,0,30,9,5,0,14,1,30,8,6,0,14,4,30,5,1,0,6,1,-15,3,1
2,0,27,1,30,3,12,0,15,5,30,2,0,0,2,0,30,7,8,0,15,0,30,6,9,0,15,5,30,6,0,0,6,1,-15,3,1
2,1,27,1,30,3,12,0,15,5,30,2,0,0,2,0,30,7,8,0,15,0,30,6,9,0,15,5,30,6,0,0,6,1,-15,3,1
2,2,27,1,30,3,12,0,15,5,30,2,0,0,2,0,30,7,8,0,15,0,30,6,9,0,15,5,30,6,0,0,6,1,-15,3,1
2,4,27,1,30,3,12,0,15,5,30,2,0,0,2,0,30,7,8,0,15,0,30,6,9,0,15,5,30,6,0,0,6,1,-15,3,1
2,3,29,0,30,6,8,0,14,6,30,10,2,0,12,0,30,3,11,0,14,0,30,2,12,0,14,3,30,9,0,0,9,1,-15,3,1
2,1,33,1,30,2,9,0,11,6,30,4,0,0,4,0,30,6,5,0,11,0,30,6,5,0,11,6,30,4,0,0,4,1,-15,3,1
2,2,33,1,30,2,9,0,11,6,30,4,0,0,4,0,30,6,5,0,11,0,30,6,5,0,11,6,30,4,0,0,4,1,-15,3,1
2,0,5,0,30,2,3,0,5,3,30,1,3,0,4,0,30,1,4,0,5,0,30,1,4,0,5,0,30,0,2,0,2,0,-27,3,0
2,4,5,0,30,2,3,0,5,3,30,1,3,0,4,0,30,1,4,0,5,0,30,1,4,0,5,0,30,0,2,0,2,0,-27,3,0
2,2,11,1,30,6,6,0,12,1,30,4,0,0,4,0,30,8,4,0,12,2,30,8,4,0,12,4,30,4,0,0,4,1,-15,3,1
2,4,11,1,30,6,6,0,12,1,30,4,0,0,4,0,30,8,4,0,12,2,30,8,4,0,12,4,30,4,0,0,4,1,-15,3,1
2,0,13,2,30,7,0,0,7,1,30,4,0,0,4,7,30,7,0,0,7,10,30,4,3,0,7,4,30,4,0,0,4,1,-15,3,1
2,4,13,2,30,7,0,0,7,1,30,4,0,0,4,7,30,7,0,0,7,10,30,4,3,0,7,4,30,4,0,0,4,1,-15,3,1
2,3,17,3,30,9,5,0,14,1,30,6,0,0,6,0,30,8,6,0,14,0,30,5,9,0,14,5,30,4,0,0,4,1,-15,3,1
2,4,17,3,30,9,5,0,14,1,30,6,0,0,6,0,30,8,6,0,14,0,30,5,9,0,14,5,30,4,0,0,4,1,-15,3,1
2,2,19,0,30,2,11,0,13,2,30,5,3,0,8,0,30,4,9,0,13,5,30,4,9,0,13,1,30,9,0,0,9,1,-15,3,1
2,4,19,0,30,2,11,0,13,0,30,5,3,0,8,0,30,4,9,0,13,5,30,4,9,0,13,1,30,9,0,0,9,1,-15,3,1
2,0,25,1,30,5,9,0,14,4,30,6,0,0,6,5,30,11,3,0,14,1,30,5,9,0,14,3,30,6,0,0,6,1,-15,3,1
2,4,25,1,30,5,9,0,14,4,30,6,0,0,6,5,30,11,3,0,14,1,30,5,9,0,14,0,30,6,0,0,6,1,-15,3,1
2,0,26,0,30,4,5,0,9,4,30,4,0,0,4,2,30,5,4,0,9,0,30,2,7,0,9,5,30,1,2,0,3,1,-15,3,1
2,2,31,1,30,5,7,0,12,7,30,8,0,0,8,3,30,4,8,0,12,2,30,7,5,0,12,3,30,6,0,0,6,1,-15,3,1
2,3,33,6,30,4,7,0,11,6,30,4,0,0,4,8,30,10,1,0,11,0,30,3,8,0,11,3,30,4,0,0,4,1,-15,3,1
2,1,37,0,30,7,4,0,11,5,30,6,2,0,8,1,30,11,0,0,11,2,30,3,8,0,11,2,30,6,0,0,6,1,-15,3,1
2,0,38,2,30,8,2,0,10,8,30,6,0,0,6,0,30,2,8,0,10,0,30,2,8,0,10,5,30,6,0,0,6,1,-15,3,1
2,2,38,2,30,8,2,0,10,8,30,6,0,0,6,0,30,2,8,0,10,0,30,2,8,0,10,5,30,6,0,0,6,1,-15,3,1
2,3,38,2,30,8,2,0,10,8,30,6,0,0,6,0,30,2,8,0,10,0,30,2,8,0,10,5,30,6,0,0,6,1,-15,3,1
2,3,43,0,30,8,6,0,14,7,30,6,0,0,6,0,30,6,8,0,14,1,30,1,13,0,14,0,30,5,0,0,5,1,-15,3,1
2,0,5,0,30,4,1,0,5,3,30,2,2,0,4,0,30,0,5,0,5,0,30,1,4,0,5,0,30,0,2,0,2,0,-27,3,0
2,1,5,0,30,4,1,0,5,3,30,2,2,0,4,0,30,0,5,0,5,0,30,1,4,0,5,0,30,0,2,0,2,0,-27,3,0
2,2,5,0,30,4,1,0,5,3,30,2,2,0,4,0,30,0,5,0,5,0,30,1,4,0,5,0,30,0,2,0,2,0,-27,3,0
2,3,5,0,30,4,1,0,5,3,30,2,2,0,4,0,30,0,5,0,5,0,30,1,4,0,5,0,30,0,2,0,2,0,-27,3,0
2,4,5,0,30,4,1,0,5,3,30,2,2,0,4,0,30,0,5,0,5,0,30,1,4,0,5,0,30,0,2,0,2,0,-27,3,0
2,0,19,0,30,2,11,0,13,3,30,6,2,0,8,0,30,4,9,0,13,5,30,7,6,0,13,1,30,9,0,0,9,1,-15,3,1
2,1,19,0,30,2,11,0,13,3,30,6,2,0,8,0,30,4,9,0,13,5,30,7,6,0,13,1,30,9,0,0,9,1,-15,3,1
2,3,19,0,30,2,11,0,13,3,30,6,2,0,8,0,30,4,9,0,13,5,30,7,6,0,13,1,30,9,0,0,9,1,-15,3,1
2,0,25,2,30,2,12,0,14,3,30,6,0,0,6,0,30,6,8,0,14,1,30,10,4,0,14,4,30,6,0,0,6,1,-15,3,1
2,4,25,2,30,2,12,0,14,3,30,6,0,0,6,0,30,6,8,0,14,1,30,10,4,0,14,4,30,6,0,0,6,1,-15,3,1
2,2,1,0,30,7,3,0,10,4,30,2,0,0,2,0,30,4,6,0,10,6,30,8,2,0,10,6,30,6,0,0,6,0,-27,3,0
2,4,5,0,30,1,4,0,5,2,30,3,1,0,4,0,30,1,4,0,5,0,30,1,4,0,5,0,30,0,2,0,2,0,-27,3,0
2,1,7,0,30,2,2,0,4,2,30,2,0,0,2,0,30,1,3,0,4,0,30,1,3,0,4,2,30,2,0,0,2,0,-27,3,0
2,1,13,2,30,7,0,0,7,0,30,4,0,0,4,1,30,6,1,0,7,10,30,4,3,0,7,6,30,4,0,0,4,1,-15,3,1
2,2,13,2,30,7,0,0,7,0,30,4,0,0,4,1,30,6,1,0,7,10,30,4,3,0,7,6,30,4,0,0,4,1,-15,3,1
2,2,19,1,30,6,7,0,13,2,30,6,2,0,8,0,30,7,6,0,13,9,30,4,9,0,13,0,30,8,1,0,9,1,-15,3,1
2,4,43,0,30,11,3,0,14,7,30,6,0,0,6,0,30,4,10,0,14,3,30,2,12,0,14,0,30,5,0,0,5,1,-15,3,1
2,4,6,0,30,5,4,0,9,3,30,2,0,0,2,0,30,3,6,0,9,0,30,4,5,0,9,1,30,3,2,0,5,0,-27,3,0
2,3,7,0,30,1,3,0,4,2,30,2,0,0,2,0,30,2,2,0,4,0,30,1,3,0,4,2,30,2,0,0,2,0,-27,3,0
2,3,11,3,30,5,7,0,12,2,30,4,0,0,4,0,30,3,9,0,12,0,30,6,6,0,12,3,30,3,1,0,4,1,-15,3,1
2,4,11,3,30,5,7,0,12,2,30,4,0,0,4,0,30,3,9,0,12,0,30,6,6,0,12,3,30,3,1,0,4,1,-15,3,1
2,1,12,0,30,6,1,0,7,2,30,4,2,0,6,1,30,2,5,0,7,5,30,6,1,0,7,4,30,3,0,0,3,1,-15,3,1
2,2,12,0,30,6,1,0,7,2,30,4,2,0,6,1,30,2,5,0,7,5,30,6,1,0,7,4,30,3,0,0,3,1,-15,3,1
2,3,19,0,30,3,10,0,13,2,30,6,2,0,8,0,30,5,8,0,13,0,30,8,5,0,13,2,30,6,3,0,9,1,-15,3,1
2,3,22,2,30,8,0,0,8,3,30,2,0,0,2,0,30,4,4,0,8,1,30,4,4,0,8,1,30,2,2,0,4,1,-15,3,1
2,4,23,2,30,6,7,0,13,2,30,6,0,0,6,5,30,10,3,0,13,0,30,4,9,0,13,1,30,5,1,0,6,1,-15,3,1
2,3,25,1,30,6,8,0,14,3,30,6,0,0,6,0,30,13,1,0,14,1,30,5,9,0,14,0,30,5,1,0,6,1,-15,3,1
2,0,27,1,30,10,5,0,15,4,30,2,0,0,2,0,30,2,13,0,15,1,30,5,10,0,15,3,30,6,0,0,6,1,-15,3,1
2,2,27,1,30,10,5,0,15,4,30,2,0,0,2,0,30,2,13,0,15,1,30,5,10,0,15,3,30,6,0,0,6,1,-15,3,1
2,2,35,1,30,8,5,0,13,7,30,2,0,0,2,1,30,2,11,0,13,4,30,5,8,0,13,0,30,8,0,0,8,1,-15,3,1
2,3,35,1,30,8,5,0,13,7,30,2,0,0,2,1,30,2,11,0,13,4,30,5,8,0,13,0,30,8,0,0,8,1,-15,3,1
2,4,35,1,30,8,5,0,13,7,30,2,0,0,2,1,30,2,11,0,13,4,30,5,8,0,13,0,30,8,0,0,8,1,-15,3,1
2,1,38,0,30,2,8,0,10,6,30,6,0,0,6,0,30,1,9,0,10,0,30,2,8,0,10,5,30,6,0,0,6,1,-15,3,1
2,2,38,0,30,2,8,0,10,6,30,6,0,0,6,0,30,1,9,0,10,0,30,2,8,0,10,5,30,6,0,0,6,1,-15,3,1
2,3,38,0,30,2,8,0,10,6,30,6,0,0,6,0,30,1,9,0,10,0,30,2,8,0,10,5,30,6,0,0,6,1,-15,3,1
2,4,38,0,30,2,8,0,10,6,30,6,0,0,6,0,30,1,9,0,10,0,30,2,8,0,10,5,30,6,0,0,6,1,-15,3,1
2,2,45,0,30,5,8,0,13,9,30,10,0,0,10,0,30,0,13,0,13,0,30,4,9,0,13,9,30,5,0,0,5,1,-15,3,1
2,3,6,1,30,9,0,0,9,4,30,2,0,0,2,0,30,3,6,0,9,0,30,4,5,0,9,0,30,4,1,0,5,0,-27,3,0
2,4,6,1,30,9,0,0,9,4,30,2,0,0,2,0,30,3,6,0,9,0,30,4,5,0,9,0,30,4,1,0,5,0,-27,3,0
2,3,7,0,30,3,1,0,4,2,30,2,0,0,2,0,30,1,3,0,4,0,30,1,3,0,4,1,30,2,0,0,2,0,-27,3,0
2,4,8,2,30,7,0,0,7,4,30,2,0,0,2,0,30,5,2,0,7,0,30,4,3,0,7,1,30,3,0,0,3,0,-27,3,0
2,4,9,0,30,1,3,0,4,2,30,2,0,0,2,0,30,1,3,0,4,4,30,1,3,0,4,0,30,1,0,0,1,0,-27,3,0
2,2,13,1,30,6,1,0,7,0,30,4,0,0,4,0,30,6,1,0,7,10,30,5,2,0,7,6,30,4,0,0,4,1,-15,3,1
2,4,13,1,30,6,1,0,7,0,30,4,0,0,4,0,30,6,1,0,7,10,30,5,2,0,7,6,30,4,0,0,4,1,-15,3,1
2,3,19,0,30,3,10,0,13,1,30,6,2,0,8,0,30,11,2,0,13,4,30,4,9,0,13,2,30,8,1,0,9,1,-15,3,1
2,4,19,0,30,3,10,0,13,1,30,6,2,0,8,0,30,11,2,0,13,4,30,4,9,0,13,2,30,8,1,0,9,1,-15,3,1
2,1,21,1,30,6,4,0,10,4,30,6,0,0,6,1,30,3,7,0,10,3,30,5,5,0,10,6,30,4,0,0,4,1,-15,3,1
2,2,21,1,30,6,4,0,10,4,30,6,0,0,6,1,30,3,7,0,10,3,30,5,5,0,10,6,30,4,0,0,4,1,-15,3,1
2,3,25,1,30,4,10,0,14,5,30,6,0,0,6,0,30,5,9,0,14,2,30,8,6,0,14,4,30,6,0,0,6,1,-15,3,1
2,3,27,1,30,6,9,0,15,2,30,2,0,0,2,1,30,10,5,0,15,0,30,4,11,0,15,1,30,2,4,0,6,1,-15,3,1
2,3,29,0,30,6,8,0,14,6,30,12,0,0,12,0,30,3,11,0,14,0,30,3,11,0,14,3,30,9,0,0,9,1,-15,3,1
2,4,32,0,30,4,5,0,9,4,30,2,0,0,2,1,30,8,1,0,9,1,30,3,6,0,9,1,30,2,0,0,2,1,-15,3,1
2,1,1,0,30,7,3,0,10,4,30,2,0,0,2,0,30,4,6,0,10,3,30,7,3,0,10,6,30,6,0,0,6,0,-27,3,0
2,0,5,0,30,4,1,0,5,3,30,3,1,0,4,0,30,0,5,0,5,1,30,2,3,0,5,0,30,0,2,0,2,0,-27,3,0
2,1,5,0,30,4,1,0,5,3,30,3,1,0,4,0,30,0,5,0,5,1,30,2,3,0,5,0,30,0,2,0,2,0,-27,3,0
2,2,5,0,30,4,1,0,5,3,30,3,1,0,4,0,30,0,5,0,5,1,30,2,3,0,5,0,30,0,2,0,2,0,-27,3,0
2,3,6,2,30,8,1,0,9,4,30,2,0,0,2,0,30,2,7,0,9,0,30,4,5,0,9,0,30,4,1,0,5,0,-27,3,0
2,3,8,1,30,7,0,0,7,3,30,2,0,0,2,6,30,5,2,0,7,1,30,7,0,0,7,0,30,3,0,0,3,0,-27,3,0
2,4,8,1,30,7,0,0,7,3,30,2,0,0,2,6,30,5,2,0,7,1,30,7,0,0,7,0,30,3,0,0,3,0,-27,3,0
2,2,11,2,30,6,6,0,12,1,30,4,0,0,4,0,30,5,7,0,12,4,30,3,9,0,12,2,30,4,0,0,4,1,-15,3,1
2,3,11,2,30,6,6,0,12,1,30,4,0,0,4,0,30,5,7,0,12,4,30,3,9,0,12,2,30,4,0,0,4,1,-15,3,1
2,3,13,1,30,5,2,0,7,1,30,4,0,0,4,4,30,6,1,0,7,5,30,5,2,0,7,0,30,4,0,0,4,1,-15,3,1
2,1,17,3,30,9,5,0,14,3,30,6,0,0,6,0,30,5,9,0,14,1,30,7,7,0,14,5,30,4,0,0,4,1,-15,3,1
2,2,17,3,30,9,5,0,14,3,30,6,0,0,6,0,30,5,9,0,14,1,30,7,7,0,14,5,30,4,0,0,4,1,-15,3,1
2,2,19,0,30,5,8,0,13,2,30,7,1,0,8,0,30,4,9,0,13,5,30,5,8,0,13,1,30,9,0,0,9,1,-15,3,1
2,3,19,0,30,5,8,0,13,2,30,7,1,0,8,0,30,4,9,0,13,5,30,5,8,0,13,1,30,9,0,0,9,1,-15,3,1
2,3,23,2,30,5,8,0,13,2,30,6,0,0,6,8,30,12,1,0,13,0,30,5,8,0,13,1,30,5,1,0,6,1,-15,3,1
2,2,29,0,30,6,8,0,14,5,30,9,3,0,12,0,30,4,10,0,14,0,30,1,13,0,14,4,30,9,0,0,9,1,-15,3,1
2,3,31,1,30,6,6,0,12,4,30,8,0,0,8,3,30,10,2,0,12,0,30,8,4,0,12,1,30,5,1,0,6,1,-15,3,1
2,1,33,2,30,3,8,0,11,5,30,4,0,0,4,1,30,9,2,0,11,4,30,4,7,0,11,7,30,4,0,0,4,1,-15,3,1
2,2,33,2,30,3,8,0,11,5,30,4,0,0,4,1,30,9,2,0,11,4,30,4,7,0,11,7,30,4,0,0,4,1,-15,3,1
2,1,4,7,30,8,0,0,8,4,30,1,3,0,4,0,30,2,6,0,8,0,30,4,4,0,8,2,30,3,1,0,4,0,-27,3,0
2,3,4,7,30,8,0,0,8,4,30,1,3,0,4,0,30,2,6,0,8,0,30,4,4,0,8,0,30,3,1,0,4,0,-27,3,0
2,3,6,0,30,5,4,0,9,4,30,2,0,0,2,0,30,2,7,0,9,0,30,4,5,0,9,1,30,5,0,0,5,0,-27,3,0
2,3,8,1,30,7,0,0,7,4,30,2,0,0,2,1,30,4,3,0,7,2,30,7,0,0,7,2,30,3,0,0,3,0,-27,3,0
2,4,8,1,30,7,0,0,7,4,30,2,0,0,2,1,30,4,3,0,7,2,30,7,0,0,7,2,30,3,0,0,3,0,-27,3,0
2,4,13,1,30,7,0,0,7,0,30,4,0,0,4,2,30,6,1,0,7,9,30,6,1,0,7,3,30,4,0,0,4,1,-15,3,1
2,4,17,4,30,8,6,0,14,4,30,6,0,0,6,0,30,5,9,0,14,0,30,8,6,0,14,4,30,4,0,0,4,1,-15,3,1
2,1,27,1,30,3,12,0,15,4,30,1,1,0,2,0,30,4,11,0,15,1,30,3,12,0,15,3,30,6,0,0,6,1,-15,3,1
2,2,27,1,30,3,12,0,15,4,30,1,1,0,2,0,30,4,11,0,15,1,30,3,12,0,15,3,30,6,0,0,6,1,-15,3,1
2,3,27,1,30,3,12,0,15,4,30,1,1,0,2,0,30,4,11,0,15,1,30,3,12,0,15,3,30,6,0,0,6,1,-15,3,1
2,2,28,1,30,6,2,0,8,6,30,4,0,0,4,0,30,1,7,0,8,0,30,5,3,0,8,5,30,4,0,0,4,1,-15,3,1
2,4,28,1,30,6,2,0,8,6,30,4,0,0,4,0,30,1,7,0,8,0,30,5,3,0,8,5,30,4,0,0,4,1,-15,3,1
2,2,29,0,30,2,12,0,14,5,30,12,0,0,12,0,30,6,8,0,14,0,30,0,14,0,14,2,30,9,0,0,9,1,-15,3,1
2,3,29,0,30,2,12,0,14,5,30,12,0,0,12,0,30,6,8,0,14,0,30,0,14,0,14,2,30,9,0,0,9,1,-15,3,1
2,1,31,4,30,6,6,0,12,6,30,8,0,0,8,7,30,8,4,0,12,0,30,3,9,0,12,0,30,6,0,0,6,1,-15,3,1
2,0,5,0,30,2,3,0,5,3,30,4,0,0,4,0,30,0,5,0,5,0,30,2,3,0,5,3,30,2,0,0,2,0,-27,3,0
2,3,5,0,30,2,3,0,5,3,30,4,0,0,4,0,30,0,5,0,5,0,30,2,3,0,5,3,30,2,0,0,2,0,-27,3,0
2,4,13,1,30,5,2,0,7,0,30,4,0,0,4,2,30,6,1,0,7,7,30,6,1,0,7,5,30,4,0,0,4,1,-15,3,1
2,0,19,0,30,7,6,0,13,2,30,7,1,0,8,4,30,4,9,0,13,1,30,3,10,0,13,0,30,7,2,0,9,1,-15,3,1
2,1,19,0,30,7,6,0,13,2,30,7,1,0,8,4,30,4,9,0,13,1,30,3,10,0,13,0,30,7,2,0,9,1,-15,3,1
2,3,19,0,30,7,6,0,13,2,30,7,1,0,8,4,30,4,9,0,13,1,30,3,10,0,13,0,30,7,2,0,9,1,-15,3,1
2,4,19,0,30,7,6,0,13,2,30,7,1,0,8,4,30,4,9,0,13,1,30,3,10,0,13,0,30,7,2,0,9,1,-15,3,1
2,3,23,1,30,4,9,0,13,2,30,6,0,0,6,8,30,13,0,0,13,0,30,5,8,0,13,3,30,6,0,0,6,1,-15,3,1
2,3,25,1,30,7,7,0,14,3,30,6,0,0,6,0,30,7,7,0,14,2,30,5,9,0,14,4,30,6,0,0,6,1,-15,3,1
2,1,27,1,30,4,11,0,15,4,30,1,1,0,2,0,30,5,10,0,15,1,30,4,11,0,15,4,30,6,0,0,6,1,-15,3,1
2,3,31,1,30,8,4,0,12,4,30,8,0,0,8,6,30,9,3,0,12,0,30,3,9,0,12,0,30,5,1,0,6,1,-15,3,1
2,2,47,0,30,1,13,0,14,6,30,4,0,0,4,0,30,3,11,0,14,0,30,2,12,0,14,9,30,7,0,0,7,1,-15,3,1
2,2,4,2,30,7,1,0,8,4,30,2,2,0,4,1,30,1,7,0,8,0,30,7,1,0,8,6,30,4,0,0,4,0,-27,3,0
2,4,4,2,30,7,1,0,8,4,30,2,2,0,4,1,30,1,7,0,8,0,30,7,1,0,8,6,30,4,0,0,4,0,-27,3,0
2,0,19,0,30,3,10,0,13,2,30,4,4,0,8,0,30,7,6,0,13,8,30,4,9,0,13,3,30,9,0,0,9,1,-15,3,1
2,1,19,0,30,3,10,0,13,2,30,4,4,0,8,0,30,7,6,0,13,8,30,4,9,0,13,3,30,9,0,0,9,1,-15,3,1
2,4,19,0,30,3,10,0,13,2,30,4,4,0,8,0,30,7,6,0,13,8,30,4,9,0,13,3,30,9,0,0,9,1,-15,3,1
2,3,23,2,30,5,8,0,13,3,30,6,0,0,6,6,30,11,2,0,13,0,30,6,7,0,13,1,30,6,0,0,6,1,-15,3,1
2,2,25,1,30,4,10,0,14,4,30,6,0,0,6,0,30,6,8,0,14,1,30,5,9,0,14,4,30,5,1,0,6,1,-15,3,1
2,3,25,1,30,4,10,0,14,4,30,6,0,0,6,0,30,6,8,0,14,1,30,5,9,0,14,4,30,5,1,0,6,1,-15,3,1
2,2,31,3,30,6,6,0,12,4,30,8,0,0,8,5,30,12,0,0,12,0,30,6,6,0,12,1,30,5,1,0,6,1,-15,3,1
2,2,47,0,30,1,13,0,14,6,30,4,0,0,4,0,30,3,11,0,14,0,30,2,12,0,14,3,30,7,0,0,7,1,-15,3,1
2,3,47,0,30,1,13,0,14,6,30,4,0,0,4,0,30,3,11,0,14,0,30,2,12,0,14,3,30,7,0,0,7,1,-15,3,1
2,0,17,6,30,12,2,0,14,4,30,6,0,0,6,0,30,3,11,0,14,1,30,6,8,0,14,1,30,4,0,0,4,1,-15,3,1
2,2,17,6,30,12,2,0,14,4,30,6,0,0,6,0,30,3,11,0,14,1,30,6,8,0,14,1,30,4,0,0,4,1,-15,3,1
2,4,17,6,30,12,2,0,14,4,30,6,0,0,6,0,30,3,11,0,14,1,30,6,8,0,14,1,30,4,0,0,4,1,-15,3,1
2,3,25,1,30,7,7,0,14,3,30,6,0,0,6,0,30,8,6,0,14,1,30,7,7,0,14,4,30,5,1,0,6,1,-15,3,1
2,2,27,1,30,5,10,0,15,4,30,2,0,0,2,0,30,9,6,0,15,2,30,7,8,0,15,0,30,6,0,0,6,1,-15,3,1
2,3,27,1,30,5,10,0,15,4,30,2,0,0,2,0,30,9,6,0,15,2,30,7,8,0,15,0,30,6,0,0,6,1,-15,3,1
2,3,29,0,30,9,5,0,14,5,30,12,0,0,12,0,30,2,12,0,14,0,30,1,13,0,14,3,30,9,0,0,9,1,-15,3,1
2,4,29,0,30,9,5,0,14,5,30,12,0,0,12,0,30,2,12,0,14,0,30,1,13,0,14,3,30,9,0,0,9,1,-15,3,1
2,0,35,0,30,6,7,0,13,6,30,2,0,0,2,1,30,2,11,0,13,4,30,10,3,0,13,9,30,8,0,0,8,1,-15,3,1
2,3,35,0,30,6,7,0,13,6,30,2,0,0,2,1,30,2,11,0,13,4,30,10,3,0,13,9,30,8,0,0,8,1,-15,3,1
2,2,39,0,30,5,6,0,11,7,30,6,0,0,6,0,30,6,5,0,11,0,30,6,5,0,11,3,30,5,0,0,5,1,-15,3,1
2,3,39,0,30,5,6,0,11,7,30,6,0,0,6,0,30,6,5,0,11,0,30,6,5,0,11,3,30,5,0,0,5,1,-15,3,1
2,4,39,0,30,5,6,0,11,7,30,6,0,0,6,0,30,6,5,0,11,0,30,6,5,0,11,3,30,5,0,0,5,1,-15,3,1
2,3,1,0,30,7,3,0,10,4,30,2,0,0,2,0,30,4,6,0,10,4,30,8,2,0,10,6,30,6,0,0,6,0,-27,3,0
2,3,6,0,30,7,2,0,9,3,30,2,0,0,2,0,30,5,4,0,9,0,30,4,5,0,9,1,30,5,0,0,5,0,-27,3,0
2,4,6,0,30,7,2,0,9,3,30,2,0,0,2,0,30,5,4,0,9,0,30,4,5,0,9,1,30,5,0,0,5,0,-27,3,0
2,2,9,0,30,1,3,0,4,2,30,2,0,0,2,0,30,2,2,0,4,2,30,1,3,0,4,3,30,1,0,0,1,0,-27,3,0
2,4,9,0,30,1,3,0,4,2,30,2,0,0,2,0,30,2,2,0,4,2,30,1,3,0,4,3,30,1,0,0,1,0,-27,3,0
2,1,13,5,30,7,0,0,7,2,30,4,0,0,4,0,30,6,1,0,7,5,30,7,0,0,7,3,30,4,0,0,4,1,-15,3,1
2,4,13,5,30,7,0,0,7,2,30,4,0,0,4,0,30,6,1,0,7,5,30,7,0,0,7,1,30,4,0,0,4,1,-15,3,1
2,3,19,0,30,4,9,0,13,2,30,6,2,0,8,0,30,7,6,0,13,6,30,5,8,0,13,0,30,8,1,0,9,1,-15,3,1
2,4,19,0,30,4,9,0,13,2,30,6,2,0,8,0,30,7,6,0,13,6,30,5,8,0,13,0,30,8,1,0,9,1,-15,3,1
2,1,27,0,30,4,11,0,15,2,30,2,0,0,2,0,30,5,10,0,15,6,30,4,11,0,15,4,30,6,0,0,6,1,-15,3,1
2,3,32,0,30,8,1,0,9,4,30,2,0,0,2,4,30,8,1,0,9,1,30,3,6,0,9,2,30,2,0,0,2,1,-15,3,1
2,3,38,0,30,1,9,0,10,7,30,6,0,0,6,0,30,1,9,0,10,0,30,4,6,0,10,7,30,6,0,0,6,1,-15,3,1
2,2,5,0,30,2,3,0,5,3,30,2,2,0,4,1,30,2,3,0,5,0,30,1,4,0,5,0,30,1,1,0,2,0,-27,3,0
2,3,6,0,30,5,4,0,9,4,30,2,0,0,2,0,30,2,7,0,9,0,30,5,4,0,9,0,30,5,0,0,5,0,-27,3,0
2,2,8,2,30,7,0,0,7,5,30,2,0,0,2,3,30,2,5,0,7,1,30,7,0,0,7,3,30,3,0,0,3,0,-27,3,0
2,4,15,0,30,4,9,0,13,1,30,6,0,0,6,0,30,5,8,0,13,1,30,8,5,0,13,2,30,5,4,0,9,1,-15,3,1
2,1,17,5,30,11,3,0,14,3,30,6,0,0,6,0,30,4,10,0,14,1,30,6,8,0,14,1,30,4,0,0,4,1,-15,3,1
2,3,17,0,30,11,3,0,14,3,30,6,0,0,6,0,30,4,10,0,14,1,30,6,8,0,14,1,30,4,0,0,4,1,-15,3,1
2,4,25,1,30,6,8,0,14,5,30,6,0,0,6,0,30,7,7,0,14,1,30,6,8,0,14,0,30,6,0,0,6,1,-15,3,1
2,1,27,1,30,4,11,0,15,4,30,2,0,0,2,0,30,3,12,0,15,1,30,5,10,0,15,2,30,6,0,0,6,1,-15,3,1
2,2,27,1,30,4,11,0,15,4,30,2,0,0,2,0,30,3,12,0,15,1,30,5,10,0,15,2,30,6,0,0,6,1,-15,3,1
2,1,4,5,30,8,0,0,8,3,30,4,0,0,4,1,30,2,6,0,8,0,30,1,7,0,8,1,30,4,0,0,4,0,-27,3,0
2,4,13,0,30,7,0,0,7,0,30,4,0,0,4,2,30,6,1,0,7,7,30,4,3,0,7,5,30,4,0,0,4,1,-15,3,1
2,4,15,0,30,3,10,0,13,1,30,6,0,0,6,0,30,3,10,0,13,1,30,5,8,0,13,2,30,7,2,0,9,1,-15,3,1
2,3,17,3,30,10,4,0,14,2,30,6,0,0,6,0,30,6,8,0,14,1,30,5,9,0,14,3,30,4,0,0,4,1,-15,3,1
2,4,17,3,30,10,4,0,14,2,30,6,0,0,6,0,30,6,8,0,14,1,30,5,9,0,14,3,30,4,0,0,4,1,-15,3,1
2,2,19,1,30,3,10,0,13,2,30,3,5,0,8,0,30,5,8,0,13,3,30,4,9,0,13,1,30,8,1,0,9,1,-15,3,1
2,2,21,2,30,5,5,0,10,4,30,6,0,0,6,1,30,3,7,0,10,6,30,4,6,0,10,0,30,4,0,0,4,1,-15,3,1
2,3,25,1,30,6,8,0,14,4,30,6,0,0,6,0,30,7,7,0,14,1,30,5,9,0,14,0,30,5,1,0,6,1,-15,3,1
2,4,25,1,30,6,8,0,14,4,30,6,0,0,6,0,30,7,7,0,14,1,30,5,9,0,14,0,30,5,1,0,6,1,-15,3,1
2,2,26,0,30,7,2,0,9,5,30,4,0,0,4,2,30,0,9,0,9,0,30,2,7,0,9,4,30,1,2,0,3,1,-15,3,1
2,3,26,0,30,7,2,0,9,5,30,4,0,0,4,2,30,0,9,0,9,0,30,2,7,0,9,4,30,1,2,0,3,1,-15,3,1
2,0,31,1,30,5,7,0,12,7,30,8,0,0,8,3,30,4,8,0,12,0,30,9,3,0,12,4,30,6,0,0,6,1,-15,3,1
2,2,31,1,30,5,7,0,12,7,30,8,0,0,8,3,30,4,8,0,12,0,30,9,3,0,12,4,30,6,0,0,6,1,-15,3,1
2,4,31,1,30,5,7,0,12,7,30,8,0,0,8,3,30,4,8,0,12,0,30,9,3,0,12,4,30,6,0,0,6,1,-15,3,1
2,4,3,0,30,1,3,0,4,2,30,4,0,0,4,1,30,2,2,0,4,0,30,0,4,0,4,0,30,1,2,0,3,0,-27,3,0
2,1,5,0,30,2,3,0,5,2,30,3,1,0,4,0,30,2,3,0,5,0,30,1,4,0,5,0,30,0,2,0,2,0,-27,3,0
2,2,5,0,30,2,3,0,5,2,30,3,1,0,4,0,30,2,3,0,5,0,30,1,4,0,5,0,30,0,2,0,2,0,-27,3,0
2,3,5,0,30,2,3,0,5,2,30,3,1,0,4,0,30,2,3,0,5,0,30,1,4,0,5,0,30,0,2,0,2,0,-27,3,0
2,4,5,0,30,2,3,0,5,2,30,3,1,0,4,0,30,2,3,0,5,0,30,1,4,0,5,0,30,0,2,0,2,0,-27,3,0
2,2,6,0,30,8,1,0,9,4,30,2,0,0,2,0,30,3,6,0,9,0,30,5,4,0,9,0,30,4,1,0,5,0,-27,3,0
2,3,6,0,30,8,1,0,9,4,30,2,0,0,2,0,30,3,6,0,9,0,30,5,4,0,9,0,30,4,1,0,5,0,-27,3,0
2,2,8,3,30,7,0,0,7,5,30,2,0,0,2,0,30,2,5,0,7,0,30,5,2,0,7,3,30,3,0,0,3,0,-27,3,0
2,1,13,1,30,7,0,0,7,0,30,4,0,0,4,2,30,6,1,0,7,9,30,7,0,0,7,5,30,4,0,0,4,1,-15,3,1
2,2,13,1,30,7,0,0,7,0,30,4,0,0,4,2,30,6,1,0,7,9,30,7,0,0,7,5,30,4,0,0,4,1,-15,3,1
2,4,13,1,30,7,0,0,7,0,30,4,0,0,4,2,30,6,1,0,7,9,30,7,0,0,7,5,30,4,0,0,4,1,-15,3,1
2,3,17,4,30,10,4,0,14,2,30,6,0,0,6,0,30,7,7,0,14,0,30,6,8,0,14,2,30,4,0,0,4,1,-15,3,1
2,3,19,0,30,2,11,0,13,2,30,5,3,0,8,0,30,6,7,0,13,5,30,4,9,0,13,4,30,8,1,0,9,1,-15,3,1
2,4,19,0,30,2,11,0,13,2,30,5,3,0,8,0,30,6,7,0,13,5,30,4,9,0,13,4,30,8,1,0,9,1,-15,3,1
2,2,23,1,30,5,8,0,13,3,30,6,0,0,6,3,30,11,2,0,13,1,30,5,8,0,13,3,30,6,0,0,6,1,-15,3,1
2,3,23,1,30,5,8,0,13,3,30,6,0,0,6,3,30,11,2,0,13,1,30,5,8,0,13,3,30,6,0,0,6,1,-15,3,1
2,3,27,1,30,4,11,0,15,4,30,2,0,0,2,0,30,7,8,0,15,2,30,4,11,0,15,2,30,6,0,0,6,1,-15,3,1
2,0,29,0,30,8,6,0,14,6,30,10,2,0,12,0,30,4,10,0,14,0,30,1,13,0,14,2,30,9,0,0,9,1,-15,3,1
2,4,31,2,30,8,4,0,12,3,30,8,0,0,8,4,30,11,1,0,12,0,30,3,9,0,12,0,30,3,3,0,6,1,-15,3,1
2,2,39,0,30,3,8,0,11,7,30,6,0,0,6,0,30,4,7,0,11,3,30,3,8,0,11,4,30,5,0,0,5,1,-15,3,1
2,2,5,0,30,1,4,0,5,3,30,0,4,0,4,0,30,1,4,0,5,0,30,1,4,0,5,0,30,0,2,0,2,0,-27,3,0
2,3,5,0,30,1,4,0,5,3,30,0,4,0,4,0,30,1,4,0,5,0,30,1,4,0,5,0,30,0,2,0,2,0,-27,3,0
2,3,17,3,30,9,5,0,14,3,30,6,0,0,6,0,30,7,7,0,14,2,30,5,9,0,14,2,30,4,0,0,4,1,-15,3,1
2,2,19,0,30,3,10,0,13,2,30,5,3,0,8,0,30,4,9,0,13,1,30,8,5,0,13,1,30,8,1,0,9,1,-15,3,1
2,4,19,0,30,3,10,0,13,2,30,5,3,0,8,0,30,4,9,0,13,1,30,8,5,0,13,1,30,8,1,0,9,1,-15,3,1
2,3,25,1,30,5,9,0,14,4,30,6,0,0,6,0,30,10,4,0,14,1,30,4,10,0,14,0,30,5,1,0,6,1,-15,3,1
2,1,29,0,30,10,4,0,14,6,30,7,5,0,12,0,30,3,11,0,14,2,30,1,13,0,14,0,30,9,0,0,9,1,-15,3,1
2,2,29,0,30,10,4,0,14,6,30,7,5,0,12,0,30,3,11,0,14,2,30,1,13,0,14,0,30,9,0,0,9,1,-15,3,1
2,3,29,0,30,10,4,0,14,6,30,7,5,0,12,0,30,3,11,0,14,2,30,1,13,0,14,0,30,9,0,0,9,1,-15,3,1
2,4,29,0,30,10,4,0,14,6,30,7,5,0,12,0,30,3,11,0,14,2,30,1,13,0,14,0,30,9,0,0,9,1,-15,3,1
2,4,39,0,30,4,7,0,11,6,30,6,0,0,6,0,30,5,6,0,11,0,30,4,7,0,11,3,30,5,0,0,5,1,-15,3,1
2,4,5,0,30,3,2,0,5,3,30,4,0,0,4,0,30,0,5,0,5,0,30,1,4,0,5,0,30,0,2,0,2,0,-27,3,0
2,0,6,1,30,9,0,0,9,4,30,2,0,0,2,0,30,2,7,0,9,0,30,4,5,0,9,0,30,3,2,0,5,0,-27,3,0
2,1,6,1,30,9,0,0,9,4,30,2,0,0,2,0,30,2,7,0,9,0,30,4,5,0,9,0,30,3,2,0,5,0,-27,3,0
2,4,13,2,30,6,1,0,7,1,30,4,0,0,4,2,30,5,2,0,7,4,30,7,0,0,7,4,30,4,0,0,4,1,-15,3,1
2,4,17,2,30,8,6,0,14,0,30,6,0,0,6,0,30,9,5,0,14,3,30,7,7,0,14,5,30,4,0,0,4,1,-15,3,1
2,2,19,1,30,4,9,0,13,2,30,6,2,0,8,0,30,6,7,0,13,0,30,3,10,0,13,1,30,9,0,0,9,1,-15,3,1
2,3,19,1,30,4,9,0,13,2,30,6,2,0,8,0,30,6,7,0,13,0,30,3,10,0,13,1,30,9,0,0,9,1,-15,3,1
2,4,19,1,30,4,9,0,13,2,30,6,2,0,8,0,30,6,7,0,13,0,30,3,10,0,13,1,30,9,0,0,9,1,-15,3,1
2,0,4,2,30,6,2,0,8,4,30,3,1,0,4,1,30,2,6,0,8,0,30,4,4,0,8,2,30,4,0,0,4,0,-27,3,0
2,2,13,2,30,7,0,0,7,0,30,4,0,0,4,2,30,5,2,0,7,5,30,5,2,0,7,5,30,4,0,0,4,1,-15,3,1
2,2,19,0,30,2,11,0,13,2,30,5,3,0,8,0,30,12,1,0,13,3,30,5,8,0,13,3,30,8,1,0,9,1,-15,3,1
2,3,19,0,30,2,11,0,13,2,30,5,3,0,8,0,30,12,1,0,13,3,30,5,8,0,13,3,30,8,1,0,9,1,-15,3,1
2,3,23,1,30,4,9,0,13,3,30,6,0,0,6,7,30,13,0,0,13,0,30,5,8,0,13,4,30,6,0,0,6,1,-15,3,1
2,3,25,1,30,8,6,0,14,4,30,6,0,0,6,1,30,7,7,0,14,1,30,5,9,0,14,1,30,5,1,0,6,1,-15,3,1
2,1,27,0,30,4,11,0,15,5,30,1,1,0,2,0,30,6,9,0,15,1,30,5,10,0,15,5,30,6,0,0,6,1,-15,3,1
2,0,29,0,30,4,10,0,14,4,30,11,1,0,12,0,30,7,7,0,14,0,30,1,13,0,14,4,30,9,0,0,9,1,-15,3,1
2,1,29,0,30,4,10,0,14,4,30,11,1,0,12,0,30,7,7,0,14,0,30,1,13,0,14,4,30,9,0,0,9,1,-15,3,1
2,3,29,0,30,4,10,0,14,4,30,11,1,0,12,0,30,7,7,0,14,0,30,1,13,0,14,4,30,9,0,0,9,1,-15,3,1
2,3,45,0,30,5,8,0,13,11,30,10,0,0,10,0,30,2,11,0,13,6,30,7,6,0,13,4,30,5,0,0,5,1,-15,3,1
2,4,13,3,30,7,0,0,7,0,30,4,0,0,4,2,30,6,1,0,7,7,30,5,2,0,7,2,30,4,0,0,4,1,-15,3,1
2,4,17,2,30,9,5,0,14,0,30,6,0,0,6,0,30,7,7,0,14,3,30,5,9,0,14,1,30,2,2,0,4,1,-15,3,1
2,4,23,1,30,7,6,0,13,2,30,6,0,0,6,4,30,12,1,0,13,0,30,4,9,0,13,3,30,6,0,0,6,1,-15,3,1
2,0,26,0,30,7,2,0,9,3,30,0,4,0,4,1,30,0,9,0,9,8,30,2,7,0,9,5,30,2,1,0,3,1,-15,3,1
2,1,26,0,30,7,2,0,9,3,30,0,4,0,4,1,30,0,9,0,9,8,30,2,7,0,9,5,30,2,1,0,3,1,-15,3,1
2,4,26,0,30,7,2,0,9,3,30,0,4,0,4,1,30,0,9,0,9,8,30,2,7,0,9,5,30,2,1,0,3,1,-15,3,1
2,0,27,1,30,5,10,0,15,4,30,2,0,0,2,0,30,5,10,0,15,2,30,11,4,0,15,2,30,6,0,0,6,1,-15,3,1
2,3,29,1,30,9,5,0,14,6,30,7,5,0,12,0,30,2,12,0,14,0,30,1,13,0,14,4,30,9,0,0,9,1,-15,3,1
2,4,29,1,30,9,5,0,14,6,30,7,5,0,12,0,30,2,12,0,14,0,30,1,13,0,14,4,30,9,0,0,9,1,-15,3,1
2,3,47,0,30,0,14,0,14,6,30,4,0,0,4,0,30,3,11,0,14,0,30,2,12,0,14,6,30,7,0,0,7,1,-15,3,1
2,4,47,0,30,0,14,0,14,6,30,4,0,0,4,0,30,3,11,0,14,0,30,2,12,0,14,6,30,7,0,0,7,1,-15,3,1
2,1,4,2,30,8,0,0,8,5,30,4,0,0,4,3,30,1,7,0,8,0,30,3,5,0,8,8,30,3,1,0,4,0,-27,3,0
2,3,4,2,30,8,0,0,8,5,30,4,0,0,4,3,30,1,7,0,8,0,30,3,5,0,8,8,30,3,1,0,4,0,-27,3,0
2,1,13,3,30,4,3,0,7,0,30,4,0,0,4,2,30,6,1,0,7,6,30,6,1,0,7,5,30,4,0,0,4,1,-15,3,1
2,3,13,3,30,4,3,0,7,0,30,4,0,0,4,2,30,6,1,0,7,6,30,6,1,0,7,5,30,4,0,0,4,1,-15,3,1
2,3,15,0,30,6,7,0,13,1,30,6,0,0,6,0,30,3,10,0,13,1,30,6,7,0,13,3,30,9,0,0,9,1,-15,3,1
2,4,15,0,30,6,7,0,13,1,30,6,0,0,6,0,30,3,10,0,13,1,30,6,7,0,13,3,30,9,0,0,9,1,-15,3,1
2,1,17,5,30,10,4,0,14,3,30,6,0,0,6,0,30,6,8,0,14,1,30,7,7,0,14,0,30,4,0,0,4,1,-15,3,1
2,2,17,5,30,10,4,0,14,3,30,6,0,0,6,0,30,6,8,0,14,1,30,7,7,0,14,0,30,4,0,0,4,1,-15,3,1
2,3,17,5,30,10,4,0,14,3,30,6,0,0,6,0,30,6,8,0,14,1,30,7,7,0,14,0,30,4,0,0,4,1,-15,3,1
2,4,17,5,30,10,4,0,14,3,30,6,0,0,6,0,30,6,8,0,14,1,30,7,7,0,14,0,30,4,0,0,4,1,-15,3,1
2,3,19,0,30,4,9,0,13,1,30,8,0,0,8,0,30,7,6,0,13,3,30,4,9,0,13,1,30,7,2,0,9,1,-15,3,1
2,3,25,1,30,8,6,0,14,3,30,6,0,0,6,1,30,6,8,0,14,1,30,5,9,0,14,5,30,5,1,0,6,1,-15,3,1
2,2,27,1,30,4,11,0,15,1,30,1,1,0,2,0,30,6,9,0,15,7,30,4,11,0,15,5,30,6,0,0,6,1,-15,3,1
2,4,27,1,30,4,11,0,15,1,30,1,1,0,2,0,30,6,9,0,15,7,30,4,11,0,15,5,30,6,0,0,6,1,-15,3,1
2,1,29,0,30,4,10,0,14,6,30,7,5,0,12,0,30,7,7,0,14,0,30,5,9,0,14,4,30,9,0,0,9,1,-15,3,1
2,4,29,0,30,4,10,0,14,6,30,7,5,0,12,0,30,7,7,0,14,0,30,5,9,0,14,4,30,9,0,0,9,1,-15,3,1
2,4,3,0,30,0,4,0,4,2,30,4,0,0,4,1,30,1,3,0,4,3,30,0,4,0,4,0,30,1,2,0,3,0,-27,3,0
2,1,13,1,30,5,2,0,7,0,30,4,0,0,4,2,30,6,1,0,7,12,30,6,1,0,7,7,30,4,0,0,4,1,-15,3,1
2,4,15,0,30,4,9,0,13,1,30,6,0,0,6,0,30,4,9,0,13,3,30,6,7,0,13,2,30,6,3,0,9,1,-15,3,1
2,1,17,5,30,11,3,0,14,4,30,6,0,0,6,0,30,3,11,0,14,2,30,5,9,0,14,1,30,4,0,0,4,1,-15,3,1
2,2,19,0,30,5,8,0,13,2,30,6,2,0,8,0,30,4,9,0,13,4,30,6,7,0,13,2,30,7,2,0,9,1,-15,3,1
2,4,22,4,30,8,0,0,8,3,30,2,0,0,2,0,30,5,3,0,8,1,30,3,5,0,8,1,30,1,3,0,4,1,-15,3,1
2,2,25,4,30,5,9,0,14,3,30,6,0,0,6,0,30,11,3,0,14,1,30,5,9,0,14,2,30,5,1,0,6,1,-15,3,1
2,4,25,4,30,5,9,0,14,3,30,6,0,0,6,0,30,11,3,0,14,1,30,5,9,0,14,2,30,5,1,0,6,1,-15,3,1
2,4,27,0,30,4,11,0,15,4,30,1,1,0,2,0,30,5,10,0,15,2,30,6,9,0,15,5,30,6,0,0,6,1,-15,3,1
2,1,13,2,30,6,1,0,7,0,30,4,0,0,4,3,30,6,1,0,7,9,30,6,1,0,7,4,30,4,0,0,4,1,-15,3,1
2,4,15,0,30,3,10,0,13,1,30,5,1,0,6,0,30,7,6,0,13,1,30,7,6,0,13,4,30,9,0,0,9,1,-15,3,1
2,1,17,2,30,10,4,0,14,3,30,6,0,0,6,0,30,5,9,0,14,1,30,8,6,0,14,7,30,4,0,0,4,1,-15,3,1
2,0,19,1,30,4,9,0,13,3,30,5,3,0,8,0,30,4,9,0,13,5,30,5,8,0,13,0,30,9,0,0,9,1,-15,3,1
2,1,19,1,30,4,9,0,13,3,30,5,3,0,8,0,30,4,9,0,13,5,30,5,8,0,13,0,30,9,0,0,9,1,-15,3,1
2,4,19,1,30,4,9,0,13,1,30,5,3,0,8,0,30,4,9,0,13,5,30,5,8,0,13,0,30,9,0,0,9,1,-15,3,1
2,3,25,1,30,6,8,0,14,3,30,6,0,0,6,0,30,12,2,0,14,1,30,4,10,0,14,4,30,5,1,0,6,1,-15,3,1
2,0,27,2,30,3,12,0,15,4,30,2,0,0,2,0,30,6,9,0,15,2,30,6,9,0,15,3,30,6,0,0,6,1,-15,3,1
2,1,27,2,30,3,12,0,15,4,30,2,0,0,2,0,30,6,9,0,15,2,30,6,9,0,15,3,30,6,0,0,6,1,-15,3,1
2,4,29,0,30,6,8,0,14,6,30,12,0,0,12,0,30,4,10,0,14,0,30,1,13,0,14,5,30,9,0,0,9,1,-15,3,1
2,4,38,0,30,2,8,0,10,7,30,6,0,0,6,0,30,1,9,0,10,0,30,4,6,0,10,6,30,6,0,0,6,1,-15,3,1
2,2,13,3,30,7,0,0,7,1,30,4,0,0,4,2,30,7,0,0,7,4,30,4,3,0,7,1,30,4,0,0,4,1,-15,3,1
2,4,13,3,30,7,0,0,7,1,30,4,0,0,4,2,30,7,0,0,7,4,30,4,3,0,7,0,30,4,0,0,4,1,-15,3,1
2,3,17,4,30,11,3,0,14,2,30,6,0,0,6,0,30,7,7,0,14,0,30,5,9,0,14,3,30,4,0,0,4,1,-15,3,1
2,4,17,4,30,11,3,0,14,2,30,6,0,0,6,0,30,7,7,0,14,0,30,5,9,0,14,3,30,4,0,0,4,1,-15,3,1
2,4,19,0,30,2,11,0,13,2,30,7,1,0,8,0,30,5,8,0,13,1,30,4,9,0,13,2,30,8,1,0,9,1,-15,3,1
2,1,21,3,30,8,2,0,10,4,30,6,0,0,6,1,30,3,7,0,10,3,30,5,5,0,10,1,30,4,0,0,4,1,-15,3,1
2,2,21,3,30,8,2,0,10,4,30,6,0,0,6,1,30,3,7,0,10,3,30,5,5,0,10,1,30,4,0,0,4,1,-15,3,1
2,4,21,3,30,8,2,0,10,4,30,6,0,0,6,1,30,3,7,0,10,3,30,5,5,0,10,1,30,4,0,0,4,1,-15,3,1
2,3,25,2,30,6,8,0,14,2,30,6,0,0,6,0,30,6,8,0,14,0,30,4,10,0,14,3,30,6,0,0,6,1,-15,3,1
2,0,27,1,30,4,11,0,15,4,30,2,0,0,2,0,30,4,11,0,15,3,30,5,10,0,15,1,30,4,2,0,6,1,-15,3,1
2,4,27,1,30,4,11,0,15,4,30,2,0,0,2,0,30,4,11,0,15,3,30,5,10,0,15,1,30,4,2,0,6,1,-15,3,1
2,3,29,0,30,5,9,0,14,6,30,12,0,0,12,0,30,6,8,0,14,0,30,1,13,0,14,0,30,9,0,0,9,1,-15,3,1
2,2,31,4,30,5,7,0,12,4,30,8,0,0,8,3,30,10,2,0,12,0,30,3,9,0,12,1,30,3,3,0,6,1,-15,3,1
2,1,37,1,30,6,5,0,11,5,30,8,0,0,8,0,30,6,5,0,11,6,30,3,8,0,11,8,30,6,0,0,6,1,-15,3,1
2,2,37,1,30,6,5,0,11,5,30,8,0,0,8,0,30,6,5,0,11,6,30,3,8,0,11,8,30,6,0,0,6,1,-15,3,1
2,2,17,4,30,9,5,0,14,3,30,6,0,0,6,0,30,6,8,0,14,4,30,7,7,0,14,1,30,3,1,0,4,1,-15,3,1
2,4,17,4,30,9,5,0,14,3,30,6,0,0,6,0,30,6,8,0,14,4,30,7,7,0,14,1,30,3,1,0,4,1,-15,3,1
2,3,23,2,30,5,8,0,13,3,30,6,0,0,6,5,30,10,3,0,13,0,30,6,7,0,13,2,30,6,0,0,6,1,-15,3,1
2,4,23,2,30,5,8,0,13,3,30,6,0,0,6,5,30,10,3,0,13,0,30,6,7,0,13,2,30,6,0,0,6,1,-15,3,1
2,3,25,2,30,6,8,0,14,4,30,6,0,0,6,0,30,5,9,0,14,1,30,5,9,0,14,6,30,5,1,0,6,1,-15,3,1
2,0,27,1,30,4,11,0,15,3,30,1,1,0,2,0,30,3,12,0,15,4,30,4,11,0,15,5,30,6,0,0,6,1,-15,3,1
2,2,27,1,30,4,11,0,15,3,30,1,1,0,2,0,30,3,12,0,15,4,30,4,11,0,15,5,30,6,0,0,6,1,-15,3,1
2,4,11,0,30,4,8,0,12,1,30,4,0,0,4,0,30,8,4,0,12,7,30,7,5,0,12,4,30,4,0,0,4,1,-15,3,1
2,3,13,5,30,7,0,0,7,1,30,4,0,0,4,2,30,6,1,0,7,4,30,5,2,0,7,3,30,4,0,0,4,1,-15,3,1
2,3,17,2,30,10,4,0,14,2,30,6,0,0,6,1,30,9,5,0,14,1,30,5,9,0,14,1,30,2,2,0,4,1,-15,3,1
2,1,19,0,30,2,11,0,13,2,30,5,3,0,8,0,30,7,6,0,13,5,30,5,8,0,13,2,30,8,1,0,9,1,-15,3,1
2,2,19,0,30,2,11,0,13,2,30,5,3,0,8,0,30,7,6,0,13,5,30,5,8,0,13,2,30,8,1,0,9,1,-15,3,1
2,4,19,0,30,2,11,0,13,2,30,5,3,0,8,0,30,7,6,0,13,0,30,5,8,0,13,2,30,8,1,0,9,1,-15,3,1
2,3,21,2,30,5,5,0,10,4,30,6,0,0,6,1,30,4,6,0,10,0,30,4,6,0,10,5,30,4,0,0,4,1,-15,3,1
2,4,21,2,30,5,5,0,10,4,30,6,0,0,6,1,30,4,6,0,10,0,30,4,6,0,10,5,30,4,0,0,4,1,-15,3,1
2,0,27,1,30,6,9,0,15,3,30,1,1,0,2,0,30,6,9,0,15,0,30,3,12,0,15,4,30,6,0,0,6,1,-15,3,1
2,3,27,1,30,6,9,0,15,3,30,1,1,0,2,0,30,6,9,0,15,0,30,3,12,0,15,4,30,6,0,0,6,1,-15,3,1
2,0,31,1,30,6,6,0,12,8,30,8,0,0,8,3,30,4,8,0,12,3,30,10,2,0,12,3,30,6,0,0,6,1,-15,3,1
2,4,35,1,30,9,4,0,13,6,30,2,0,0,2,1,30,2,11,0,13,7,30,4,9,0,13,3,30,8,0,0,8,1,-15,3,1
2,0,4,3,30,6,2,0,8,5,30,3,1,0,4,1,30,1,7,0,8,0,30,6,2,0,8,2,30,4,0,0,4,0,-27,3,0
2,2,4,3,30,6,2,0,8,5,30,3,1,0,4,1,30,1,7,0,8,0,30,6,2,0,8,2,30,4,0,0,4,0,-27,3,0
2,3,4,3,30,6,2,0,8,5,30,3,1,0,4,1,30,1,7,0,8,0,30,6,2,0,8,2,30,4,0,0,4,0,-27,3,0
2,4,4,3,30,6,2,0,8,5,30,3,1,0,4,1,30,1,7,0,8,0,30,6,2,0,8,2,30,4,0,0,4,0,-27,3,0
2,2,6,0,30,8,1,0,9,4,30,2,0,0,2,0,30,2,7,0,9,0,30,4,5,0,9,0,30,5,0,0,5,0,-27,3,0
2,1,13,2,30,5,2,0,7,0,30,4,0,0,4,2,30,6,1,0,7,7,30,7,0,0,7,5,30,4,0,0,4,1,-15,3,1
2,2,13,2,30,5,2,0,7,0,30,4,0,0,4,2,30,6,1,0,7,7,30,7,0,0,7,5,30,4,0,0,4,1,-15,3,1
2,4,19,0,30,7,6,0,13,2,30,7,1,0,8,5,30,4,9,0,13,0,30,6,7,0,13,0,30,6,3,0,9,1,-15,3,1
2,4,22,1,30,8,0,0,8,3,30,2,0,0,2,1,30,5,3,0,8,1,30,4,4,0,8,0,30,4,0,0,4,1,-15,3,1
2,4,25,0,30,6,8,0,14,3,30,6,0,0,6,0,30,4,10,0,14,1,30,8,6,0,14,5,30,6,0,0,6,1,-15,3,1
2,0,27,2,30,5,10,0,15,4,30,1,1,0,2,0,30,5,10,0,15,3,30,6,9,0,15,4,30,6,0,0,6,1,-15,3,1
2,1,27,2,30,5,10,0,15,4,30,1,1,0,2,0,30,5,10,0,15,3,30,6,9,0,15,4,30,6,0,0,6,1,-15,3,1
2,2,27,2,30,5,10,0,15,4,30,1,1,0,2,0,30,5,10,0,15,3,30,6,9,0,15,4,30,6,0,0,6,1,-15,3,1
2,3,27,2,30,5,10,0,15,4,30,1,1,0,2,0,30,5,10,0,15,3,30,6,9,0,15,4,30,6,0,0,6,1,-15,3,1
2,4,27,2,30,5,10,0,15,4,30,1,1,0,2,0,30,5,10,0,15,3,30,6,9,0,15,4,30,6,0,0,6,1,-15,3,1
2,4,32,0,30,7,2,0,9,4,30,2,0,0,2,0,30,7,2,0,9,7,30,4,5,0,9,3,30,2,0,0,2,1,-15,3,1
2,2,37,1,30,7,4,0,11,5,30,6,2,0,8,1,30,9,2,0,11,2,30,3,8,0,11,0,30,6,0,0,6,1,-15,3,1
2,2,43,0,30,8,6,0,14,7,30,6,0,0,6,0,30,6,8,0,14,1,30,5,9,0,14,5,30,5,0,0,5,1,-15,3,1
2,3,43,0,30,8,6,0,14,7,30,6,0,0,6,0,30,6,8,0,14,1,30,5,9,0,14,5,30,5,0,0,5,1,-15,3,1
2,2,4,2,30,6,2,0,8,5,30,4,0,0,4,1,30,1,7,0,8,0,30,6,2,0,8,2,30,4,0,0,4,0,-27,3,0
2,0,17,4,30,8,6,0,14,2,30,6,0,0,6,0,30,6,8,0,14,6,30,5,9,0,14,0,30,3,1,0,4,1,-15,3,1
2,1,17,4,30,8,6,0,14,2,30,6,0,0,6,0,30,6,8,0,14,6,30,5,9,0,14,0,30,3,1,0,4,1,-15,3,1
2,2,17,4,30,8,6,0,14,2,30,6,0,0,6,0,30,6,8,0,14,6,30,5,9,0,14,0,30,3,1,0,4,1,-15,3,1
2,1,23,1,30,5,8,0,13,1,30,6,0,0,6,5,30,9,4,0,13,4,30,4,9,0,13,4,30,6,0,0,6,1,-15,3,1
2,2,23,1,30,5,8,0,13,1,30,6,0,0,6,5,30,9,4,0,13,4,30,4,9,0,13,4,30,6,0,0,6,1,-15,3,1
2,3,23,1,30,5,8,0,13,1,30,6,0,0,6,5,30,9,4,0,13,4,30,4,9,0,13,4,30,6,0,0,6,1,-15,3,1
2,4,25,0,30,10,4,0,14,2,30,6,0,0,6,0,30,7,7,0,14,1,30,5,9,0,14,4,30,6,0,0,6,1,-15,3,1
2,1,27,5,30,3,12,0,15,3,30,2,0,0,2,0,30,6,9,0,15,3,30,3,12,0,15,3,30,6,0,0,6,1,-15,3,1
2,2,27,5,30,3,12,0,15,3,30,2,0,0,2,0,30,6,9,0,15,3,30,3,12,0,15,3,30,6,0,0,6,1,-15,3,1
2,4,27,5,30,3,12,0,15,3,30,2,0,0,2,0,30,6,9,0,15,3,30,3,12,0,15,3,30,6,0,0,6,1,-15,3,1
2,2,29,0,30,3,11,0,14,5,30,12,0,0,12,0,30,6,8,0,14,0,30,1,13,0,14,3,30,9,0,0,9,1,-15,3,1
2,4,29,0,30,3,11,0,14,5,30,12,0,0,12,0,30,6,8,0,14,0,30,1,13,0,14,3,30,9,0,0,9,1,-15,3,1
2,1,31,2,30,6,6,0,12,5,30,8,0,0,8,5,30,10,2,0,12,0,30,3,9,0,12,2,30,5,1,0,6,1,-15,3,1
2,3,31,2,30,6,6,0,12,5,30,8,0,0,8,5,30,10,2,0,12,0,30,3,9,0,12,2,30,5,1,0,6,1,-15,3,1
2,3,3,1,30,2,2,0,4,3,30,4,0,0,4,2,30,1,3,0,4,2,30,1,3,0,4,0,30,1,2,0,3,0,-27,3,0
2,2,8,3,30,7,0,0,7,4,30,2,0,0,2,0,30,1,6,0,7,0,30,4,3,0,7,5,30,3,0,0,3,0,-27,3,0
2,3,8,3,30,7,0,0,7,4,30,2,0,0,2,0,30,1,6,0,7,0,30,4,3,0,7,5,30,3,0,0,3,0,-27,3,0
2,4,8,3,30,7,0,0,7,4,30,2,0,0,2,0,30,1,6,0,7,0,30,4,3,0,7,5,30,3,0,0,3,0,-27,3,0
2,3,13,5,30,7,0,0,7,1,30,4,0,0,4,1,30,6,1,0,7,4,30,6,1,0,7,2,30,4,0,0,4,1,-15,3,1
2,4,13,5,30,7,0,0,7,1,30,4,0,0,4,1,30,6,1,0,7,4,30,6,1,0,7,2,30,4,0,0,4,1,-15,3,1
2,3,15,1,30,4,9,0,13,1,30,6,0,0,6,0,30,3,10,0,13,1,30,3,10,0,13,1,30,7,2,0,9,1,-15,3,1
2,2,17,3,30,8,6,0,14,2,30,6,0,0,6,0,30,7,7,0,14,4,30,5,9,0,14,4,30,4,0,0,4,1,-15,3,1
2,3,17,3,30,8,6,0,14,2,30,6,0,0,6,0,30,7,7,0,14,4,30,5,9,0,14,4,30,4,0,0,4,1,-15,3,1
2,4,17,3,30,8,6,0,14,2,30,6,0,0,6,0,30,7,7,0,14,4,30,5,9,0,14,4,30,4,0,0,4,1,-15,3,1
2,2,25,5,30,10,4,0,14,5,30,6,0,0,6,0,30,5,9,0,14,1,30,5,9,0,14,3,30,5,1,0,6,1,-15,3,1
2,1,27,3,30,3,12,0,15,3,30,2,0,0,2,0,30,9,6,0,15,0,30,4,11,0,15,1,30,5,1,0,6,1,-15,3,1
2,2,27,3,30,3,12,0,15,3,30,2,0,0,2,0,30,9,6,0,15,0,30,4,11,0,15,1,30,5,1,0,6,1,-15,3,1
2,3,27,3,30,3,12,0,15,3,30,2,0,0,2,0,30,9,6,0,15,0,30,4,11,0,15,1,30,5,1,0,6,1,-15,3,1
2,4,27,3,30,3,12,0,15,3,30,2,0,0,2,0,30,9,6,0,15,0,30,4,11,0,15,1,30,5,1,0,6,1,-15,3,1
2,4,29,0,30,7,7,0,14,6,30,12,0,0,12,0,30,4,10,0,14,0,30,1,13,0,14,2,30,9,0,0,9,1,-15,3,1
2,0,38,0,30,1,9,0,10,6,30,6,0,0,6,0,30,3,7,0,10,0,30,5,5,0,10,8,30,6,0,0,6,1,-15,3,1
2,1,38,0,30,1,9,0,10,6,30,6,0,0,6,0,30,3,7,0,10,0,30,5,5,0,10,8,30,6,0,0,6,1,-15,3,1
2,3,5,0,30,2,3,0,5,3,30,2,2,0,4,0,30,0,5,0,5,2,30,2,3,0,5,0,30,0,2,0,2,0,-27,3,0
2,4,5,0,30,2,3,0,5,3,30,2,2,0,4,0,30,0,5,0,5,2,30,2,3,0,5,0,30,0,2,0,2,0,-27,3,0
2,2,13,0,30,4,3,0,7,0,30,4,0,0,4,2,30,7,0,0,7,8,30,7,0,0,7,6,30,4,0,0,4,1,-15,3,1
2,1,19,2,30,7,6,0,13,1,30,3,5,0,8,0,30,5,8,0,13,1,30,6,7,0,13,2,30,8,1,0,9,1,-15,3,1
2,2,19,2,30,7,6,0,13,1,30,3,5,0,8,0,30,5,8,0,13,1,30,6,7,0,13,2,30,8,1,0,9,1,-15,3,1
2,4,19,0,30,7,6,0,13,1,30,3,5,0,8,0,30,5,8,0,13,1,30,6,7,0,13,2,30,8,1,0,9,1,-15,3,1
2,4,23,0,30,5,8,0,13,3,30,6,0,0,6,2,30,13,0,0,13,0,30,6,7,0,13,2,30,5,1,0,6,1,-15,3,1
2,0,29,0,30,4,10,0,14,5,30,12,0,0,12,0,30,7,7,0,14,0,30,0,14,0,14,5,30,9,0,0,9,1,-15,3,1
2,2,31,0,30,7,5,0,12,5,30,8,0,0,8,3,30,8,4,0,12,0,30,5,7,0,12,3,30,6,0,0,6,1,-15,3,1
2,3,31,0,30,7,5,0,12,5,30,8,0,0,8,3,30,8,4,0,12,0,30,5,7,0,12,3,30,6,0,0,6,1,-15,3,1
2,4,39,1,30,5,6,0,11,5,30,6,0,0,6,2,30,9,2,0,11,0,30,2,9,0,11,1,30,2,3,0,5,1,-15,3,1
2,0,45,5,30,8,5,0,13,11,30,10,0,0,10,0,30,0,13,0,13,0,30,4,9,0,13,8,30,5,0,0,5,1,-15,3,1
2,0,4,2,30,7,1,0,8,5,30,4,0,0,4,2,30,1,7,0,8,0,30,6,2,0,8,1,30,4,0,0,4,0,-27,3,0
2,2,8,4,30,7,0,0,7,4,30,2,0,0,2,3,30,7,0,0,7,1,30,6,1,0,7,2,30,3,0,0,3,0,-27,3,0
2,1,17,4,30,8,6,0,14,4,30,6,0,0,6,0,30,4,10,0,14,5,30,5,9,0,14,8,30,4,0,0,4,1,-15,3,1
2,2,17,4,30,8,6,0,14,4,30,6,0,0,6,0,30,4,10,0,14,5,30,5,9,0,14,8,30,4,0,0,4,1,-15,3,1
2,3,25,1,30,9,5,0,14,5,30,6,0,0,6,1,30,7,7,0,14,1,30,5,9,0,14,5,30,5,1,0,6,1,-15,3,1
2,4,25,1,30,9,5,0,14,5,30,6,0,0,6,1,30,7,7,0,14,1,30,5,9,0,14,5,30,5,1,0,6,1,-15,3,1
2,1,29,1,30,7,7,0,14,6,30,8,4,0,12,0,30,2,12,0,14,0,30,1,13,0,14,4,30,9,0,0,9,1,-15,3,1
2,0,31,2,30,6,6,0,12,5,30,8,0,0,8,6,30,9,3,0,12,0,30,3,9,0,12,2,30,3,3,0,6,1,-15,3,1
2,2,39,0,30,5,6,0,11,7,30,6,0,0,6,0,30,4,7,0,11,2,30,4,7,0,11,3,30,5,0,0,5,1,-15,3,1
2,3,39,0,30,5,6,0,11,7,30,6,0,0,6,0,30,4,7,0,11,2,30,4,7,0,11,3,30,5,0,0,5,1,-15,3,1
2,4,39,0,30,5,6,0,11,7,30,6,0,0,6,0,30,4,7,0,11,2,30,4,7,0,11,3,30,5,0,0,5,1,-15,3,1
2,1,1,0,30,7,3,0,10,4,30,2,0,0,2,1,30,4,6,0,10,8,30,10,0,0,10,2,30,6,0,0,6,0,-27,3,0
2,4,1,0,30,7,3,0,10,4,30,2,0,0,2,1,30,4,6,0,10,8,30,10,0,0,10,2,30,6,0,0,6,0,-27,3,0
2,3,8,2,30,7,0,0,7,4,30,2,0,0,2,0,30,3,4,0,7,2,30,7,0,0,7,0,30,3,0,0,3,0,-27,3,0
2,2,15,3,30,4,9,0,13,2,30,6,0,0,6,0,30,3,10,0,13,1,30,5,8,0,13,0,30,7,2,0,9,1,-15,3,1
2,4,15,3,30,4,9,0,13,2,30,6,0,0,6,0,30,3,10,0,13,1,30,5,8,0,13,0,30,7,2,0,9,1,-15,3,1
2,4,23,1,30,6,7,0,13,3,30,6,0,0,6,9,30,12,1,0,13,0,30,5,8,0,13,0,30,6,0,0,6,1,-15,3,1
2,2,25,1,30,7,7,0,14,5,30,6,0,0,6,0,30,8,6,0,14,1,30,10,4,0,14,4,30,5,1,0,6,1,-15,3,1
2,4,25,1,30,7,7,0,14,5,30,6,0,0,6,0,30,8,6,0,14,1,30,10,4,0,14,4,30,5,1,0,6,1,-15,3,1
2,1,27,1,30,4,11,0,15,1,30,2,0,0,2,0,30,5,10,0,15,1,30,6,9,0,15,5,30,6,0,0,6,1,-15,3,1
2,2,27,1,30,4,11,0,15,1,30,2,0,0,2,0,30,5,10,0,15,1,30,6,9,0,15,5,30,6,0,0,6,1,-15,3,1
2,3,27,1,30,4,11,0,15,1,30,2,0,0,2,0,30,5,10,0,15,1,30,6,9,0,15,5,30,6,0,0,6,1,-15,3,1
2,4,27,1,30,4,11,0,15,1,30,2,0,0,2,0,30,5,10,0,15,1,30,6,9,0,15,5,30,6,0,0,6,1,-15,3,1
2,3,4,4,30,8,0,0,8,4,30,4,0,0,4,0,30,2,6,0,8,0,30,0,8,0,8,2,30,4,0,0,4,0,-27,3,0
2,3,5,0,30,1,4,0,5,2,30,4,0,0,4,1,30,0,5,0,5,0,30,1,4,0,5,0,30,0,2,0,2,0,-27,3,0
2,4,8,3,30,7,0,0,7,5,30,2,0,0,2,0,30,2,5,0,7,2,30,7,0,0,7,0,30,3,0,0,3,0,-27,3,0
2,3,11,3,30,6,6,0,12,0,30,4,0,0,4,0,30,9,3,0,12,4,30,1,11,0,12,1,30,3,1,0,4,1,-15,3,1
2,4,11,3,30,6,6,0,12,0,30,4,0,0,4,0,30,9,3,0,12,4,30,1,11,0,12,1,30,3,1,0,4,1,-15,3,1
2,4,15,0,30,4,9,0,13,0,30,6,0,0,6,0,30,5,8,0,13,1,30,5,8,0,13,3,30,9,0,0,9,1,-15,3,1
2,4,17,2,30,12,2,0,14,3,30,6,0,0,6,0,30,4,10,0,14,1,30,5,9,0,14,0,30,4,0,0,4,1,-15,3,1
2,2,19,0,30,3,10,0,13,2,30,5,3,0,8,0,30,4,9,0,13,0,30,7,6,0,13,1,30,8,1,0,9,1,-15,3,1
2,3,19,0,30,3,10,0,13,2,30,5,3,0,8,0,30,4,9,0,13,0,30,7,6,0,13,1,30,8,1,0,9,1,-15,3,1
2,4,19,0,30,3,10,0,13,2,30,5,3,0,8,0,30,4,9,0,13,0,30,7,6,0,13,1,30,8,1,0,9,1,-15,3,1
2,4,25,1,30,9,5,0,14,1,30,6,0,0,6,0,30,11,3,0,14,0,30,5,9,0,14,3,30,5,1,0,6,1,-15,3,1
2,2,27,1,30,3,12,0,15,3,30,1,1,0,2,0,30,6,9,0,15,0,30,6,9,0,15,4,30,6,0,0,6,1,-15,3,1
2,3,27,1,30,3,12,0,15,3,30,1,1,0,2,0,30,6,9,0,15,0,30,6,9,0,15,4,30,6,0,0,6,1,-15,3,1
2,4,31,0,30,5,7,0,12,5,30,8,0,0,8,3,30,8,4,0,12,0,30,3,9,0,12,2,30,6,0,0,6,1,-15,3,1
2,4,43,0,30,10,4,0,14,7,30,6,0,0,6,0,30,4,10,0,14,1,30,1,13,0,14,4,30,5,0,0,5,1,-15,3,1
2,3,4,0,30,6,2,0,8,4,30,2,2,0,4,2,30,4,4,0,8,3,30,5,3,0,8,0,30,4,0,0,4,0,-27,3,0
2,4,4,0,30,6,2,0,8,4,30,2,2,0,4,2,30,4,4,0,8,3,30,5,3,0,8,0,30,4,0,0,4,0,-27,3,0
2,3,15,0,30,4,9,0,13,1,30,5,1,0,6,0,30,3,10,0,13,1,30,5,8,0,13,3,30,9,0,0,9,1,-15,3,1
2,4,15,0,30,4,9,0,13,1,30,5,1,0,6,0,30,3,10,0,13,1,30,5,8,0,13,3,30,9,0,0,9,1,-15,3,1
2,2,19,0,30,5,8,0,13,2,30,3,5,0,8,0,30,11,2,0,13,3,30,6,7,0,13,3,30,8,1,0,9,1,-15,3,1
2,4,25,1,30,11,3,0,14,3,30,6,0,0,6,0,30,4,10,0,14,1,30,6,8,0,14,3,30,6,0,0,6,1,-15,3,1
2,2,29,1,30,5,9,0,14,6,30,9,3,0,12,0,30,8,6,0,14,0,30,1,13,0,14,2,30,9,0,0,9,1,-15,3,1
2,0,31,3,30,5,7,0,12,4,30,8,0,0,8,6,30,9,3,0,12,0,30,3,9,0,12,2,30,3,3,0,6,1,-15,3,1
2,1,31,3,30,5,7,0,12,4,30,8,0,0,8,6,30,9,3,0,12,0,30,3,9,0,12,2,30,3,3,0,6,1,-15,3,1
2,3,31,3,30,5,7,0,12,4,30,8,0,0,8,6,30,9,3,0,12,0,30,3,9,0,12,2,30,3,3,0,6,1,-15,3,1
2,4,31,3,30,5,7,0,12,4,30,8,0,0,8,6,30,9,3,0,12,0,30,3,9,0,12,2,30,3,3,0,6,1,-15,3,1
2,3,35,0,30,8,5,0,13,7,30,2,0,0,2,1,30,2,11,0,13,0,30,4,9,0,13,3,30,8,0,0,8,1,-15,3,1
2,0,41,0,30,11,1,0,12,6,30,8,0,0,8,0,30,4,8,0,12,0,30,3,9,0,12,4,30,5,2,0,7,1,-15,3,1
2,1,41,0,30,11,1,0,12,6,30,8,0,0,8,0,30,4,8,0,12,0,30,3,9,0,12,4,30,5,2,0,7,1,-15,3,1
2,3,4,2,30,7,1,0,8,5,30,4,0,0,4,0,30,2,6,0,8,0,30,7,1,0,8,3,30,3,1,0,4,0,-27,3,0
2,4,5,0,30,2,3,0,5,3,30,3,1,0,4,0,30,0,5,0,5,0,30,1,4,0,5,0,30,2,0,0,2,0,-27,3,0
2,4,7,0,30,4,5,0,9,3,30,3,1,0,4,2,30,6,3,0,9,8,30,3,6,0,9,3,30,5,1,0,6,0,-27,3,0
2,4,8,1,30,7,0,0,7,3,30,2,0,0,2,3,30,6,1,0,7,1,30,7,0,0,7,2,30,3,0,0,3,0,-27,3,0
2,2,13,1,30,6,1,0,7,0,30,4,0,0,4,2,30,7,0,0,7,5,30,6,1,0,7,5,30,4,0,0,4,1,-15,3,1
2,3,13,1,30,6,1,0,7,0,30,4,0,0,4,2,30,7,0,0,7,5,30,6,1,0,7,5,30,4,0,0,4,1,-15,3,1
2,4,13,1,30,6,1,0,7,0,30,4,0,0,4,2,30,7,0,0,7,5,30,6,1,0,7,5,30,4,0,0,4,1,-15,3,1
2,4,15,1,30,4,9,0,13,0,30,6,0,0,6,0,30,4,9,0,13,1,30,5,8,0,13,2,30,8,1,0,9,1,-15,3,1
2,1,17,3,30,9,5,0,14,2,30,6,0,0,6,0,30,8,6,0,14,3,30,5,9,0,14,3,30,4,0,0,4,1,-15,3,1
2,2,17,3,30,9,5,0,14,2,30,6,0,0,6,0,30,8,6,0,14,3,30,5,9,0,14,3,30,4,0,0,4,1,-15,3,1
2,1,21,1,30,6,4,0,10,3,30,5,1,0,6,1,30,4,6,0,10,3,30,5,5,0,10,6,30,4,0,0,4,1,-15,3,1
2,4,21,1,30,6,4,0,10,3,30,5,1,0,6,1,30,4,6,0,10,3,30,5,5,0,10,6,30,4,0,0,4,1,-15,3,1
2,3,26,1,30,6,3,0,9,4,30,4,0,0,4,2,30,4,5,0,9,0,30,1,8,0,9,4,30,1,2,0,3,1,-15,3,1
2,3,27,1,30,6,9,0,15,4,30,2,0,0,2,0,30,6,9,0,15,1,30,6,9,0,15,2,30,6,0,0,6,1,-15,3,1
2,4,27,1,30,6,9,0,15,4,30,2,0,0,2,0,30,6,9,0,15,1,30,6,9,0,15,2,30,6,0,0,6,1,-15,3,1
2,1,30,9,30,3,2,0,5,5,30,2,0,0,2,2,30,2,3,0,5,2,30,1,4,0,5,1,30,2,1,0,3,1,-15,3,1
2,2,30,9,30,3,2,0,5,5,30,2,0,0,2,2,30,2,3,0,5,2,30,1,4,0,5,1,30,2,1,0,3,1,-15,3,1
2,2,31,5,30,8,4,0,12,6,30,8,0,0,8,3,30,4,8,0,12,0,30,3,9,0,12,0,30,3,3,0,6,1,-15,3,1
2,4,31,5,30,8,4,0,12,6,30,8,0,0,8,3,30,4,8,0,12,0,30,3,9,0,12,0,30,3,3,0,6,1,-15,3,1
2,2,38,0,30,1,9,0,10,5,30,6,0,0,6,0,30,1,9,0,10,0,30,1,9,0,10,6,30,6,0,0,6,1,-15,3,1
2,3,39,0,30,4,7,0,11,5,30,6,0,0,6,0,30,9,2,0,11,0,30,4,7,0,11,2,30,5,0,0,5,1,-15,3,1
2,4,39,0,30,4,7,0,11,5,30,6,0,0,6,0,30,9,2,0,11,0,30,4,7,0,11,2,30,5,0,0,5,1,-15,3,1
2,3,5,0,30,2,3,0,5,3,30,4,0,0,4,0,30,0,5,0,5,0,30,1,4,0,5,0,30,2,0,0,2,0,-27,3,0
2,3,7,0,30,2,2,0,4,2,30,2,0,0,2,2,30,2,2,0,4,0,30,1,3,0,4,1,30,1,1,0,2,0,-27,3,0
2,1,25,1,30,8,6,0,14,3,30,6,0,0,6,0,30,8,6,0,14,1,30,8,6,0,14,3,30,5,1,0,6,1,-15,3,1
2,2,25,1,30,8,6,0,14,3,30,6,0,0,6,0,30,8,6,0,14,1,30,8,6,0,14,3,30,5,1,0,6,1,-15,3,1
2,1,27,1,30,4,11,0,15,2,30,1,1,0,2,0,30,5,10,0,15,2,30,5,10,0,15,3,30,6,0,0,6,1,-15,3,1
2,3,27,1,30,4,11,0,15,2,30,1,1,0,2,0,30,5,10,0,15,2,30,5,10,0,15,3,30,6,0,0,6,1,-15,3,1
2,4,27,1,30,4,11,0,15,2,30,1,1,0,2,0,30,5,10,0,15,2,30,5,10,0,15,3,30,6,0,0,6,1,-15,3,1
2,3,32,0,30,7,2,0,9,4,30,2,0,0,2,1,30,9,0,0,9,1,30,3,6,0,9,2,30,2,0,0,2,1,-15,3,1
2,3,1,0,30,7,3,0,10,4,30,2,0,0,2,1,30,4,6,0,10,3,30,5,5,0,10,6,30,6,0,0,6,0,-27,3,0
2,4,1,0,30,7,3,0,10,4,30,2,0,0,2,1,30,4,6,0,10,3,30,5,5,0,10,6,30,6,0,0,6,0,-27,3,0
2,4,6,0,30,9,0,0,9,4,30,2,0,0,2,0,30,2,7,0,9,0,30,4,5,0,9,0,30,5,0,0,5,0,-27,3,0
2,3,11,3,30,4,8,0,12,1,30,4,0,0,4,0,30,5,7,0,12,0,30,4,8,0,12,2,30,4,0,0,4,1,-15,3,1
2,1,13,1,30,5,2,0,7,0,30,4,0,0,4,2,30,7,0,0,7,11,30,7,0,0,7,5,30,4,0,0,4,1,-15,3,1
2,2,13,1,30,5,2,0,7,0,30,4,0,0,4,2,30,7,0,0,7,11,30,7,0,0,7,5,30,4,0,0,4,1,-15,3,1
2,4,13,1,30,5,2,0,7,0,30,4,0,0,4,2,30,7,0,0,7,11,30,7,0,0,7,5,30,4,0,0,4,1,-15,3,1
2,3,23,1,30,5,8,0,13,2,30,6,0,0,6,5,30,9,4,0,13,0,30,6,7,0,13,2,30,5,1,0,6,1,-15,3,1
2,2,25,1,30,6,8,0,14,5,30,6,0,0,6,0,30,8,6,0,14,1,30,5,9,0,14,4,30,5,1,0,6,1,-15,3,1
2,1,27,1,30,4,11,0,15,2,30,1,1,0,2,0,30,6,9,0,15,5,30,6,9,0,15,4,30,6,0,0,6,1,-15,3,1
2,4,27,1,30,4,11,0,15,0,30,1,1,0,2,0,30,6,9,0,15,5,30,6,9,0,15,4,30,6,0,0,6,1,-15,3,1
2,4,35,6,30,5,8,0,13,6,30,2,0,0,2,1,30,6,7,0,13,0,30,3,10,0,13,1,30,8,0,0,8,1,-15,3,1
2,4,3,0,30,1,3,0,4,2,30,4,0,0,4,0,30,0,4,0,4,2,30,1,3,0,4,2,30,3,0,0,3,0,-27,3,0
2,0,5,2,30,2,3,0,5,3,30,3,1,0,4,0,30,0,5,0,5,0,30,1,4,0,5,0,30,0,2,0,2,0,-27,3,0
2,2,5,2,30,2,3,0,5,3,30,3,1,0,4,0,30,0,5,0,5,0,30,1,4,0,5,0,30,0,2,0,2,0,-27,3,0
2,4,9,0,30,1,3,0,4,2,30,2,0,0,2,0,30,2,2,0,4,4,30,1,3,0,4,1,30,1,0,0,1,0,-27,3,0
2,4,13,1,30,6,1,0,7,0,30,4,0,0,4,3,30,7,0,0,7,10,30,6,1,0,7,0,30,4,0,0,4,1,-15,3,1
2,4,19,0,30,3,10,0,13,2,30,8,0,0,8,0,30,7,6,0,13,1,30,4,9,0,13,2,30,9,0,0,9,1,-15,3,1
2,4,23,1,30,5,8,0,13,1,30,6,0,0,6,4,30,11,2,0,13,1,30,6,7,0,13,1,30,6,0,0,6,1,-15,3,1
2,0,27,3,30,5,10,0,15,3,30,2,0,0,2,0,30,10,5,0,15,0,30,4,11,0,15,1,30,5,1,0,6,1,-15,3,1
2,1,27,3,30,5,10,0,15,3,30,2,0,0,2,0,30,10,5,0,15,0,30,4,11,0,15,1,30,5,1,0,6,1,-15,3,1
2,2,27,3,30,5,10,0,15,3,30,2,0,0,2,0,30,10,5,0,15,0,30,4,11,0,15,1,30,5,1,0,6,1,-15,3,1
2,0,29,0,30,5,9,0,14,6,30,11,1,0,12,0,30,4,10,0,14,2,30,2,12,0,14,3,30,9,0,0,9,1,-15,3,1
2,2,29,0,30,5,9,0,14,6,30,11,1,0,12,0,30,4,10,0,14,2,30,2,12,0,14,3,30,9,0,0,9,1,-15,3,1
2,3,29,0,30,5,9,0,14,6,30,11,1,0,12,0,30,4,10,0,14,2,30,2,12,0,14,3,30,9,0,0,9,1,-15,3,1
2,4,31,3,30,7,5,0,12,4,30,8,0,0,8,4,30,11,1,0,12,0,30,3,9,0,12,0,30,3,3,0,6,1,-15,3,1
2,4,32,0,30,7,2,0,9,4,30,2,0,0,2,0,30,9,0,0,9,1,30,2,7,0,9,3,30,1,1,0,2,1,-15,3,1
2,2,35,0,30,10,3,0,13,6,30,2,0,0,2,1,30,4,9,0,13,0,30,7,6,0,13,6,30,8,0,0,8,1,-15,3,1
2,3,35,0,30,10,3,0,13,6,30,2,0,0,2,1,30,4,9,0,13,0,30,7,6,0,13,6,30,8,0,0,8,1,-15,3,1
2,4,35,0,30,10,3,0,13,6,30,2,0,0,2,1,30,4,9,0,13,0,30,7,6,0,13,6,30,8,0,0,8,1,-15,3,1
2,3,38,0,30,5,5,0,10,7,30,6,0,0,6,0,30,1,9,0,10,0,30,2,8,0,10,7,30,6,0,0,6,1,-15,3,1
2,1,13,1,30,6,1,0,7,0,30,4,0,0,4,4,30,7,0,0,7,6,30,6,1,0,7,4,30,4,0,0,4,1,-15,3,1
2,1,17,2,30,10,4,0,14,2,30,6,0,0,6,0,30,6,8,0,14,2,30,5,9,0,14,0,30,3,1,0,4,1,-15,3,1
2,1,19,0,30,2,11,0,13,2,30,6,2,0,8,0,30,6,7,0,13,5,30,4,9,0,13,0,30,8,1,0,9,1,-15,3,1
2,4,19,0,30,2,11,0,13,2,30,6,2,0,8,0,30,6,7,0,13,5,30,4,9,0,13,0,30,8,1,0,9,1,-15,3,1
2,2,25,1,30,8,6,0,14,4,30,6,0,0,6,0,30,8,6,0,14,1,30,5,9,0,14,2,30,5,1,0,6,1,-15,3,1
2,4,25,1,30,8,6,0,14,4,30,6,0,0,6,0,30,8,6,0,14,1,30,5,9,0,14,2,30,5,1,0,6,1,-15,3,1
2,2,26,0,30,7,2,0,9,5,30,4,0,0,4,1,30,0,9,0,9,0,30,2,7,0,9,5,30,3,0,0,3,1,-15,3,1
2,3,26,0,30,7,2,0,9,5,30,4,0,0,4,1,30,0,9,0,9,0,30,2,7,0,9,5,30,3,0,0,3,1,-15,3,1
2,2,27,1,30,4,11,0,15,4,30,1,1,0,2,0,30,5,10,0,15,2,30,5,10,0,15,0,30,6,0,0,6,1,-15,3,1
2,3,33,1,30,2,9,0,11,5,30,4,0,0,4,0,30,9,2,0,11,0,30,3,8,0,11,5,30,4,0,0,4,1,-15,3,1
2,1,5,1,30,2,3,0,5,4,30,1,3,0,4,0,30,0,5,0,5,0,30,3,2,0,5,0,30,0,2,0,2,0,-27,3,0
2,2,5,1,30,2,3,0,5,4,30,1,3,0,4,0,30,0,5,0,5,0,30,3,2,0,5,0,30,0,2,0,2,0,-27,3,0
2,4,5,1,30,2,3,0,5,4,30,1,3,0,4,0,30,0,5,0,5,0,30,3,2,0,5,0,30,0,2,0,2,0,-27,3,0
2,2,6,2,30,9,0,0,9,4,30,2,0,0,2,0,30,2,7,0,9,0,30,4,5,0,9,0,30,3,2,0,5,0,-27,3,0
2,3,8,0,30,7,0,0,7,4,30,2,0,0,2,3,30,2,5,0,7,0,30,6,1,0,7,1,30,3,0,0,3,0,-27,3,0
2,4,8,0,30,7,0,0,7,4,30,2,0,0,2,3,30,2,5,0,7,0,30,6,1,0,7,1,30,3,0,0,3,0,-27,3,0
2,1,5,0,30,2,3,0,5,3,30,1,3,0,4,0,30,0,5,0,5,1,30,2,3,0,5,2,30,2,0,0,2,0,-27,3,0
2,4,5,0,30,2,3,0,5,3,30,1,3,0,4,0,30,0,5,0,5,1,30,2,3,0,5,2,30,2,0,0,2,0,-27,3,0
2,3,6,0,30,5,4,0,9,4,30,2,0,0,2,0,30,2,7,0,9,0,30,4,5,0,9,5,30,5,0,0,5,0,-27,3,0
2,4,13,2,30,7,0,0,7,0,30,4,0,0,4,2,30,6,1,0,7,7,30,7,0,0,7,5,30,4,0,0,4,1,-15,3,1
2,4,15,0,30,7,6,0,13,0,30,6,0,0,6,0,30,4,9,0,13,1,30,4,9,0,13,2,30,7,2,0,9,1,-15,3,1
2,2,17,3,30,10,4,0,14,2,30,6,0,0,6,0,30,7,7,0,14,3,30,3,11,0,14,8,30,4,0,0,4,1,-15,3,1
2,3,17,3,30,10,4,0,14,2,30,6,0,0,6,0,30,7,7,0,14,3,30,3,11,0,14,8,30,4,0,0,4,1,-15,3,1
2,4,23,2,30,5,8,0,13,3,30,6,0,0,6,7,30,10,3,0,13,0,30,6,7,0,13,1,30,5,1,0,6,1,-15,3,1
2,3,25,1,30,5,9,0,14,2,30,6,0,0,6,2,30,11,3,0,14,0,30,5,9,0,14,3,30,5,1,0,6,1,-15,3,1
2,4,25,1,30,5,9,0,14,2,30,6,0,0,6,2,30,11,3,0,14,0,30,5,9,0,14,3,30,5,1,0,6,1,-15,3,1
2,1,4,2,30,4,4,0,8,4,30,2,2,0,4,0,30,4,4,0,8,1,30,7,1,0,8,3,30,4,0,0,4,0,-27,3,0
2,2,4,2,30,4,4,0,8,4,30,2,2,0,4,0,30,4,4,0,8,1,30,7,1,0,8,3,30,4,0,0,4,0,-27,3,0
2,3,4,2,30,4,4,0,8,4,30,2,2,0,4,0,30,4,4,0,8,1,30,7,1,0,8,3,30,4,0,0,4,0,-27,3,0
2,4,4,2,30,4,4,0,8,4,30,2,2,0,4,0,30,4,4,0,8,1,30,7,1,0,8,3,30,4,0,0,4,0,-27,3,0
2,2,13,1,30,3,0,0,3,0,30,2,0,0,2,0,30,3,0,0,3,6,30,3,0,0,3,4,30,2,0,0,2,1,-15,3,1
2,3,17,3,30,8,6,0,14,3,30,6,0,0,6,0,30,5,9,0,14,1,30,8,6,0,14,6,30,4,0,0,4,1,-15,3,1
2,2,21,2,30,6,4,0,10,4,30,6,0,0,6,1,30,3,7,0,10,4,30,5,5,0,10,0,30,3,1,0,4,1,-15,3,1
2,3,21,2,30,6,4,0,10,4,30,6,0,0,6,1,30,3,7,0,10,4,30,5,5,0,10,0,30,3,1,0,4,1,-15,3,1
2,4,21,2,30,6,4,0,10,4,30,6,0,0,6,1,30,3,7,0,10,4,30,5,5,0,10,0,30,3,1,0,4,1,-15,3,1
2,4,39,0,30,4,7,0,11,7,30,6,0,0,6,0,30,3,8,0,11,1,30,3,8,0,11,3,30,5,0,0,5,1,-15,3,1
2,3,41,1,30,7,5,0,12,9,30,8,0,0,8,0,30,2,10,0,12,0,30,4,8,0,12,3,30,7,0,0,7,1,-15,3,1
2,4,41,1,30,7,5,0,12,9,30,8,0,0,8,0,30,2,10,0,12,0,30,4,8,0,12,3,30,7,0,0,7,1,-15,3,1
2,2,1,0,30,7,3,0,10,4,30,2,0,0,2,1,30,4,6,0,10,5,30,7,3,0,10,6,30,6,0,0,6,0,-27,3,0
2,4,7,0,30,1,3,0,4,2,30,2,0,0,2,0,30,2,2,0,4,0,30,1,3,0,4,2,30,1,1,0,2,0,-27,3,0
2,2,13,4,30,6,1,0,7,0,30,4,0,0,4,2,30,6,1,0,7,8,30,7,0,0,7,5,30,4,0,0,4,1,-15,3,1
2,2,19,0,30,5,8,0,13,0,30,5,3,0,8,0,30,6,7,0,13,3,30,4,9,0,13,1,30,8,1,0,9,1,-15,3,1
2,3,19,0,30,5,8,0,13,0,30,5,3,0,8,0,30,6,7,0,13,3,30,4,9,0,13,1,30,8,1,0,9,1,-15,3,1
2,1,27,1,30,6,9,0,15,4,30,2,0,0,2,3,30,6,9,0,15,0,30,9,6,0,15,0,30,5,1,0,6,1,-15,3,1
2,4,27,1,30,6,9,0,15,4,30,2,0,0,2,0,30,6,9,0,15,0,30,9,6,0,15,0,30,5,1,0,6,1,-15,3,1
2,2,29,1,30,7,7,0,14,5,30,12,0,0,12,0,30,7,7,0,14,0,30,1,13,0,14,0,30,6,3,0,9,1,-15,3,1
2,3,29,1,30,7,7,0,14,5,30,12,0,0,12,0,30,7,7,0,14,0,30,1,13,0,14,0,30,6,3,0,9,1,-15,3,1
2,1,31,1,30,3,9,0,12,5,30,8,0,0,8,3,30,8,4,0,12,0,30,3,9,0,12,1,30,5,1,0,6,1,-15,3,1
2,2,31,1,30,3,9,0,12,5,30,8,0,0,8,3,30,8,4,0,12,0,30,3,9,0,12,1,30,5,1,0,6,1,-15,3,1
2,3,31,1,30,3,9,0,12,5,30,8,0,0,8,3,30,8,4,0,12,0,30,3,9,0,12,1,30,5,1,0,6,1,-15,3,1
2,4,31,1,30,3,9,0,12,5,30,8,0,0,8,3,30,8,4,0,12,0,30,3,9,0,12,1,30,5,1,0,6,1,-15,3,1
2,3,39,0,30,2,9,0,11,6,30,6,0,0,6,0,30,4,7,0,11,2,30,2,9,0,11,3,30,5,0,0,5,1,-15,3,1
2,4,39,0,30,2,9,0,11,6,30,6,0,0,6,0,30,4,7,0,11,2,30,2,9,0,11,3,30,5,0,0,5,1,-15,3,1
2,0,4,2,30,6,2,0,8,4,30,2,2,0,4,1,30,2,6,0,8,0,30,6,2,0,8,3,30,4,0,0,4,0,-27,3,0
2,1,4,2,30,6,2,0,8,4,30,2,2,0,4,1,30,2,6,0,8,0,30,6,2,0,8,3,30,4,0,0,4,0,-27,3,0
2,2,4,2,30,6,2,0,8,4,30,2,2,0,4,1,30,2,6,0,8,0,30,6,2,0,8,3,30,4,0,0,4,0,-27,3,0
2,4,4,2,30,6,2,0,8,4,30,2,2,0,4,1,30,2,6,0,8,0,30,6,2,0,8,3,30,4,0,0,4,0,-27,3,0
2,1,5,0,30,1,4,0,5,2,30,4,0,0,4,0,30,0,5,0,5,0,30,1,4,0,5,1,30,2,0,0,2,0,-27,3,0
2,4,5,0,30,1,4,0,5,2,30,4,0,0,4,0,30,0,5,0,5,0,30,1,4,0,5,1,30,2,0,0,2,0,-27,3,0
2,4,6,0,30,6,3,0,9,4,30,2,0,0,2,0,30,2,7,0,9,0,30,4,5,0,9,2,30,5,0,0,5,0,-27,3,0
2,2,17,5,30,10,4,0,14,4,30,6,0,0,6,0,30,5,9,0,14,2,30,8,6,0,14,3,30,4,0,0,4,1,-15,3,1
2,3,19,0,30,5,8,0,13,1,30,4,4,0,8,0,30,7,6,0,13,3,30,4,9,0,13,1,30,8,1,0,9,1,-15,3,1
2,2,23,1,30,6,7,0,13,2,30,6,0,0,6,0,30,13,0,0,13,0,30,5,8,0,13,4,30,6,0,0,6,1,-15,3,1
2,2,25,1,30,4,10,0,14,4,30,6,0,0,6,0,30,6,8,0,14,2,30,7,7,0,14,3,30,6,0,0,6,1,-15,3,1
2,3,25,1,30,4,10,0,14,4,30,6,0,0,6,0,30,6,8,0,14,2,30,7,7,0,14,3,30,6,0,0,6,1,-15,3,1
2,4,25,1,30,4,10,0,14,4,30,6,0,0,6,0,30,6,8,0,14,2,30,7,7,0,14,3,30,6,0,0,6,1,-15,3,1
2,2,27,2,30,7,8,0,15,1,30,2,0,0,2,0,30,5,10,0,15,2,30,4,11,0,15,0,30,4,2,0,6,1,-15,3,1
2,3,27,2,30,7,8,0,15,1,30,2,0,0,2,0,30,5,10,0,15,2,30,4,11,0,15,0,30,4,2,0,6,1,-15,3,1
2,3,29,0,30,7,7,0,14,6,30,12,0,0,12,0,30,4,10,0,14,0,30,2,12,0,14,0,30,8,1,0,9,1,-15,3,1
2,3,35,0,30,6,7,0,13,3,30,2,0,0,2,1,30,2,11,0,13,5,30,4,9,0,13,5,30,8,0,0,8,1,-15,3,1
2,2,11,1,30,5,7,0,12,0,30,4,0,0,4,0,30,7,5,0,12,7,30,6,6,0,12,6,30,4,0,0,4,1,-15,3,1
2,2,19,0,30,3,10,0,13,2,30,5,3,0,8,0,30,5,8,0,13,3,30,4,9,0,13,3,30,9,0,0,9,1,-15,3,1
2,4,25,1,30,3,11,0,14,5,30,6,0,0,6,0,30,10,4,0,14,1,30,7,7,0,14,3,30,5,1,0,6,1,-15,3,1
2,1,27,1,30,6,9,0,15,5,30,2,0,0,2,0,30,2,13,0,15,4,30,5,10,0,15,6,30,5,1,0,6,1,-15,3,1
2,2,27,1,30,6,9,0,15,5,30,2,0,0,2,0,30,2,13,0,15,4,30,5,10,0,15,6,30,5,1,0,6,1,-15,3,1
2,2,29,0,30,6,8,0,14,5,30,10,2,0,12,0,30,5,9,0,14,0,30,1,13,0,14,3,30,9,0,0,9,1,-15,3,1
2,4,29,0,30,6,8,0,14,5,30,10,2,0,12,0,30,5,9,0,14,0,30,1,13,0,14,3,30,9,0,0,9,1,-15,3,1
2,1,31,5,30,6,6,0,12,5,30,8,0,0,8,4,30,9,3,0,12,0,30,3,9,0,12,1,30,4,2,0,6,1,-15,3,1
2,2,31,5,30,6,6,0,12,5,30,8,0,0,8,4,30,9,3,0,12,0,30,3,9,0,12,1,30,4,2,0,6,1,-15,3,1
2,3,45,0,30,7,6,0,13,10,30,10,0,0,10,0,30,0,13,0,13,0,30,4,9,0,13,10,30,5,0,0,5,1,-15,3,1
2,3,47,0,30,0,14,0,14,6,30,4,0,0,4,0,30,4,10,0,14,1,30,3,11,0,14,7,30,7,0,0,7,1,-15,3,1
2,1,5,0,30,3,2,0,5,3,30,0,4,0,4,0,30,0,5,0,5,0,30,1,4,0,5,0,30,2,0,0,2,0,-27,3,0
2,4,6,1,30,7,2,0,9,4,30,2,0,0,2,0,30,3,6,0,9,3,30,5,4,0,9,1,30,4,1,0,5,0,-27,3,0
2,3,8,1,30,7,0,0,7,4,30,2,0,0,2,1,30,2,5,0,7,1,30,7,0,0,7,2,30,3,0,0,3,0,-27,3,0
2,4,8,1,30,7,0,0,7,4,30,2,0,0,2,1,30,2,5,0,7,1,30,7,0,0,7,2,30,3,0,0,3,0,-27,3,0
2,3,13,1,30,3,4,0,7,0,30,4,0,0,4,2,30,7,0,0,7,4,30,7,0,0,7,5,30,4,0,0,4,1,-15,3,1
2,3,17,4,30,11,3,0,14,3,30,6,0,0,6,0,30,5,9,0,14,0,30,5,9,0,14,2,30,4,0,0,4,1,-15,3,1
2,4,17,4,30,11,3,0,14,3,30,6,0,0,6,0,30,5,9,0,14,0,30,5,9,0,14,2,30,4,0,0,4,1,-15,3,1
2,3,19,0,30,4,9,0,13,2,30,8,0,0,8,0,30,6,7,0,13,3,30,4,9,0,13,0,30,7,2,0,9,1,-15,3,1
2,4,25,1,30,5,9,0,14,1,30,6,0,0,6,0,30,11,3,0,14,0,30,8,6,0,14,2,30,6,0,0,6,1,-15,3,1
2,4,31,3,30,4,8,0,12,6,30,8,0,0,8,9,30,9,3,0,12,0,30,4,8,0,12,1,30,6,0,0,6,1,-15,3,1
2,3,38,0,30,1,9,0,10,7,30,6,0,0,6,0,30,2,8,0,10,0,30,6,4,0,10,7,30,6,0,0,6,1,-15,3,1
2,4,39,0,30,3,8,0,11,6,30,6,0,0,6,0,30,5,6,0,11,0,30,2,9,0,11,4,30,5,0,0,5,1,-15,3,1
2,3,5,4,30,2,3,0,5,3,30,0,4,0,4,0,30,0,5,0,5,0,30,1,4,0,5,0,30,0,2,0,2,0,-27,3,0
2,2,13,2,30,7,0,0,7,0,30,4,0,0,4,2,30,6,1,0,7,11,30,7,0,0,7,3,30,4,0,0,4,1,-15,3,1
2,3,15,0,30,4,9,0,13,1,30,6,0,0,6,0,30,3,10,0,13,1,30,4,9,0,13,1,30,8,1,0,9,1,-15,3,1
2,1,19,0,30,3,10,0,13,2,30,3,5,0,8,0,30,4,9,0,13,4,30,7,6,0,13,2,30,9,0,0,9,1,-15,3,1
2,1,21,3,30,6,4,0,10,4,30,5,1,0,6,1,30,3,7,0,10,1,30,4,6,0,10,4,30,4,0,0,4,1,-15,3,1
2,3,21,3,30,6,4,0,10,4,30,5,1,0,6,1,30,3,7,0,10,1,30,4,6,0,10,4,30,4,0,0,4,1,-15,3,1
2,4,39,0,30,7,4,0,11,4,30,6,0,0,6,1,30,10,1,0,11,0,30,2,9,0,11,0,30,1,4,0,5,1,-15,3,1
2,3,5,0,30,0,5,0,5,3,30,0,4,0,4,0,30,0,5,0,5,0,30,1,4,0,5,0,30,0,2,0,2,0,-27,3,0
2,0,13,4,30,6,1,0,7,2,30,4,0,0,4,2,30,5,2,0,7,10,30,5,2,0,7,0,30,4,0,0,4,1,-15,3,1
2,1,13,4,30,6,1,0,7,2,30,4,0,0,4,2,30,5,2,0,7,10,30,5,2,0,7,0,30,4,0,0,4,1,-15,3,1
2,2,13,4,30,6,1,0,7,2,30,4,0,0,4,2,30,5,2,0,7,10,30,5,2,0,7,0,30,4,0,0,4,1,-15,3,1
2,4,13,4,30,6,1,0,7,2,30,4,0,0,4,2,30,5,2,0,7,10,30,5,2,0,7,0,30,4,0,0,4,1,-15,3,1
2,4,23,1,30,5,8,0,13,3,30,6,0,0,6,6,30,10,3,0,13,1,30,4,9,0,13,0,30,6,0,0,6,1,-15,3,1
2,2,25,6,30,7,7,0,14,3,30,6,0,0,6,3,30,9,5,0,14,1,30,5,9,0,14,4,30,5,1,0,6,1,-15,3,1
2,3,25,6,30,7,7,0,14,3,30,6,0,0,6,3,30,9,5,0,14,1,30,5,9,0,14,4,30,5,1,0,6,1,-15,3,1
2,0,27,4,30,5,10,0,15,3,30,1,1,0,2,0,30,11,4,0,15,0,30,4,11,0,15,1,30,5,1,0,6,1,-15,3,1
2,3,27,4,30,5,10,0,15,3,30,1,1,0,2,0,30,11,4,0,15,0,30,4,11,0,15,0,30,5,1,0,6,1,-15,3,1
2,4,27,4,30,5,10,0,15,3,30,1,1,0,2,0,30,11,4,0,15,0,30,4,11,0,15,0,30,5,1,0,6,1,-15,3,1
2,4,29,0,30,4,10,0,14,6,30,12,0,0,12,0,30,5,9,0,14,0,30,0,14,0,14,1,30,9,0,0,9,1,-15,3,1
2,3,31,1,30,6,6,0,12,5,30,8,0,0,8,7,30,10,2,0,12,0,30,3,9,0,12,3,30,4,2,0,6,1,-15,3,1
2,0,37,0,30,7,4,0,11,7,30,8,0,0,8,0,30,2,9,0,11,2,30,5,6,0,11,8,30,6,0,0,6,1,-15,3,1
2,4,43,0,30,6,8,0,14,6,30,6,0,0,6,0,30,9,5,0,14,1,30,1,13,0,14,3,30,5,0,0,5,1,-15,3,1
2,3,4,0,30,6,2,0,8,4,30,4,0,0,4,2,30,4,4,0,8,0,30,6,2,0,8,1,30,3,1,0,4,0,-27,3,0
2,4,4,0,30,6,2,0,8,4,30,4,0,0,4,2,30,4,4,0,8,0,30,6,2,0,8,1,30,3,1,0,4,0,-27,3,0
2,0,5,0,30,2,3,0,5,3,30,2,2,0,4,0,30,0,5,0,5,0,30,1,4,0,5,2,30,0,2,0,2,0,-27,3,0
2,1,5,0,30,2,3,0,5,3,30,2,2,0,4,0,30,0,5,0,5,0,30,1,4,0,5,2,30,0,2,0,2,0,-27,3,0
2,3,5,0,30,2,3,0,5,3,30,2,2,0,4,0,30,0,5,0,5,0,30,1,4,0,5,2,30,0,2,0,2,0,-27,3,0
2,4,5,0,30,2,3,0,5,3,30,2,2,0,4,0,30,0,5,0,5,0,30,1,4,0,5,2,30,0,2,0,2,0,-27,3,0
2,3,13,2,30,6,1,0,7,0,30,4,0,0,4,2,30,7,0,0,7,5,30,6,1,0,7,3,30,4,0,0,4,1,-15,3,1
2,3,17,3,30,9,5,0,14,2,30,6,0,0,6,0,30,8,6,0,14,1,30,6,8,0,14,1,30,4,0,0,4,1,-15,3,1
2,0,21,6,30,9,1,0,10,4,30,6,0,0,6,1,30,3,7,0,10,3,30,5,5,0,10,2,30,4,0,0,4,1,-15,3,1
2,2,21,6,30,9,1,0,10,4,30,6,0,0,6,1,30,3,7,0,10,3,30,5,5,0,10,2,30,4,0,0,4,1,-15,3,1
2,4,23,2,30,8,5,0,13,1,30,6,0,0,6,5,30,11,2,0,13,0,30,4,9,0,13,2,30,6,0,0,6,1,-15,3,1
2,1,27,1,30,4,11,0,15,5,30,2,0,0,2,0,30,3,12,0,15,3,30,5,10,0,15,0,30,6,0,0,6,1,-15,3,1
2,3,35,1,30,8,5,0,13,3,30,2,0,0,2,1,30,9,4,0,13,2,30,1,12,0,13,3,30,8,0,0,8,1,-15,3,1
2,0,5,0,30,2,3,0,5,3,30,2,2,0,4,0,30,1,4,0,5,0,30,3,2,0,5,1,30,2,0,0,2,0,-27,3,0
2,1,5,0,30,2,3,0,5,3,30,2,2,0,4,0,30,1,4,0,5,0,30,3,2,0,5,1,30,2,0,0,2,0,-27,3,0
2,3,35,1,30,9,4,0,13,4,30,1,1,0,2,1,30,6,7,0,13,3,30,2,11,0,13,7,30,8,0,0,8,1,-15,3,1
2,4,1,0,30,4,6,0,10,4,30,2,0,0,2,1,30,4,6,0,10,1,30,9,1,0,10,6,30,6,0,0,6,0,-27,3,0
2,4,3,0,30,1,3,0,4,2,30,4,0,0,4,0,30,1,3,0,4,0,30,3,1,0,4,0,30,1,2,0,3,0,-27,3,0
2,3,4,1,30,8,0,0,8,4,30,4,0,0,4,0,30,1,7,0,8,0,30,0,8,0,8,3,30,3,1,0,4,0,-27,3,0
2,4,4,1,30,8,0,0,8,4,30,4,0,0,4,0,30,1,7,0,8,0,30,0,8,0,8,3,30,3,1,0,4,0,-27,3,0
2,1,11,1,30,3,9,0,12,0,30,4,0,0,4,0,30,6,6,0,12,7,30,4,8,0,12,6,30,4,0,0,4,1,-15,3,1
2,2,13,3,30,7,0,0,7,0,30,4,0,0,4,5,30,7,0,0,7,7,30,4,3,0,7,4,30,4,0,0,4,1,-15,3,1
2,4,13,3,30,7,0,0,7,0,30,4,0,0,4,5,30,7,0,0,7,7,30,4,3,0,7,4,30,4,0,0,4,1,-15,3,1
2,3,17,0,30,9,5,0,14,2,30,6,0,0,6,0,30,5,9,0,14,0,30,5,9,0,14,5,30,4,0,0,4,1,-15,3,1
2,4,17,0,30,9,5,0,14,2,30,6,0,0,6,0,30,5,9,0,14,0,30,5,9,0,14,5,30,4,0,0,4,1,-15,3,1
2,2,25,1,30,4,10,0,14,5,30,6,0,0,6,0,30,6,8,0,14,2,30,8,6,0,14,5,30,5,1,0,6,1,-15,3,1
2,4,25,1,30,4,10,0,14,5,30,6,0,0,6,0,30,6,8,0,14,2,30,8,6,0,14,5,30,5,1,0,6,1,-15,3,1
2,0,27,1,30,5,10,0,15,3,30,1,1,0,2,0,30,6,9,0,15,3,30,6,9,0,15,4,30,6,0,0,6,1,-15,3,1
2,3,27,1,30,5,10,0,15,3,30,1,1,0,2,0,30,6,9,0,15,3,30,6,9,0,15,4,30,6,0,0,6,1,-15,3,1
2,4,27,1,30,5,10,0,15,3,30,1,1,0,2,0,30,6,9,0,15,3,30,6,9,0,15,4,30,6,0,0,6,1,-15,3,1
2,2,45,2,30,10,3,0,13,8,30,10,0,0,10,0,30,6,7,0,13,0,30,5,8,0,13,7,30,5,0,0,5,1,-15,3,1
2,0,5,0,30,5,0,0,5,3,30,0,4,0,4,0,30,0,5,0,5,0,30,1,4,0,5,1,30,2,0,0,2,0,-27,3,0
2,2,5,0,30,5,0,0,5,3,30,0,4,0,4,0,30,0,5,0,5,0,30,1,4,0,5,1,30,2,0,0,2,0,-27,3,0
2,3,5,0,30,5,0,0,5,3,30,0,4,0,4,0,30,0,5,0,5,0,30,1,4,0,5,1,30,2,0,0,2,0,-27,3,0
2,3,8,2,30,7,0,0,7,3,30,2,0,0,2,3,30,4,3,0,7,1,30,7,0,0,7,0,30,3,0,0,3,0,-27,3,0
2,3,13,1,30,5,2,0,7,0,30,4,0,0,4,3,30,7,0,0,7,6,30,5,2,0,7,0,30,4,0,0,4,1,-15,3,1
2,1,25,2,30,4,10,0,14,2,30,6,0,0,6,0,30,8,6,0,14,1,30,5,9,0,14,5,30,5,1,0,6,1,-15,3,1
2,2,25,2,30,4,10,0,14,2,30,6,0,0,6,0,30,8,6,0,14,1,30,5,9,0,14,5,30,5,1,0,6,1,-15,3,1
2,2,27,0,30,4,11,0,15,3,30,1,1,0,2,0,30,6,9,0,15,2,30,4,11,0,15,5,30,6,0,0,6,1,-15,3,1
2,4,27,0,30,4,11,0,15,3,30,1,1,0,2,0,30,6,9,0,15,2,30,4,11,0,15,5,30,6,0,0,6,1,-15,3,1
2,2,31,3,30,5,7,0,12,8,30,8,0,0,8,3,30,4,8,0,12,3,30,9,3,0,12,0,30,5,1,0,6,1,-15,3,1
2,4,31,1,30,5,7,0,12,8,30,8,0,0,8,3,30,4,8,0,12,3,30,9,3,0,12,0,30,5,1,0,6,1,-15,3,1
2,4,3,0,30,0,4,0,4,2,30,4,0,0,4,1,30,2,2,0,4,2,30,1,3,0,4,0,30,1,2,0,3,0,-27,3,0
2,4,11,0,30,4,8,0,12,1,30,4,0,0,4,0,30,5,7,0,12,0,30,6,6,0,12,3,30,4,0,0,4,1,-15,3,1
2,2,13,3,30,6,1,0,7,0,30,4,0,0,4,5,30,6,1,0,7,7,30,7,0,0,7,4,30,4,0,0,4,1,-15,3,1
2,4,13,3,30,6,1,0,7,0,30,4,0,0,4,5,30,6,1,0,7,7,30,7,0,0,7,4,30,4,0,0,4,1,-15,3,1
2,1,19,0,30,3,10,0,13,2,30,4,4,0,8,0,30,7,6,0,13,6,30,6,7,0,13,1,30,8,1,0,9,1,-15,3,1
2,3,19,0,30,3,10,0,13,2,30,4,4,0,8,0,30,7,6,0,13,6,30,6,7,0,13,1,30,8,1,0,9,1,-15,3,1
2,4,19,0,30,3,10,0,13,2,30,4,4,0,8,0,30,7,6,0,13,6,30,6,7,0,13,1,30,8,1,0,9,1,-15,3,1
2,3,23,1,30,6,7,0,13,4,30,6,0,0,6,7,30,10,3,0,13,0,30,5,8,0,13,3,30,6,0,0,6,1,-15,3,1
2,3,25,1,30,4,10,0,14,4,30,6,0,0,6,0,30,9,5,0,14,1,30,5,9,0,14,4,30,5,1,0,6,1,-15,3,1
2,1,27,1,30,7,8,0,15,0,30,1,1,0,2,0,30,11,4,0,15,2,30,4,11,0,15,2,30,6,0,0,6,1,-15,3,1
2,2,27,1,30,7,8,0,15,0,30,1,1,0,2,0,30,11,4,0,15,2,30,4,11,0,15,2,30,6,0,0,6,1,-15,3,1
2,4,27,1,30,7,8,0,15,0,30,1,1,0,2,0,30,11,4,0,15,2,30,4,11,0,15,2,30,6,0,0,6,1,-15,3,1
2,2,37,0,30,5,6,0,11,6,30,8,0,0,8,0,30,8,3,0,11,2,30,3,8,0,11,6,30,6,0,0,6,1,-15,3,1
2,3,37,0,30,5,6,0,11,6,30,8,0,0,8,0,30,8,3,0,11,2,30,3,8,0,11,6,30,6,0,0,6,1,-15,3,1
2,3,19,0,30,2,11,0,13,2,30,5,3,0,8,0,30,8,5,0,13,0,30,5,8,0,13,1,30,8,1,0,9,1,-15,3,1
2,4,19,0,30,2,11,0,13,2,30,5,3,0,8,0,30,8,5,0,13,0,30,5,8,0,13,1,30,8,1,0,9,1,-15,3,1
2,3,23,1,30,7,6,0,13,4,30,6,0,0,6,9,30,10,3,0,13,0,30,5,8,0,13,2,30,5,1,0,6,1,-15,3,1
2,4,23,1,30,7,6,0,13,4,30,6,0,0,6,9,30,10,3,0,13,0,30,5,8,0,13,2,30,5,1,0,6,1,-15,3,1
2,4,39,0,30,5,6,0,11,6,30,6,0,0,6,0,30,5,6,0,11,2,30,4,7,0,11,4,30,5,0,0,5,1,-15,3,1
2,2,7,0,30,1,3,0,4,1,30,2,0,0,2,0,30,4,0,0,4,2,30,1,3,0,4,1,30,1,1,0,2,0,-27,3,0
2,4,7,0,30,1,3,0,4,1,30,2,0,0,2,0,30,4,0,0,4,2,30,1,3,0,4,0,30,1,1,0,2,0,-27,3,0
2,3,8,0,30,7,0,0,7,3,30,2,0,0,2,0,30,2,5,0,7,0,30,4,3,0,7,2,30,3,0,0,3,0,-27,3,0
2,1,17,1,30,6,8,0,14,2,30,6,0,0,6,0,30,6,8,0,14,5,30,5,9,0,14,5,30,4,0,0,4,1,-15,3,1
2,2,17,1,30,6,8,0,14,2,30,6,0,0,6,0,30,6,8,0,14,5,30,5,9,0,14,5,30,4,0,0,4,1,-15,3,1
2,3,19,0,30,6,7,0,13,1,30,4,4,0,8,0,30,7,6,0,13,0,30,5,8,0,13,2,30,8,1,0,9,1,-15,3,1
2,4,19,0,30,6,7,0,13,1,30,4,4,0,8,0,30,7,6,0,13,0,30,5,8,0,13,2,30,8,1,0,9,1,-15,3,1
2,1,25,1,30,7,7,0,14,4,30,6,0,0,6,0,30,10,4,0,14,1,30,5,9,0,14,3,30,5,1,0,6,1,-15,3,1
2,2,25,1,30,7,7,0,14,4,30,6,0,0,6,0,30,10,4,0,14,1,30,5,9,0,14,3,30,5,1,0,6,1,-15,3,1
2,0,27,1,30,5,10,0,15,3,30,1,1,0,2,0,30,3,12,0,15,0,30,4,11,0,15,2,30,6,0,0,6,1,-15,3,1
2,1,27,1,30,5,10,0,15,3,30,1,1,0,2,0,30,3,12,0,15,0,30,4,11,0,15,2,30,6,0,0,6,1,-15,3,1
2,2,29,0,30,7,7,0,14,6,30,10,2,0,12,0,30,4,10,0,14,0,30,0,14,0,14,1,30,9,0,0,9,1,-15,3,1
2,3,29,0,30,7,7,0,14,6,30,10,2,0,12,0,30,4,10,0,14,0,30,0,14,0,14,1,30,9,0,0,9,1,-15,3,1
2,4,31,3,30,5,7,0,12,4,30,8,0,0,8,6,30,11,1,0,12,0,30,3,9,0,12,0,30,4,2,0,6,1,-15,3,1
2,1,5,0,30,2,3,0,5,3,30,4,0,0,4,0,30,0,5,0,5,0,30,1,4,0,5,2,30,2,0,0,2,0,-27,3,0
2,2,5,0,30,2,3,0,5,3,30,4,0,0,4,0,30,0,5,0,5,0,30,1,4,0,5,2,30,2,0,0,2,0,-27,3,0
2,3,8,6,30,7,0,0,7,4,30,2,0,0,2,3,30,3,4,0,7,2,30,7,0,0,7,0,30,3,0,0,3,0,-27,3,0
2,4,9,0,30,8,3,0,11,4,30,5,1,0,6,5,30,4,7,0,11,1,30,2,9,0,11,3,30,4,0,0,4,0,-27,3,0
2,2,13,0,30,5,2,0,7,0,30,4,0,0,4,2,30,6,1,0,7,13,30,5,2,0,7,4,30,4,0,0,4,1,-15,3,1
2,4,13,0,30,5,2,0,7,0,30,4,0,0,4,2,30,6,1,0,7,13,30,5,2,0,7,4,30,4,0,0,4,1,-15,3,1
2,1,15,0,30,3,10,0,13,0,30,6,0,0,6,0,30,3,10,0,13,3,30,6,7,0,13,5,30,6,3,0,9,1,-15,3,1
2,0,17,5,30,10,4,0,14,4,30,6,0,0,6,0,30,2,12,0,14,1,30,7,7,0,14,2,30,4,0,0,4,1,-15,3,1
2,2,17,5,30,10,4,0,14,4,30,6,0,0,6,0,30,2,12,0,14,0,30,7,7,0,14,2,30,4,0,0,4,1,-15,3,1
2,3,17,5,30,10,4,0,14,4,30,6,0,0,6,0,30,2,12,0,14,0,30,7,7,0,14,2,30,4,0,0,4,1,-15,3,1
2,4,25,2,30,10,4,0,14,1,30,6,0,0,6,0,30,10,4,0,14,1,30,6,8,0,14,4,30,5,1,0,6,1,-15,3,1
2,2,27,2,30,5,10,0,15,4,30,1,1,0,2,0,30,7,8,0,15,0,30,2,13,0,15,1,30,6,0,0,6,1,-15,3,1
2,4,27,2,30,5,10,0,15,4,30,1,1,0,2,0,30,7,8,0,15,0,30,2,13,0,15,1,30,6,0,0,6,1,-15,3,1
2,3,35,3,30,9,4,0,13,3,30,2,0,0,2,0,30,6,7,0,13,0,30,4,9,0,13,6,30,8,0,0,8,1,-15,3,1
2,4,35,3,30,9,4,0,13,3,30,2,0,0,2,0,30,6,7,0,13,0,30,4,9,0,13,6,30,8,0,0,8,1,-15,3,1
2,3,1,0,30,7,3,0,10,4,30,2,0,0,2,1,30,4,6,0,10,4,30,8,2,0,10,8,30,6,0,0,6,0,-27,3,0
2,4,3,0,30,0,4,0,4,3,30,4,0,0,4,0,30,0,4,0,4,4,30,2,2,0,4,0,30,3,0,0,3,0,-27,3,0
2,1,5,0,30,2,3,0,5,2,30,3,1,0,4,0,30,1,4,0,5,0,30,1,4,0,5,0,30,1,1,0,2,0,-27,3,0
2,2,5,0,30,2,3,0,5,2,30,3,1,0,4,0,30,1,4,0,5,0,30,1,4,0,5,0,30,1,1,0,2,0,-27,3,0
2,4,5,0,30,2,3,0,5,2,30,3,1,0,4,0,30,1,4,0,5,0,30,1,4,0,5,0,30,1,1,0,2,0,-27,3,0
2,4,9,0,30,6,5,0,11,3,30,5,1,0,6,2,30,7,4,0,11,1,30,3,8,0,11,4,30,3,1,0,4,0,-27,3,0
2,2,13,3,30,7,0,0,7,0,30,4,0,0,4,3,30,6,1,0,7,11,30,6,1,0,7,0,30,4,0,0,4,1,-15,3,1
2,4,15,0,30,3,10,0,13,1,30,6,0,0,6,0,30,3,10,0,13,1,30,7,6,0,13,2,30,5,4,0,9,1,-15,3,1
2,3,17,4,30,10,4,0,14,4,30,6,0,0,6,0,30,3,11,0,14,1,30,7,7,0,14,1,30,4,0,0,4,1,-15,3,1
2,2,19,1,30,5,8,0,13,2,30,8,0,0,8,4,30,10,3,0,13,0,30,5,8,0,13,2,30,7,2,0,9,1,-15,3,1
2,4,19,1,30,5,8,0,13,2,30,8,0,0,8,4,30,10,3,0,13,0,30,5,8,0,13,2,30,7,2,0,9,1,-15,3,1
2,2,23,4,30,5,8,0,13,3,30,6,0,0,6,0,30,12,1,0,13,0,30,5,8,0,13,4,30,6,0,0,6,1,-15,3,1
2,3,27,1,30,6,9,0,15,4,30,2,0,0,2,0,30,3,12,0,15,3,30,3,12,0,15,1,30,6,0,0,6,1,-15,3,1
2,4,27,1,30,6,9,0,15,4,30,2,0,0,2,0,30,3,12,0,15,3,30,3,12,0,15,1,30,6,0,0,6,1,-15,3,1
2,2,31,5,30,7,5,0,12,4,30,8,0,0,8,3,30,9,3,0,12,0,30,3,9,0,12,0,30,3,3,0,6,1,-15,3,1
2,4,31,5,30,7,5,0,12,4,30,8,0,0,8,0,30,9,3,0,12,0,30,3,9,0,12,0,30,3,3,0,6,1,-15,3,1
2,1,4,2,30,7,1,0,8,4,30,4,0,0,4,0,30,1,7,0,8,0,30,3,5,0,8,3,30,4,0,0,4,0,-27,3,0
2,3,11,0,30,1,3,0,4,0,30,0,0,0,0,0,30,0,4,0,4,6,30,4,0,0,4,3,30,1,0,0,1,1,-15,3,1
2,4,13,4,30,5,2,0,7,2,30,4,0,0,4,1,30,6,1,0,7,1,30,6,1,0,7,2,30,4,0,0,4,1,-15,3,1
2,3,17,2,30,8,6,0,14,2,30,6,0,0,6,0,30,6,8,0,14,2,30,5,9,0,14,3,30,4,0,0,4,1,-15,3,1
2,4,17,2,30,8,6,0,14,2,30,6,0,0,6,0,30,6,8,0,14,2,30,5,9,0,14,3,30,4,0,0,4,1,-15,3,1
2,4,22,1,30,7,1,0,8,3,30,2,0,0,2,0,30,4,4,0,8,1,30,4,4,0,8,3,30,4,0,0,4,1,-15,3,1
2,4,23,1,30,5,8,0,13,1,30,6,0,0,6,2,30,13,0,0,13,1,30,5,8,0,13,3,30,6,0,0,6,1,-15,3,1
2,1,25,2,30,6,8,0,14,3,30,6,0,0,6,0,30,7,7,0,14,1,30,5,9,0,14,3,30,5,1,0,6,1,-15,3,1
2,2,25,2,30,6,8,0,14,3,30,6,0,0,6,0,30,7,7,0,14,1,30,5,9,0,14,3,30,5,1,0,6,1,-15,3,1
2,1,27,1,30,4,11,0,15,4,30,2,0,0,2,0,30,5,10,0,15,0,30,5,10,0,15,2,30,6,0,0,6,1,-15,3,1
2,4,27,1,30,4,11,0,15,4,30,2,0,0,2,0,30,5,10,0,15,0,30,5,10,0,15,2,30,6,0,0,6,1,-15,3,1
2,3,32,0,30,7,2,0,9,4,30,2,0,0,2,0,30,8,1,0,9,1,30,3,6,0,9,3,30,2,0,0,2,1,-15,3,1
2,4,39,0,30,4,7,0,11,7,30,6,0,0,6,0,30,4,7,0,11,0,30,6,5,0,11,4,30,2,3,0,5,1,-15,3,1
2,3,47,0,30,3,11,0,14,7,30,4,0,0,4,0,30,4,10,0,14,0,30,7,7,0,14,7,30,7,0,0,7,1,-15,3,1
2,1,5,0,30,2,3,0,5,3,30,1,3,0,4,0,30,0,5,0,5,0,30,1,4,0,5,4,30,0,2,0,2,0,-27,3,0
2,2,5,0,30,2,3,0,5,3,30,1,3,0,4,0,30,0,5,0,5,0,30,1,4,0,5,4,30,0,2,0,2,0,-27,3,0
2,2,17,3,30,9,5,0,14,2,30,6,0,0,6,0,30,9,5,0,14,6,30,5,9,0,14,3,30,4,0,0,4,1,-15,3,1
2,1,19,0,30,2,11,0,13,2,30,6,2,0,8,1,30,4,9,0,13,5,30,6,7,0,13,2,30,8,1,0,9,1,-15,3,1
2,2,19,0,30,2,11,0,13,2,30,6,2,0,8,1,30,4,9,0,13,5,30,6,7,0,13,2,30,8,1,0,9,1,-15,3,1
2,3,19,0,30,2,11,0,13,2,30,6,2,0,8,1,30,4,9,0,13,5,30,6,7,0,13,2,30,8,1,0,9,1,-15,3,1
2,4,19,0,30,2,11,0,13,2,30,6,2,0,8,1,30,4,9,0,13,5,30,6,7,0,13,2,30,8,1,0,9,1,-15,3,1
2,1,21,4,30,8,2,0,10,4,30,6,0,0,6,1,30,3,7,0,10,1,30,4,6,0,10,1,30,4,0,0,4,1,-15,3,1
2,1,25,0,30,7,7,0,14,5,30,6,0,0,6,0,30,3,11,0,14,1,30,5,9,0,14,7,30,5,1,0,6,1,-15,3,1
2,2,25,0,30,7,7,0,14,5,30,6,0,0,6,0,30,3,11,0,14,1,30,5,9,0,14,7,30,5,1,0,6,1,-15,3,1
2,2,27,1,30,4,11,0,15,5,30,2,0,0,2,0,30,6,9,0,15,0,30,7,8,0,15,1,30,6,0,0,6,1,-15,3,1
2,4,27,1,30,4,11,0,15,5,30,2,0,0,2,0,30,6,9,0,15,0,30,7,8,0,15,1,30,6,0,0,6,1,-15,3,1
2,2,31,1,30,2,10,0,12,8,30,8,0,0,8,3,30,4,8,0,12,11,30,8,4,0,12,0,30,4,2,0,6,1,-15,3,1
2,4,31,1,30,2,10,0,12,8,30,8,0,0,8,3,30,4,8,0,12,11,30,8,4,0,12,0,30,4,2,0,6,1,-15,3,1
2,4,38,0,30,0,10,0,10,6,30,6,0,0,6,3,30,3,7,0,10,0,30,2,8,0,10,4,30,6,0,0,6,1,-15,3,1
2,1,4,2,30,5,3,0,8,4,30,4,0,0,4,2,30,3,5,0,8,0,30,6,2,0,8,1,30,4,0,0,4,0,-27,3,0
2,2,13,3,30,6,1,0,7,0,30,4,0,0,4,2,30,6,1,0,7,10,30,5,2,0,7,3,30,4,0,0,4,1,-15,3,1
2,4,13,3,30,6,1,0,7,0,30,4,0,0,4,2,30,6,1,0,7,10,30,5,2,0,7,3,30,4,0,0,4,1,-15,3,1
2,1,17,3,30,9,5,0,14,2,30,6,0,0,6,0,30,6,8,0,14,2,30,3,11,0,14,4,30,4,0,0,4,1,-15,3,1
2,3,17,3,30,9,5,0,14,2,30,6,0,0,6,0,30,6,8,0,14,2,30,3,11,0,14,4,30,4,0,0,4,1,-15,3,1
2,2,19,0,30,2,11,0,13,2,30,6,2,0,8,0,30,5,8,0,13,3,30,5,8,0,13,0,30,8,1,0,9,1,-15,3,1
2,3,19,0,30,2,11,0,13,2,30,6,2,0,8,0,30,5,8,0,13,3,30,5,8,0,13,0,30,8,1,0,9,1,-15,3,1
2,4,19,0,30,2,11,0,13,2,30,6,2,0,8,0,30,5,8,0,13,3,30,5,8,0,13,0,30,8,1,0,9,1,-15,3,1
2,1,21,3,30,10,0,0,10,3,30,4,2,0,6,1,30,6,4,0,10,2,30,5,5,0,10,1,30,4,0,0,4,1,-15,3,1
2,2,25,1,30,4,10,0,14,2,30,6,0,0,6,0,30,9,5,0,14,1,30,4,10,0,14,4,30,5,1,0,6,1,-15,3,1
2,3,25,1,30,4,10,0,14,2,30,6,0,0,6,0,30,9,5,0,14,1,30,4,10,0,14,4,30,5,1,0,6,1,-15,3,1
2,4,25,1,30,4,10,0,14,2,30,6,0,0,6,0,30,9,5,0,14,1,30,4,10,0,14,4,30,5,1,0,6,1,-15,3,1
2,2,27,1,30,4,11,0,15,3,30,2,0,0,2,0,30,5,10,0,15,0,30,6,9,0,15,5,30,6,0,0,6,1,-15,3,1
2,3,27,1,30,4,11,0,15,3,30,2,0,0,2,0,30,5,10,0,15,0,30,6,9,0,15,5,30,6,0,0,6,1,-15,3,1
2,0,4,3,30,6,2,0,8,4,30,4,0,0,4,2,30,2,6,0,8,0,30,4,4,0,8,2,30,3,1,0,4,0,-27,3,0
2,4,8,1,30,7,0,0,7,4,30,2,0,0,2,3,30,4,3,0,7,0,30,6,1,0,7,0,30,2,1,0,3,0,-27,3,0
2,3,17,4,30,11,3,0,14,3,30,6,0,0,6,0,30,5,9,0,14,1,30,5,9,0,14,3,30,4,0,0,4,1,-15,3,1
2,1,19,0,30,2,11,0,13,3,30,4,4,0,8,0,30,4,9,0,13,8,30,7,6,0,13,2,30,7,2,0,9,1,-15,3,1
2,2,19,0,30,2,11,0,13,3,30,4,4,0,8,0,30,4,9,0,13,8,30,7,6,0,13,2,30,7,2,0,9,1,-15,3,1
2,1,23,1,30,6,7,0,13,2,30,6,0,0,6,7,30,10,3,0,13,0,30,7,6,0,13,3,30,5,1,0,6,1,-15,3,1
2,4,23,1,30,6,7,0,13,2,30,6,0,0,6,7,30,10,3,0,13,0,30,7,6,0,13,3,30,5,1,0,6,1,-15,3,1
2,3,25,0,30,8,6,0,14,4,30,6,0,0,6,0,30,8,6,0,14,1,30,5,9,0,14,4,30,6,0,0,6,1,-15,3,1
2,4,25,0,30,8,6,0,14,4,30,6,0,0,6,0,30,8,6,0,14,1,30,5,9,0,14,4,30,6,0,0,6,1,-15,3,1
2,2,27,1,30,3,12,0,15,4,30,2,0,0,2,0,30,5,10,0,15,1,30,6,9,0,15,4,30,6,0,0,6,1,-15,3,1
2,3,29,0,30,7,7,0,14,6,30,11,1,0,12,0,30,5,9,0,14,0,30,1,13,0,14,0,30,9,0,0,9,1,-15,3,1
2,4,29,0,30,7,7,0,14,6,30,11,1,0,12,0,30,5,9,0,14,0,30,1,13,0,14,0,30,9,0,0,9,1,-15,3,1
2,2,47,0,30,0,14,0,14,6,30,4,0,0,4,0,30,3,11,0,14,0,30,2,12,0,14,8,30,7,0,0,7,1,-15,3,1
2,1,11,1,30,4,8,0,12,1,30,4,0,0,4,4,30,7,5,0,12,0,30,8,4,0,12,3,30,4,0,0,4,1,-15,3,1
2,2,11,1,30,4,8,0,12,1,30,4,0,0,4,4,30,7,5,0,12,0,30,8,4,0,12,3,30,4,0,0,4,1,-15,3,1
2,3,11,1,30,4,8,0,12,1,30,4,0,0,4,4,30,7,5,0,12,0,30,8,4,0,12,3,30,4,0,0,4,1,-15,3,1
2,4,11,1,30,4,8,0,12,1,30,4,0,0,4,4,30,7,5,0,12,0,30,8,4,0,12,3,30,4,0,0,4,1,-15,3,1
2,0,13,2,30,6,1,0,7,1,30,4,0,0,4,2,30,5,2,0,7,6,30,7,0,0,7,2,30,4,0,0,4,1,-15,3,1
2,1,13,2,30,6,1,0,7,1,30,4,0,0,4,2,30,5,2,0,7,6,30,7,0,0,7,2,30,4,0,0,4,1,-15,3,1
2,4,15,0,30,6,7,0,13,1,30,5,1,0,6,0,30,3,10,0,13,1,30,7,6,0,13,2,30,7,2,0,9,1,-15,3,1
2,2,17,4,30,11,3,0,14,3,30,6,0,0,6,0,30,5,9,0,14,1,30,6,8,0,14,0,30,4,0,0,4,1,-15,3,1
2,2,19,2,30,2,11,0,13,2,30,7,1,0,8,0,30,8,5,0,13,5,30,3,10,0,13,2,30,8,1,0,9,1,-15,3,1
2,4,22,1,30,6,2,0,8,3,30,2,0,0,2,4,30,5,3,0,8,1,30,4,4,0,8,2,30,2,2,0,4,1,-15,3,1
2,3,23,2,30,6,7,0,13,3,30,6,0,0,6,4,30,13,0,0,13,0,30,5,8,0,13,3,30,6,0,0,6,1,-15,3,1
2,4,23,2,30,6,7,0,13,3,30,6,0,0,6,4,30,13,0,0,13,0,30,5,8,0,13,3,30,6,0,0,6,1,-15,3,1
2,3,25,3,30,4,10,0,14,6,30,6,0,0,6,0,30,6,8,0,14,1,30,9,5,0,14,5,30,5,1,0,6,1,-15,3,1
2,0,27,1,30,5,10,0,15,4,30,1,1,0,2,0,30,3,12,0,15,2,30,4,11,0,15,2,30,6,0,0,6,1,-15,3,1
2,4,27,1,30,5,10,0,15,4,30,1,1,0,2,0,30,3,12,0,15,2,30,4,11,0,15,2,30,6,0,0,6,1,-15,3,1
2,3,32,0,30,5,4,0,9,4,30,2,0,0,2,2,30,9,0,0,9,1,30,3,6,0,9,3,30,2,0,0,2,1,-15,3,1
2,3,39,3,30,5,6,0,11,8,30,6,0,0,6,0,30,5,6,0,11,3,30,4,7,0,11,0,30,2,3,0,5,1,-15,3,1
2,4,47,0,30,0,14,0,14,8,30,4,0,0,4,0,30,6,8,0,14,0,30,2,12,0,14,0,30,5,2,0,7,1,-15,3,1
2,0,4,2,30,4,4,0,8,5,30,4,0,0,4,2,30,2,6,0,8,1,30,8,0,0,8,1,30,4,0,0,4,0,-27,3,0
2,2,4,2,30,4,4,0,8,5,30,4,0,0,4,2,30,2,6,0,8,1,30,8,0,0,8,1,30,4,0,0,4,0,-27,3,0
2,3,4,2,30,4,4,0,8,5,30,4,0,0,4,2,30,2,6,0,8,1,30,8,0,0,8,1,30,4,0,0,4,0,-27,3,0
2,3,21,0,30,9,1,0,10,3,30,6,0,0,6,1,30,4,6,0,10,2,30,4,6,0,10,2,30,4,0,0,4,1,-15,3,1
2,1,25,1,30,7,7,0,14,4,30,6,0,0,6,0,30,6,8,0,14,1,30,9,5,0,14,5,30,6,0,0,6,1,-15,3,1
2,4,25,1,30,7,7,0,14,4,30,6,0,0,6,0,30,6,8,0,14,1,30,9,5,0,14,5,30,6,0,0,6,1,-15,3,1
2,0,27,1,30,5,10,0,15,3,30,1,1,0,2,1,30,3,12,0,15,0,30,8,7,0,15,4,30,6,0,0,6,1,-15,3,1
2,1,27,1,30,5,10,0,15,3,30,1,1,0,2,1,30,3,12,0,15,0,30,8,7,0,15,4,30,6,0,0,6,1,-15,3,1
2,2,27,1,30,5,10,0,15,3,30,1,1,0,2,1,30,3,12,0,15,0,30,8,7,0,15,4,30,6,0,0,6,1,-15,3,1
2,4,27,1,30,5,10,0,15,3,30,1,1,0,2,1,30,3,12,0,15,0,30,8,7,0,15,4,30,6,0,0,6,1,-15,3,1
2,3,29,0,30,8,6,0,14,5,30,12,0,0,12,0,30,4,10,0,14,0,30,0,14,0,14,1,30,9,0,0,9,1,-15,3,1
2,4,4,2,30,6,2,0,8,5,30,4,0,0,4,3,30,1,7,0,8,0,30,1,7,0,8,4,30,4,0,0,4,0,-27,3,0
2,4,11,1,30,4,8,0,12,0,30,4,0,0,4,0,30,8,4,0,12,4,30,3,9,0,12,3,30,4,0,0,4,1,-15,3,1
2,2,13,1,30,5,2,0,7,0,30,4,0,0,4,2,30,6,1,0,7,5,30,6,1,0,7,4,30,4,0,0,4,1,-15,3,1
2,4,13,1,30,5,2,0,7,0,30,4,0,0,4,2,30,6,1,0,7,5,30,6,1,0,7,4,30,4,0,0,4,1,-15,3,1
2,3,17,3,30,11,3,0,14,2,30,6,0,0,6,0,30,6,8,0,14,2,30,6,8,0,14,0,30,4,0,0,4,1,-15,3,1
2,1,21,1,30,6,4,0,10,4,30,4,2,0,6,0,30,3,7,0,10,5,30,6,4,0,10,5,30,4,0,0,4,1,-15,3,1
2,1,27,5,30,7,8,0,15,4,30,2,0,0,2,0,30,5,10,0,15,0,30,4,11,0,15,5,30,5,1,0,6,1,-15,3,1
2,3,27,5,30,7,8,0,15,4,30,2,0,0,2,0,30,5,10,0,15,0,30,4,11,0,15,5,30,5,1,0,6,1,-15,3,1
2,4,27,5,30,7,8,0,15,4,30,2,0,0,2,0,30,5,10,0,15,0,30,4,11,0,15,5,30,5,1,0,6,1,-15,3,1
2,1,29,0,30,5,9,0,14,5,30,11,1,0,12,0,30,6,8,0,14,0,30,1,13,0,14,1,30,9,0,0,9,1,-15,3,1
2,3,29,0,30,5,9,0,14,5,30,11,1,0,12,0,30,6,8,0,14,0,30,1,13,0,14,1,30,9,0,0,9,1,-15,3,1
2,4,29,0,30,5,9,0,14,5,30,11,1,0,12,0,30,6,8,0,14,0,30,1,13,0,14,1,30,9,0,0,9,1,-15,3,1
2,2,4,7,30,8,0,0,8,5,30,4,0,0,4,0,30,3,5,0,8,0,30,6,2,0,8,1,30,4,0,0,4,0,-27,3,0
2,3,4,7,30,8,0,0,8,5,30,4,0,0,4,0,30,3,5,0,8,0,30,6,2,0,8,1,30,4,0,0,4,0,-27,3,0
2,1,13,2,30,6,1,0,7,0,30,4,0,0,4,1,30,5,2,0,7,11,30,5,2,0,7,1,30,4,0,0,4,1,-15,3,1
2,3,16,0,30,7,2,0,9,2,30,8,0,0,8,0,30,1,8,0,9,0,30,1,8,0,9,0,30,1,3,0,4,1,-15,3,1
2,3,17,4,30,9,5,0,14,3,30,6,0,0,6,0,30,6,8,0,14,2,30,6,8,0,14,5,30,4,0,0,4,1,-15,3,1
2,2,19,0,30,5,8,0,13,2,30,4,4,0,8,0,30,4,9,0,13,0,30,7,6,0,13,1,30,8,1,0,9,1,-15,3,1
2,4,19,0,30,5,8,0,13,2,30,4,4,0,8,0,30,4,9,0,13,0,30,7,6,0,13,1,30,8,1,0,9,1,-15,3,1
2,3,21,4,30,10,0,0,10,3,30,6,0,0,6,0,30,6,4,0,10,1,30,4,6,0,10,0,30,3,1,0,4,1,-15,3,1
2,4,21,4,30,10,0,0,10,3,30,6,0,0,6,0,30,6,4,0,10,1,30,4,6,0,10,0,30,3,1,0,4,1,-15,3,1
2,3,23,1,30,5,8,0,13,2,30,6,0,0,6,1,30,10,3,0,13,0,30,6,7,0,13,1,30,6,0,0,6,1,-15,3,1
2,2,25,1,30,11,3,0,14,4,30,6,0,0,6,0,30,6,8,0,14,1,30,5,9,0,14,3,30,5,1,0,6,1,-15,3,1
2,3,25,1,30,11,3,0,14,4,30,6,0,0,6,0,30,6,8,0,14,1,30,5,9,0,14,3,30,5,1,0,6,1,-15,3,1
2,4,25,1,30,11,3,0,14,4,30,6,0,0,6,0,30,6,8,0,14,1,30,5,9,0,14,3,30,5,1,0,6,1,-15,3,1
2,3,26,0,30,7,2,0,9,5,30,4,0,0,4,3,30,2,7,0,9,0,30,3,6,0,9,4,30,3,0,0,3,1,-15,3,1
2,4,27,1,30,3,12,0,15,3,30,1,1,0,2,0,30,4,11,0,15,0,30,3,12,0,15,2,30,6,0,0,6,1,-15,3,1
2,3,43,0,30,8,6,0,14,9,30,6,0,0,6,0,30,4,10,0,14,1,30,6,8,0,14,0,30,5,0,0,5,1,-15,3,1
2,4,43,0,30,8,6,0,14,9,30,6,0,0,6,0,30,4,10,0,14,1,30,6,8,0,14,0,30,5,0,0,5,1,-15,3,1
2,2,1,0,30,7,3,0,10,4,30,2,0,0,2,1,30,4,6,0,10,9,30,7,3,0,10,6,30,6,0,0,6,0,-27,3,0
2,4,1,0,30,7,3,0,10,4,30,2,0,0,2,1,30,4,6,0,10,9,30,7,3,0,10,6,30,6,0,0,6,0,-27,3,0
2,4,8,2,30,7,0,0,7,4,30,2,0,0,2,2,30,5,2,0,7,0,30,6,1,0,7,2,30,3,0,0,3,0,-27,3,0
2,1,13,2,30,5,2,0,7,0,30,4,0,0,4,2,30,7,0,0,7,6,30,6,1,0,7,5,30,4,0,0,4,1,-15,3,1
2,2,13,2,30,5,2,0,7,0,30,4,0,0,4,2,30,7,0,0,7,6,30,6,1,0,7,5,30,4,0,0,4,1,-15,3,1
2,3,13,2,30,5,2,0,7,0,30,4,0,0,4,2,30,7,0,0,7,6,30,6,1,0,7,5,30,4,0,0,4,1,-15,3,1
2,1,17,3,30,11,3,0,14,3,30,6,0,0,6,0,30,5,9,0,14,5,30,5,9,0,14,3,30,4,0,0,4,1,-15,3,1
2,3,17,0,30,11,3,0,14,3,30,6,0,0,6,0,30,5,9,0,14,5,30,5,9,0,14,3,30,4,0,0,4,1,-15,3,1
2,4,17,0,30,11,3,0,14,3,30,6,0,0,6,0,30,5,9,0,14,5,30,5,9,0,14,3,30,4,0,0,4,1,-15,3,1
2,2,19,0,30,2,11,0,13,2,30,8,0,0,8,0,30,4,9,0,13,0,30,7,6,0,13,1,30,7,2,0,9,1,-15,3,1
2,4,19,0,30,2,11,0,13,2,30,8,0,0,8,0,30,4,9,0,13,0,30,7,6,0,13,1,30,7,2,0,9,1,-15,3,1
2,4,22,2,30,8,0,0,8,3,30,2,0,0,2,0,30,5,3,0,8,1,30,4,4,0,8,2,30,1,3,0,4,1,-15,3,1
2,3,23,1,30,6,7,0,13,3,30,6,0,0,6,5,30,11,2,0,13,0,30,5,8,0,13,1,30,6,0,0,6,1,-15,3,1
2,4,23,1,30,6,7,0,13,3,30,6,0,0,6,5,30,11,2,0,13,0,30,5,8,0,13,1,30,6,0,0,6,1,-15,3,1
2,2,27,1,30,8,7,0,15,3,30,2,0,0,2,0,30,4,11,0,15,0,30,3,12,0,15,2,30,6,0,0,6,1,-15,3,1
2,0,5,0,30,2,3,0,5,3,30,2,2,0,4,0,30,0,5,0,5,0,30,2,3,0,5,2,30,2,0,0,2,0,-27,3,0
2,4,11,0,30,1,3,0,4,0,30,0,0,0,0,0,30,2,2,0,4,4,30,4,0,0,4,2,30,1,0,0,1,1,-15,3,1
2,1,13,2,30,7,0,0,7,0,30,4,0,0,4,2,30,6,1,0,7,7,30,7,0,0,7,7,30,4,0,0,4,1,-15,3,1
2,2,13,2,30,7,0,0,7,0,30,4,0,0,4,2,30,6,1,0,7,7,30,7,0,0,7,7,30,4,0,0,4,1,-15,3,1
2,4,15,0,30,4,9,0,13,1,30,6,0,0,6,0,30,3,10,0,13,1,30,4,9,0,13,3,30,9,0,0,9,1,-15,3,1
2,2,19,0,30,3,10,0,13,1,30,6,2,0,8,0,30,7,6,0,13,3,30,4,9,0,13,0,30,8,1,0,9,1,-15,3,1
2,3,23,1,30,5,8,0,13,2,30,6,0,0,6,2,30,10,3,0,13,1,30,5,8,0,13,4,30,6,0,0,6,1,-15,3,1
2,4,27,0,30,4,11,0,15,5,30,1,1,0,2,0,30,6,9,0,15,2,30,6,9,0,15,3,30,6,0,0,6,1,-15,3,1
2,4,1,0,30,7,3,0,10,4,30,2,0,0,2,1,30,4,6,0,10,0,30,6,4,0,10,5,30,6,0,0,6,0,-27,3,0
2,4,8,2,30,7,0,0,7,4,30,2,0,0,2,3,30,3,4,0,7,0,30,5,2,0,7,5,30,3,0,0,3,0,-27,3,0
2,2,11,2,30,4,8,0,12,1,30,4,0,0,4,1,30,5,7,0,12,3,30,3,9,0,12,3,30,4,0,0,4,1,-15,3,1
2,2,13,1,30,7,0,0,7,0,30,4,0,0,4,2,30,5,2,0,7,5,30,6,1,0,7,3,30,4,0,0,4,1,-15,3,1
2,3,13,1,30,7,0,0,7,0,30,4,0,0,4,2,30,5,2,0,7,5,30,6,1,0,7,3,30,4,0,0,4,1,-15,3,1
2,2,17,3,30,8,6,0,14,2,30,6,0,0,6,0,30,7,7,0,14,2,30,8,6,0,14,7,30,4,0,0,4,1,-15,3,1
2,2,19,0,30,3,10,0,13,2,30,3,5,0,8,0,30,4,9,0,13,4,30,9,4,0,13,3,30,9,0,0,9,1,-15,3,1
2,4,19,0,30,3,10,0,13,2,30,3,5,0,8,0,30,4,9,0,13,4,30,9,4,0,13,3,30,9,0,0,9,1,-15,3,1
2,4,22,1,30,7,1,0,8,3,30,2,0,0,2,3,30,4,4,0,8,0,30,4,4,0,8,2,30,4,0,0,4,1,-15,3,1
2,2,25,1,30,6,8,0,14,4,30,6,0,0,6,0,30,7,7,0,14,1,30,9,5,0,14,5,30,6,0,0,6,1,-15,3,1
2,4,25,1,30,6,8,0,14,4,30,6,0,0,6,0,30,7,7,0,14,1,30,9,5,0,14,5,30,6,0,0,6,1,-15,3,1
2,2,29,0,30,7,7,0,14,6,30,10,2,0,12,0,30,4,10,0,14,0,30,1,13,0,14,1,30,9,0,0,9,1,-15,3,1
2,3,29,0,30,7,7,0,14,6,30,10,2,0,12,0,30,4,10,0,14,0,30,1,13,0,14,1,30,9,0,0,9,1,-15,3,1
2,4,29,0,30,7,7,0,14,6,30,10,2,0,12,0,30,4,10,0,14,0,30,1,13,0,14,1,30,9,0,0,9,1,-15,3,1
2,2,31,1,30,5,7,0,12,4,30,8,0,0,8,3,30,12,0,0,12,0,30,3,9,0,12,1,30,4,2,0,6,1,-15,3,1
2,3,31,1,30,5,7,0,12,4,30,8,0,0,8,3,30,12,0,0,12,0,30,3,9,0,12,1,30,4,2,0,6,1,-15,3,1
2,4,31,1,30,5,7,0,12,4,30,8,0,0,8,3,30,12,0,0,12,0,30,3,9,0,12,1,30,4,2,0,6,1,-15,3,1
2,1,4,0,30,6,2,0,8,5,30,4,0,0,4,2,30,2,6,0,8,0,30,8,0,0,8,3,30,4,0,0,4,0,-27,3,0
2,1,13,1,30,3,0,0,3,0,30,2,0,0,2,0,30,3,0,0,3,7,30,3,0,0,3,4,30,2,0,0,2,1,-15,3,1
2,4,15,1,30,4,9,0,13,1,30,6,0,0,6,0,30,3,10,0,13,1,30,2,11,0,13,0,30,9,0,0,9,1,-15,3,1
2,2,17,2,30,8,6,0,14,2,30,6,0,0,6,0,30,6,8,0,14,1,30,5,9,0,14,3,30,4,0,0,4,1,-15,3,1
2,3,17,2,30,8,6,0,14,2,30,6,0,0,6,0,30,6,8,0,14,1,30,5,9,0,14,3,30,4,0,0,4,1,-15,3,1
2,4,17,2,30,8,6,0,14,2,30,6,0,0,6,0,30,6,8,0,14,1,30,5,9,0,14,3,30,4,0,0,4,1,-15,3,1
2,4,19,0,30,3,10,0,13,2,30,8,0,0,8,4,30,6,7,0,13,0,30,4,9,0,13,1,30,6,3,0,9,1,-15,3,1
2,4,22,1,30,5,3,0,8,3,30,2,0,0,2,0,30,4,4,0,8,1,30,4,4,0,8,4,30,4,0,0,4,1,-15,3,1
2,2,25,3,30,6,8,0,14,3,30,6,0,0,6,0,30,6,8,0,14,1,30,10,4,0,14,7,30,5,1,0,6,1,-15,3,1
2,0,27,1,30,4,11,0,15,3,30,1,1,0,2,0,30,2,13,0,15,1,30,6,9,0,15,7,30,6,0,0,6,1,-15,3,1
2,1,27,1,30,4,11,0,15,3,30,1,1,0,2,0,30,2,13,0,15,1,30,6,9,0,15,7,30,6,0,0,6,1,-15,3,1
2,0,31,1,30,7,5,0,12,5,30,8,0,0,8,3,30,8,4,0,12,0,30,3,9,0,12,2,30,3,3,0,6,1,-15,3,1
2,2,39,0,30,6,5,0,11,7,30,6,0,0,6,0,30,4,7,0,11,0,30,5,6,0,11,3,30,2,3,0,5,1,-15,3,1
2,4,39,0,30,6,5,0,11,7,30,6,0,0,6,0,30,4,7,0,11,0,30,5,6,0,11,3,30,2,3,0,5,1,-15,3,1
2,2,4,2,30,8,0,0,8,5,30,4,0,0,4,0,30,1,7,0,8,4,30,8,0,0,8,2,30,3,1,0,4,0,-27,3,0
2,4,13,1,30,6,1,0,7,0,30,4,0,0,4,6,30,7,0,0,7,5,30,7,0,0,7,6,30,4,0,0,4,1,-15,3,1
2,3,19,0,30,4,9,0,13,0,30,5,3,0,8,0,30,4,9,0,13,4,30,4,9,0,13,1,30,9,0,0,9,1,-15,3,1
2,4,19,0,30,4,9,0,13,0,30,5,3,0,8,0,30,4,9,0,13,4,30,4,9,0,13,1,30,9,0,0,9,1,-15,3,1
2,4,25,0,30,5,9,0,14,3,30,6,0,0,6,0,30,6,8,0,14,4,30,7,7,0,14,2,30,6,0,0,6,1,-15,3,1
2,3,27,2,30,5,10,0,15,0,30,2,0,0,2,0,30,8,7,0,15,4,30,4,11,0,15,1,30,4,2,0,6,1,-15,3,1
2,4,27,2,30,5,10,0,15,0,30,2,0,0,2,0,30,8,7,0,15,4,30,4,11,0,15,1,30,4,2,0,6,1,-15,3,1
2,2,29,0,30,5,9,0,14,5,30,7,5,0,12,0,30,9,5,0,14,0,30,1,13,0,14,0,30,9,0,0,9,1,-15,3,1
2,3,29,0,30,5,9,0,14,5,30,7,5,0,12,0,30,9,5,0,14,0,30,1,13,0,14,0,30,9,0,0,9,1,-15,3,1
2,4,29,0,30,5,9,0,14,5,30,7,5,0,12,0,30,9,5,0,14,0,30,1,13,0,14,0,30,9,0,0,9,1,-15,3,1
2,3,43,1,30,11,3,0,14,6,30,6,0,0,6,0,30,4,10,0,14,1,30,1,13,0,14,5,30,5,0,0,5,1,-15,3,1
2,4,43,1,30,11,3,0,14,6,30,6,0,0,6,0,30,4,10,0,14,1,30,1,13,0,14,5,30,5,0,0,5,1,-15,3,1
2,1,19,0,30,4,9,0,13,2,30,5,3,0,8,0,30,4,9,0,13,5,30,4,9,0,13,5,30,9,0,0,9,1,-15,3,1
2,4,19,0,30,4,9,0,13,2,30,5,3,0,8,0,30,4,9,0,13,5,30,4,9,0,13,5,30,9,0,0,9,1,-15,3,1
2,3,23,2,30,6,7,0,13,3,30,6,0,0,6,5,30,11,2,0,13,0,30,6,7,0,13,1,30,5,1,0,6,1,-15,3,1
2,4,23,2,30,6,7,0,13,3,30,6,0,0,6,5,30,11,2,0,13,0,30,6,7,0,13,1,30,5,1,0,6,1,-15,3,1
2,3,25,1,30,9,5,0,14,2,30,6,0,0,6,0,30,6,8,0,14,1,30,5,9,0,14,3,30,5,1,0,6,1,-15,3,1
2,4,25,1,30,9,5,0,14,2,30,6,0,0,6,0,30,6,8,0,14,1,30,5,9,0,14,3,30,5,1,0,6,1,-15,3,1
2,3,27,0,30,4,11,0,15,4,30,1,1,0,2,0,30,8,7,0,15,4,30,3,12,0,15,0,30,6,0,0,6,1,-15,3,1
2,2,39,0,30,3,8,0,11,7,30,6,0,0,6,0,30,4,7,0,11,0,30,6,5,0,11,3,30,5,0,0,5,1,-15,3,1
2,3,39,0,30,3,8,0,11,7,30,6,0,0,6,0,30,4,7,0,11,0,30,6,5,0,11,3,30,5,0,0,5,1,-15,3,1
2,4,39,0,30,3,8,0,11,7,30,6,0,0,6,0,30,4,7,0,11,0,30,6,5,0,11,3,30,5,0,0,5,1,-15,3,1
2,3,43,0,30,10,4,0,14,8,30,6,0,0,6,0,30,4,10,0,14,1,30,6,8,0,14,1,30,5,0,0,5,1,-15,3,1
2,2,4,0,30,5,3,0,8,5,30,4,0,0,4,2,30,1,7,0,8,2,30,8,0,0,8,3,30,4,0,0,4,0,-27,3,0
2,3,6,0,30,9,0,0,9,4,30,2,0,0,2,0,30,2,7,0,9,0,30,4,5,0,9,0,30,4,1,0,5,0,-27,3,0
2,4,6,0,30,9,0,0,9,4,30,2,0,0,2,0,30,2,7,0,9,0,30,4,5,0,9,0,30,4,1,0,5,0,-27,3,0
2,4,8,0,30,7,0,0,7,4,30,2,0,0,2,4,30,1,6,0,7,1,30,7,0,0,7,0,30,3,0,0,3,0,-27,3,0
2,2,13,3,30,7,0,0,7,0,30,4,0,0,4,0,30,6,1,0,7,8,30,6,1,0,7,4,30,4,0,0,4,1,-15,3,1
2,4,13,3,30,7,0,0,7,0,30,4,0,0,4,0,30,6,1,0,7,8,30,6,1,0,7,4,30,4,0,0,4,1,-15,3,1
2,1,17,3,30,9,5,0,14,2,30,6,0,0,6,0,30,6,8,0,14,7,30,5,9,0,14,4,30,4,0,0,4,1,-15,3,1
2,4,17,3,30,9,5,0,14,2,30,6,0,0,6,0,30,6,8,0,14,7,30,5,9,0,14,4,30,4,0,0,4,1,-15,3,1
2,3,23,2,30,7,6,0,13,3,30,6,0,0,6,6,30,10,3,0,13,0,30,6,7,0,13,2,30,6,0,0,6,1,-15,3,1
2,4,23,2,30,7,6,0,13,3,30,6,0,0,6,6,30,10,3,0,13,0,30,6,7,0,13,2,30,6,0,0,6,1,-15,3,1
2,0,25,1,30,6,8,0,14,4,30,6,0,0,6,0,30,6,8,0,14,1,30,7,7,0,14,5,30,5,1,0,6,1,-15,3,1
2,1,25,1,30,6,8,0,14,4,30,6,0,0,6,0,30,6,8,0,14,1,30,7,7,0,14,5,30,5,1,0,6,1,-15,3,1
2,4,25,1,30,6,8,0,14,4,30,6,0,0,6,0,30,6,8,0,14,1,30,7,7,0,14,5,30,5,1,0,6,1,-15,3,1
2,2,27,0,30,5,10,0,15,4,30,2,0,0,2,0,30,3,12,0,15,4,30,4,11,0,15,3,30,6,0,0,6,1,-15,3,1
2,2,29,0,30,6,8,0,14,6,30,11,1,0,12,0,30,3,11,0,14,0,30,1,13,0,14,0,30,9,0,0,9,1,-15,3,1
2,3,32,0,30,7,2,0,9,4,30,2,0,0,2,0,30,7,2,0,9,1,30,2,7,0,9,2,30,2,0,0,2,1,-15,3,1
2,2,5,0,30,0,5,0,5,2,30,2,2,0,4,0,30,0,5,0,5,0,30,1,4,0,5,0,30,1,1,0,2,0,-27,3,0
2,3,5,0,30,0,5,0,5,2,30,2,2,0,4,0,30,0,5,0,5,0,30,1,4,0,5,0,30,1,1,0,2,0,-27,3,0
2,1,13,1,30,5,2,0,7,0,30,4,0,0,4,2,30,7,0,0,7,6,30,6,1,0,7,2,30,4,0,0,4,1,-15,3,1
2,2,13,1,30,5,2,0,7,0,30,4,0,0,4,2,30,7,0,0,7,6,30,6,1,0,7,2,30,4,0,0,4,1,-15,3,1
2,3,13,1,30,5,2,0,7,0,30,4,0,0,4,2,30,7,0,0,7,6,30,6,1,0,7,2,30,4,0,0,4,1,-15,3,1
2,4,13,1,30,5,2,0,7,0,30,4,0,0,4,2,30,7,0,0,7,6,30,6,1,0,7,2,30,4,0,0,4,1,-15,3,1
2,4,15,1,30,4,9,0,13,1,30,6,0,0,6,0,30,4,9,0,13,1,30,7,6,0,13,2,30,6,3,0,9,1,-15,3,1
2,3,17,5,30,11,3,0,14,3,30,6,0,0,6,0,30,5,9,0,14,2,30,5,9,0,14,6,30,4,0,0,4,1,-15,3,1
2,2,19,0,30,4,9,0,13,2,30,8,0,0,8,4,30,9,4,0,13,0,30,4,9,0,13,2,30,7,2,0,9,1,-15,3,1
2,4,19,0,30,4,9,0,13,2,30,8,0,0,8,4,30,9,4,0,13,0,30,4,9,0,13,2,30,7,2,0,9,1,-15,3,1
2,0,21,4,30,5,5,0,10,4,30,4,2,0,6,0,30,3,7,0,10,3,30,5,5,0,10,2,30,4,0,0,4,1,-15,3,1
2,1,21,4,30,5,5,0,10,4,30,4,2,0,6,0,30,3,7,0,10,3,30,5,5,0,10,2,30,4,0,0,4,1,-15,3,1
2,3,21,4,30,5,5,0,10,4,30,4,2,0,6,0,30,3,7,0,10,3,30,5,5,0,10,2,30,4,0,0,4,1,-15,3,1
2,1,27,1,30,5,10,0,15,2,30,2,0,0,2,0,30,7,8,0,15,2,30,4,11,0,15,5,30,6,0,0,6,1,-15,3,1
2,1,5,0,30,3,2,0,5,3,30,4,0,0,4,0,30,0,5,0,5,0,30,2,3,0,5,0,30,0,2,0,2,0,-27,3,0
2,4,8,4,30,7,0,0,7,4,30,2,0,0,2,5,30,4,3,0,7,0,30,6,1,0,7,2,30,3,0,0,3,0,-27,3,0
2,2,19,0,30,4,9,0,13,2,30,3,5,0,8,0,30,7,6,0,13,3,30,3,10,0,13,1,30,9,0,0,9,1,-15,3,1
2,2,21,2,30,4,6,0,10,3,30,6,0,0,6,1,30,4,6,0,10,2,30,4,6,0,10,3,30,4,0,0,4,1,-15,3,1
2,1,27,2,30,4,11,0,15,4,30,1,1,0,2,0,30,5,10,0,15,4,30,7,8,0,15,6,30,6,0,0,6,1,-15,3,1
2,2,27,2,30,4,11,0,15,4,30,1,1,0,2,0,30,5,10,0,15,4,30,7,8,0,15,6,30,6,0,0,6,1,-15,3,1
2,3,27,2,30,4,11,0,15,4,30,1,1,0,2,0,30,5,10,0,15,4,30,7,8,0,15,6,30,6,0,0,6,1,-15,3,1
2,4,3,0,30,1,3,0,4,2,30,4,0,0,4,0,30,0,4,0,4,3,30,0,4,0,4,1,30,3,0,0,3,0,-27,3,0
2,4,5,0,30,2,3,0,5,3,30,3,1,0,4,3,30,0,5,0,5,0,30,1,4,0,5,0,30,0,2,0,2,0,-27,3,0
2,3,8,2,30,7,0,0,7,4,30,2,0,0,2,4,30,4,3,0,7,4,30,4,3,0,7,0,30,2,1,0,3,0,-27,3,0
2,2,9,0,30,1,3,0,4,2,30,2,0,0,2,0,30,1,3,0,4,0,30,1,3,0,4,1,30,1,0,0,1,0,-27,3,0
2,3,9,0,30,1,3,0,4,2,30,2,0,0,2,0,30,1,3,0,4,0,30,1,3,0,4,1,30,1,0,0,1,0,-27,3,0
2,2,17,4,30,7,7,0,14,3,30,6,0,0,6,2,30,6,8,0,14,1,30,5,9,0,14,5,30,4,0,0,4,1,-15,3,1
2,4,17,4,30,7,7,0,14,3,30,6,0,0,6,2,30,6,8,0,14,1,30,5,9,0,14,5,30,4,0,0,4,1,-15,3,1
2,4,25,2,30,9,5,0,14,4,30,6,0,0,6,0,30,9,5,0,14,0,30,5,9,0,14,3,30,4,2,0,6,1,-15,3,1
2,4,31,3,30,7,5,0,12,4,30,8,0,0,8,3,30,10,2,0,12,0,30,4,8,0,12,0,30,3,3,0,6,1,-15,3,1
2,4,32,0,30,5,4,0,9,5,30,2,0,0,2,1,30,6,3,0,9,1,30,2,7,0,9,1,30,1,1,0,2,1,-15,3,1
2,3,39,0,30,1,10,0,11,6,30,6,0,0,6,0,30,6,5,0,11,3,30,3,8,0,11,4,30,5,0,0,5,1,-15,3,1
2,4,39,0,30,1,10,0,11,6,30,6,0,0,6,0,30,6,5,0,11,3,30,3,8,0,11,4,30,5,0,0,5,1,-15,3,1
2,0,4,3,30,7,1,0,8,5,30,4,0,0,4,1,30,1,7,0,8,0,30,5,3,0,8,1,30,4,0,0,4,0,-27,3,0
2,2,4,3,30,7,1,0,8,5,30,4,0,0,4,1,30,1,7,0,8,0,30,5,3,0,8,1,30,4,0,0,4,0,-27,3,0
2,2,6,0,30,7,2,0,9,4,30,2,0,0,2,0,30,3,6,0,9,0,30,5,4,0,9,0,30,3,2,0,5,0,-27,3,0
2,3,6,0,30,7,2,0,9,4,30,2,0,0,2,0,30,3,6,0,9,0,30,5,4,0,9,0,30,3,2,0,5,0,-27,3,0
2,2,27,1,30,4,11,0,15,3,30,2,0,0,2,0,30,4,11,0,15,4,30,6,9,0,15,5,30,6,0,0,6,1,-15,3,1
2,4,27,1,30,4,11,0,15,3,30,2,0,0,2,0,30,4,11,0,15,4,30,6,9,0,15,5,30,6,0,0,6,1,-15,3,1
2,3,5,0,30,2,3,0,5,2,30,1,3,0,4,1,30,2,3,0,5,0,30,1,4,0,5,0,30,0,2,0,2,0,-27,3,0
2,4,5,0,30,2,3,0,5,2,30,1,3,0,4,1,30,2,3,0,5,0,30,1,4,0,5,0,30,0,2,0,2,0,-27,3,0
2,4,9,1,30,11,0,0,11,3,30,6,0,0,6,3,30,8,3,0,11,1,30,3,8,0,11,3,30,2,2,0,4,0,-27,3,0
2,4,13,2,30,6,1,0,7,0,30,4,0,0,4,4,30,6,1,0,7,8,30,6,1,0,7,2,30,4,0,0,4,1,-15,3,1
2,2,27,1,30,3,12,0,15,4,30,2,0,0,2,0,30,8,7,0,15,1,30,5,10,0,15,2,30,6,0,0,6,1,-15,3,1
2,3,27,1,30,3,12,0,15,4,30,2,0,0,2,0,30,8,7,0,15,1,30,5,10,0,15,2,30,6,0,0,6,1,-15,3,1
2,4,27,1,30,3,12,0,15,4,30,2,0,0,2,0,30,8,7,0,15,1,30,5,10,0,15,2,30,6,0,0,6,1,-15,3,1
2,2,29,0,30,7,7,0,14,6,30,11,1,0,12,0,30,4,10,0,14,0,30,1,13,0,14,3,30,9,0,0,9,1,-15,3,1
2,4,29,0,30,7,7,0,14,5,30,11,1,0,12,0,30,4,10,0,14,0,30,1,13,0,14,3,30,9,0,0,9,1,-15,3,1
2,2,35,0,30,4,9,0,13,5,30,2,0,0,2,1,30,7,6,0,13,0,30,1,12,0,13,2,30,8,0,0,8,1,-15,3,1
2,0,37,1,30,8,3,0,11,5,30,6,2,0,8,0,30,5,6,0,11,4,30,3,8,0,11,6,30,5,1,0,6,1,-15,3,1
2,1,37,1,30,8,3,0,11,5,30,6,2,0,8,0,30,5,6,0,11,4,30,3,8,0,11,6,30,5,1,0,6,1,-15,3,1
2,2,37,1,30,8,3,0,11,5,30,6,2,0,8,0,30,5,6,0,11,4,30,3,8,0,11,6,30,5,1,0,6,1,-15,3,1
2,4,37,1,30,8,3,0,11,5,30,6,2,0,8,0,30,5,6,0,11,4,30,3,8,0,11,6,30,5,1,0,6,1,-15,3,1
2,3,41,0,30,8,4,0,12,7,30,8,0,0,8,0,30,3,9,0,12,1,30,4,8,0,12,3,30,7,0,0,7,1,-15,3,1
2,1,4,5,30,8,0,0,8,5,30,4,0,0,4,0,30,3,5,0,8,2,30,6,2,0,8,1,30,4,0,0,4,0,-27,3,0
2,2,4,5,30,8,0,0,8,5,30,4,0,0,4,0,30,3,5,0,8,2,30,6,2,0,8,1,30,4,0,0,4,0,-27,3,0
2,4,8,2,30,7,0,0,7,4,30,2,0,0,2,0,30,4,3,0,7,0,30,6,1,0,7,2,30,3,0,0,3,0,-27,3,0
2,1,11,0,30,9,3,0,12,0,30,4,0,0,4,0,30,8,4,0,12,8,30,2,10,0,12,4,30,4,0,0,4,1,-15,3,1
2,4,13,1,30,4,3,0,7,0,30,4,0,0,4,0,30,7,0,0,7,11,30,7,0,0,7,2,30,4,0,0,4,1,-15,3,1
2,1,17,4,30,9,5,0,14,3,30,6,0,0,6,0,30,4,10,0,14,1,30,7,7,0,14,3,30,4,0,0,4,1,-15,3,1
2,2,17,4,30,9,5,0,14,3,30,6,0,0,6,0,30,4,10,0,14,1,30,7,7,0,14,3,30,4,0,0,4,1,-15,3,1
2,3,17,4,30,9,5,0,14,3,30,6,0,0,6,0,30,4,10,0,14,1,30,7,7,0,14,3,30,4,0,0,4,1,-15,3,1
2,0,19,0,30,5,8,0,13,2,30,4,4,0,8,0,30,4,9,0,13,7,30,8,5,0,13,1,30,8,1,0,9,1,-15,3,1
2,1,19,0,30,5,8,0,13,2,30,4,4,0,8,0,30,4,9,0,13,7,30,8,5,0,13,1,30,8,1,0,9,1,-15,3,1
2,2,19,0,30,5,8,0,13,2,30,4,4,0,8,0,30,4,9,0,13,7,30,8,5,0,13,1,30,8,1,0,9,1,-15,3,1
2,4,19,0,30,5,8,0,13,2,30,4,4,0,8,0,30,4,9,0,13,7,30,8,5,0,13,1,30,8,1,0,9,1,-15,3,1
2,2,25,1,30,8,6,0,14,5,30,6,0,0,6,0,30,5,9,0,14,2,30,8,6,0,14,4,30,6,0,0,6,1,-15,3,1
2,2,29,0,30,5,9,0,14,6,30,12,0,0,12,0,30,5,9,0,14,0,30,0,14,0,14,1,30,9,0,0,9,1,-15,3,1
2,3,29,0,30,5,9,0,14,6,30,12,0,0,12,0,30,5,9,0,14,0,30,0,14,0,14,1,30,9,0,0,9,1,-15,3,1
2,2,13,3,30,6,1,0,7,1,30,4,0,0,4,2,30,7,0,0,7,4,30,7,0,0,7,4,30,4,0,0,4,1,-15,3,1
2,3,13,3,30,6,1,0,7,1,30,4,0,0,4,2,30,7,0,0,7,4,30,7,0,0,7,4,30,4,0,0,4,1,-15,3,1
2,4,13,3,30,6,1,0,7,1,30,4,0,0,4,2,30,7,0,0,7,4,30,7,0,0,7,4,30,4,0,0,4,1,-15,3,1
2,4,22,1,30,5,3,0,8,2,30,2,0,0,2,0,30,4,4,0,8,1,30,3,5,0,8,2,30,3,1,0,4,1,-15,3,1
2,4,23,1,30,4,9,0,13,2,30,6,0,0,6,6,30,11,2,0,13,0,30,3,10,0,13,2,30,6,0,0,6,1,-15,3,1
2,4,25,0,30,11,3,0,14,3,30,6,0,0,6,0,30,9,5,0,14,1,30,5,9,0,14,3,30,5,1,0,6,1,-15,3,1
2,0,27,1,30,8,7,0,15,3,30,2,0,0,2,0,30,5,10,0,15,0,30,5,10,0,15,5,30,6,0,0,6,1,-15,3,1
2,2,27,1,30,8,7,0,15,3,30,2,0,0,2,0,30,5,10,0,15,0,30,5,10,0,15,5,30,6,0,0,6,1,-15,3,1
2,3,27,1,30,8,7,0,15,3,30,2,0,0,2,0,30,5,10,0,15,0,30,5,10,0,15,5,30,6,0,0,6,1,-15,3,1
2,4,27,1,30,8,7,0,15,3,30,2,0,0,2,0,30,5,10,0,15,0,30,5,10,0,15,5,30,6,0,0,6,1,-15,3,1
2,2,29,0,30,5,9,0,14,6,30,11,1,0,12,0,30,3,11,0,14,0,30,3,11,0,14,4,30,9,0,0,9,1,-15,3,1
2,4,35,5,30,6,7,0,13,4,30,2,0,0,2,1,30,6,7,0,13,0,30,1,12,0,13,3,30,8,0,0,8,1,-15,3,1
2,0,37,1,30,6,5,0,11,5,30,8,0,0,8,0,30,6,5,0,11,4,30,3,8,0,11,6,30,6,0,0,6,1,-15,3,1
2,1,37,1,30,6,5,0,11,5,30,8,0,0,8,0,30,6,5,0,11,4,30,3,8,0,11,6,30,6,0,0,6,1,-15,3,1
2,2,39,0,30,2,9,0,11,6,30,6,0,0,6,0,30,6,5,0,11,3,30,3,8,0,11,5,30,5,0,0,5,1,-15,3,1
2,4,39,0,30,2,9,0,11,6,30,6,0,0,6,0,30,6,5,0,11,3,30,3,8,0,11,5,30,5,0,0,5,1,-15,3,1
2,4,6,0,30,7,2,0,9,4,30,2,0,0,2,0,30,2,7,0,9,0,30,3,6,0,9,1,30,5,0,0,5,0,-27,3,0
2,1,13,2,30,6,1,0,7,0,30,4,0,0,4,2,30,7,0,0,7,9,30,7,0,0,7,5,30,4,0,0,4,1,-15,3,1
2,2,19,1,30,5,8,0,13,2,30,7,1,0,8,0,30,4,9,0,13,0,30,5,8,0,13,1,30,9,0,0,9,1,-15,3,1
2,4,19,1,30,5,8,0,13,2,30,7,1,0,8,0,30,4,9,0,13,0,30,5,8,0,13,1,30,9,0,0,9,1,-15,3,1
2,2,27,1,30,4,11,0,15,4,30,2,0,0,2,0,30,2,13,0,15,2,30,7,8,0,15,8,30,6,0,0,6,1,-15,3,1
2,3,27,1,30,4,11,0,15,4,30,2,0,0,2,0,30,2,13,0,15,2,30,7,8,0,15,8,30,6,0,0,6,1,-15,3,1
2,3,35,0,30,8,5,0,13,5,30,2,0,0,2,1,30,3,10,0,13,2,30,3,10,0,13,8,30,8,0,0,8,1,-15,3,1
2,3,38,0,30,0,10,0,10,6,30,6,0,0,6,0,30,4,6,0,10,0,30,4,6,0,10,7,30,6,0,0,6,1,-15,3,1
2,1,5,0,30,2,3,0,5,3,30,1,3,0,4,0,30,0,5,0,5,1,30,2,3,0,5,0,30,0,2,0,2,0,-27,3,0
2,3,5,0,30,2,3,0,5,3,30,1,3,0,4,0,30,0,5,0,5,1,30,2,3,0,5,0,30,0,2,0,2,0,-27,3,0
2,4,5,0,30,2,3,0,5,3,30,1,3,0,4,0,30,0,5,0,5,1,30,2,3,0,5,0,30,0,2,0,2,0,-27,3,0
2,4,8,1,30,7,0,0,7,3,30,2,0,0,2,1,30,7,0,0,7,0,30,4,3,0,7,0,30,3,0,0,3,0,-27,3,0
2,1,13,4,30,6,1,0,7,0,30,4,0,0,4,2,30,6,1,0,7,7,30,7,0,0,7,6,30,4,0,0,4,1,-15,3,1
2,4,13,4,30,6,1,0,7,0,30,4,0,0,4,2,30,6,1,0,7,7,30,7,0,0,7,6,30,4,0,0,4,1,-15,3,1
2,3,15,1,30,4,9,0,13,1,30,6,0,0,6,0,30,3,10,0,13,1,30,4,9,0,13,2,30,8,1,0,9,1,-15,3,1
2,4,15,1,30,4,9,0,13,1,30,6,0,0,6,0,30,3,10,0,13,1,30,4,9,0,13,2,30,8,1,0,9,1,-15,3,1
2,1,19,0,30,3,10,0,13,2,30,5,3,0,8,0,30,5,8,0,13,8,30,7,6,0,13,3,30,8,1,0,9,1,-15,3,1
2,2,19,0,30,3,10,0,13,2,30,5,3,0,8,0,30,5,8,0,13,8,30,7,6,0,13,3,30,8,1,0,9,1,-15,3,1
2,4,19,0,30,3,10,0,13,2,30,5,3,0,8,0,30,5,8,0,13,8,30,7,6,0,13,3,30,8,1,0,9,1,-15,3,1
2,2,26,0,30,5,4,0,9,5,30,4,0,0,4,2,30,0,9,0,9,0,30,2,7,0,9,4,30,2,1,0,3,1,-15,3,1
2,3,27,0,30,6,9,0,15,1,30,2,0,0,2,0,30,12,3,0,15,2,30,4,11,0,15,1,30,5,1,0,6,1,-15,3,1
2,4,27,0,30,6,9,0,15,1,30,2,0,0,2,0,30,12,3,0,15,2,30,4,11,0,15,1,30,5,1,0,6,1,-15,3,1
2,4,31,3,30,9,3,0,12,3,30,8,0,0,8,3,30,12,0,0,12,0,30,3,9,0,12,0,30,2,4,0,6,1,-15,3,1
2,2,38,0,30,4,6,0,10,6,30,5,1,0,6,0,30,1,9,0,10,0,30,2,8,0,10,7,30,6,0,0,6,1,-15,3,1
2,1,5,2,30,5,0,0,5,3,30,3,1,0,4,0,30,0,5,0,5,0,30,1,4,0,5,0,30,0,2,0,2,0,-27,3,0
2,3,5,2,30,5,0,0,5,3,30,3,1,0,4,0,30,0,5,0,5,0,30,1,4,0,5,0,30,0,2,0,2,0,-27,3,0
2,2,17,1,30,9,5,0,14,2,30,6,0,0,6,0,30,6,8,0,14,1,30,6,8,0,14,5,30,4,0,0,4,1,-15,3,1
2,4,17,1,30,9,5,0,14,2,30,6,0,0,6,0,30,6,8,0,14,1,30,6,8,0,14,5,30,4,0,0,4,1,-15,3,1
2,2,19,0,30,4,9,0,13,2,30,8,0,0,8,0,30,4,9,0,13,3,30,5,8,0,13,0,30,6,3,0,9,1,-15,3,1
2,4,19,0,30,4,9,0,13,2,30,8,0,0,8,0,30,4,9,0,13,3,30,5,8,0,13,0,30,6,3,0,9,1,-15,3,1
2,4,22,1,30,7,1,0,8,3,30,2,0,0,2,1,30,5,3,0,8,1,30,3,5,0,8,2,30,1,3,0,4,1,-15,3,1
2,4,23,1,30,7,6,0,13,2,30,6,0,0,6,2,30,12,1,0,13,2,30,5,8,0,13,1,30,6,0,0,6,1,-15,3,1
2,3,25,1,30,8,6,0,14,4,30,6,0,0,6,0,30,6,8,0,14,1,30,7,7,0,14,3,30,5,1,0,6,1,-15,3,1
2,4,25,1,30,8,6,0,14,4,30,6,0,0,6,0,30,6,8,0,14,1,30,7,7,0,14,3,30,5,1,0,6,1,-15,3,1
2,1,27,1,30,4,11,0,15,4,30,2,0,0,2,0,30,6,9,0,15,3,30,5,10,0,15,1,30,6,0,0,6,1,-15,3,1
2,2,27,1,30,4,11,0,15,4,30,2,0,0,2,0,30,6,9,0,15,3,30,5,10,0,15,1,30,6,0,0,6,1,-15,3,1
2,2,33,1,30,6,5,0,11,5,30,4,0,0,4,1,30,9,2,0,11,0,30,5,6,0,11,6,30,4,0,0,4,1,-15,3,1
2,3,33,1,30,6,5,0,11,5,30,4,0,0,4,1,30,9,2,0,11,0,30,5,6,0,11,6,30,4,0,0,4,1,-15,3,1
2,4,1,0,30,7,3,0,10,4,30,2,0,0,2,1,30,4,6,0,10,4,30,7,3,0,10,6,30,6,0,0,6,0,-27,3,0
2,0,5,0,30,4,1,0,5,3,30,3,1,0,4,0,30,0,5,0,5,0,30,1,4,0,5,0,30,0,2,0,2,0,-27,3,0
2,1,5,0,30,4,1,0,5,3,30,3,1,0,4,0,30,0,5,0,5,0,30,1,4,0,5,0,30,0,2,0,2,0,-27,3,0
2,2,5,0,30,4,1,0,5,3,30,3,1,0,4,0,30,0,5,0,5,0,30,1,4,0,5,0,30,0,2,0,2,0,-27,3,0
2,4,5,0,30,4,1,0,5,3,30,3,1,0,4,0,30,0,5,0,5,0,30,1,4,0,5,0,30,0,2,0,2,0,-27,3,0
2,2,11,1,30,5,7,0,12,2,30,4,0,0,4,0,30,6,6,0,12,4,30,6,6,0,12,0,30,4,0,0,4,1,-15,3,1
2,0,13,4,30,7,0,0,7,2,30,4,0,0,4,2,30,6,1,0,7,5,30,6,1,0,7,5,30,4,0,0,4,1,-15,3,1
2,3,13,4,30,7,0,0,7,2,30,4,0,0,4,2,30,6,1,0,7,5,30,6,1,0,7,5,30,4,0,0,4,1,-15,3,1
2,4,13,4,30,7,0,0,7,2,30,4,0,0,4,2,30,6,1,0,7,5,30,6,1,0,7,5,30,4,0,0,4,1,-15,3,1
2,3,15,1,30,4,9,0,13,1,30,6,0,0,6,0,30,3,10,0,13,1,30,5,8,0,13,2,30,8,1,0,9,1,-15,3,1
2,2,17,2,30,8,6,0,14,3,30,6,0,0,6,0,30,5,9,0,14,1,30,9,5,0,14,1,30,4,0,0,4,1,-15,3,1
2,4,17,2,30,8,6,0,14,3,30,6,0,0,6,0,30,5,9,0,14,1,30,9,5,0,14,1,30,4,0,0,4,1,-15,3,1
2,3,19,1,30,5,8,0,13,1,30,6,2,0,8,0,30,11,2,0,13,2,30,6,7,0,13,0,30,8,1,0,9,1,-15,3,1
2,4,19,1,30,5,8,0,13,1,30,6,2,0,8,0,30,11,2,0,13,2,30,6,7,0,13,0,30,8,1,0,9,1,-15,3,1
2,4,23,1,30,6,7,0,13,3,30,6,0,0,6,8,30,10,3,0,13,0,30,5,8,0,13,1,30,6,0,0,6,1,-15,3,1
2,2,25,2,30,6,8,0,14,4,30,6,0,0,6,0,30,11,3,0,14,1,30,5,9,0,14,3,30,5,1,0,6,1,-15,3,1
2,3,25,2,30,6,8,0,14,4,30,6,0,0,6,0,30,11,3,0,14,1,30,5,9,0,14,3,30,5,1,0,6,1,-15,3,1
2,1,27,0,30,4,11,0,15,4,30,2,0,0,2,0,30,6,9,0,15,2,30,9,6,0,15,2,30,5,1,0,6,1,-15,3,1
2,2,29,0,30,9,5,0,14,6,30,11,1,0,12,0,30,3,11,0,14,0,30,1,13,0,14,4,30,9,0,0,9,1,-15,3,1
2,0,41,0,30,10,2,0,12,5,30,7,1,0,8,0,30,12,0,0,12,0,30,3,9,0,12,3,30,4,3,0,7,1,-15,3,1
2,2,41,0,30,10,2,0,12,5,30,7,1,0,8,0,30,12,0,0,12,0,30,3,9,0,12,3,30,4,3,0,7,1,-15,3,1
2,3,41,0,30,10,2,0,12,5,30,7,1,0,8,0,30,12,0,0,12,0,30,3,9,0,12,3,30,4,3,0,7,1,-15,3,1
2,0,4,2,30,7,1,0,8,5,30,4,0,0,4,1,30,1,7,0,8,2,30,8,0,0,8,1,30,3,1,0,4,0,-27,3,0
2,2,5,0,30,2,3,0,5,2,30,3,1,0,4,0,30,0,5,0,5,0,30,1,4,0,5,0,30,0,2,0,2,0,-27,3,0
2,2,11,0,30,1,3,0,4,0,30,0,0,0,0,0,30,0,4,0,4,8,30,2,2,0,4,3,30,1,0,0,1,1,-15,3,1
2,3,13,2,30,3,0,0,3,1,30,2,0,0,2,0,30,2,1,0,3,4,30,2,1,0,3,2,30,2,0,0,2,1,-15,3,1
2,1,13,4,30,7,0,0,7,0,30,4,0,0,4,2,30,5,2,0,7,10,30,6,1,0,7,2,30,4,0,0,4,1,-15,3,1
2,4,13,4,30,7,0,0,7,0,30,4,0,0,4,2,30,5,2,0,7,10,30,6,1,0,7,2,30,4,0,0,4,1,-15,3,1
2,4,17,3,30,9,5,0,14,2,30,6,0,0,6,0,30,5,9,0,14,0,30,5,9,0,14,5,30,4,0,0,4,1,-15,3,1
2,1,19,0,30,2,11,0,13,3,30,3,5,0,8,0,30,4,9,0,13,8,30,5,8,0,13,2,30,9,0,0,9,1,-15,3,1
2,4,19,0,30,2,11,0,13,3,30,3,5,0,8,0,30,4,9,0,13,8,30,5,8,0,13,2,30,9,0,0,9,1,-15,3,1
2,1,23,1,30,5,8,0,13,2,30,6,0,0,6,7,30,12,1,0,13,0,30,6,7,0,13,1,30,5,1,0,6,1,-15,3,1
2,4,23,0,30,5,8,0,13,2,30,6,0,0,6,7,30,12,1,0,13,0,30,6,7,0,13,1,30,5,1,0,6,1,-15,3,1
2,0,25,1,30,7,7,0,14,4,30,6,0,0,6,0,30,9,5,0,14,1,30,5,9,0,14,5,30,5,1,0,6,1,-15,3,1
2,4,27,0,30,5,10,0,15,3,30,2,0,0,2,0,30,3,12,0,15,2,30,4,11,0,15,5,30,6,0,0,6,1,-15,3,1
2,3,4,2,30,6,2,0,8,5,30,4,0,0,4,1,30,2,6,0,8,0,30,4,4,0,8,3,30,4,0,0,4,0,-27,3,0
2,3,6,0,30,5,4,0,9,3,30,2,0,0,2,0,30,3,6,0,9,0,30,4,5,0,9,3,30,3,2,0,5,0,-27,3,0
2,3,8,1,30,7,0,0,7,3,30,2,0,0,2,0,30,4,3,0,7,0,30,6,1,0,7,7,30,3,0,0,3,0,-27,3,0
2,3,15,0,30,5,8,0,13,0,30,5,1,0,6,0,30,3,10,0,13,1,30,3,10,0,13,2,30,9,0,0,9,1,-15,3,1
2,1,17,2,30,8,6,0,14,4,30,6,0,0,6,0,30,3,11,0,14,3,30,9,5,0,14,8,30,4,0,0,4,1,-15,3,1
2,3,19,0,30,5,8,0,13,2,30,8,0,0,8,0,30,7,6,0,13,4,30,6,7,0,13,1,30,8,1,0,9,1,-15,3,1
2,4,25,1,30,6,8,0,14,1,30,6,0,0,6,0,30,9,5,0,14,1,30,4,10,0,14,4,30,5,1,0,6,1,-15,3,1
2,2,5,1,30,2,3,0,5,3,30,1,3,0,4,0,30,0,5,0,5,0,30,1,4,0,5,2,30,2,0,0,2,0,-27,3,0
2,4,5,1,30,2,3,0,5,3,30,1,3,0,4,0,30,0,5,0,5,0,30,1,4,0,5,2,30,2,0,0,2,0,-27,3,0
2,1,9,5,30,4,0,0,4,4,30,2,0,0,2,4,30,0,4,0,4,0,30,1,3,0,4,0,30,1,0,0,1,0,-27,3,0
2,2,9,5,30,4,0,0,4,4,30,2,0,0,2,4,30,0,4,0,4,0,30,1,3,0,4,0,30,1,0,0,1,0,-27,3,0
2,3,9,5,30,4,0,0,4,4,30,2,0,0,2,4,30,0,4,0,4,0,30,1,3,0,4,0,30,1,0,0,1,0,-27,3,0
2,4,9,5,30,4,0,0,4,4,30,2,0,0,2,4,30,0,4,0,4,0,30,1,3,0,4,0,30,1,0,0,1,0,-27,3,0
2,1,13,2,30,6,1,0,7,1,30,4,0,0,4,4,30,7,0,0,7,4,30,6,1,0,7,5,30,4,0,0,4,1,-15,3,1
2,3,13,2,30,6,1,0,7,1,30,4,0,0,4,4,30,7,0,0,7,4,30,6,1,0,7,5,30,4,0,0,4,1,-15,3,1
2,1,17,4,30,11,3,0,14,2,30,6,0,0,6,0,30,4,10,0,14,3,30,5,9,0,14,0,30,4,0,0,4,1,-15,3,1
2,2,19,0,30,2,11,0,13,2,30,8,0,0,8,2,30,8,5,0,13,3,30,4,9,0,13,0,30,7,2,0,9,1,-15,3,1
2,3,19,0,30,2,11,0,13,2,30,8,0,0,8,2,30,8,5,0,13,3,30,4,9,0,13,0,30,7,2,0,9,1,-15,3,1
2,4,19,0,30,2,11,0,13,2,30,8,0,0,8,2,30,8,5,0,13,3,30,4,9,0,13,0,30,7,2,0,9,1,-15,3,1
2,1,23,1,30,6,7,0,13,3,30,6,0,0,6,6,30,11,2,0,13,0,30,5,8,0,13,1,30,6,0,0,6,1,-15,3,1
2,4,23,0,30,6,7,0,13,3,30,6,0,0,6,6,30,11,2,0,13,0,30,5,8,0,13,1,30,6,0,0,6,1,-15,3,1
2,0,27,1,30,5,10,0,15,0,30,1,1,0,2,0,30,9,6,0,15,0,30,7,8,0,15,2,30,6,0,0,6,1,-15,3,1
2,2,27,1,30,5,10,0,15,0,30,1,1,0,2,0,30,9,6,0,15,0,30,7,8,0,15,2,30,6,0,0,6,1,-15,3,1
2,3,27,1,30,5,10,0,15,0,30,1,1,0,2,0,30,9,6,0,15,0,30,7,8,0,15,2,30,6,0,0,6,1,-15,3,1
2,3,29,1,30,9,5,0,14,6,30,10,2,0,12,0,30,3,11,0,14,0,30,0,14,0,14,0,30,9,0,0,9,1,-15,3,1
2,2,31,3,30,9,3,0,12,4,30,8,0,0,8,3,30,9,3,0,12,0,30,3,9,0,12,0,30,2,4,0,6,1,-15,3,1
2,1,37,1,30,8,3,0,11,5,30,6,2,0,8,0,30,7,4,0,11,6,30,3,8,0,11,4,30,6,0,0,6,1,-15,3,1
2,2,37,1,30,8,3,0,11,5,30,6,2,0,8,0,30,7,4,0,11,6,30,3,8,0,11,4,30,6,0,0,6,1,-15,3,1
2,4,8,3,30,7,0,0,7,3,30,2,0,0,2,4,30,2,5,0,7,2,30,7,0,0,7,1,30,3,0,0,3,0,-27,3,0
2,2,11,3,30,4,8,0,12,1,30,4,0,0,4,0,30,6,6,0,12,4,30,1,11,0,12,0,30,4,0,0,4,1,-15,3,1
2,1,17,3,30,8,6,0,14,2,30,6,0,0,6,0,30,6,8,0,14,3,30,8,6,0,14,7,30,4,0,0,4,1,-15,3,1
2,1,19,0,30,5,8,0,13,2,30,5,3,0,8,0,30,4,9,0,13,3,30,4,9,0,13,3,30,9,0,0,9,1,-15,3,1
2,3,19,0,30,5,8,0,13,1,30,5,3,0,8,0,30,4,9,0,13,3,30,4,9,0,13,3,30,9,0,0,9,1,-15,3,1
2,2,25,0,30,5,9,0,14,2,30,6,0,0,6,1,30,14,0,0,14,1,30,5,9,0,14,5,30,5,1,0,6,1,-15,3,1
2,3,25,0,30,5,9,0,14,2,30,6,0,0,6,1,30,14,0,0,14,1,30,5,9,0,14,5,30,5,1,0,6,1,-15,3,1
2,4,25,0,30,5,9,0,14,2,30,6,0,0,6,1,30,14,0,0,14,1,30,5,9,0,14,5,30,5,1,0,6,1,-15,3,1
2,1,29,0,30,4,10,0,14,4,30,12,0,0,12,0,30,8,6,0,14,0,30,1,13,0,14,4,30,9,0,0,9,1,-15,3,1
2,2,29,0,30,4,10,0,14,4,30,12,0,0,12,0,30,8,6,0,14,0,30,1,13,0,14,4,30,9,0,0,9,1,-15,3,1
2,4,32,3,30,7,2,0,9,6,30,2,0,0,2,0,30,4,5,0,9,1,30,3,6,0,9,3,30,2,0,0,2,1,-15,3,1
2,0,5,3,30,2,3,0,5,3,30,0,4,0,4,0,30,2,3,0,5,0,30,1,4,0,5,2,30,0,2,0,2,0,-27,3,0
2,3,11,0,30,4,8,0,12,0,30,4,0,0,4,0,30,10,2,0,12,6,30,5,7,0,12,0,30,4,0,0,4,1,-15,3,1
2,4,11,0,30,4,8,0,12,0,30,4,0,0,4,0,30,10,2,0,12,6,30,5,7,0,12,0,30,4,0,0,4,1,-15,3,1
2,2,15,4,30,4,9,0,13,2,30,6,0,0,6,0,30,3,10,0,13,1,30,4,9,0,13,4,30,9,0,0,9,1,-15,3,1
2,3,15,4,30,4,9,0,13,2,30,6,0,0,6,0,30,3,10,0,13,1,30,4,9,0,13,4,30,9,0,0,9,1,-15,3,1
2,3,19,0,30,7,6,0,13,1,30,5,3,0,8,0,30,7,6,0,13,0,30,6,7,0,13,0,30,7,2,0,9,1,-15,3,1
2,4,19,0,30,7,6,0,13,1,30,5,3,0,8,0,30,7,6,0,13,0,30,6,7,0,13,0,30,7,2,0,9,1,-15,3,1
2,2,21,2,30,7,3,0,10,3,30,5,1,0,6,1,30,4,6,0,10,2,30,4,6,0,10,5,30,4,0,0,4,1,-15,3,1
2,2,27,1,30,4,11,0,15,4,30,1,1,0,2,0,30,8,7,0,15,1,30,4,11,0,15,4,30,6,0,0,6,1,-15,3,1
2,3,31,1,30,5,7,0,12,4,30,8,0,0,8,3,30,11,1,0,12,0,30,8,4,0,12,2,30,6,0,0,6,1,-15,3,1
2,2,4,2,30,6,2,0,8,4,30,2,2,0,4,0,30,3,5,0,8,0,30,4,4,0,8,5,30,4,0,0,4,0,-27,3,0
2,3,4,2,30,6,2,0,8,4,30,2,2,0,4,0,30,3,5,0,8,0,30,4,4,0,8,5,30,4,0,0,4,0,-27,3,0
2,4,4,2,30,6,2,0,8,4,30,2,2,0,4,0,30,3,5,0,8,0,30,4,4,0,8,5,30,4,0,0,4,0,-27,3,0
2,1,5,0,30,1,4,0,5,2,30,4,0,0,4,0,30,0,5,0,5,0,30,1,4,0,5,2,30,2,0,0,2,0,-27,3,0
2,4,5,0,30,1,4,0,5,2,30,4,0,0,4,0,30,0,5,0,5,0,30,1,4,0,5,2,30,2,0,0,2,0,-27,3,0
2,3,8,1,30,7,0,0,7,3,30,2,0,0,2,0,30,5,2,0,7,0,30,7,0,0,7,3,30,3,0,0,3,0,-27,3,0
2,4,8,1,30,7,0,0,7,3,30,2,0,0,2,0,30,5,2,0,7,0,30,7,0,0,7,3,30,3,0,0,3,0,-27,3,0
2,4,13,1,30,5,2,0,7,0,30,4,0,0,4,0,30,5,2,0,7,8,30,6,1,0,7,5,30,4,0,0,4,1,-15,3,1
2,4,15,2,30,4,9,0,13,2,30,6,0,0,6,0,30,3,10,0,13,1,30,8,5,0,13,0,30,8,1,0,9,1,-15,3,1
2,3,17,4,30,9,5,0,14,2,30,6,0,0,6,0,30,7,7,0,14,1,30,5,9,0,14,2,30,4,0,0,4,1,-15,3,1
2,1,23,1,30,9,4,0,13,2,30,6,0,0,6,1,30,12,1,0,13,0,30,5,8,0,13,3,30,6,0,0,6,1,-15,3,1
2,1,27,1,30,3,12,0,15,4,30,2,0,0,2,0,30,7,8,0,15,2,30,4,11,0,15,2,30,6,0,0,6,1,-15,3,1
2,2,29,0,30,7,7,0,14,6,30,10,2,0,12,0,30,3,11,0,14,0,30,1,13,0,14,3,30,9,0,0,9,1,-15,3,1
2,3,29,0,30,7,7,0,14,6,30,10,2,0,12,0,30,3,11,0,14,0,30,1,13,0,14,3,30,9,0,0,9,1,-15,3,1
2,2,4,2,30,4,4,0,8,5,30,3,1,0,4,0,30,1,7,0,8,0,30,6,2,0,8,4,30,4,0,0,4,0,-27,3,0
2,3,4,2,30,4,4,0,8,5,30,3,1,0,4,0,30,1,7,0,8,0,30,6,2,0,8,4,30,4,0,0,4,0,-27,3,0
2,4,4,2,30,4,4,0,8,5,30,3,1,0,4,0,30,1,7,0,8,0,30,6,2,0,8,4,30,4,0,0,4,0,-27,3,0
2,1,5,0,30,2,3,0,5,3,30,4,0,0,4,0,30,0,5,0,5,0,30,1,4,0,5,1,30,2,0,0,2,0,-27,3,0
2,2,5,0,30,2,3,0,5,3,30,4,0,0,4,0,30,0,5,0,5,0,30,1,4,0,5,1,30,2,0,0,2,0,-27,3,0
2,2,8,1,30,7,0,0,7,4,30,2,0,0,2,4,30,3,4,0,7,2,30,7,0,0,7,1,30,3,0,0,3,0,-27,3,0
2,3,8,1,30,7,0,0,7,4,30,2,0,0,2,4,30,3,4,0,7,2,30,7,0,0,7,1,30,3,0,0,3,0,-27,3,0
2,4,8,1,30,7,0,0,7,4,30,2,0,0,2,4,30,3,4,0,7,2,30,7,0,0,7,1,30,3,0,0,3,0,-27,3,0
2,3,15,2,30,4,9,0,13,1,30,6,0,0,6,0,30,4,9,0,13,1,30,4,9,0,13,2,30,7,2,0,9,1,-15,3,1
2,4,17,5,30,9,5,0,14,4,30,6,0,0,6,0,30,5,9,0,14,5,30,5,9,0,14,5,30,4,0,0,4,1,-15,3,1
2,1,19,0,30,2,11,0,13,2,30,5,3,0,8,0,30,4,9,0,13,4,30,7,6,0,13,2,30,8,1,0,9,1,-15,3,1
2,3,23,1,30,5,8,0,13,3,30,6,0,0,6,7,30,11,2,0,13,0,30,4,9,0,13,3,30,6,0,0,6,1,-15,3,1
2,4,23,1,30,5,8,0,13,3,30,6,0,0,6,7,30,11,2,0,13,0,30,4,9,0,13,3,30,6,0,0,6,1,-15,3,1
2,3,25,1,30,10,4,0,14,4,30,6,0,0,6,0,30,3,11,0,14,1,30,7,7,0,14,3,30,6,0,0,6,1,-15,3,1
2,1,26,0,30,4,5,0,9,6,30,4,0,0,4,5,30,0,9,0,9,0,30,3,6,0,9,4,30,3,0,0,3,1,-15,3,1
2,2,26,0,30,4,5,0,9,6,30,4,0,0,4,5,30,0,9,0,9,0,30,3,6,0,9,4,30,3,0,0,3,1,-15,3,1
2,3,27,1,30,5,10,0,15,3,30,2,0,0,2,0,30,14,1,0,15,0,30,5,10,0,15,1,30,4,2,0,6,1,-15,3,1
2,0,29,0,30,5,9,0,14,6,30,11,1,0,12,0,30,5,9,0,14,0,30,1,13,0,14,3,30,9,0,0,9,1,-15,3,1
2,1,29,0,30,5,9,0,14,6,30,11,1,0,12,0,30,5,9,0,14,0,30,1,13,0,14,3,30,9,0,0,9,1,-15,3,1
2,1,31,3,30,6,6,0,12,5,30,8,0,0,8,3,30,8,4,0,12,0,30,5,7,0,12,1,30,4,2,0,6,1,-15,3,1
2,2,31,3,30,6,6,0,12,5,30,8,0,0,8,3,30,8,4,0,12,0,30,5,7,0,12,1,30,4,2,0,6,1,-15,3,1
2,4,31,3,30,6,6,0,12,5,30,8,0,0,8,3,30,8,4,0,12,0,30,5,7,0,12,1,30,4,2,0,6,1,-15,3,1
2,3,35,0,30,7,6,0,13,5,30,2,0,0,2,0,30,6,7,0,13,0,30,3,10,0,13,2,30,7,1,0,8,1,-15,3,1
2,2,43,0,30,9,5,0,14,6,30,6,0,0,6,0,30,4,10,0,14,1,30,4,10,0,14,7,30,5,0,0,5,1,-15,3,1
2,3,43,0,30,9,5,0,14,6,30,6,0,0,6,0,30,4,10,0,14,1,30,4,10,0,14,7,30,5,0,0,5,1,-15,3,1
2,0,5,0,30,2,3,0,5,3,30,2,2,0,4,0,30,0,5,0,5,2,30,2,3,0,5,0,30,1,1,0,2,0,-27,3,0
2,1,5,0,30,2,3,0,5,3,30,2,2,0,4,0,30,0,5,0,5,2,30,2,3,0,5,0,30,1,1,0,2,0,-27,3,0
2,3,8,2,30,7,0,0,7,4,30,2,0,0,2,3,30,4,3,0,7,1,30,7,0,0,7,1,30,3,0,0,3,0,-27,3,0
2,4,8,2,30,7,0,0,7,4,30,2,0,0,2,3,30,4,3,0,7,1,30,7,0,0,7,1,30,3,0,0,3,0,-27,3,0
2,2,9,0,30,2,2,0,4,2,30,2,0,0,2,0,30,3,1,0,4,0,30,1,3,0,4,0,30,1,0,0,1,0,-27,3,0
2,4,11,0,30,1,3,0,4,0,30,0,0,0,0,0,30,3,1,0,4,3,30,3,1,0,4,1,30,1,0,0,1,1,-15,3,1
2,4,13,3,30,7,0,0,7,0,30,4,0,0,4,3,30,7,0,0,7,7,30,6,1,0,7,2,30,4,0,0,4,1,-15,3,1
2,0,19,1,30,2,11,0,13,3,30,7,1,0,8,0,30,5,8,0,13,4,30,3,10,0,13,2,30,9,0,0,9,1,-15,3,1
2,1,19,1,30,2,11,0,13,3,30,7,1,0,8,0,30,5,8,0,13,4,30,3,10,0,13,2,30,9,0,0,9,1,-15,3,1
2,4,19,1,30,2,11,0,13,3,30,7,1,0,8,0,30,5,8,0,13,4,30,3,10,0,13,2,30,9,0,0,9,1,-15,3,1
2,4,23,2,30,5,8,0,13,3,30,6,0,0,6,10,30,13,0,0,13,0,30,6,7,0,13,2,30,5,1,0,6,1,-15,3,1
2,2,25,1,30,8,6,0,14,1,30,6,0,0,6,0,30,9,5,0,14,1,30,5,9,0,14,4,30,5,1,0,6,1,-15,3,1
2,3,25,1,30,8,6,0,14,1,30,6,0,0,6,0,30,9,5,0,14,1,30,5,9,0,14,4,30,5,1,0,6,1,-15,3,1
2,2,30,11,30,5,0,0,5,5,30,2,0,0,2,1,30,2,3,0,5,2,30,1,4,0,5,0,30,2,1,0,3,1,-15,3,1
2,2,47,0,30,1,13,0,14,6,30,4,0,0,4,0,30,4,10,0,14,0,30,2,12,0,14,7,30,7,0,0,7,1,-15,3,1
2,2,5,0,30,0,5,0,5,2,30,3,1,0,4,0,30,0,5,0,5,0,30,1,4,0,5,0,30,0,2,0,2,0,-27,3,0
2,3,5,0,30,0,5,0,5,2,30,3,1,0,4,0,30,0,5,0,5,0,30,1,4,0,5,0,30,0,2,0,2,0,-27,3,0
2,4,8,0,30,7,0,0,7,4,30,2,0,0,2,0,30,2,5,0,7,0,30,7,0,0,7,3,30,3,0,0,3,0,-27,3,0
2,2,13,2,30,6,1,0,7,0,30,4,0,0,4,2,30,6,1,0,7,13,30,6,1,0,7,2,30,4,0,0,4,1,-15,3,1
2,0,27,1,30,5,10,0,15,5,30,2,0,0,2,0,30,6,9,0,15,1,30,5,10,0,15,1,30,6,0,0,6,1,-15,3,1
2,2,27,1,30,5,10,0,15,5,30,2,0,0,2,0,30,6,9,0,15,1,30,5,10,0,15,1,30,6,0,0,6,1,-15,3,1
2,4,27,1,30,5,10,0,15,5,30,2,0,0,2,0,30,6,9,0,15,0,30,5,10,0,15,1,30,6,0,0,6,1,-15,3,1
2,3,2,1,30,7,3,0,10,3,30,4,0,0,4,4,30,3,7,0,10,0,30,5,5,0,10,1,30,4,4,0,8,0,-27,3,0
2,4,2,1,30,7,3,0,10,3,30,4,0,0,4,4,30,3,7,0,10,0,30,5,5,0,10,1,30,4,4,0,8,0,-27,3,0
2,1,5,0,30,1,4,0,5,3,30,1,3,0,4,0,30,0,5,0,5,0,30,1,4,0,5,2,30,2,0,0,2,0,-27,3,0
2,2,5,0,30,1,4,0,5,3,30,1,3,0,4,0,30,0,5,0,5,0,30,1,4,0,5,2,30,2,0,0,2,0,-27,3,0
2,3,5,0,30,1,4,0,5,3,30,1,3,0,4,0,30,0,5,0,5,0,30,1,4,0,5,2,30,2,0,0,2,0,-27,3,0
2,4,9,0,30,6,5,0,11,2,30,6,0,0,6,1,30,8,3,0,11,6,30,3,8,0,11,3,30,2,2,0,4,0,-27,3,0
2,3,11,3,30,7,5,0,12,3,30,4,0,0,4,0,30,1,11,0,12,1,30,5,7,0,12,5,30,4,0,0,4,1,-15,3,1
2,2,15,0,30,5,8,0,13,1,30,6,0,0,6,0,30,4,9,0,13,1,30,7,6,0,13,2,30,7,2,0,9,1,-15,3,1
2,3,17,4,30,8,6,0,14,2,30,6,0,0,6,0,30,8,6,0,14,1,30,5,9,0,14,5,30,4,0,0,4,1,-15,3,1
2,1,19,0,30,5,8,0,13,2,30,5,3,0,8,0,30,5,8,0,13,7,30,6,7,0,13,2,30,8,1,0,9,1,-15,3,1
2,2,19,0,30,5,8,0,13,2,30,5,3,0,8,0,30,5,8,0,13,7,30,6,7,0,13,2,30,8,1,0,9,1,-15,3,1
2,2,21,3,30,7,3,0,10,4,30,5,1,0,6,1,30,3,7,0,10,5,30,6,4,0,10,3,30,4,0,0,4,1,-15,3,1
2,4,21,3,30,7,3,0,10,4,30,5,1,0,6,1,30,3,7,0,10,5,30,6,4,0,10,0,30,4,0,0,4,1,-15,3,1
2,3,23,2,30,5,8,0,13,4,30,6,0,0,6,7,30,11,2,0,13,0,30,5,8,0,13,2,30,6,0,0,6,1,-15,3,1
2,4,27,2,30,6,9,0,15,1,30,1,1,0,2,0,30,7,8,0,15,3,30,5,10,0,15,2,30,6,0,0,6,1,-15,3,1
2,4,31,3,30,5,7,0,12,4,30,8,0,0,8,3,30,11,1,0,12,2,30,3,9,0,12,2,30,2,4,0,6,1,-15,3,1
2,4,3,1,30,5,6,0,11,2,30,8,0,0,8,0,30,5,6,0,11,8,30,3,8,0,11,1,30,2,5,0,7,0,-27,3,0
2,1,7,0,30,3,1,0,4,2,30,2,0,0,2,0,30,1,3,0,4,0,30,1,3,0,4,2,30,1,1,0,2,0,-27,3,0
2,2,13,3,30,7,0,0,7,0,30,4,0,0,4,2,30,6,1,0,7,7,30,7,0,0,7,6,30,4,0,0,4,1,-15,3,1
2,1,25,2,30,3,11,0,14,2,30,6,0,0,6,0,30,11,3,0,14,1,30,5,9,0,14,3,30,5,1,0,6,1,-15,3,1
2,2,25,2,30,3,11,0,14,2,30,6,0,0,6,0,30,11,3,0,14,1,30,5,9,0,14,3,30,5,1,0,6,1,-15,3,1
2,3,25,2,30,3,11,0,14,2,30,6,0,0,6,0,30,11,3,0,14,1,30,5,9,0,14,3,30,5,1,0,6,1,-15,3,1
2,4,25,2,30,3,11,0,14,2,30,6,0,0,6,0,30,11,3,0,14,1,30,5,9,0,14,3,30,5,1,0,6,1,-15,3,1
2,2,38,0,30,2,8,0,10,7,30,6,0,0,6,0,30,1,9,0,10,0,30,3,7,0,10,8,30,6,0,0,6,1,-15,3,1
2,3,38,0,30,2,8,0,10,7,30,6,0,0,6,0,30,1,9,0,10,0,30,3,7,0,10,8,30,6,0,0,6,1,-15,3,1
2,3,39,0,30,4,7,0,11,6,30,6,0,0,6,0,30,5,6,0,11,0,30,2,9,0,11,5,30,5,0,0,5,1,-15,3,1
2,4,5,0,30,2,3,0,5,2,30,2,2,0,4,0,30,2,3,0,5,0,30,1,4,0,5,0,30,0,2,0,2,0,-27,3,0
2,3,8,2,30,7,0,0,7,4,30,2,0,0,2,0,30,2,5,0,7,0,30,5,2,0,7,5,30,3,0,0,3,0,-27,3,0
2,2,9,0,30,2,2,0,4,2,30,2,0,0,2,0,30,2,2,0,4,0,30,1,3,0,4,0,30,1,0,0,1,0,-27,3,0
2,2,13,3,30,5,2,0,7,0,30,4,0,0,4,2,30,6,1,0,7,12,30,7,0,0,7,4,30,4,0,0,4,1,-15,3,1
2,4,13,3,30,5,2,0,7,0,30,4,0,0,4,2,30,6,1,0,7,12,30,7,0,0,7,4,30,4,0,0,4,1,-15,3,1
2,1,17,2,30,9,5,0,14,3,30,6,0,0,6,0,30,6,8,0,14,5,30,5,9,0,14,3,30,4,0,0,4,1,-15,3,1
2,3,17,2,30,9,5,0,14,3,30,6,0,0,6,0,30,6,8,0,14,5,30,5,9,0,14,3,30,4,0,0,4,1,-15,3,1
2,4,17,2,30,9,5,0,14,3,30,6,0,0,6,0,30,6,8,0,14,5,30,5,9,0,14,3,30,4,0,0,4,1,-15,3,1
2,3,23,1,30,3,10,0,13,4,30,6,0,0,6,10,30,13,0,0,13,0,30,6,7,0,13,2,30,5,1,0,6,1,-15,3,1
2,2,27,0,30,4,11,0,15,4,30,2,0,0,2,0,30,3,12,0,15,0,30,5,10,0,15,6,30,6,0,0,6,1,-15,3,1
2,4,27,0,30,4,11,0,15,4,30,2,0,0,2,0,30,3,12,0,15,0,30,5,10,0,15,6,30,6,0,0,6,1,-15,3,1
2,4,29,0,30,7,7,0,14,6,30,11,1,0,12,0,30,2,12,0,14,0,30,1,13,0,14,2,30,9,0,0,9,1,-15,3,1
2,3,31,3,30,10,2,0,12,4,30,8,0,0,8,3,30,8,4,0,12,0,30,3,9,0,12,0,30,3,3,0,6,1,-15,3,1
2,4,32,0,30,7,2,0,9,4,30,2,0,0,2,3,30,8,1,0,9,1,30,3,6,0,9,3,30,2,0,0,2,1,-15,3,1
2,3,33,1,30,2,9,0,11,4,30,4,0,0,4,1,30,10,1,0,11,2,30,5,6,0,11,0,30,4,0,0,4,1,-15,3,1
2,3,35,1,30,7,6,0,13,2,30,1,1,0,2,1,30,7,6,0,13,1,30,2,11,0,13,0,30,8,0,0,8,1,-15,3,1
2,1,5,0,30,5,0,0,5,3,30,2,2,0,4,0,30,1,4,0,5,0,30,1,4,0,5,0,30,0,2,0,2,0,-27,3,0
2,2,5,0,30,5,0,0,5,3,30,2,2,0,4,0,30,1,4,0,5,0,30,1,4,0,5,0,30,0,2,0,2,0,-27,3,0
2,3,5,0,30,5,0,0,5,3,30,2,2,0,4,0,30,1,4,0,5,0,30,1,4,0,5,0,30,0,2,0,2,0,-27,3,0
2,4,5,0,30,5,0,0,5,3,30,2,2,0,4,0,30,1,4,0,5,0,30,1,4,0,5,0,30,0,2,0,2,0,-27,3,0
2,3,8,1,30,7,0,0,7,4,30,2,0,0,2,0,30,5,2,0,7,0,30,6,1,0,7,3,30,3,0,0,3,0,-27,3,0
2,2,11,1,30,5,7,0,12,1,30,4,0,0,4,0,30,5,7,0,12,3,30,6,6,0,12,4,30,4,0,0,4,1,-15,3,1
2,0,13,4,30,7,0,0,7,1,30,4,0,0,4,2,30,6,1,0,7,9,30,6,1,0,7,4,30,4,0,0,4,1,-15,3,1
2,4,13,4,30,7,0,0,7,1,30,4,0,0,4,2,30,6,1,0,7,9,30,6,1,0,7,4,30,4,0,0,4,1,-15,3,1
2,4,15,2,30,4,9,0,13,1,30,6,0,0,6,0,30,3,10,0,13,1,30,6,7,0,13,2,30,5,4,0,9,1,-15,3,1
2,1,17,4,30,9,5,0,14,3,30,6,0,0,6,0,30,6,8,0,14,1,30,5,9,0,14,0,30,3,1,0,4,1,-15,3,1
2,3,17,4,30,9,5,0,14,3,30,6,0,0,6,0,30,6,8,0,14,1,30,5,9,0,14,0,30,3,1,0,4,1,-15,3,1
2,4,17,4,30,9,5,0,14,3,30,6,0,0,6,0,30,6,8,0,14,1,30,5,9,0,14,0,30,3,1,0,4,1,-15,3,1
2,4,22,4,30,8,0,0,8,3,30,2,0,0,2,0,30,4,4,0,8,1,30,3,5,0,8,1,30,3,1,0,4,1,-15,3,1
2,2,25,2,30,8,6,0,14,4,30,6,0,0,6,0,30,8,6,0,14,1,30,5,9,0,14,4,30,5,1,0,6,1,-15,3,1
2,4,27,0,30,8,7,0,15,2,30,1,1,0,2,0,30,5,10,0,15,0,30,5,10,0,15,5,30,6,0,0,6,1,-15,3,1
2,4,8,1,30,7,0,0,7,3,30,2,0,0,2,0,30,3,4,0,7,0,30,5,2,0,7,1,30,3,0,0,3,0,-27,3,0
2,1,13,2,30,7,0,0,7,0,30,4,0,0,4,2,30,5,2,0,7,7,30,6,1,0,7,6,30,4,0,0,4,1,-15,3,1
2,2,13,2,30,7,0,0,7,0,30,4,0,0,4,2,30,5,2,0,7,7,30,6,1,0,7,6,30,4,0,0,4,1,-15,3,1
2,4,15,0,30,4,9,0,13,0,30,6,0,0,6,4,30,3,10,0,13,1,30,4,9,0,13,2,30,6,3,0,9,1,-15,3,1
2,3,19,0,30,4,9,0,13,2,30,8,0,0,8,0,30,4,9,0,13,3,30,5,8,0,13,2,30,8,1,0,9,1,-15,3,1
2,4,19,0,30,4,9,0,13,2,30,8,0,0,8,0,30,4,9,0,13,3,30,5,8,0,13,2,30,8,1,0,9,1,-15,3,1
2,4,25,1,30,5,9,0,14,4,30,6,0,0,6,0,30,4,10,0,14,0,30,6,8,0,14,5,30,6,0,0,6,1,-15,3,1
2,1,27,1,30,4,11,0,15,1,30,2,0,0,2,0,30,10,5,0,15,0,30,7,8,0,15,2,30,6,0,0,6,1,-15,3,1
2,2,27,1,30,4,11,0,15,1,30,2,0,0,2,0,30,10,5,0,15,0,30,7,8,0,15,2,30,6,0,0,6,1,-15,3,1
2,3,27,1,30,4,11,0,15,1,30,2,0,0,2,0,30,10,5,0,15,0,30,7,8,0,15,2,30,6,0,0,6,1,-15,3,1
2,4,27,1,30,4,11,0,15,1,30,2,0,0,2,0,30,10,5,0,15,0,30,7,8,0,15,2,30,6,0,0,6,1,-15,3,1
2,2,29,0,30,7,7,0,14,5,30,12,0,0,12,0,30,3,11,0,14,0,30,2,12,0,14,0,30,9,0,0,9,1,-15,3,1
2,4,39,0,30,2,9,0,11,6,30,6,0,0,6,0,30,6,5,0,11,0,30,4,7,0,11,3,30,5,0,0,5,1,-15,3,1
2,3,47,0,30,0,14,0,14,6,30,4,0,0,4,0,30,4,10,0,14,0,30,2,12,0,14,9,30,7,0,0,7,1,-15,3,1
2,3,19,2,30,2,11,0,13,3,30,8,0,0,8,0,30,4,9,0,13,3,30,4,9,0,13,1,30,8,1,0,9,1,-15,3,1
2,4,19,2,30,2,11,0,13,3,30,8,0,0,8,0,30,4,9,0,13,3,30,4,9,0,13,1,30,8,1,0,9,1,-15,3,1
2,4,23,1,30,7,6,0,13,1,30,6,0,0,6,2,30,13,0,0,13,2,30,6,7,0,13,2,30,6,0,0,6,1,-15,3,1
2,4,27,1,30,4,11,0,15,2,30,1,1,0,2,0,30,5,10,0,15,4,30,4,11,0,15,4,30,6,0,0,6,1,-15,3,1
2,3,43,0,30,6,8,0,14,7,30,6,0,0,6,8,30,5,9,0,14,1,30,1,13,0,14,4,30,5,0,0,5,1,-15,3,1
2,2,6,0,30,7,2,0,9,4,30,2,0,0,2,0,30,2,7,0,9,0,30,4,5,0,9,0,30,2,3,0,5,0,-27,3,0
2,4,6,0,30,7,2,0,9,4,30,2,0,0,2,0,30,2,7,0,9,0,30,4,5,0,9,0,30,2,3,0,5,0,-27,3,0
2,3,8,0,30,6,1,0,7,2,30,2,0,0,2,2,30,6,1,0,7,3,30,5,2,0,7,0,30,3,0,0,3,0,-27,3,0
2,4,8,0,30,6,1,0,7,2,30,2,0,0,2,2,30,6,1,0,7,3,30,5,2,0,7,0,30,3,0,0,3,0,-27,3,0
2,3,9,0,30,2,2,0,4,2,30,2,0,0,2,0,30,0,4,0,4,0,30,1,3,0,4,1,30,1,0,0,1,0,-27,3,0
2,0,17,3,30,9,5,0,14,4,30,6,0,0,6,0,30,3,11,0,14,1,30,7,7,0,14,1,30,4,0,0,4,1,-15,3,1
2,2,17,3,30,9,5,0,14,4,30,6,0,0,6,0,30,3,11,0,14,1,30,7,7,0,14,1,30,4,0,0,4,1,-15,3,1
2,3,17,3,30,9,5,0,14,4,30,6,0,0,6,0,30,3,11,0,14,1,30,7,7,0,14,1,30,4,0,0,4,1,-15,3,1
2,1,19,1,30,3,10,0,13,3,30,8,0,0,8,0,30,4,9,0,13,3,30,7,6,0,13,0,30,8,1,0,9,1,-15,3,1
2,3,19,1,30,3,10,0,13,3,30,8,0,0,8,0,30,4,9,0,13,3,30,7,6,0,13,0,30,8,1,0,9,1,-15,3,1
2,4,23,2,30,7,6,0,13,2,30,6,0,0,6,4,30,13,0,0,13,0,30,6,7,0,13,2,30,5,1,0,6,1,-15,3,1
2,1,26,0,30,7,2,0,9,5,30,4,0,0,4,5,30,0,9,0,9,0,30,4,5,0,9,7,30,3,0,0,3,1,-15,3,1
2,2,26,0,30,7,2,0,9,5,30,4,0,0,4,5,30,0,9,0,9,0,30,4,5,0,9,7,30,3,0,0,3,1,-15,3,1
2,3,26,0,30,7,2,0,9,5,30,4,0,0,4,5,30,0,9,0,9,0,30,4,5,0,9,7,30,3,0,0,3,1,-15,3,1
2,1,27,1,30,5,10,0,15,2,30,2,0,0,2,0,30,6,9,0,15,2,30,6,9,0,15,2,30,6,0,0,6,1,-15,3,1
2,3,27,1,30,5,10,0,15,2,30,2,0,0,2,0,30,6,9,0,15,2,30,6,9,0,15,2,30,6,0,0,6,1,-15,3,1
2,4,27,1,30,5,10,0,15,2,30,2,0,0,2,0,30,6,9,0,15,2,30,6,9,0,15,2,30,6,0,0,6,1,-15,3,1
2,1,33,1,30,2,9,0,11,6,30,4,0,0,4,0,30,6,5,0,11,3,30,6,5,0,11,8,30,4,0,0,4,1,-15,3,1
2,2,33,1,30,2,9,0,11,6,30,4,0,0,4,0,30,6,5,0,11,3,30,6,5,0,11,8,30,4,0,0,4,1,-15,3,1
2,3,33,1,30,2,9,0,11,6,30,4,0,0,4,0,30,6,5,0,11,3,30,6,5,0,11,8,30,4,0,0,4,1,-15,3,1
2,4,39,0,30,4,7,0,11,5,30,6,0,0,6,3,30,9,2,0,11,0,30,2,9,0,11,2,30,5,0,0,5,1,-15,3,1
2,4,41,0,30,7,5,0,12,7,30,7,1,0,8,0,30,5,7,0,12,0,30,3,9,0,12,2,30,7,0,0,7,1,-15,3,1
2,2,1,0,30,7,3,0,10,4,30,2,0,0,2,1,30,4,6,0,10,4,30,10,0,0,10,8,30,4,2,0,6,0,-27,3,0
2,3,1,0,30,7,3,0,10,4,30,2,0,0,2,1,30,4,6,0,10,4,30,10,0,0,10,8,30,4,2,0,6,0,-27,3,0
2,0,4,2,30,6,2,0,8,5,30,2,2,0,4,1,30,1,7,0,8,1,30,8,0,0,8,2,30,4,0,0,4,0,-27,3,0
2,1,4,2,30,6,2,0,8,5,30,2,2,0,4,1,30,1,7,0,8,1,30,8,0,0,8,2,30,4,0,0,4,0,-27,3,0
2,3,7,0,30,2,2,0,4,2,30,2,0,0,2,0,30,1,3,0,4,0,30,3,1,0,4,1,30,2,0,0,2,0,-27,3,0
2,4,7,0,30,2,2,0,4,2,30,2,0,0,2,0,30,1,3,0,4,0,30,3,1,0,4,1,30,2,0,0,2,0,-27,3,0
2,3,7,2,30,4,5,0,9,3,30,4,0,0,4,1,30,6,3,0,9,4,30,5,4,0,9,1,30,5,1,0,6,0,-27,3,0
2,4,7,2,30,4,5,0,9,3,30,4,0,0,4,1,30,6,3,0,9,4,30,5,4,0,9,1,30,5,1,0,6,0,-27,3,0
2,3,8,4,30,7,0,0,7,4,30,2,0,0,2,3,30,4,3,0,7,0,30,5,2,0,7,1,30,3,0,0,3,0,-27,3,0
2,4,8,4,30,7,0,0,7,4,30,2,0,0,2,3,30,4,3,0,7,0,30,5,2,0,7,1,30,3,0,0,3,0,-27,3,0
2,4,9,0,30,4,0,0,4,2,30,1,1,0,2,0,30,0,4,0,4,0,30,1,3,0,4,0,30,1,0,0,1,0,-27,3,0
2,4,17,3,30,10,4,0,14,4,30,6,0,0,6,0,30,3,11,0,14,2,30,4,10,0,14,4,30,4,0,0,4,1,-15,3,1
2,3,25,1,30,7,7,0,14,5,30,6,0,0,6,0,30,8,6,0,14,1,30,6,8,0,14,4,30,5,1,0,6,1,-15,3,1
2,1,27,1,30,5,10,0,15,1,30,2,0,0,2,0,30,9,6,0,15,0,30,6,9,0,15,4,30,6,0,0,6,1,-15,3,1
2,4,27,1,30,5,10,0,15,1,30,2,0,0,2,0,30,9,6,0,15,0,30,6,9,0,15,4,30,6,0,0,6,1,-15,3,1
2,0,31,1,30,5,7,0,12,7,30,8,0,0,8,3,30,4,8,0,12,0,30,9,3,0,12,5,30,6,0,0,6,1,-15,3,1
2,2,31,1,30,5,7,0,12,7,30,8,0,0,8,3,30,4,8,0,12,0,30,9,3,0,12,5,30,6,0,0,6,1,-15,3,1
2,4,31,1,30,5,7,0,12,7,30,8,0,0,8,3,30,4,8,0,12,0,30,9,3,0,12,5,30,6,0,0,6,1,-15,3,1
2,2,11,2,30,6,6,0,12,1,30,4,0,0,4,0,30,5,7,0,12,7,30,5,7,0,12,4,30,3,1,0,4,1,-15,3,1
2,3,17,6,30,10,4,0,14,3,30,6,0,0,6,0,30,5,9,0,14,1,30,7,7,0,14,5,30,4,0,0,4,1,-15,3,1
2,4,17,6,30,10,4,0,14,3,30,6,0,0,6,0,30,5,9,0,14,1,30,7,7,0,14,5,30,4,0,0,4,1,-15,3,1
2,3,23,1,30,5,8,0,13,1,30,6,0,0,6,2,30,13,0,0,13,0,30,8,5,0,13,4,30,6,0,0,6,1,-15,3,1
2,0,25,1,30,5,9,0,14,4,30,6,0,0,6,0,30,8,6,0,14,2,30,8,6,0,14,7,30,6,0,0,6,1,-15,3,1
2,3,25,1,30,5,9,0,14,4,30,6,0,0,6,0,30,8,6,0,14,2,30,8,6,0,14,7,30,6,0,0,6,1,-15,3,1
2,0,38,0,30,4,6,0,10,7,30,6,0,0,6,0,30,1,9,0,10,0,30,3,7,0,10,8,30,6,0,0,6,1,-15,3,1
2,2,38,0,30,4,6,0,10,7,30,6,0,0,6,0,30,1,9,0,10,0,30,3,7,0,10,8,30,6,0,0,6,1,-15,3,1
2,3,39,0,30,5,6,0,11,8,30,6,0,0,6,0,30,3,8,0,11,0,30,6,5,0,11,4,30,5,0,0,5,1,-15,3,1
2,4,39,0,30,5,6,0,11,8,30,6,0,0,6,0,30,3,8,0,11,0,30,6,5,0,11,4,30,5,0,0,5,1,-15,3,1
2,2,13,2,30,7,0,0,7,0,30,4,0,0,4,2,30,5,2,0,7,10,30,7,0,0,7,4,30,4,0,0,4,1,-15,3,1
2,3,17,3,30,11,3,0,14,2,30,6,0,0,6,0,30,7,7,0,14,1,30,5,9,0,14,1,30,4,0,0,4,1,-15,3,1
2,1,19,0,30,3,10,0,13,2,30,5,3,0,8,0,30,7,6,0,13,4,30,4,9,0,13,1,30,8,1,0,9,1,-15,3,1
2,2,19,0,30,3,10,0,13,2,30,5,3,0,8,0,30,7,6,0,13,4,30,4,9,0,13,1,30,8,1,0,9,1,-15,3,1
2,1,23,1,30,5,8,0,13,2,30,6,0,0,6,6,30,12,1,0,13,0,30,8,5,0,13,4,30,5,1,0,6,1,-15,3,1
2,3,23,0,30,5,8,0,13,2,30,6,0,0,6,6,30,12,1,0,13,0,30,8,5,0,13,4,30,5,1,0,6,1,-15,3,1
2,4,23,0,30,5,8,0,13,2,30,6,0,0,6,6,30,12,1,0,13,0,30,8,5,0,13,4,30,5,1,0,6,1,-15,3,1
2,3,25,2,30,4,10,0,14,4,30,6,0,0,6,0,30,6,8,0,14,1,30,8,6,0,14,3,30,6,0,0,6,1,-15,3,1
2,4,25,2,30,4,10,0,14,4,30,6,0,0,6,0,30,6,8,0,14,1,30,8,6,0,14,3,30,6,0,0,6,1,-15,3,1
2,2,26,1,30,9,0,0,9,4,30,4,0,0,4,4,30,1,8,0,9,0,30,2,7,0,9,7,30,3,0,0,3,1,-15,3,1
2,4,27,1,30,3,12,0,15,4,30,2,0,0,2,0,30,2,13,0,15,2,30,3,12,0,15,2,30,6,0,0,6,1,-15,3,1
2,2,31,3,30,8,4,0,12,4,30,8,0,0,8,3,30,9,3,0,12,0,30,3,9,0,12,0,30,4,2,0,6,1,-15,3,1
2,4,31,3,30,8,4,0,12,4,30,8,0,0,8,3,30,9,3,0,12,0,30,3,9,0,12,0,30,4,2,0,6,1,-15,3,1
2,4,32,0,30,5,4,0,9,4,30,2,0,0,2,1,30,7,2,0,9,1,30,3,6,0,9,3,30,2,0,0,2,1,-15,3,1
2,4,39,0,30,2,9,0,11,6,30,6,0,0,6,0,30,8,3,0,11,0,30,4,7,0,11,6,30,5,0,0,5,1,-15,3,1
2,4,17,2,30,6,8,0,14,1,30,6,0,0,6,0,30,10,4,0,14,7,30,5,9,0,14,1,30,4,0,0,4,1,-15,3,1
2,0,21,3,30,8,2,0,10,3,30,5,1,0,6,1,30,4,6,0,10,4,30,5,5,0,10,5,30,4,0,0,4,1,-15,3,1
2,1,21,3,30,8,2,0,10,3,30,5,1,0,6,1,30,4,6,0,10,4,30,5,5,0,10,5,30,4,0,0,4,1,-15,3,1
2,4,23,1,30,8,5,0,13,1,30,6,0,0,6,5,30,10,3,0,13,0,30,4,9,0,13,1,30,5,1,0,6,1,-15,3,1
2,4,25,1,30,6,8,0,14,2,30,6,0,0,6,0,30,14,0,0,14,1,30,5,9,0,14,3,30,5,1,0,6,1,-15,3,1
2,3,27,2,30,5,10,0,15,1,30,2,0,0,2,0,30,6,9,0,15,4,30,6,9,0,15,6,30,6,0,0,6,1,-15,3,1
2,4,27,2,30,5,10,0,15,1,30,2,0,0,2,0,30,6,9,0,15,4,30,6,9,0,15,6,30,6,0,0,6,1,-15,3,1
2,4,31,3,30,7,5,0,12,4,30,8,0,0,8,3,30,10,2,0,12,2,30,7,5,0,12,0,30,4,2,0,6,1,-15,3,1
2,4,33,1,30,6,5,0,11,4,30,4,0,0,4,0,30,10,1,0,11,0,30,3,8,0,11,5,30,4,0,0,4,1,-15,3,1
2,1,5,0,30,0,5,0,5,2,30,2,2,0,4,0,30,0,5,0,5,0,30,1,4,0,5,0,30,0,2,0,2,0,-27,3,0
2,3,6,0,30,7,2,0,9,3,30,2,0,0,2,0,30,4,5,0,9,0,30,3,6,0,9,2,30,5,0,0,5,0,-27,3,0
2,4,6,0,30,7,2,0,9,3,30,2,0,0,2,0,30,4,5,0,9,0,30,3,6,0,9,2,30,5,0,0,5,0,-27,3,0
2,4,8,2,30,7,0,0,7,2,30,2,0,0,2,1,30,3,4,0,7,0,30,5,2,0,7,6,30,3,0,0,3,0,-27,3,0
2,1,13,5,30,7,0,0,7,0,30,4,0,0,4,2,30,6,1,0,7,7,30,7,0,0,7,2,30,4,0,0,4,1,-15,3,1
2,2,13,5,30,7,0,0,7,0,30,4,0,0,4,2,30,6,1,0,7,7,30,7,0,0,7,2,30,4,0,0,4,1,-15,3,1
2,3,17,3,30,9,5,0,14,2,30,6,0,0,6,0,30,7,7,0,14,0,30,5,9,0,14,3,30,2,2,0,4,1,-15,3,1
2,3,19,0,30,4,9,0,13,2,30,3,5,0,8,0,30,7,6,0,13,3,30,5,8,0,13,0,30,9,0,0,9,1,-15,3,1
2,4,19,0,30,4,9,0,13,2,30,3,5,0,8,0,30,7,6,0,13,3,30,5,8,0,13,0,30,9,0,0,9,1,-15,3,1
2,4,27,1,30,3,12,0,15,5,30,1,1,0,2,0,30,6,9,0,15,0,30,3,12,0,15,4,30,6,0,0,6,1,-15,3,1
2,2,35,0,30,11,2,0,13,4,30,2,0,0,2,1,30,6,7,0,13,2,30,1,12,0,13,7,30,8,0,0,8,1,-15,3,1
2,3,35,0,30,11,2,0,13,4,30,2,0,0,2,1,30,6,7,0,13,2,30,1,12,0,13,7,30,8,0,0,8,1,-15,3,1
2,0,41,0,30,7,5,0,12,7,30,8,0,0,8,0,30,3,9,0,12,0,30,5,7,0,12,6,30,7,0,0,7,1,-15,3,1
2,2,41,0,30,7,5,0,12,7,30,8,0,0,8,0,30,3,9,0,12,0,30,5,7,0,12,6,30,7,0,0,7,1,-15,3,1
2,3,1,0,30,7,3,0,10,3,30,2,0,0,2,1,30,7,3,0,10,1,30,9,1,0,10,6,30,6,0,0,6,0,-27,3,0
2,4,1,0,30,7,3,0,10,3,30,2,0,0,2,1,30,7,3,0,10,1,30,9,1,0,10,6,30,6,0,0,6,0,-27,3,0
2,0,4,2,30,6,2,0,8,5,30,4,0,0,4,0,30,1,7,0,8,0,30,7,1,0,8,4,30,4,0,0,4,0,-27,3,0
2,2,13,1,30,3,0,0,3,0,30,2,0,0,2,1,30,3,0,0,3,7,30,2,1,0,3,3,30,2,0,0,2,1,-15,3,1
2,4,13,2,30,6,1,0,7,0,30,4,0,0,4,2,30,7,0,0,7,9,30,6,1,0,7,5,30,4,0,0,4,1,-15,3,1
2,1,27,1,30,3,12,0,15,4,30,1,1,0,2,0,30,5,10,0,15,3,30,3,12,0,15,5,30,6,0,0,6,1,-15,3,1
2,2,27,1,30,3,12,0,15,4,30,1,1,0,2,0,30,5,10,0,15,3,30,3,12,0,15,5,30,6,0,0,6,1,-15,3,1
2,4,27,1,30,3,12,0,15,4,30,1,1,0,2,0,30,5,10,0,15,3,30,3,12,0,15,5,30,6,0,0,6,1,-15,3,1
2,4,1,0,30,4,6,0,10,3,30,2,0,0,2,1,30,4,6,0,10,4,30,6,4,0,10,6,30,6,0,0,6,0,-27,3,0
2,2,6,0,30,8,1,0,9,4,30,2,0,0,2,0,30,3,6,0,9,0,30,3,6,0,9,5,30,5,0,0,5,0,-27,3,0
2,3,6,0,30,8,1,0,9,4,30,2,0,0,2,0,30,3,6,0,9,0,30,3,6,0,9,5,30,5,0,0,5,0,-27,3,0
2,1,17,3,30,7,7,0,14,3,30,6,0,0,6,0,30,6,8,0,14,5,30,9,5,0,14,6,30,4,0,0,4,1,-15,3,1
2,2,17,3,30,7,7,0,14,3,30,6,0,0,6,0,30,6,8,0,14,5,30,9,5,0,14,6,30,4,0,0,4,1,-15,3,1
2,4,17,3,30,7,7,0,14,3,30,6,0,0,6,0,30,6,8,0,14,5,30,9,5,0,14,6,30,4,0,0,4,1,-15,3,1
2,1,25,2,30,4,10,0,14,2,30,6,0,0,6,0,30,12,2,0,14,4,30,6,8,0,14,3,30,5,1,0,6,1,-15,3,1
2,2,25,2,30,4,10,0,14,2,30,6,0,0,6,0,30,12,2,0,14,4,30,6,8,0,14,3,30,5,1,0,6,1,-15,3,1
2,2,31,0,30,4,8,0,12,7,30,8,0,0,8,3,30,6,6,0,12,2,30,9,3,0,12,5,30,6,0,0,6,1,-15,3,1
2,3,31,0,30,4,8,0,12,7,30,8,0,0,8,3,30,6,6,0,12,2,30,9,3,0,12,5,30,6,0,0,6,1,-15,3,1
2,4,31,0,30,4,8,0,12,7,30,8,0,0,8,3,30,6,6,0,12,2,30,9,3,0,12,5,30,6,0,0,6,1,-15,3,1
2,2,35,1,30,7,6,0,13,5,30,2,0,0,2,0,30,4,9,0,13,3,30,2,11,0,13,7,30,8,0,0,8,1,-15,3,1
2,3,35,1,30,7,6,0,13,5,30,2,0,0,2,0,30,4,9,0,13,3,30,2,11,0,13,7,30,8,0,0,8,1,-15,3,1
2,0,5,0,30,2,3,0,5,3,30,4,0,0,4,3,30,0,5,0,5,0,30,1,4,0,5,0,30,2,0,0,2,0,-27,3,0
2,4,5,0,30,2,3,0,5,3,30,4,0,0,4,3,30,0,5,0,5,0,30,1,4,0,5,0,30,2,0,0,2,0,-27,3,0
2,2,6,0,30,6,3,0,9,4,30,2,0,0,2,0,30,2,7,0,9,0,30,4,5,0,9,0,30,3,2,0,5,0,-27,3,0
2,4,17,2,30,10,4,0,14,4,30,6,0,0,6,0,30,4,10,0,14,4,30,6,8,0,14,3,30,4,0,0,4,1,-15,3,1
2,0,27,1,30,5,10,0,15,2,30,2,0,0,2,0,30,9,6,0,15,1,30,7,8,0,15,2,30,6,0,0,6,1,-15,3,1
2,3,31,4,30,7,5,0,12,4,30,8,0,0,8,3,30,12,0,0,12,0,30,3,9,0,12,0,30,5,1,0,6,1,-15,3,1
2,4,31,4,30,7,5,0,12,4,30,8,0,0,8,3,30,12,0,0,12,0,30,3,9,0,12,0,30,5,1,0,6,1,-15,3,1
2,2,6,2,30,9,0,0,9,4,30,2,0,0,2,0,30,3,6,0,9,0,30,3,6,0,9,0,30,2,3,0,5,0,-27,3,0
2,4,6,2,30,9,0,0,9,4,30,2,0,0,2,0,30,3,6,0,9,0,30,3,6,0,9,0,30,2,3,0,5,0,-27,3,0
2,2,13,1,30,7,0,0,7,1,30,4,0,0,4,2,30,7,0,0,7,9,30,6,1,0,7,3,30,4,0,0,4,1,-15,3,1
2,2,17,3,30,9,5,0,14,3,30,6,0,0,6,5,30,8,6,0,14,1,30,5,9,0,14,1,30,2,2,0,4,1,-15,3,1
2,3,17,3,30,9,5,0,14,3,30,6,0,0,6,5,30,8,6,0,14,1,30,5,9,0,14,1,30,2,2,0,4,1,-15,3,1
2,4,17,3,30,9,5,0,14,3,30,6,0,0,6,5,30,8,6,0,14,1,30,5,9,0,14,1,30,2,2,0,4,1,-15,3,1
2,4,23,1,30,6,7,0,13,2,30,6,0,0,6,6,30,10,3,0,13,0,30,4,9,0,13,4,30,6,0,0,6,1,-15,3,1
2,1,27,1,30,4,11,0,15,1,30,2,0,0,2,0,30,9,6,0,15,2,30,4,11,0,15,4,30,6,0,0,6,1,-15,3,1
2,4,35,0,30,5,8,0,13,4,30,2,0,0,2,1,30,6,7,0,13,2,30,3,10,0,13,5,30,8,0,0,8,1,-15,3,1
2,0,6,1,30,7,2,0,9,4,30,2,0,0,2,0,30,4,5,0,9,1,30,5,4,0,9,0,30,5,0,0,5,0,-27,3,0
2,3,6,1,30,7,2,0,9,4,30,2,0,0,2,0,30,4,5,0,9,1,30,5,4,0,9,0,30,5,0,0,5,0,-27,3,0
2,4,8,1,30,7,0,0,7,4,30,2,0,0,2,0,30,1,6,0,7,1,30,7,0,0,7,5,30,3,0,0,3,0,-27,3,0
2,3,13,1,30,7,0,0,7,0,30,4,0,0,4,1,30,7,0,0,7,4,30,5,2,0,7,1,30,4,0,0,4,1,-15,3,1
2,4,13,1,30,7,0,0,7,0,30,4,0,0,4,1,30,7,0,0,7,4,30,5,2,0,7,1,30,4,0,0,4,1,-15,3,1
2,0,17,2,30,9,5,0,14,3,30,6,0,0,6,0,30,3,11,0,14,2,30,7,7,0,14,9,30,4,0,0,4,1,-15,3,1
2,0,27,1,30,3,12,0,15,1,30,2,0,0,2,0,30,7,8,0,15,1,30,4,11,0,15,2,30,6,0,0,6,1,-15,3,1
2,4,27,1,30,3,12,0,15,1,30,2,0,0,2,0,30,7,8,0,15,1,30,4,11,0,15,1,30,6,0,0,6,1,-15,3,1
2,3,37,0,30,7,4,0,11,7,30,8,0,0,8,3,30,7,4,0,11,2,30,7,4,0,11,5,30,6,0,0,6,1,-15,3,1
2,4,37,0,30,7,4,0,11,7,30,8,0,0,8,3,30,7,4,0,11,2,30,7,4,0,11,5,30,6,0,0,6,1,-15,3,1
2,4,38,0,30,3,7,0,10,6,30,6,0,0,6,0,30,4,6,0,10,0,30,4,6,0,10,4,30,6,0,0,6,1,-15,3,1
2,2,41,0,30,7,5,0,12,4,30,7,1,0,8,0,30,12,0,0,12,2,30,3,9,0,12,1,30,6,1,0,7,1,-15,3,1
2,2,47,0,30,1,13,0,14,8,30,4,0,0,4,0,30,3,11,0,14,0,30,9,5,0,14,7,30,7,0,0,7,1,-15,3,1
2,3,47,0,30,1,13,0,14,8,30,4,0,0,4,0,30,3,11,0,14,0,30,9,5,0,14,7,30,7,0,0,7,1,-15,3,1
2,2,4,2,30,6,2,0,8,5,30,4,0,0,4,0,30,2,6,0,8,0,30,8,0,0,8,3,30,4,0,0,4,0,-27,3,0
2,3,4,2,30,6,2,0,8,5,30,4,0,0,4,0,30,2,6,0,8,0,30,8,0,0,8,3,30,4,0,0,4,0,-27,3,0
2,3,5,0,30,2,3,0,5,2,30,3,1,0,4,0,30,1,4,0,5,0,30,1,4,0,5,0,30,1,1,0,2,0,-27,3,0
2,3,8,1,30,7,0,0,7,4,30,2,0,0,2,4,30,3,4,0,7,0,30,6,1,0,7,5,30,3,0,0,3,0,-27,3,0
2,1,17,2,30,8,6,0,14,3,30,6,0,0,6,0,30,5,9,0,14,1,30,7,7,0,14,1,30,4,0,0,4,1,-15,3,1
2,4,17,2,30,8,6,0,14,3,30,6,0,0,6,0,30,5,9,0,14,1,30,7,7,0,14,1,30,4,0,0,4,1,-15,3,1
2,3,19,1,30,4,9,0,13,1,30,7,1,0,8,0,30,7,6,0,13,0,30,5,8,0,13,0,30,7,2,0,9,1,-15,3,1
2,0,25,0,30,5,9,0,14,4,30,6,0,0,6,0,30,6,8,0,14,1,30,6,8,0,14,4,30,6,0,0,6,1,-15,3,1
2,2,25,0,30,5,9,0,14,2,30,6,0,0,6,0,30,6,8,0,14,1,30,6,8,0,14,4,30,6,0,0,6,1,-15,3,1
2,3,25,0,30,5,9,0,14,2,30,6,0,0,6,0,30,6,8,0,14,1,30,6,8,0,14,4,30,6,0,0,6,1,-15,3,1
2,3,31,3,30,7,5,0,12,6,30,8,0,0,8,0,30,6,6,0,12,0,30,3,9,0,12,6,30,6,0,0,6,1,-15,3,1
2,4,31,3,30,7,5,0,12,6,30,8,0,0,8,0,30,6,6,0,12,0,30,3,9,0,12,6,30,6,0,0,6,1,-15,3,1
2,3,35,0,30,8,5,0,13,2,30,2,0,0,2,1,30,7,6,0,13,6,30,1,12,0,13,4,30,8,0,0,8,1,-15,3,1
2,1,4,4,30,8,0,0,8,4,30,4,0,0,4,1,30,5,3,0,8,0,30,4,4,0,8,2,30,4,0,0,4,0,-27,3,0
2,4,5,0,30,2,3,0,5,1,30,1,3,0,4,0,30,1,4,0,5,0,30,1,4,0,5,0,30,0,2,0,2,0,-27,3,0
2,2,6,1,30,9,0,0,9,3,30,2,0,0,2,0,30,2,7,0,9,0,30,3,6,0,9,3,30,3,2,0,5,0,-27,3,0
2,4,8,0,30,7,0,0,7,4,30,2,0,0,2,0,30,3,4,0,7,1,30,6,1,0,7,3,30,3,0,0,3,0,-27,3,0
2,2,11,0,30,4,8,0,12,2,30,4,0,0,4,0,30,5,7,0,12,7,30,6,6,0,12,3,30,4,0,0,4,1,-15,3,1
2,1,17,3,30,9,5,0,14,3,30,6,0,0,6,0,30,7,7,0,14,3,30,8,6,0,14,2,30,4,0,0,4,1,-15,3,1
2,2,17,3,30,9,5,0,14,3,30,6,0,0,6,0,30,7,7,0,14,3,30,8,6,0,14,2,30,4,0,0,4,1,-15,3,1
2,0,21,1,30,5,5,0,10,4,30,6,0,0,6,1,30,3,7,0,10,5,30,5,5,0,10,3,30,4,0,0,4,1,-15,3,1
2,3,21,1,30,5,5,0,10,4,30,6,0,0,6,1,30,3,7,0,10,5,30,5,5,0,10,3,30,4,0,0,4,1,-15,3,1
2,0,25,1,30,6,8,0,14,5,30,6,0,0,6,0,30,7,7,0,14,1,30,9,5,0,14,5,30,6,0,0,6,1,-15,3,1
2,2,25,1,30,6,8,0,14,5,30,6,0,0,6,0,30,7,7,0,14,1,30,9,5,0,14,5,30,6,0,0,6,1,-15,3,1
2,4,25,1,30,6,8,0,14,5,30,6,0,0,6,0,30,7,7,0,14,1,30,9,5,0,14,5,30,6,0,0,6,1,-15,3,1
2,0,27,1,30,6,9,0,15,4,30,2,0,0,2,0,30,3,12,0,15,2,30,6,9,0,15,4,30,6,0,0,6,1,-15,3,1
2,1,27,1,30,6,9,0,15,4,30,2,0,0,2,0,30,3,12,0,15,2,30,6,9,0,15,4,30,6,0,0,6,1,-15,3,1
2,3,29,0,30,6,8,0,14,6,30,12,0,0,12,0,30,3,11,0,14,0,30,1,13,0,14,0,30,9,0,0,9,1,-15,3,1
2,2,32,0,30,3,6,0,9,4,30,2,0,0,2,2,30,9,0,0,9,5,30,4,5,0,9,3,30,2,0,0,2,1,-15,3,1
2,4,35,1,30,10,3,0,13,6,30,2,0,0,2,1,30,2,11,0,13,0,30,1,12,0,13,5,30,8,0,0,8,1,-15,3,1
2,4,37,1,30,5,6,0,11,5,30,7,1,0,8,2,30,10,1,0,11,4,30,3,8,0,11,6,30,6,0,0,6,1,-15,3,1
2,4,5,0,30,2,3,0,5,3,30,1,3,0,4,1,30,2,3,0,5,0,30,1,4,0,5,0,30,0,2,0,2,0,-27,3,0
2,3,19,0,30,3,10,0,13,2,30,5,3,0,8,0,30,7,6,0,13,1,30,4,9,0,13,0,30,8,1,0,9,1,-15,3,1
2,0,21,2,30,6,4,0,10,4,30,5,1,0,6,1,30,3,7,0,10,3,30,4,6,0,10,5,30,4,0,0,4,1,-15,3,1
2,4,25,0,30,5,9,0,14,3,30,6,0,0,6,0,30,8,6,0,14,2,30,9,5,0,14,3,30,6,0,0,6,1,-15,3,1
2,4,29,0,30,5,9,0,14,6,30,8,4,0,12,0,30,4,10,0,14,0,30,6,8,0,14,1,30,9,0,0,9,1,-15,3,1
2,4,8,2,30,7,0,0,7,4,30,2,0,0,2,0,30,3,4,0,7,0,30,7,0,0,7,0,30,3,0,0,3,0,-27,3,0
2,3,13,1,30,6,1,0,7,1,30,4,0,0,4,2,30,6,1,0,7,3,30,6,1,0,7,0,30,4,0,0,4,1,-15,3,1
2,4,13,1,30,6,1,0,7,1,30,4,0,0,4,2,30,6,1,0,7,3,30,6,1,0,7,0,30,4,0,0,4,1,-15,3,1
2,4,17,4,30,10,4,0,14,3,30,6,0,0,6,0,30,6,8,0,14,1,30,5,9,0,14,0,30,4,0,0,4,1,-15,3,1
2,2,23,3,30,9,4,0,13,3,30,6,0,0,6,3,30,10,3,0,13,0,30,3,10,0,13,2,30,6,0,0,6,1,-15,3,1
2,3,23,3,30,9,4,0,13,3,30,6,0,0,6,3,30,10,3,0,13,0,30,3,10,0,13,2,30,6,0,0,6,1,-15,3,1
2,0,27,1,30,5,10,0,15,4,30,2,0,0,2,4,30,8,7,0,15,0,30,7,8,0,15,0,30,2,4,0,6,1,-15,3,1
2,3,27,1,30,5,10,0,15,4,30,2,0,0,2,4,30,8,7,0,15,0,30,7,8,0,15,0,30,2,4,0,6,1,-15,3,1
2,4,27,1,30,5,10,0,15,4,30,2,0,0,2,4,30,8,7,0,15,0,30,7,8,0,15,0,30,2,4,0,6,1,-15,3,1
2,2,29,1,30,6,8,0,14,6,30,8,4,0,12,0,30,8,6,0,14,0,30,1,13,0,14,0,30,9,0,0,9,1,-15,3,1
2,3,29,1,30,6,8,0,14,6,30,8,4,0,12,0,30,8,6,0,14,0,30,1,13,0,14,0,30,9,0,0,9,1,-15,3,1
2,4,29,1,30,6,8,0,14,6,30,8,4,0,12,0,30,8,6,0,14,0,30,1,13,0,14,0,30,9,0,0,9,1,-15,3,1
2,4,32,0,30,4,5,0,9,5,30,2,0,0,2,1,30,7,2,0,9,1,30,7,2,0,9,4,30,2,0,0,2,1,-15,3,1
2,3,1,1,30,7,3,0,10,5,30,2,0,0,2,1,30,3,7,0,10,3,30,7,3,0,10,5,30,6,0,0,6,0,-27,3,0
2,4,11,0,30,2,2,0,4,0,30,0,0,0,0,0,30,2,2,0,4,3,30,3,1,0,4,1,30,1,0,0,1,1,-15,3,1
2,1,12,0,30,3,4,0,7,1,30,2,4,0,6,1,30,2,5,0,7,8,30,5,2,0,7,5,30,3,0,0,3,1,-15,3,1
2,2,12,0,30,3,4,0,7,1,30,2,4,0,6,1,30,2,5,0,7,8,30,5,2,0,7,5,30,3,0,0,3,1,-15,3,1
2,3,17,1,30,9,5,0,14,1,30,6,0,0,6,0,30,9,5,0,14,4,30,6,8,0,14,6,30,4,0,0,4,1,-15,3,1
2,4,17,1,30,9,5,0,14,1,30,6,0,0,6,0,30,9,5,0,14,4,30,6,8,0,14,6,30,4,0,0,4,1,-15,3,1
2,4,19,0,30,3,10,0,13,1,30,5,3,0,8,0,30,8,5,0,13,5,30,5,8,0,13,1,30,8,1,0,9,1,-15,3,1
2,1,26,0,30,4,5,0,9,5,30,4,0,0,4,6,30,3,6,0,9,0,30,2,7,0,9,5,30,3,0,0,3,1,-15,3,1
2,4,31,1,30,3,9,0,12,7,30,8,0,0,8,3,30,4,8,0,12,1,30,10,2,0,12,4,30,6,0,0,6,1,-15,3,1
2,1,13,5,30,7,0,0,7,2,30,4,0,0,4,6,30,6,1,0,7,7,30,7,0,0,7,3,30,4,0,0,4,1,-15,3,1
2,2,13,5,30,7,0,0,7,2,30,4,0,0,4,6,30,6,1,0,7,7,30,7,0,0,7,3,30,4,0,0,4,1,-15,3,1
2,4,17,3,30,8,6,0,14,0,30,6,0,0,6,0,30,7,7,0,14,3,30,5,9,0,14,3,30,4,0,0,4,1,-15,3,1
2,0,19,0,30,3,10,0,13,2,30,4,4,0,8,0,30,6,7,0,13,4,30,6,7,0,13,0,30,8,1,0,9,1,-15,3,1
2,3,19,0,30,3,10,0,13,2,30,4,4,0,8,0,30,6,7,0,13,4,30,6,7,0,13,0,30,8,1,0,9,1,-15,3,1
2,2,25,1,30,4,10,0,14,4,30,6,0,0,6,0,30,9,5,0,14,2,30,7,7,0,14,3,30,5,1,0,6,1,-15,3,1
2,4,25,1,30,4,10,0,14,4,30,6,0,0,6,0,30,9,5,0,14,2,30,7,7,0,14,3,30,5,1,0,6,1,-15,3,1
2,1,26,0,30,7,2,0,9,5,30,4,0,0,4,4,30,2,7,0,9,0,30,3,6,0,9,6,30,3,0,0,3,1,-15,3,1
2,2,26,0,30,7,2,0,9,5,30,4,0,0,4,4,30,2,7,0,9,0,30,3,6,0,9,6,30,3,0,0,3,1,-15,3,1
2,3,26,0,30,7,2,0,9,5,30,4,0,0,4,4,30,2,7,0,9,0,30,3,6,0,9,6,30,3,0,0,3,1,-15,3,1
2,4,26,0,30,7,2,0,9,5,30,4,0,0,4,4,30,2,7,0,9,0,30,3,6,0,9,6,30,3,0,0,3,1,-15,3,1
2,1,27,1,30,5,10,0,15,3,30,1,1,0,2,0,30,5,10,0,15,4,30,5,10,0,15,5,30,6,0,0,6,1,-15,3,1
2,3,27,1,30,5,10,0,15,3,30,1,1,0,2,0,30,5,10,0,15,4,30,5,10,0,15,5,30,6,0,0,6,1,-15,3,1
2,2,31,1,30,7,5,0,12,7,30,8,0,0,8,3,30,4,8,0,12,0,30,4,8,0,12,5,30,6,0,0,6,1,-15,3,1
2,3,31,1,30,7,5,0,12,7,30,8,0,0,8,3,30,4,8,0,12,0,30,4,8,0,12,5,30,6,0,0,6,1,-15,3,1
2,0,6,1,30,7,2,0,9,4,30,2,0,0,2,0,30,2,7,0,9,0,30,4,5,0,9,1,30,3,2,0,5,0,-27,3,0
2,3,6,1,30,7,2,0,9,4,30,2,0,0,2,0,30,2,7,0,9,0,30,4,5,0,9,1,30,3,2,0,5,0,-27,3,0
2,4,6,1,30,7,2,0,9,4,30,2,0,0,2,0,30,2,7,0,9,0,30,4,5,0,9,1,30,3,2,0,5,0,-27,3,0
2,4,7,2,30,4,5,0,9,3,30,4,0,0,4,0,30,5,4,0,9,4,30,3,6,0,9,1,30,5,1,0,6,0,-27,3,0
2,2,13,1,30,3,4,0,7,0,30,4,0,0,4,1,30,7,0,0,7,11,30,6,1,0,7,5,30,4,0,0,4,1,-15,3,1
2,4,13,1,30,3,4,0,7,0,30,4,0,0,4,1,30,7,0,0,7,11,30,6,1,0,7,5,30,4,0,0,4,1,-15,3,1
2,1,17,5,30,11,3,0,14,3,30,6,0,0,6,0,30,5,9,0,14,1,30,5,9,0,14,1,30,4,0,0,4,1,-15,3,1
2,2,17,5,30,11,3,0,14,3,30,6,0,0,6,0,30,5,9,0,14,1,30,5,9,0,14,1,30,4,0,0,4,1,-15,3,1
2,2,19,0,30,3,10,0,13,2,30,6,2,0,8,0,30,7,6,0,13,7,30,3,10,0,13,2,30,8,1,0,9,1,-15,3,1
2,2,25,1,30,7,7,0,14,3,30,6,0,0,6,0,30,8,6,0,14,2,30,6,8,0,14,3,30,5,1,0,6,1,-15,3,1
2,2,37,1,30,5,6,0,11,6,30,8,0,0,8,0,30,7,4,0,11,5,30,6,5,0,11,6,30,6,0,0,6,1,-15,3,1
2,3,37,1,30,5,6,0,11,6,30,8,0,0,8,0,30,7,4,0,11,5,30,6,5,0,11,6,30,6,0,0,6,1,-15,3,1
2,4,37,1,30,5,6,0,11,6,30,8,0,0,8,0,30,7,4,0,11,5,30,6,5,0,11,6,30,6,0,0,6,1,-15,3,1
2,3,39,3,30,2,9,0,11,7,30,6,0,0,6,0,30,4,7,0,11,2,30,3,8,0,11,1,30,4,1,0,5,1,-15,3,1
2,1,5,0,30,2,3,0,5,3,30,2,2,0,4,0,30,2,3,0,5,0,30,3,2,0,5,0,30,0,2,0,2,0,-27,3,0
2,3,6,1,30,8,1,0,9,4,30,2,0,0,2,0,30,2,7,0,9,0,30,4,5,0,9,1,30,3,2,0,5,0,-27,3,0
2,4,11,0,30,3,9,0,12,1,30,4,0,0,4,2,30,6,6,0,12,1,30,7,5,0,12,4,30,4,0,0,4,1,-15,3,1
2,1,13,4,30,7,0,0,7,0,30,4,0,0,4,2,30,6,1,0,7,5,30,7,0,0,7,4,30,4,0,0,4,1,-15,3,1
2,2,13,4,30,7,0,0,7,0,30,4,0,0,4,2,30,6,1,0,7,5,30,7,0,0,7,4,30,4,0,0,4,1,-15,3,1
2,4,13,4,30,7,0,0,7,0,30,4,0,0,4,2,30,6,1,0,7,5,30,7,0,0,7,4,30,4,0,0,4,1,-15,3,1
2,4,15,0,30,4,9,0,13,0,30,6,0,0,6,0,30,3,10,0,13,1,30,4,9,0,13,2,30,6,3,0,9,1,-15,3,1
2,4,17,4,30,8,6,0,14,0,30,6,0,0,6,4,30,10,4,0,14,2,30,5,9,0,14,2,30,4,0,0,4,1,-15,3,1
2,0,27,1,30,6,9,0,15,5,30,1,1,0,2,0,30,3,12,0,15,0,30,6,9,0,15,4,30,6,0,0,6,1,-15,3,1
2,1,27,1,30,6,9,0,15,5,30,1,1,0,2,0,30,3,12,0,15,0,30,6,9,0,15,4,30,6,0,0,6,1,-15,3,1
2,4,31,5,30,3,9,0,12,5,30,8,0,0,8,3,30,10,2,0,12,0,30,3,9,0,12,2,30,2,4,0,6,1,-15,3,1
2,2,38,0,30,1,9,0,10,7,30,6,0,0,6,0,30,1,9,0,10,2,30,4,6,0,10,5,30,6,0,0,6,1,-15,3,1
2,3,2,3,30,9,1,0,10,3,30,1,3,0,4,1,30,4,6,0,10,0,30,4,6,0,10,1,30,8,0,0,8,0,-27,3,0
2,4,5,0,30,3,2,0,5,3,30,3,1,0,4,0,30,0,5,0,5,0,30,1,4,0,5,1,30,1,1,0,2,0,-27,3,0
2,3,7,0,30,4,5,0,9,2,30,4,0,0,4,0,30,8,1,0,9,5,30,5,4,0,9,1,30,5,1,0,6,0,-27,3,0
2,2,19,0,30,6,7,0,13,2,30,4,4,0,8,0,30,4,9,0,13,0,30,3,10,0,13,1,30,9,0,0,9,1,-15,3,1
2,4,19,0,30,6,7,0,13,2,30,4,4,0,8,0,30,4,9,0,13,0,30,3,10,0,13,1,30,9,0,0,9,1,-15,3,1
2,4,25,2,30,5,9,0,14,4,30,6,0,0,6,0,30,5,9,0,14,1,30,10,4,0,14,5,30,6,0,0,6,1,-15,3,1
2,0,27,1,30,5,10,0,15,5,30,2,0,0,2,0,30,3,12,0,15,5,30,5,10,0,15,3,30,6,0,0,6,1,-15,3,1
2,1,27,1,30,5,10,0,15,5,30,2,0,0,2,0,30,3,12,0,15,5,30,5,10,0,15,3,30,6,0,0,6,1,-15,3,1
2,2,27,1,30,5,10,0,15,5,30,2,0,0,2,0,30,3,12,0,15,5,30,5,10,0,15,3,30,6,0,0,6,1,-15,3,1
2,3,27,1,30,5,10,0,15,5,30,2,0,0,2,0,30,3,12,0,15,5,30,5,10,0,15,3,30,6,0,0,6,1,-15,3,1
2,0,5,0,30,0,5,0,5,3,30,2,2,0,4,0,30,0,5,0,5,2,30,5,0,0,5,0,30,0,2,0,2,0,-27,3,0
2,1,5,0,30,0,5,0,5,3,30,2,2,0,4,0,30,0,5,0,5,2,30,5,0,0,5,0,30,0,2,0,2,0,-27,3,0
2,2,5,0,30,0,5,0,5,3,30,2,2,0,4,0,30,0,5,0,5,2,30,5,0,0,5,0,30,0,2,0,2,0,-27,3,0
2,4,7,0,30,5,4,0,9,3,30,4,0,0,4,0,30,5,4,0,9,4,30,3,6,0,9,3,30,6,0,0,6,0,-27,3,0
2,2,13,1,30,7,0,0,7,0,30,4,0,0,4,1,30,7,0,0,7,12,30,6,1,0,7,1,30,4,0,0,4,1,-15,3,1
2,4,13,1,30,7,0,0,7,0,30,4,0,0,4,1,30,7,0,0,7,12,30,6,1,0,7,1,30,4,0,0,4,1,-15,3,1
2,4,17,3,30,10,4,0,14,2,30,6,0,0,6,0,30,6,8,0,14,1,30,4,10,0,14,3,30,4,0,0,4,1,-15,3,1
2,2,19,0,30,3,10,0,13,2,30,5,3,0,8,0,30,6,7,0,13,2,30,4,9,0,13,0,30,8,1,0,9,1,-15,3,1
2,3,19,0,30,3,10,0,13,2,30,5,3,0,8,0,30,6,7,0,13,2,30,4,9,0,13,0,30,8,1,0,9,1,-15,3,1
2,4,19,0,30,3,10,0,13,2,30,5,3,0,8,0,30,6,7,0,13,2,30,4,9,0,13,0,30,8,1,0,9,1,-15,3,1
2,0,21,2,30,7,3,0,10,4,30,6,0,0,6,1,30,3,7,0,10,4,30,5,5,0,10,4,30,4,0,0,4,1,-15,3,1
2,1,21,2,30,7,3,0,10,4,30,6,0,0,6,1,30,3,7,0,10,4,30,5,5,0,10,4,30,4,0,0,4,1,-15,3,1
2,4,23,2,30,5,8,0,13,2,30,6,0,0,6,7,30,11,2,0,13,0,30,5,8,0,13,2,30,6,0,0,6,1,-15,3,1
2,2,25,1,30,7,7,0,14,4,30,6,0,0,6,0,30,6,8,0,14,3,30,5,9,0,14,7,30,6,0,0,6,1,-15,3,1
2,1,27,1,30,6,9,0,15,2,30,2,0,0,2,0,30,5,10,0,15,7,30,7,8,0,15,1,30,4,2,0,6,1,-15,3,1
2,2,27,1,30,6,9,0,15,2,30,2,0,0,2,0,30,5,10,0,15,7,30,7,8,0,15,1,30,4,2,0,6,1,-15,3,1
2,4,27,1,30,6,9,0,15,2,30,2,0,0,2,0,30,5,10,0,15,7,30,7,8,0,15,1,30,4,2,0,6,1,-15,3,1
2,3,29,0,30,7,7,0,14,6,30,11,1,0,12,0,30,3,11,0,14,0,30,2,12,0,14,0,30,8,1,0,9,1,-15,3,1
2,0,31,4,30,7,5,0,12,5,30,8,0,0,8,3,30,8,4,0,12,0,30,3,9,0,12,0,30,4,2,0,6,1,-15,3,1
2,2,31,4,30,7,5,0,12,5,30,8,0,0,8,3,30,8,4,0,12,0,30,3,9,0,12,0,30,4,2,0,6,1,-15,3,1
2,4,2,0,30,7,3,0,10,3,30,3,1,0,4,5,30,7,3,0,10,1,30,10,0,0,10,1,30,2,6,0,8,0,-27,3,0
2,3,9,0,30,6,5,0,11,2,30,6,0,0,6,1,30,7,4,0,11,6,30,2,9,0,11,6,30,4,0,0,4,0,-27,3,0
2,1,13,4,30,7,0,0,7,0,30,4,0,0,4,2,30,6,1,0,7,7,30,6,1,0,7,0,30,4,0,0,4,1,-15,3,1
2,4,19,0,30,4,9,0,13,2,30,8,0,0,8,1,30,6,7,0,13,3,30,4,9,0,13,3,30,9,0,0,9,1,-15,3,1
2,3,23,3,30,7,6,0,13,1,30,6,0,0,6,4,30,11,2,0,13,0,30,5,8,0,13,2,30,6,0,0,6,1,-15,3,1
2,2,25,3,30,6,8,0,14,5,30,6,0,0,6,0,30,7,7,0,14,1,30,5,9,0,14,4,30,5,1,0,6,1,-15,3,1
2,3,25,3,30,6,8,0,14,5,30,6,0,0,6,0,30,7,7,0,14,1,30,5,9,0,14,4,30,5,1,0,6,1,-15,3,1
2,4,25,3,30,6,8,0,14,5,30,6,0,0,6,0,30,7,7,0,14,1,30,5,9,0,14,4,30,5,1,0,6,1,-15,3,1
2,1,27,1,30,4,11,0,15,2,30,2,0,0,2,0,30,6,9,0,15,0,30,8,7,0,15,1,30,5,1,0,6,1,-15,3,1
2,1,31,0,30,2,10,0,12,6,30,8,0,0,8,3,30,6,6,0,12,0,30,9,3,0,12,5,30,6,0,0,6,1,-15,3,1
2,2,31,0,30,2,10,0,12,6,30,8,0,0,8,3,30,6,6,0,12,0,30,9,3,0,12,5,30,6,0,0,6,1,-15,3,1
2,2,39,0,30,4,7,0,11,6,30,6,0,0,6,1,30,6,5,0,11,3,30,3,8,0,11,4,30,5,0,0,5,1,-15,3,1
2,3,39,0,30,4,7,0,11,6,30,6,0,0,6,1,30,6,5,0,11,3,30,3,8,0,11,4,30,5,0,0,5,1,-15,3,1
2,2,1,2,30,10,0,0,10,4,30,2,0,0,2,1,30,4,6,0,10,0,30,8,2,0,10,8,30,6,0,0,6,0,-27,3,0
2,2,5,0,30,3,2,0,5,3,30,0,4,0,4,0,30,1,4,0,5,0,30,1,4,0,5,4,30,0,2,0,2,0,-27,3,0
2,3,17,0,30,11,3,0,14,2,30,6,0,0,6,0,30,6,8,0,14,2,30,5,9,0,14,3,30,4,0,0,4,1,-15,3,1
2,2,19,0,30,6,7,0,13,0,30,7,1,0,8,0,30,5,8,0,13,1,30,3,10,0,13,3,30,6,3,0,9,1,-15,3,1
2,3,19,0,30,6,7,0,13,0,30,7,1,0,8,0,30,5,8,0,13,1,30,3,10,0,13,3,30,6,3,0,9,1,-15,3,1
2,3,23,0,30,5,8,0,13,2,30,6,0,0,6,6,30,9,4,0,13,0,30,5,8,0,13,2,30,6,0,0,6,1,-15,3,1
2,4,23,0,30,5,8,0,13,2,30,6,0,0,6,6,30,9,4,0,13,0,30,5,8,0,13,2,30,6,0,0,6,1,-15,3,1
2,2,29,0,30,5,9,0,14,3,30,11,1,0,12,0,30,7,7,0,14,0,30,1,13,0,14,0,30,9,0,0,9,1,-15,3,1
2,4,29,0,30,5,9,0,14,3,30,11,1,0,12,0,30,7,7,0,14,0,30,1,13,0,14,0,30,9,0,0,9,1,-15,3,1
2,3,32,2,30,7,2,0,9,4,30,2,0,0,2,4,30,7,2,0,9,1,30,2,7,0,9,4,30,2,0,0,2,1,-15,3,1
2,4,32,2,30,7,2,0,9,4,30,2,0,0,2,4,30,7,2,0,9,1,30,2,7,0,9,4,30,2,0,0,2,1,-15,3,1
2,0,4,2,30,7,1,0,8,5,30,4,0,0,4,0,30,1,7,0,8,0,30,7,1,0,8,2,30,4,0,0,4,0,-27,3,0
2,2,4,2,30,7,1,0,8,5,30,4,0,0,4,0,30,1,7,0,8,0,30,7,1,0,8,2,30,4,0,0,4,0,-27,3,0
2,0,5,0,30,2,3,0,5,3,30,2,2,0,4,0,30,1,4,0,5,0,30,1,4,0,5,1,30,1,1,0,2,0,-27,3,0
2,1,5,0,30,2,3,0,5,3,30,2,2,0,4,0,30,1,4,0,5,0,30,1,4,0,5,1,30,1,1,0,2,0,-27,3,0
2,4,5,0,30,2,3,0,5,3,30,2,2,0,4,0,30,1,4,0,5,0,30,1,4,0,5,1,30,1,1,0,2,0,-27,3,0
2,4,13,2,30,6,1,0,7,0,30,4,0,0,4,2,30,6,1,0,7,10,30,6,1,0,7,6,30,4,0,0,4,1,-15,3,1
2,3,19,0,30,6,7,0,13,1,30,7,1,0,8,0,30,8,5,0,13,3,30,6,7,0,13,1,30,7,2,0,9,1,-15,3,1
2,0,21,3,30,7,3,0,10,4,30,6,0,0,6,1,30,3,7,0,10,4,30,5,5,0,10,2,30,4,0,0,4,1,-15,3,1
2,2,21,3,30,7,3,0,10,4,30,6,0,0,6,1,30,3,7,0,10,4,30,5,5,0,10,2,30,4,0,0,4,1,-15,3,1
2,3,21,3,30,7,3,0,10,4,30,6,0,0,6,1,30,3,7,0,10,4,30,5,5,0,10,2,30,4,0,0,4,1,-15,3,1
2,4,47,0,30,0,14,0,14,9,30,4,0,0,4,0,30,3,11,0,14,0,30,2,12,0,14,1,30,7,0,0,7,1,-15,3,1
2,1,4,2,30,5,3,0,8,4,30,4,0,0,4,4,30,2,6,0,8,0,30,5,3,0,8,1,30,3,1,0,4,0,-27,3,0
2,3,4,2,30,5,3,0,8,4,30,4,0,0,4,4,30,2,6,0,8,0,30,5,3,0,8,0,30,3,1,0,4,0,-27,3,0
2,4,15,0,30,4,9,0,13,1,30,6,0,0,6,0,30,4,9,0,13,1,30,5,8,0,13,0,30,9,0,0,9,1,-15,3,1
2,4,17,3,30,8,6,0,14,2,30,6,0,0,6,0,30,5,9,0,14,4,30,6,8,0,14,4,30,4,0,0,4,1,-15,3,1
2,2,19,0,30,3,10,0,13,2,30,6,2,0,8,0,30,8,5,0,13,0,30,4,9,0,13,1,30,8,1,0,9,1,-15,3,1
2,4,22,1,30,8,0,0,8,3,30,2,0,0,2,0,30,4,4,0,8,1,30,5,3,0,8,2,30,2,2,0,4,1,-15,3,1
2,4,23,2,30,5,8,0,13,2,30,6,0,0,6,0,30,13,0,0,13,0,30,4,9,0,13,2,30,6,0,0,6,1,-15,3,1
2,2,25,4,30,6,8,0,14,3,30,6,0,0,6,0,30,11,3,0,14,1,30,5,9,0,14,2,30,5,1,0,6,1,-15,3,1
2,1,26,0,30,8,1,0,9,4,30,4,0,0,4,4,30,2,7,0,9,0,30,2,7,0,9,4,30,3,0,0,3,1,-15,3,1
2,2,26,0,30,8,1,0,9,4,30,4,0,0,4,4,30,2,7,0,9,0,30,2,7,0,9,4,30,3,0,0,3,1,-15,3,1
2,0,27,3,30,4,11,0,15,1,30,2,0,0,2,0,30,9,6,0,15,0,30,4,11,0,15,2,30,4,2,0,6,1,-15,3,1
2,1,27,3,30,4,11,0,15,1,30,2,0,0,2,0,30,9,6,0,15,0,30,4,11,0,15,2,30,4,2,0,6,1,-15,3,1
2,4,27,3,30,4,11,0,15,0,30,2,0,0,2,0,30,9,6,0,15,0,30,4,11,0,15,2,30,4,2,0,6,1,-15,3,1
2,2,31,3,30,3,9,0,12,8,30,8,0,0,8,3,30,4,8,0,12,1,30,10,2,0,12,3,30,6,0,0,6,1,-15,3,1
2,2,41,0,30,7,5,0,12,8,30,5,3,0,8,0,30,4,8,0,12,0,30,3,9,0,12,2,30,7,0,0,7,1,-15,3,1
2,3,4,0,30,6,2,0,8,4,30,4,0,0,4,0,30,3,5,0,8,0,30,5,3,0,8,0,30,4,0,0,4,0,-27,3,0
2,4,8,3,30,7,0,0,7,4,30,2,0,0,2,3,30,5,2,0,7,0,30,4,3,0,7,3,30,3,0,0,3,0,-27,3,0
2,3,19,0,30,5,8,0,13,2,30,6,2,0,8,0,30,4,9,0,13,2,30,5,8,0,13,0,30,8,1,0,9,1,-15,3,1
2,4,23,4,30,5,8,0,13,4,30,6,0,0,6,6,30,9,4,0,13,2,30,6,7,0,13,1,30,5,1,0,6,1,-15,3,1
2,2,27,3,30,4,11,0,15,5,30,1,1,0,2,0,30,8,7,0,15,2,30,6,9,0,15,2,30,6,0,0,6,1,-15,3,1
2,3,27,3,30,4,11,0,15,5,30,1,1,0,2,0,30,8,7,0,15,2,30,6,9,0,15,2,30,6,0,0,6,1,-15,3,1
2,4,27,3,30,4,11,0,15,5,30,1,1,0,2,0,30,8,7,0,15,2,30,6,9,0,15,2,30,6,0,0,6,1,-15,3,1
2,3,29,0,30,6,8,0,14,6,30,12,0,0,12,0,30,5,9,0,14,0,30,3,11,0,14,0,30,9,0,0,9,1,-15,3,1
2,4,2,0,30,7,3,0,10,3,30,3,1,0,4,8,30,4,6,0,10,0,30,7,3,0,10,1,30,2,6,0,8,0,-27,3,0
2,3,6,0,30,5,4,0,9,4,30,2,0,0,2,0,30,2,7,0,9,0,30,5,4,0,9,5,30,5,0,0,5,0,-27,3,0
2,4,8,3,30,7,0,0,7,5,30,2,0,0,2,3,30,3,4,0,7,2,30,7,0,0,7,0,30,3,0,0,3,0,-27,3,0
2,2,9,0,30,6,5,0,11,3,30,6,0,0,6,1,30,7,4,0,11,5,30,3,8,0,11,3,30,4,0,0,4,0,-27,3,0
2,3,9,0,30,6,5,0,11,3,30,6,0,0,6,1,30,7,4,0,11,5,30,3,8,0,11,3,30,4,0,0,4,0,-27,3,0
2,2,13,1,30,6,1,0,7,0,30,4,0,0,4,2,30,5,2,0,7,9,30,7,0,0,7,3,30,4,0,0,4,1,-15,3,1
2,4,13,1,30,6,1,0,7,0,30,4,0,0,4,2,30,5,2,0,7,9,30,7,0,0,7,3,30,4,0,0,4,1,-15,3,1
2,1,17,3,30,10,4,0,14,3,30,6,0,0,6,0,30,3,11,0,14,1,30,5,9,0,14,3,30,4,0,0,4,1,-15,3,1
2,0,19,1,30,3,10,0,13,3,30,8,0,0,8,1,30,4,9,0,13,4,30,7,6,0,13,0,30,8,1,0,9,1,-15,3,1
2,3,25,2,30,7,7,0,14,1,30,6,0,0,6,0,30,9,5,0,14,1,30,5,9,0,14,3,30,4,2,0,6,1,-15,3,1
2,4,25,2,30,7,7,0,14,1,30,6,0,0,6,0,30,9,5,0,14,1,30,5,9,0,14,3,30,4,2,0,6,1,-15,3,1
2,2,27,1,30,4,11,0,15,1,30,2,0,0,2,0,30,12,3,0,15,1,30,4,11,0,15,2,30,4,2,0,6,1,-15,3,1
2,3,27,1,30,4,11,0,15,1,30,2,0,0,2,0,30,12,3,0,15,1,30,4,11,0,15,2,30,4,2,0,6,1,-15,3,1
2,2,39,0,30,6,5,0,11,7,30,6,0,0,6,0,30,4,7,0,11,0,30,2,9,0,11,5,30,5,0,0,5,1,-15,3,1
2,2,4,2,30,7,1,0,8,4,30,4,0,0,4,4,30,2,6,0,8,0,30,6,2,0,8,2,30,4,0,0,4,0,-27,3,0
2,3,4,2,30,7,1,0,8,4,30,4,0,0,4,4,30,2,6,0,8,0,30,6,2,0,8,2,30,4,0,0,4,0,-27,3,0
2,1,5,0,30,2,3,0,5,2,30,0,4,0,4,0,30,3,2,0,5,0,30,1,4,0,5,0,30,0,2,0,2,0,-27,3,0
2,3,6,0,30,6,3,0,9,4,30,2,0,0,2,0,30,2,7,0,9,0,30,4,5,0,9,2,30,5,0,0,5,0,-27,3,0
2,4,17,2,30,11,3,0,14,4,30,6,0,0,6,0,30,3,11,0,14,3,30,7,7,0,14,0,30,4,0,0,4,1,-15,3,1
2,4,19,0,30,4,9,0,13,1,30,6,2,0,8,0,30,8,5,0,13,4,30,6,7,0,13,1,30,9,0,0,9,1,-15,3,1
2,3,25,1,30,5,9,0,14,3,30,6,0,0,6,0,30,6,8,0,14,1,30,7,7,0,14,3,30,5,1,0,6,1,-15,3,1
2,4,25,1,30,5,9,0,14,3,30,6,0,0,6,0,30,6,8,0,14,1,30,7,7,0,14,3,30,5,1,0,6,1,-15,3,1
2,4,1,1,30,6,4,0,10,4,30,2,0,0,2,1,30,4,6,0,10,0,30,8,2,0,10,6,30,6,0,0,6,0,-27,3,0
2,1,5,0,30,0,5,0,5,2,30,3,1,0,4,0,30,0,5,0,5,0,30,1,4,0,5,1,30,2,0,0,2,0,-27,3,0
2,2,6,0,30,6,3,0,9,4,30,2,0,0,2,0,30,2,7,0,9,0,30,4,5,0,9,5,30,5,0,0,5,0,-27,3,0
2,4,8,3,30,7,0,0,7,3,30,2,0,0,2,4,30,7,0,0,7,0,30,6,1,0,7,0,30,2,1,0,3,0,-27,3,0
2,2,13,1,30,3,0,0,3,1,30,2,0,0,2,0,30,3,0,0,3,7,30,2,1,0,3,1,30,2,0,0,2,1,-15,3,1
2,1,19,1,30,4,9,0,13,3,30,8,0,0,8,4,30,4,9,0,13,0,30,5,8,0,13,3,30,7,2,0,9,1,-15,3,1
2,2,19,1,30,4,9,0,13,3,30,8,0,0,8,4,30,4,9,0,13,0,30,5,8,0,13,3,30,7,2,0,9,1,-15,3,1
2,3,19,1,30,4,9,0,13,3,30,8,0,0,8,4,30,4,9,0,13,0,30,5,8,0,13,3,30,7,2,0,9,1,-15,3,1
2,4,19,1,30,4,9,0,13,3,30,8,0,0,8,4,30,4,9,0,13,0,30,5,8,0,13,3,30,7,2,0,9,1,-15,3,1
2,0,27,1,30,6,9,0,15,4,30,2,0,0,2,0,30,2,13,0,15,2,30,6,9,0,15,4,30,6,0,0,6,1,-15,3,1
2,2,33,3,30,5,6,0,11,5,30,4,0,0,4,3,30,11,0,0,11,0,30,3,8,0,11,3,30,4,0,0,4,1,-15,3,1
2,3,35,0,30,9,4,0,13,3,30,2,0,0,2,1,30,4,9,0,13,2,30,3,10,0,13,6,30,8,0,0,8,1,-15,3,1
2,1,1,0,30,7,3,0,10,3,30,2,0,0,2,5,30,4,6,0,10,7,30,7,3,0,10,6,30,6,0,0,6,0,-27,3,0
2,4,1,0,30,7,3,0,10,3,30,2,0,0,2,5,30,4,6,0,10,7,30,7,3,0,10,6,30,6,0,0,6,0,-27,3,0
2,3,7,1,30,3,6,0,9,3,30,4,0,0,4,0,30,5,4,0,9,6,30,4,5,0,9,1,30,5,1,0,6,0,-27,3,0
2,4,8,0,30,7,0,0,7,5,30,2,0,0,2,4,30,1,6,0,7,3,30,7,0,0,7,1,30,3,0,0,3,0,-27,3,0
2,4,9,0,30,3,1,0,4,2,30,2,0,0,2,1,30,3,1,0,4,4,30,1,3,0,4,0,30,0,1,0,1,0,-27,3,0
2,1,13,1,30,5,2,0,7,0,30,4,0,0,4,2,30,6,1,0,7,4,30,6,1,0,7,4,30,4,0,0,4,1,-15,3,1
2,1,17,3,30,9,5,0,14,3,30,6,0,0,6,0,30,5,9,0,14,3,30,8,6,0,14,6,30,4,0,0,4,1,-15,3,1
2,1,19,0,30,9,4,0,13,2,30,8,0,0,8,0,30,4,9,0,13,3,30,5,8,0,13,1,30,8,1,0,9,1,-15,3,1
2,2,19,0,30,9,4,0,13,2,30,8,0,0,8,0,30,4,9,0,13,3,30,5,8,0,13,1,30,8,1,0,9,1,-15,3,1
2,3,19,0,30,9,4,0,13,2,30,8,0,0,8,0,30,4,9,0,13,3,30,5,8,0,13,1,30,8,1,0,9,1,-15,3,1
2,4,25,2,30,7,7,0,14,0,30,6,0,0,6,0,30,12,2,0,14,1,30,5,9,0,14,2,30,5,1,0,6,1,-15,3,1
2,3,27,0,30,4,11,0,15,4,30,2,0,0,2,0,30,7,8,0,15,0,30,4,11,0,15,1,30,6,0,0,6,1,-15,3,1
2,3,3,0,30,0,4,0,4,2,30,4,0,0,4,1,30,2,2,0,4,0,30,3,1,0,4,0,30,2,1,0,3,0,-27,3,0
2,4,3,0,30,0,4,0,4,2,30,4,0,0,4,1,30,2,2,0,4,0,30,3,1,0,4,0,30,2,1,0,3,0,-27,3,0
2,2,4,0,30,6,2,0,8,4,30,4,0,0,4,1,30,2,6,0,8,0,30,4,4,0,8,3,30,4,0,0,4,0,-27,3,0
2,0,11,2,30,4,8,0,12,1,30,4,0,0,4,0,30,5,7,0,12,2,30,6,6,0,12,3,30,4,0,0,4,1,-15,3,1
2,1,11,2,30,4,8,0,12,1,30,4,0,0,4,0,30,5,7,0,12,2,30,6,6,0,12,3,30,4,0,0,4,1,-15,3,1
2,2,11,2,30,4,8,0,12,1,30,4,0,0,4,0,30,5,7,0,12,2,30,6,6,0,12,3,30,4,0,0,4,1,-15,3,1
2,3,11,2,30,4,8,0,12,1,30,4,0,0,4,0,30,5,7,0,12,2,30,6,6,0,12,3,30,4,0,0,4,1,-15,3,1
2,4,11,2,30,4,8,0,12,1,30,4,0,0,4,0,30,5,7,0,12,2,30,6,6,0,12,3,30,4,0,0,4,1,-15,3,1
2,2,13,1,30,7,0,0,7,1,30,4,0,0,4,2,30,5,2,0,7,4,30,6,1,0,7,0,30,4,0,0,4,1,-15,3,1
2,3,13,1,30,7,0,0,7,1,30,4,0,0,4,2,30,5,2,0,7,4,30,6,1,0,7,0,30,4,0,0,4,1,-15,3,1
2,4,13,1,30,7,0,0,7,1,30,4,0,0,4,2,30,5,2,0,7,4,30,6,1,0,7,0,30,4,0,0,4,1,-15,3,1
2,4,25,1,30,6,8,0,14,3,30,6,0,0,6,0,30,12,2,0,14,1,30,4,10,0,14,4,30,4,2,0,6,1,-15,3,1
2,2,27,1,30,4,11,0,15,5,30,2,0,0,2,0,30,5,10,0,15,4,30,6,9,0,15,5,30,6,0,0,6,1,-15,3,1
2,4,31,2,30,6,6,0,12,7,30,8,0,0,8,7,30,4,8,0,12,0,30,8,4,0,12,1,30,6,0,0,6,1,-15,3,1
2,0,4,2,30,8,0,0,8,5,30,4,0,0,4,1,30,1,7,0,8,0,30,6,2,0,8,1,30,4,0,0,4,0,-27,3,0
2,2,4,2,30,8,0,0,8,5,30,4,0,0,4,1,30,1,7,0,8,0,30,6,2,0,8,0,30,4,0,0,4,0,-27,3,0
2,3,4,2,30,8,0,0,8,5,30,4,0,0,4,1,30,1,7,0,8,0,30,6,2,0,8,0,30,4,0,0,4,0,-27,3,0
2,1,5,1,30,2,3,0,5,3,30,4,0,0,4,0,30,0,5,0,5,0,30,1,4,0,5,0,30,0,2,0,2,0,-27,3,0
2,4,9,2,30,4,0,0,4,3,30,2,0,0,2,0,30,0,4,0,4,0,30,1,3,0,4,1,30,1,0,0,1,0,-27,3,0
2,3,9,0,30,10,1,0,11,3,30,6,0,0,6,3,30,6,5,0,11,1,30,3,8,0,11,0,30,3,1,0,4,0,-27,3,0
2,3,15,0,30,4,9,0,13,1,30,6,0,0,6,0,30,3,10,0,13,1,30,4,9,0,13,4,30,7,2,0,9,1,-15,3,1
2,4,15,0,30,4,9,0,13,1,30,6,0,0,6,0,30,3,10,0,13,1,30,4,9,0,13,4,30,7,2,0,9,1,-15,3,1
2,2,17,3,30,9,5,0,14,2,30,6,0,0,6,0,30,6,8,0,14,4,30,5,9,0,14,3,30,4,0,0,4,1,-15,3,1
2,4,17,0,30,9,5,0,14,2,30,6,0,0,6,0,30,6,8,0,14,4,30,5,9,0,14,3,30,4,0,0,4,1,-15,3,1
2,4,19,0,30,3,10,0,13,2,30,6,2,0,8,0,30,6,7,0,13,1,30,6,7,0,13,0,30,9,0,0,9,1,-15,3,1
2,2,27,1,30,3,12,0,15,5,30,2,0,0,2,0,30,5,10,0,15,0,30,6,9,0,15,2,30,6,0,0,6,1,-15,3,1
2,3,27,1,30,3,12,0,15,5,30,2,0,0,2,0,30,5,10,0,15,0,30,6,9,0,15,2,30,6,0,0,6,1,-15,3,1
2,3,29,0,30,6,8,0,14,6,30,11,1,0,12,0,30,4,10,0,14,0,30,1,13,0,14,1,30,9,0,0,9,1,-15,3,1
2,4,38,0,30,2,8,0,10,6,30,6,0,0,6,0,30,3,7,0,10,0,30,2,8,0,10,5,30,6,0,0,6,1,-15,3,1
2,3,39,0,30,7,4,0,11,6,30,6,0,0,6,0,30,5,6,0,11,1,30,3,8,0,11,4,30,5,0,0,5,1,-15,3,1
2,4,7,0,30,5,4,0,9,3,30,4,0,0,4,0,30,5,4,0,9,4,30,2,7,0,9,3,30,6,0,0,6,0,-27,3,0
2,2,13,1,30,6,1,0,7,1,30,4,0,0,4,3,30,5,2,0,7,4,30,7,0,0,7,4,30,4,0,0,4,1,-15,3,1
2,3,13,1,30,6,1,0,7,1,30,4,0,0,4,3,30,5,2,0,7,4,30,7,0,0,7,4,30,4,0,0,4,1,-15,3,1
2,3,17,4,30,9,5,0,14,2,30,6,0,0,6,0,30,8,6,0,14,1,30,3,11,0,14,0,30,4,0,0,4,1,-15,3,1
2,4,19,0,30,6,7,0,13,1,30,4,4,0,8,0,30,8,5,0,13,8,30,3,10,0,13,0,30,8,1,0,9,1,-15,3,1
2,4,23,1,30,9,4,0,13,3,30,6,0,0,6,4,30,11,2,0,13,0,30,5,8,0,13,1,30,6,0,0,6,1,-15,3,1
2,1,27,1,30,6,9,0,15,3,30,2,0,0,2,0,30,4,11,0,15,2,30,4,11,0,15,1,30,6,0,0,6,1,-15,3,1
2,3,27,1,30,6,9,0,15,3,30,2,0,0,2,0,30,4,11,0,15,2,30,4,11,0,15,1,30,6,0,0,6,1,-15,3,1
2,3,29,0,30,8,6,0,14,6,30,10,2,0,12,0,30,3,11,0,14,0,30,1,13,0,14,0,30,9,0,0,9,1,-15,3,1
2,4,29,0,30,8,6,0,14,6,30,10,2,0,12,0,30,3,11,0,14,0,30,1,13,0,14,0,30,9,0,0,9,1,-15,3,1
2,4,32,0,30,8,1,0,9,4,30,2,0,0,2,2,30,9,0,0,9,1,30,2,7,0,9,4,30,2,0,0,2,1,-15,3,1
2,3,35,1,30,13,0,0,13,4,30,2,0,0,2,1,30,6,7,0,13,0,30,1,12,0,13,6,30,8,0,0,8,1,-15,3,1
2,2,5,0,30,2,3,0,5,3,30,1,3,0,4,0,30,0,5,0,5,0,30,2,3,0,5,0,30,1,1,0,2,0,-27,3,0
2,0,11,3,30,7,5,0,12,3,30,4,0,0,4,0,30,5,7,0,12,9,30,7,5,0,12,6,30,4,0,0,4,1,-15,3,1
2,1,17,2,30,7,7,0,14,3,30,6,0,0,6,0,30,5,9,0,14,5,30,5,9,0,14,4,30,4,0,0,4,1,-15,3,1
2,3,17,2,30,7,7,0,14,3,30,6,0,0,6,0,30,5,9,0,14,5,30,5,9,0,14,4,30,4,0,0,4,1,-15,3,1
2,3,19,0,30,3,10,0,13,2,30,7,1,0,8,0,30,7,6,0,13,0,30,6,7,0,13,0,30,8,1,0,9,1,-15,3,1
2,2,21,3,30,10,0,0,10,4,30,6,0,0,6,1,30,3,7,0,10,4,30,5,5,0,10,1,30,4,0,0,4,1,-15,3,1
2,4,25,1,30,6,8,0,14,1,30,6,0,0,6,0,30,10,4,0,14,1,30,5,9,0,14,4,30,5,1,0,6,1,-15,3,1
2,2,35,0,30,7,6,0,13,2,30,2,0,0,2,1,30,9,4,0,13,4,30,3,10,0,13,5,30,8,0,0,8,1,-15,3,1
2,4,35,0,30,7,6,0,13,2,30,2,0,0,2,1,30,9,4,0,13,4,30,3,10,0,13,5,30,8,0,0,8,1,-15,3,1
2,3,4,3,30,8,0,0,8,4,30,4,0,0,4,0,30,5,3,0,8,0,30,4,4,0,8,2,30,4,0,0,4,0,-27,3,0
2,2,5,0,30,1,4,0,5,2,30,3,1,0,4,0,30,0,5,0,5,0,30,1,4,0,5,0,30,0,2,0,2,0,-27,3,0
2,4,5,0,30,1,4,0,5,2,30,3,1,0,4,0,30,0,5,0,5,0,30,1,4,0,5,0,30,0,2,0,2,0,-27,3,0
2,3,8,3,30,7,0,0,7,4,30,2,0,0,2,3,30,5,2,0,7,1,30,7,0,0,7,2,30,3,0,0,3,0,-27,3,0
2,4,8,3,30,7,0,0,7,4,30,2,0,0,2,3,30,5,2,0,7,1,30,7,0,0,7,2,30,3,0,0,3,0,-27,3,0
2,1,13,2,30,6,1,0,7,0,30,4,0,0,4,2,30,5,2,0,7,8,30,6,1,0,7,5,30,4,0,0,4,1,-15,3,1
2,4,13,2,30,6,1,0,7,0,30,4,0,0,4,2,30,5,2,0,7,8,30,6,1,0,7,4,30,4,0,0,4,1,-15,3,1
2,3,15,1,30,4,9,0,13,2,30,6,0,0,6,3,30,3,10,0,13,1,30,7,6,0,13,2,30,6,3,0,9,1,-15,3,1
2,3,23,1,30,5,8,0,13,2,30,6,0,0,6,6,30,12,1,0,13,0,30,5,8,0,13,0,30,6,0,0,6,1,-15,3,1
2,4,25,1,30,10,4,0,14,3,30,6,0,0,6,0,30,7,7,0,14,1,30,5,9,0,14,3,30,6,0,0,6,1,-15,3,1
2,0,27,1,30,3,12,0,15,4,30,1,1,0,2,0,30,5,10,0,15,1,30,4,11,0,15,4,30,6,0,0,6,1,-15,3,1
2,2,27,1,30,3,12,0,15,4,30,1,1,0,2,0,30,5,10,0,15,1,30,4,11,0,15,4,30,6,0,0,6,1,-15,3,1
2,4,29,0,30,4,10,0,14,4,30,11,1,0,12,0,30,4,10,0,14,0,30,2,12,0,14,0,30,6,3,0,9,1,-15,3,1
2,2,39,0,30,1,10,0,11,6,30,6,0,0,6,0,30,5,6,0,11,0,30,4,7,0,11,6,30,5,0,0,5,1,-15,3,1
2,0,47,0,30,1,13,0,14,7,30,4,0,0,4,0,30,3,11,0,14,0,30,8,6,0,14,7,30,7,0,0,7,1,-15,3,1
2,4,17,4,30,9,5,0,14,3,30,6,0,0,6,0,30,5,9,0,14,1,30,6,8,0,14,0,30,2,2,0,4,1,-15,3,1
2,3,25,2,30,7,7,0,14,3,30,6,0,0,6,1,30,10,4,0,14,3,30,5,9,0,14,3,30,5,1,0,6,1,-15,3,1
2,2,39,6,30,4,7,0,11,7,30,6,0,0,6,0,30,6,5,0,11,1,30,3,8,0,11,2,30,5,0,0,5,1,-15,3,1
2,3,39,6,30,4,7,0,11,7,30,6,0,0,6,0,30,6,5,0,11,1,30,3,8,0,11,2,30,5,0,0,5,1,-15,3,1
2,4,39,6,30,4,7,0,11,7,30,6,0,0,6,0,30,6,5,0,11,1,30,3,8,0,11,2,30,5,0,0,5,1,-15,3,1
2,2,4,2,30,6,2,0,8,5,30,3,1,0,4,0,30,1,7,0,8,0,30,5,3,0,8,4,30,3,1,0,4,0,-27,3,0
2,3,4,2,30,6,2,0,8,5,30,3,1,0,4,0,30,1,7,0,8,0,30,5,3,0,8,4,30,3,1,0,4,0,-27,3,0
2,4,4,2,30,6,2,0,8,5,30,3,1,0,4,0,30,1,7,0,8,0,30,5,3,0,8,4,30,3,1,0,4,0,-27,3,0
2,0,5,0,30,3,2,0,5,3,30,4,0,0,4,0,30,0,5,0,5,0,30,1,4,0,5,1,30,2,0,0,2,0,-27,3,0
2,1,5,0,30,3,2,0,5,3,30,4,0,0,4,0,30,0,5,0,5,0,30,1,4,0,5,1,30,2,0,0,2,0,-27,3,0
2,3,5,0,30,3,2,0,5,3,30,4,0,0,4,0,30,0,5,0,5,0,30,1,4,0,5,1,30,2,0,0,2,0,-27,3,0
2,4,13,3,30,3,0,0,3,0,30,2,0,0,2,0,30,3,0,0,3,7,30,2,1,0,3,3,30,2,0,0,2,1,-15,3,1
2,4,13,3,30,7,0,0,7,0,30,4,0,0,4,2,30,6,1,0,7,11,30,6,1,0,7,3,30,4,0,0,4,1,-15,3,1
2,4,17,2,30,9,5,0,14,2,30,6,0,0,6,0,30,7,7,0,14,2,30,5,9,0,14,6,30,4,0,0,4,1,-15,3,1
2,0,27,3,30,5,10,0,15,4,30,1,1,0,2,0,30,8,7,0,15,0,30,2,13,0,15,1,30,6,0,0,6,1,-15,3,1
2,2,1,0,30,7,3,0,10,4,30,2,0,0,2,1,30,4,6,0,10,8,30,6,4,0,10,3,30,6,0,0,6,0,-27,3,0
2,4,1,0,30,7,3,0,10,4,30,2,0,0,2,1,30,4,6,0,10,8,30,6,4,0,10,3,30,6,0,0,6,0,-27,3,0
2,1,5,0,30,0,5,0,5,3,30,0,4,0,4,0,30,0,5,0,5,1,30,3,2,0,5,0,30,0,2,0,2,0,-27,3,0
2,2,5,0,30,0,5,0,5,3,30,0,4,0,4,0,30,0,5,0,5,1,30,3,2,0,5,0,30,0,2,0,2,0,-27,3,0
2,4,5,0,30,0,5,0,5,3,30,0,4,0,4,0,30,0,5,0,5,1,30,3,2,0,5,0,30,0,2,0,2,0,-27,3,0
2,4,8,1,30,7,0,0,7,3,30,2,0,0,2,0,30,7,0,0,7,0,30,5,2,0,7,1,30,3,0,0,3,0,-27,3,0
2,4,9,0,30,1,3,0,4,2,30,2,0,0,2,0,30,1,3,0,4,0,30,1,3,0,4,0,30,1,0,0,1,0,-27,3,0
2,2,13,3,30,5,2,0,7,0,30,4,0,0,4,2,30,6,1,0,7,12,30,6,1,0,7,3,30,4,0,0,4,1,-15,3,1
2,1,21,3,30,7,3,0,10,4,30,6,0,0,6,1,30,3,7,0,10,2,30,5,5,0,10,2,30,4,0,0,4,1,-15,3,1
2,4,27,1,30,4,11,0,15,4,30,2,0,0,2,0,30,3,12,0,15,2,30,6,9,0,15,0,30,6,0,0,6,1,-15,3,1
2,0,4,2,30,7,1,0,8,5,30,4,0,0,4,1,30,1,7,0,8,0,30,6,2,0,8,1,30,3,1,0,4,0,-27,3,0
2,2,4,2,30,7,1,0,8,5,30,4,0,0,4,1,30,1,7,0,8,0,30,6,2,0,8,1,30,3,1,0,4,0,-27,3,0
2,3,4,2,30,7,1,0,8,5,30,4,0,0,4,1,30,1,7,0,8,0,30,6,2,0,8,1,30,3,1,0,4,0,-27,3,0
2,4,4,2,30,7,1,0,8,5,30,4,0,0,4,1,30,1,7,0,8,0,30,6,2,0,8,1,30,3,1,0,4,0,-27,3,0
2,1,11,2,30,6,6,0,12,2,30,4,0,0,4,0,30,3,9,0,12,5,30,5,7,0,12,5,30,4,0,0,4,1,-15,3,1
2,3,17,2,30,9,5,0,14,4,30,6,0,0,6,0,30,2,12,0,14,1,30,4,10,0,14,0,30,4,0,0,4,1,-15,3,1
2,1,19,0,30,3,10,0,13,2,30,7,1,0,8,0,30,7,6,0,13,0,30,8,5,0,13,2,30,8,1,0,9,1,-15,3,1
2,2,19,0,30,3,10,0,13,2,30,7,1,0,8,0,30,7,6,0,13,0,30,8,5,0,13,2,30,8,1,0,9,1,-15,3,1
2,3,19,0,30,3,10,0,13,2,30,7,1,0,8,0,30,7,6,0,13,0,30,8,5,0,13,2,30,8,1,0,9,1,-15,3,1
2,4,19,0,30,3,10,0,13,2,30,7,1,0,8,0,30,7,6,0,13,0,30,8,5,0,13,2,30,8,1,0,9,1,-15,3,1
2,0,27,1,30,5,10,0,15,3,30,2,0,0,2,0,30,2,13,0,15,2,30,5,10,0,15,6,30,6,0,0,6,1,-15,3,1
2,2,27,1,30,5,10,0,15,3,30,2,0,0,2,0,30,2,13,0,15,1,30,5,10,0,15,6,30,6,0,0,6,1,-15,3,1
2,3,27,1,30,5,10,0,15,3,30,2,0,0,2,0,30,2,13,0,15,1,30,5,10,0,15,6,30,6,0,0,6,1,-15,3,1
2,1,33,1,30,3,8,0,11,6,30,4,0,0,4,0,30,6,5,0,11,7,30,5,6,0,11,3,30,4,0,0,4,1,-15,3,1
2,2,33,1,30,3,8,0,11,6,30,4,0,0,4,0,30,6,5,0,11,7,30,5,6,0,11,3,30,4,0,0,4,1,-15,3,1
2,3,35,0,30,8,5,0,13,4,30,2,0,0,2,3,30,9,4,0,13,0,30,4,9,0,13,0,30,6,2,0,8,1,-15,3,1
2,1,37,2,30,5,6,0,11,5,30,3,5,0,8,0,30,10,1,0,11,5,30,3,8,0,11,5,30,6,0,0,6,1,-15,3,1
2,2,37,2,30,5,6,0,11,5,30,3,5,0,8,0,30,10,1,0,11,5,30,3,8,0,11,5,30,6,0,0,6,1,-15,3,1
2,2,39,0,30,1,10,0,11,6,30,6,0,0,6,0,30,7,4,0,11,4,30,4,7,0,11,4,30,5,0,0,5,1,-15,3,1
2,4,39,0,30,1,10,0,11,6,30,6,0,0,6,0,30,7,4,0,11,4,30,4,7,0,11,4,30,5,0,0,5,1,-15,3,1
2,2,47,0,30,0,14,0,14,6,30,4,0,0,4,0,30,5,9,0,14,0,30,2,12,0,14,6,30,7,0,0,7,1,-15,3,1
2,4,47,0,30,0,14,0,14,6,30,4,0,0,4,0,30,5,9,0,14,0,30,2,12,0,14,6,30,7,0,0,7,1,-15,3,1
2,0,4,2,30,8,0,0,8,5,30,4,0,0,4,1,30,2,6,0,8,0,30,8,0,0,8,2,30,4,0,0,4,0,-27,3,0
2,1,4,2,30,8,0,0,8,5,30,4,0,0,4,1,30,2,6,0,8,0,30,8,0,0,8,2,30,4,0,0,4,0,-27,3,0
2,4,8,3,30,7,0,0,7,4,30,2,0,0,2,3,30,3,4,0,7,0,30,7,0,0,7,2,30,3,0,0,3,0,-27,3,0
2,1,13,4,30,6,1,0,7,0,30,4,0,0,4,2,30,6,1,0,7,4,30,6,1,0,7,3,30,4,0,0,4,1,-15,3,1
2,3,17,3,30,9,5,0,14,2,30,6,0,0,6,0,30,6,8,0,14,2,30,4,10,0,14,3,30,4,0,0,4,1,-15,3,1
2,3,23,1,30,4,9,0,13,3,30,6,0,0,6,6,30,12,1,0,13,0,30,5,8,0,13,3,30,6,0,0,6,1,-15,3,1
2,4,23,1,30,4,9,0,13,3,30,6,0,0,6,6,30,12,1,0,13,0,30,5,8,0,13,3,30,6,0,0,6,1,-15,3,1
2,0,27,3,30,6,9,0,15,2,30,1,1,0,2,0,30,6,9,0,15,0,30,2,13,0,15,1,30,6,0,0,6,1,-15,3,1
2,1,27,3,30,6,9,0,15,2,30,1,1,0,2,0,30,6,9,0,15,0,30,2,13,0,15,1,30,6,0,0,6,1,-15,3,1
2,3,27,3,30,6,9,0,15,2,30,1,1,0,2,0,30,6,9,0,15,0,30,2,13,0,15,1,30,6,0,0,6,1,-15,3,1
2,4,31,3,30,5,7,0,12,5,30,8,0,0,8,9,30,10,2,0,12,0,30,3,9,0,12,0,30,2,4,0,6,1,-15,3,1
2,0,5,0,30,1,4,0,5,3,30,0,4,0,4,0,30,0,5,0,5,3,30,5,0,0,5,0,30,2,0,0,2,0,-27,3,0
2,1,5,0,30,1,4,0,5,3,30,0,4,0,4,0,30,0,5,0,5,3,30,5,0,0,5,0,30,2,0,0,2,0,-27,3,0
2,3,5,0,30,1,4,0,5,3,30,0,4,0,4,0,30,0,5,0,5,3,30,5,0,0,5,0,30,2,0,0,2,0,-27,3,0
2,2,9,0,30,7,4,0,11,3,30,6,0,0,6,3,30,7,4,0,11,4,30,3,8,0,11,2,30,3,1,0,4,0,-27,3,0
2,3,9,0,30,7,4,0,11,3,30,6,0,0,6,3,30,7,4,0,11,4,30,3,8,0,11,2,30,3,1,0,4,0,-27,3,0
2,2,13,3,30,7,0,0,7,1,30,4,0,0,4,0,30,6,1,0,7,4,30,7,0,0,7,4,30,4,0,0,4,1,-15,3,1
2,4,13,3,30,7,0,0,7,1,30,4,0,0,4,0,30,6,1,0,7,4,30,7,0,0,7,4,30,4,0,0,4,1,-15,3,1
2,2,17,5,30,11,3,0,14,4,30,6,0,0,6,0,30,3,11,0,14,1,30,5,9,0,14,1,30,3,1,0,4,1,-15,3,1
2,3,17,5,30,11,3,0,14,4,30,6,0,0,6,0,30,3,11,0,14,1,30,5,9,0,14,1,30,3,1,0,4,1,-15,3,1
2,0,19,0,30,3,10,0,13,1,30,6,2,0,8,0,30,6,7,0,13,1,30,7,6,0,13,1,30,9,0,0,9,1,-15,3,1
2,2,19,0,30,3,10,0,13,0,30,6,2,0,8,0,30,6,7,0,13,1,30,7,6,0,13,1,30,9,0,0,9,1,-15,3,1
2,3,19,0,30,3,10,0,13,0,30,6,2,0,8,0,30,6,7,0,13,1,30,7,6,0,13,1,30,9,0,0,9,1,-15,3,1
2,1,25,2,30,7,7,0,14,2,30,5,1,0,6,0,30,7,7,0,14,4,30,4,10,0,14,3,30,5,1,0,6,1,-15,3,1
2,2,25,2,30,7,7,0,14,2,30,5,1,0,6,0,30,7,7,0,14,4,30,4,10,0,14,3,30,5,1,0,6,1,-15,3,1
2,4,25,2,30,7,7,0,14,2,30,5,1,0,6,0,30,7,7,0,14,0,30,4,10,0,14,3,30,5,1,0,6,1,-15,3,1
2,2,27,0,30,3,12,0,15,4,30,2,0,0,2,0,30,7,8,0,15,2,30,6,9,0,15,1,30,6,0,0,6,1,-15,3,1
2,3,27,0,30,3,12,0,15,4,30,2,0,0,2,0,30,7,8,0,15,2,30,6,9,0,15,1,30,6,0,0,6,1,-15,3,1
2,2,29,0,30,7,7,0,14,6,30,12,0,0,12,0,30,5,9,0,14,0,30,2,12,0,14,2,30,9,0,0,9,1,-15,3,1
2,3,31,0,30,8,4,0,12,3,30,8,0,0,8,5,30,10,2,0,12,0,30,3,9,0,12,2,30,4,2,0,6,1,-15,3,1
2,4,31,0,30,8,4,0,12,3,30,8,0,0,8,5,30,10,2,0,12,0,30,3,9,0,12,2,30,4,2,0,6,1,-15,3,1
2,3,35,0,30,12,1,0,13,3,30,2,0,0,2,1,30,8,5,0,13,2,30,1,12,0,13,7,30,8,0,0,8,1,-15,3,1
2,4,4,2,30,7,1,0,8,4,30,4,0,0,4,1,30,4,4,0,8,0,30,4,4,0,8,1,30,4,0,0,4,0,-27,3,0
2,4,7,0,30,4,0,0,4,2,30,2,0,0,2,0,30,1,3,0,4,0,30,1,3,0,4,0,30,1,1,0,2,0,-27,3,0
2,3,8,2,30,7,0,0,7,4,30,2,0,0,2,0,30,3,4,0,7,0,30,4,3,0,7,3,30,3,0,0,3,0,-27,3,0
2,1,17,3,30,8,6,0,14,3,30,6,0,0,6,1,30,5,9,0,14,1,30,5,9,0,14,6,30,4,0,0,4,1,-15,3,1
2,3,19,0,30,6,7,0,13,0,30,5,3,0,8,0,30,6,7,0,13,4,30,6,7,0,13,0,30,8,1,0,9,1,-15,3,1
2,2,38,0,30,3,7,0,10,7,30,5,1,0,6,3,30,3,7,0,10,0,30,5,5,0,10,2,30,6,0,0,6,1,-15,3,1
2,3,38,0,30,3,7,0,10,7,30,5,1,0,6,3,30,3,7,0,10,0,30,5,5,0,10,2,30,6,0,0,6,1,-15,3,1
2,4,38,0,30,3,7,0,10,7,30,5,1,0,6,3,30,3,7,0,10,0,30,5,5,0,10,2,30,6,0,0,6,1,-15,3,1
2,4,3,0,30,1,3,0,4,2,30,4,0,0,4,0,30,0,4,0,4,4,30,2,2,0,4,0,30,2,1,0,3,0,-27,3,0
2,3,4,3,30,7,1,0,8,4,30,4,0,0,4,0,30,5,3,0,8,0,30,4,4,0,8,0,30,4,0,0,4,0,-27,3,0
2,4,4,3,30,7,1,0,8,4,30,4,0,0,4,0,30,5,3,0,8,0,30,4,4,0,8,0,30,4,0,0,4,0,-27,3,0
2,3,8,1,30,7,0,0,7,4,30,2,0,0,2,4,30,1,6,0,7,0,30,7,0,0,7,1,30,3,0,0,3,0,-27,3,0
2,4,8,1,30,7,0,0,7,4,30,2,0,0,2,4,30,1,6,0,7,0,30,7,0,0,7,1,30,3,0,0,3,0,-27,3,0
2,4,11,2,30,2,2,0,4,1,30,0,0,0,0,0,30,1,3,0,4,0,30,2,2,0,4,1,30,1,0,0,1,1,-15,3,1
2,4,11,1,30,7,5,0,12,0,30,4,0,0,4,0,30,7,5,0,12,3,30,3,9,0,12,0,30,4,0,0,4,1,-15,3,1
2,1,13,1,30,5,2,0,7,0,30,4,0,0,4,2,30,7,0,0,7,9,30,7,0,0,7,7,30,4,0,0,4,1,-15,3,1
2,4,17,2,30,8,6,0,14,3,30,6,0,0,6,0,30,5,9,0,14,3,30,7,7,0,14,4,30,4,0,0,4,1,-15,3,1
2,1,19,0,30,5,8,0,13,1,30,6,2,0,8,0,30,4,9,0,13,8,30,6,7,0,13,1,30,8,1,0,9,1,-15,3,1
2,4,19,0,30,5,8,0,13,1,30,6,2,0,8,0,30,4,9,0,13,8,30,6,7,0,13,1,30,8,1,0,9,1,-15,3,1
2,3,23,1,30,6,7,0,13,0,30,6,0,0,6,5,30,11,2,0,13,0,30,5,8,0,13,2,30,6,0,0,6,1,-15,3,1
2,3,25,1,30,3,11,0,14,5,30,6,0,0,6,0,30,8,6,0,14,1,30,4,10,0,14,3,30,5,1,0,6,1,-15,3,1
2,4,25,1,30,3,11,0,14,5,30,6,0,0,6,0,30,8,6,0,14,1,30,4,10,0,14,3,30,5,1,0,6,1,-15,3,1
2,4,32,0,30,7,2,0,9,5,30,2,0,0,2,0,30,5,4,0,9,1,30,2,7,0,9,2,30,2,0,0,2,1,-15,3,1
2,2,33,1,30,4,7,0,11,5,30,4,0,0,4,3,30,10,1,0,11,2,30,3,8,0,11,6,30,4,0,0,4,1,-15,3,1
2,3,33,1,30,4,7,0,11,5,30,4,0,0,4,3,30,10,1,0,11,2,30,3,8,0,11,6,30,4,0,0,4,1,-15,3,1
2,2,43,0,30,10,4,0,14,6,30,6,0,0,6,0,30,4,10,0,14,1,30,1,13,0,14,2,30,5,0,0,5,1,-15,3,1
2,4,43,0,30,10,4,0,14,6,30,6,0,0,6,0,30,4,10,0,14,1,30,1,13,0,14,2,30,5,0,0,5,1,-15,3,1
2,2,45,0,30,4,9,0,13,9,30,10,0,0,10,0,30,0,13,0,13,0,30,4,9,0,13,4,30,5,0,0,5,1,-15,3,1
2,3,45,0,30,4,9,0,13,9,30,10,0,0,10,0,30,0,13,0,13,0,30,4,9,0,13,4,30,5,0,0,5,1,-15,3,1
2,3,47,0,30,0,14,0,14,7,30,4,0,0,4,0,30,3,11,0,14,0,30,2,12,0,14,7,30,7,0,0,7,1,-15,3,1
2,1,4,2,30,6,2,0,8,5,30,4,0,0,4,0,30,1,7,0,8,0,30,7,1,0,8,3,30,3,1,0,4,0,-27,3,0
2,3,4,0,30,6,2,0,8,5,30,4,0,0,4,0,30,1,7,0,8,0,30,7,1,0,8,3,30,3,1,0,4,0,-27,3,0
2,4,4,0,30,6,2,0,8,5,30,4,0,0,4,0,30,1,7,0,8,0,30,7,1,0,8,3,30,3,1,0,4,0,-27,3,0
2,3,8,7,30,6,1,0,7,4,30,2,0,0,2,2,30,3,4,0,7,0,30,5,2,0,7,1,30,3,0,0,3,0,-27,3,0
2,4,8,7,30,6,1,0,7,4,30,2,0,0,2,2,30,3,4,0,7,0,30,5,2,0,7,1,30,3,0,0,3,0,-27,3,0
2,2,13,6,30,7,0,0,7,1,30,4,0,0,4,2,30,6,1,0,7,2,30,6,1,0,7,5,30,4,0,0,4,1,-15,3,1
2,2,15,0,30,7,6,0,13,0,30,6,0,0,6,0,30,4,9,0,13,1,30,5,8,0,13,0,30,7,2,0,9,1,-15,3,1
2,3,15,0,30,7,6,0,13,0,30,6,0,0,6,0,30,4,9,0,13,1,30,5,8,0,13,0,30,7,2,0,9,1,-15,3,1
2,3,17,6,30,9,5,0,14,0,30,6,0,0,6,0,30,6,8,0,14,3,30,3,11,0,14,1,30,4,0,0,4,1,-15,3,1
2,0,25,0,30,5,9,0,14,4,30,6,0,0,6,0,30,9,5,0,14,7,30,6,8,0,14,4,30,6,0,0,6,1,-15,3,1
2,4,25,0,30,5,9,0,14,4,30,6,0,0,6,0,30,9,5,0,14,7,30,6,8,0,14,4,30,6,0,0,6,1,-15,3,1
2,3,32,0,30,3,6,0,9,4,30,2,0,0,2,1,30,8,1,0,9,1,30,3,6,0,9,5,30,2,0,0,2,1,-15,3,1
2,1,13,2,30,6,1,0,7,2,30,4,0,0,4,9,30,6,1,0,7,6,30,6,1,0,7,3,30,4,0,0,4,1,-15,3,1
2,3,13,2,30,6,1,0,7,2,30,4,0,0,4,9,30,6,1,0,7,6,30,6,1,0,7,3,30,4,0,0,4,1,-15,3,1
2,4,13,2,30,6,1,0,7,2,30,4,0,0,4,9,30,6,1,0,7,6,30,6,1,0,7,3,30,4,0,0,4,1,-15,3,1
2,3,23,1,30,7,6,0,13,3,30,6,0,0,6,3,30,11,2,0,13,0,30,5,8,0,13,1,30,5,1,0,6,1,-15,3,1
2,2,26,0,30,5,4,0,9,5,30,4,0,0,4,3,30,2,7,0,9,0,30,2,7,0,9,3,30,3,0,0,3,1,-15,3,1
2,3,26,0,30,5,4,0,9,5,30,4,0,0,4,3,30,2,7,0,9,0,30,2,7,0,9,3,30,3,0,0,3,1,-15,3,1
2,2,27,1,30,6,9,0,15,4,30,1,1,0,2,0,30,9,6,0,15,0,30,5,10,0,15,0,30,5,1,0,6,1,-15,3,1
2,4,27,1,30,6,9,0,15,4,30,1,1,0,2,0,30,9,6,0,15,0,30,5,10,0,15,0,30,5,1,0,6,1,-15,3,1
2,2,37,1,30,9,2,0,11,7,30,8,0,0,8,0,30,3,8,0,11,0,30,3,8,0,11,1,30,6,0,0,6,1,-15,3,1
2,4,37,1,30,9,2,0,11,7,30,8,0,0,8,0,30,3,8,0,11,0,30,3,8,0,11,1,30,6,0,0,6,1,-15,3,1
2,3,39,0,30,2,9,0,11,7,30,6,0,0,6,0,30,7,4,0,11,2,30,6,5,0,11,1,30,5,0,0,5,1,-15,3,1
2,4,39,0,30,2,9,0,11,7,30,6,0,0,6,0,30,7,4,0,11,2,30,6,5,0,11,1,30,5,0,0,5,1,-15,3,1
2,3,45,1,30,7,6,0,13,10,30,10,0,0,10,0,30,1,12,0,13,0,30,4,9,0,13,5,30,5,0,0,5,1,-15,3,1
2,2,13,7,30,7,0,0,7,1,30,4,0,0,4,2,30,5,2,0,7,1,30,6,1,0,7,3,30,4,0,0,4,1,-15,3,1
2,4,13,7,30,7,0,0,7,1,30,4,0,0,4,2,30,5,2,0,7,1,30,6,1,0,7,3,30,4,0,0,4,1,-15,3,1
2,4,19,0,30,5,8,0,13,1,30,7,1,0,8,0,30,12,1,0,13,0,30,4,9,0,13,1,30,8,1,0,9,1,-15,3,1
2,2,27,1,30,3,12,0,15,2,30,2,0,0,2,0,30,6,9,0,15,5,30,5,10,0,15,6,30,6,0,0,6,1,-15,3,1
2,4,27,1,30,3,12,0,15,2,30,2,0,0,2,0,30,6,9,0,15,5,30,5,10,0,15,6,30,6,0,0,6,1,-15,3,1
2,4,29,0,30,4,10,0,14,5,30,7,5,0,12,1,30,9,5,0,14,0,30,1,13,0,14,0,30,9,0,0,9,1,-15,3,1
2,1,33,7,30,2,9,0,11,6,30,4,0,0,4,0,30,7,4,0,11,2,30,5,6,0,11,9,30,4,0,0,4,1,-15,3,1
2,2,33,7,30,2,9,0,11,6,30,4,0,0,4,0,30,7,4,0,11,2,30,5,6,0,11,9,30,4,0,0,4,1,-15,3,1
2,4,35,0,30,6,7,0,13,3,30,2,0,0,2,1,30,2,11,0,13,4,30,1,12,0,13,6,30,8,0,0,8,1,-15,3,1
2,3,4,0,30,7,1,0,8,4,30,4,0,0,4,0,30,3,5,0,8,0,30,5,3,0,8,3,30,3,1,0,4,0,-27,3,0
2,1,5,0,30,2,3,0,5,3,30,3,1,0,4,0,30,1,4,0,5,0,30,3,2,0,5,0,30,1,1,0,2,0,-27,3,0
2,2,5,0,30,2,3,0,5,3,30,3,1,0,4,0,30,1,4,0,5,0,30,3,2,0,5,0,30,1,1,0,2,0,-27,3,0
2,3,5,0,30,2,3,0,5,3,30,3,1,0,4,0,30,1,4,0,5,0,30,3,2,0,5,0,30,1,1,0,2,0,-27,3,0
2,4,8,3,30,7,0,0,7,4,30,2,0,0,2,0,30,2,5,0,7,0,30,5,2,0,7,2,30,3,0,0,3,0,-27,3,0
2,3,11,0,30,5,7,0,12,2,30,4,0,0,4,0,30,1,11,0,12,0,30,5,7,0,12,4,30,4,0,0,4,1,-15,3,1
2,1,13,9,30,7,0,0,7,3,30,4,0,0,4,6,30,7,0,0,7,3,30,3,4,0,7,0,30,3,1,0,4,1,-15,3,1
2,0,19,0,30,2,11,0,13,2,30,4,4,0,8,0,30,8,5,0,13,6,30,5,8,0,13,3,30,9,0,0,9,1,-15,3,1
2,4,19,0,30,2,11,0,13,2,30,4,4,0,8,0,30,8,5,0,13,6,30,5,8,0,13,3,30,9,0,0,9,1,-15,3,1
2,0,21,3,30,8,2,0,10,4,30,6,0,0,6,1,30,3,7,0,10,5,30,5,5,0,10,5,30,4,0,0,4,1,-15,3,1
2,2,21,3,30,8,2,0,10,4,30,6,0,0,6,1,30,3,7,0,10,5,30,5,5,0,10,5,30,4,0,0,4,1,-15,3,1
2,3,21,3,30,8,2,0,10,4,30,6,0,0,6,1,30,3,7,0,10,5,30,5,5,0,10,5,30,4,0,0,4,1,-15,3,1
2,4,21,3,30,8,2,0,10,4,30,6,0,0,6,1,30,3,7,0,10,5,30,5,5,0,10,5,30,4,0,0,4,1,-15,3,1
2,3,23,0,30,5,8,0,13,4,30,6,0,0,6,6,30,11,2,0,13,0,30,5,8,0,13,4,30,6,0,0,6,1,-15,3,1
2,2,27,1,30,4,11,0,15,3,30,1,1,0,2,3,30,8,7,0,15,0,30,10,5,0,15,1,30,3,3,0,6,1,-15,3,1
2,2,29,1,30,6,8,0,14,6,30,10,2,0,12,0,30,5,9,0,14,0,30,0,14,0,14,3,30,9,0,0,9,1,-15,3,1
2,1,4,2,30,8,0,0,8,5,30,4,0,0,4,1,30,1,7,0,8,2,30,6,2,0,8,0,30,3,1,0,4,0,-27,3,0
2,4,4,2,30,8,0,0,8,5,30,4,0,0,4,0,30,1,7,0,8,2,30,6,2,0,8,0,30,3,1,0,4,0,-27,3,0
2,2,8,1,30,7,0,0,7,4,30,2,0,0,2,4,30,4,3,0,7,2,30,7,0,0,7,2,30,3,0,0,3,0,-27,3,0
2,3,8,1,30,7,0,0,7,4,30,2,0,0,2,4,30,4,3,0,7,2,30,7,0,0,7,2,30,3,0,0,3,0,-27,3,0
2,4,13,1,30,6,1,0,7,0,30,4,0,0,4,3,30,7,0,0,7,9,30,6,1,0,7,4,30,4,0,0,4,1,-15,3,1
2,3,15,0,30,4,9,0,13,1,30,6,0,0,6,0,30,4,9,0,13,1,30,4,9,0,13,3,30,9,0,0,9,1,-15,3,1
2,4,17,3,30,8,6,0,14,4,30,6,0,0,6,0,30,4,10,0,14,1,30,9,5,0,14,0,30,4,0,0,4,1,-15,3,1
2,1,27,2,30,7,8,0,15,2,30,1,1,0,2,0,30,8,7,0,15,0,30,5,10,0,15,0,30,6,0,0,6,1,-15,3,1
2,2,27,2,30,7,8,0,15,2,30,1,1,0,2,0,30,8,7,0,15,0,30,5,10,0,15,0,30,6,0,0,6,1,-15,3,1
2,4,31,4,30,6,6,0,12,4,30,8,0,0,8,4,30,11,1,0,12,0,30,5,7,0,12,0,30,5,1,0,6,1,-15,3,1
2,3,47,0,30,0,14,0,14,5,30,4,0,0,4,0,30,6,8,0,14,1,30,3,11,0,14,8,30,7,0,0,7,1,-15,3,1
2,4,17,0,30,10,4,0,14,3,30,6,0,0,6,0,30,4,10,0,14,2,30,6,8,0,14,1,30,4,0,0,4,1,-15,3,1
2,4,19,0,30,3,10,0,13,2,30,8,0,0,8,6,30,6,7,0,13,3,30,5,8,0,13,0,30,6,3,0,9,1,-15,3,1
2,1,27,1,30,4,11,0,15,5,30,1,1,0,2,0,30,4,11,0,15,0,30,6,9,0,15,4,30,6,0,0,6,1,-15,3,1
2,4,29,0,30,7,7,0,14,6,30,12,0,0,12,0,30,3,11,0,14,0,30,1,13,0,14,1,30,9,0,0,9,1,-15,3,1
2,0,31,4,30,7,5,0,12,4,30,8,0,0,8,6,30,9,3,0,12,0,30,3,9,0,12,0,30,3,3,0,6,1,-15,3,1
2,1,31,4,30,7,5,0,12,4,30,8,0,0,8,6,30,9,3,0,12,0,30,3,9,0,12,0,30,3,3,0,6,1,-15,3,1
2,3,31,4,30,7,5,0,12,4,30,8,0,0,8,6,30,9,3,0,12,0,30,3,9,0,12,0,30,3,3,0,6,1,-15,3,1
2,4,31,4,30,7,5,0,12,4,30,8,0,0,8,6,30,9,3,0,12,0,30,3,9,0,12,0,30,3,3,0,6,1,-15,3,1
2,4,39,0,30,5,6,0,11,7,30,6,0,0,6,0,30,4,7,0,11,1,30,3,8,0,11,2,30,5,0,0,5,1,-15,3,1
2,0,4,3,30,7,1,0,8,3,30,2,2,0,4,1,30,3,5,0,8,0,30,5,3,0,8,2,30,3,1,0,4,0,-27,3,0
2,1,4,3,30,7,1,0,8,3,30,2,2,0,4,1,30,3,5,0,8,0,30,5,3,0,8,2,30,3,1,0,4,0,-27,3,0
2,0,5,0,30,2,3,0,5,3,30,0,4,0,4,0,30,0,5,0,5,0,30,1,4,0,5,1,30,0,2,0,2,0,-27,3,0
2,3,5,0,30,2,3,0,5,3,30,0,4,0,4,0,30,0,5,0,5,0,30,1,4,0,5,1,30,0,2,0,2,0,-27,3,0
2,2,11,0,30,4,8,0,12,1,30,4,0,0,4,0,30,5,7,0,12,0,30,7,5,0,12,3,30,4,0,0,4,1,-15,3,1
2,3,11,0,30,4,8,0,12,1,30,4,0,0,4,0,30,5,7,0,12,0,30,7,5,0,12,3,30,4,0,0,4,1,-15,3,1
2,3,13,1,30,6,1,0,7,1,30,4,0,0,4,2,30,6,1,0,7,4,30,7,0,0,7,0,30,4,0,0,4,1,-15,3,1
2,4,15,1,30,5,8,0,13,0,30,5,1,0,6,0,30,7,6,0,13,1,30,7,6,0,13,3,30,4,5,0,9,1,-15,3,1
2,2,17,3,30,10,4,0,14,2,30,6,0,0,6,0,30,5,9,0,14,0,30,6,8,0,14,3,30,4,0,0,4,1,-15,3,1
2,3,17,3,30,10,4,0,14,2,30,6,0,0,6,0,30,5,9,0,14,0,30,6,8,0,14,3,30,4,0,0,4,1,-15,3,1
2,3,22,1,30,6,2,0,8,3,30,2,0,0,2,1,30,4,4,0,8,0,30,5,3,0,8,4,30,4,0,0,4,1,-15,3,1
2,4,22,1,30,6,2,0,8,3,30,2,0,0,2,1,30,4,4,0,8,0,30,5,3,0,8,4,30,4,0,0,4,1,-15,3,1
2,1,37,0,30,5,6,0,11,4,30,7,1,0,8,1,30,9,2,0,11,3,30,3,8,0,11,4,30,6,0,0,6,1,-15,3,1
2,3,37,0,30,5,6,0,11,4,30,7,1,0,8,1,30,9,2,0,11,3,30,3,8,0,11,4,30,6,0,0,6,1,-15,3,1
2,0,5,0,30,2,3,0,5,3,30,0,4,0,4,0,30,0,5,0,5,2,30,3,2,0,5,0,30,0,2,0,2,0,-27,3,0
2,1,5,0,30,2,3,0,5,3,30,0,4,0,4,0,30,0,5,0,5,2,30,3,2,0,5,0,30,0,2,0,2,0,-27,3,0
2,4,5,0,30,2,3,0,5,3,30,0,4,0,4,0,30,0,5,0,5,2,30,3,2,0,5,0,30,0,2,0,2,0,-27,3,0
2,3,8,0,30,7,0,0,7,3,30,2,0,0,2,0,30,1,6,0,7,0,30,4,3,0,7,3,30,3,0,0,3,0,-27,3,0
2,3,13,1,30,5,2,0,7,1,30,4,0,0,4,5,30,6,1,0,7,4,30,7,0,0,7,4,30,4,0,0,4,1,-15,3,1
2,3,17,3,30,10,4,0,14,3,30,6,0,0,6,0,30,4,10,0,14,0,30,3,11,0,14,4,30,4,0,0,4,1,-15,3,1
2,2,23,2,30,6,7,0,13,2,30,6,0,0,6,0,30,11,2,0,13,0,30,6,7,0,13,0,30,6,0,0,6,1,-15,3,1
2,0,27,5,30,4,11,0,15,2,30,1,1,0,2,0,30,9,6,0,15,2,30,4,11,0,15,1,30,5,1,0,6,1,-15,3,1
2,1,27,5,30,4,11,0,15,2,30,1,1,0,2,0,30,9,6,0,15,2,30,4,11,0,15,1,30,5,1,0,6,1,-15,3,1
2,2,27,5,30,4,11,0,15,2,30,1,1,0,2,0,30,9,6,0,15,2,30,4,11,0,15,1,30,5,1,0,6,1,-15,3,1
2,3,27,5,30,4,11,0,15,2,30,1,1,0,2,0,30,9,6,0,15,2,30,4,11,0,15,1,30,5,1,0,6,1,-15,3,1
2,1,33,3,30,7,4,0,11,5,30,4,0,0,4,4,30,10,1,0,11,0,30,3,8,0,11,6,30,4,0,0,4,1,-15,3,1
2,2,33,3,30,7,4,0,11,5,30,4,0,0,4,4,30,10,1,0,11,0,30,3,8,0,11,6,30,4,0,0,4,1,-15,3,1
2,3,35,0,30,7,6,0,13,4,30,2,0,0,2,1,30,2,11,0,13,4,30,3,10,0,13,3,30,8,0,0,8,1,-15,3,1
2,0,37,0,30,6,5,0,11,3,30,5,3,0,8,0,30,8,3,0,11,9,30,2,9,0,11,5,30,4,2,0,6,1,-15,3,1
2,0,41,0,30,9,3,0,12,8,30,8,0,0,8,0,30,3,9,0,12,0,30,5,7,0,12,3,30,4,3,0,7,1,-15,3,1
2,4,43,0,30,5,9,0,14,6,30,6,0,0,6,0,30,13,1,0,14,1,30,2,12,0,14,5,30,5,0,0,5,1,-15,3,1
2,0,4,2,30,8,0,0,8,5,30,4,0,0,4,0,30,3,5,0,8,1,30,8,0,0,8,2,30,4,0,0,4,0,-27,3,0
2,2,4,2,30,8,0,0,8,5,30,4,0,0,4,0,30,3,5,0,8,1,30,8,0,0,8,2,30,4,0,0,4,0,-27,3,0
2,3,4,2,30,8,0,0,8,5,30,4,0,0,4,0,30,3,5,0,8,1,30,8,0,0,8,2,30,4,0,0,4,0,-27,3,0
2,4,15,0,30,4,9,0,13,1,30,5,1,0,6,0,30,3,10,0,13,1,30,6,7,0,13,2,30,5,4,0,9,1,-15,3,1
2,1,19,0,30,4,9,0,13,2,30,5,3,0,8,0,30,4,9,0,13,6,30,8,5,0,13,2,30,8,1,0,9,1,-15,3,1
2,2,19,0,30,4,9,0,13,2,30,5,3,0,8,0,30,4,9,0,13,6,30,8,5,0,13,2,30,8,1,0,9,1,-15,3,1
2,1,27,1,30,3,12,0,15,3,30,1,1,0,2,0,30,6,9,0,15,4,30,4,11,0,15,4,30,6,0,0,6,1,-15,3,1
2,3,27,1,30,3,12,0,15,3,30,1,1,0,2,0,30,6,9,0,15,4,30,4,11,0,15,4,30,6,0,0,6,1,-15,3,1
2,4,27,1,30,3,12,0,15,3,30,1,1,0,2,0,30,6,9,0,15,4,30,4,11,0,15,4,30,6,0,0,6,1,-15,3,1
2,4,29,0,30,5,9,0,14,5,30,10,2,0,12,0,30,5,9,0,14,0,30,0,14,0,14,4,30,8,1,0,9,1,-15,3,1
2,2,39,0,30,4,7,0,11,6,30,6,0,0,6,0,30,6,5,0,11,2,30,2,9,0,11,4,30,5,0,0,5,1,-15,3,1
2,0,5,0,30,2,3,0,5,3,30,3,1,0,4,0,30,0,5,0,5,0,30,5,0,0,5,0,30,0,2,0,2,0,-27,3,0
2,1,5,0,30,2,3,0,5,3,30,3,1,0,4,0,30,0,5,0,5,0,30,5,0,0,5,0,30,0,2,0,2,0,-27,3,0
2,1,17,1,30,4,10,0,14,1,30,6,0,0,6,0,30,7,7,0,14,8,30,7,7,0,14,8,30,4,0,0,4,1,-15,3,1
2,2,17,1,30,4,10,0,14,1,30,6,0,0,6,0,30,7,7,0,14,8,30,7,7,0,14,8,30,4,0,0,4,1,-15,3,1
2,4,23,2,30,9,4,0,13,2,30,6,0,0,6,4,30,11,2,0,13,0,30,5,8,0,13,3,30,6,0,0,6,1,-15,3,1
2,3,25,1,30,7,7,0,14,4,30,6,0,0,6,0,30,6,8,0,14,2,30,6,8,0,14,3,30,5,1,0,6,1,-15,3,1
2,1,27,1,30,5,10,0,15,1,30,2,0,0,2,0,30,7,8,0,15,5,30,5,10,0,15,2,30,6,0,0,6,1,-15,3,1
2,3,27,1,30,5,10,0,15,1,30,2,0,0,2,0,30,7,8,0,15,5,30,5,10,0,15,2,30,6,0,0,6,1,-15,3,1
2,4,27,1,30,5,10,0,15,1,30,2,0,0,2,0,30,7,8,0,15,5,30,5,10,0,15,2,30,6,0,0,6,1,-15,3,1
2,1,29,0,30,5,9,0,14,5,30,11,1,0,12,0,30,5,9,0,14,0,30,1,13,0,14,1,30,9,0,0,9,1,-15,3,1
2,3,29,0,30,5,9,0,14,5,30,11,1,0,12,0,30,5,9,0,14,0,30,1,13,0,14,1,30,9,0,0,9,1,-15,3,1
2,1,31,1,30,9,3,0,12,4,30,8,0,0,8,8,30,10,2,0,12,0,30,3,9,0,12,1,30,2,4,0,6,1,-15,3,1
2,3,31,1,30,9,3,0,12,4,30,8,0,0,8,8,30,10,2,0,12,0,30,3,9,0,12,1,30,2,4,0,6,1,-15,3,1
2,3,33,1,30,2,9,0,11,5,30,4,0,0,4,0,30,9,2,0,11,0,30,5,6,0,11,5,30,4,0,0,4,1,-15,3,1
2,3,35,0,30,6,7,0,13,4,30,2,0,0,2,1,30,2,11,0,13,6,30,4,9,0,13,7,30,8,0,0,8,1,-15,3,1
2,2,5,0,30,2,3,0,5,2,30,4,0,0,4,0,30,0,5,0,5,0,30,1,4,0,5,2,30,0,2,0,2,0,-27,3,0
2,3,5,0,30,2,3,0,5,2,30,4,0,0,4,0,30,0,5,0,5,0,30,1,4,0,5,2,30,0,2,0,2,0,-27,3,0
2,3,11,1,30,5,7,0,12,0,30,4,0,0,4,0,30,7,5,0,12,3,30,3,9,0,12,3,30,4,0,0,4,1,-15,3,1
2,1,19,0,30,1,12,0,13,2,30,3,5,0,8,0,30,7,6,0,13,3,30,4,9,0,13,1,30,9,0,0,9,1,-15,3,1
2,4,19,0,30,1,12,0,13,2,30,3,5,0,8,0,30,7,6,0,13,3,30,4,9,0,13,1,30,9,0,0,9,1,-15,3,1
2,1,25,1,30,6,8,0,14,5,30,6,0,0,6,0,30,6,8,0,14,1,30,7,7,0,14,7,30,6,0,0,6,1,-15,3,1
2,2,25,1,30,6,8,0,14,5,30,6,0,0,6,0,30,6,8,0,14,1,30,7,7,0,14,7,30,6,0,0,6,1,-15,3,1
2,0,27,2,30,4,11,0,15,5,30,2,0,0,2,0,30,3,12,0,15,2,30,6,9,0,15,6,30,6,0,0,6,1,-15,3,1
2,2,27,2,30,4,11,0,15,3,30,2,0,0,2,0,30,3,12,0,15,2,30,6,9,0,15,6,30,6,0,0,6,1,-15,3,1
2,3,29,0,30,8,6,0,14,6,30,11,1,0,12,0,30,3,11,0,14,0,30,1,13,0,14,1,30,9,0,0,9,1,-15,3,1
2,4,29,0,30,8,6,0,14,6,30,11,1,0,12,0,30,3,11,0,14,0,30,1,13,0,14,1,30,9,0,0,9,1,-15,3,1
2,3,32,0,30,7,2,0,9,4,30,2,0,0,2,2,30,9,0,0,9,1,30,3,6,0,9,3,30,2,0,0,2,1,-15,3,1
2,3,39,1,30,4,7,0,11,6,30,6,0,0,6,0,30,7,4,0,11,0,30,2,9,0,11,2,30,5,0,0,5,1,-15,3,1
2,4,39,1,30,4,7,0,11,6,30,6,0,0,6,0,30,7,4,0,11,0,30,2,9,0,11,2,30,5,0,0,5,1,-15,3,1
2,2,43,0,30,5,9,0,14,6,30,6,0,0,6,0,30,6,8,0,14,1,30,1,13,0,14,0,30,5,0,0,5,1,-15,3,1
2,2,5,0,30,2,3,0,5,3,30,0,4,0,4,0,30,2,3,0,5,0,30,1,4,0,5,0,30,0,2,0,2,0,-27,3,0
2,3,5,0,30,2,3,0,5,3,30,0,4,0,4,0,30,2,3,0,5,0,30,1,4,0,5,0,30,0,2,0,2,0,-27,3,0
2,2,6,4,30,9,0,0,9,4,30,2,0,0,2,0,30,2,7,0,9,0,30,4,5,0,9,0,30,2,3,0,5,0,-27,3,0
2,3,6,4,30,9,0,0,9,4,30,2,0,0,2,0,30,2,7,0,9,0,30,4,5,0,9,0,30,2,3,0,5,0,-27,3,0
2,4,11,1,30,5,7,0,12,1,30,4,0,0,4,0,30,8,4,0,12,2,30,8,4,0,12,4,30,4,0,0,4,1,-15,3,1
2,4,13,4,30,7,0,0,7,0,30,4,0,0,4,2,30,6,1,0,7,4,30,6,1,0,7,5,30,4,0,0,4,1,-15,3,1
2,0,19,0,30,4,9,0,13,1,30,4,4,0,8,0,30,8,5,0,13,9,30,4,9,0,13,1,30,8,1,0,9,1,-15,3,1
2,1,19,0,30,4,9,0,13,1,30,4,4,0,8,0,30,8,5,0,13,9,30,4,9,0,13,1,30,8,1,0,9,1,-15,3,1
2,3,23,1,30,6,7,0,13,3,30,6,0,0,6,7,30,10,3,0,13,0,30,8,5,0,13,1,30,6,0,0,6,1,-15,3,1
2,1,25,3,30,5,9,0,14,2,30,6,0,0,6,0,30,9,5,0,14,1,30,4,10,0,14,4,30,5,1,0,6,1,-15,3,1
2,3,25,3,30,5,9,0,14,2,30,6,0,0,6,0,30,9,5,0,14,1,30,4,10,0,14,4,30,5,1,0,6,1,-15,3,1
2,1,27,1,30,5,10,0,15,3,30,1,1,0,2,0,30,5,10,0,15,1,30,9,6,0,15,4,30,6,0,0,6,1,-15,3,1
2,2,27,1,30,5,10,0,15,3,30,1,1,0,2,0,30,5,10,0,15,1,30,9,6,0,15,4,30,6,0,0,6,1,-15,3,1
2,4,32,0,30,5,4,0,9,4,30,2,0,0,2,0,30,8,1,0,9,1,30,3,6,0,9,1,30,2,0,0,2,1,-15,3,1
2,3,35,2,30,11,2,0,13,6,30,2,0,0,2,9,30,2,11,0,13,0,30,1,12,0,13,2,30,7,1,0,8,1,-15,3,1
2,2,39,0,30,1,10,0,11,6,30,6,0,0,6,0,30,5,6,0,11,0,30,2,9,0,11,4,30,5,0,0,5,1,-15,3,1
2,3,39,0,30,1,10,0,11,6,30,6,0,0,6,0,30,5,6,0,11,0,30,2,9,0,11,4,30,5,0,0,5,1,-15,3,1
2,2,5,0,30,2,3,0,5,2,30,2,2,0,4,0,30,3,2,0,5,0,30,1,4,0,5,1,30,0,2,0,2,0,-27,3,0
2,1,17,4,30,11,3,0,14,2,30,6,0,0,6,0,30,6,8,0,14,3,30,5,9,0,14,2,30,4,0,0,4,1,-15,3,1
2,2,17,4,30,11,3,0,14,2,30,6,0,0,6,0,30,6,8,0,14,3,30,5,9,0,14,2,30,4,0,0,4,1,-15,3,1
2,3,17,4,30,11,3,0,14,2,30,6,0,0,6,0,30,6,8,0,14,3,30,5,9,0,14,2,30,4,0,0,4,1,-15,3,1
2,3,31,1,30,5,7,0,12,4,30,8,0,0,8,6,30,11,1,0,12,0,30,3,9,0,12,0,30,4,2,0,6,1,-15,3,1
2,4,39,0,30,4,7,0,11,8,30,6,0,0,6,0,30,4,7,0,11,3,30,5,6,0,11,3,30,5,0,0,5,1,-15,3,1
2,3,6,2,30,9,0,0,9,4,30,2,0,0,2,0,30,2,7,0,9,0,30,4,5,0,9,0,30,3,2,0,5,0,-27,3,0
2,1,13,2,30,6,1,0,7,0,30,4,0,0,4,4,30,7,0,0,7,6,30,7,0,0,7,6,30,4,0,0,4,1,-15,3,1
2,3,15,0,30,5,8,0,13,0,30,5,1,0,6,2,30,4,9,0,13,1,30,4,9,0,13,2,30,9,0,0,9,1,-15,3,1
2,4,15,0,30,5,8,0,13,0,30,5,1,0,6,2,30,4,9,0,13,1,30,4,9,0,13,2,30,9,0,0,9,1,-15,3,1
2,4,19,0,30,2,11,0,13,0,30,8,0,0,8,0,30,7,6,0,13,9,30,4,9,0,13,4,30,9,0,0,9,1,-15,3,1
2,4,25,2,30,9,5,0,14,4,30,6,0,0,6,0,30,7,7,0,14,0,30,4,10,0,14,4,30,5,1,0,6,1,-15,3,1
2,0,27,1,30,7,8,0,15,3,30,1,1,0,2,0,30,5,10,0,15,2,30,6,9,0,15,5,30,6,0,0,6,1,-15,3,1
2,3,27,0,30,7,8,0,15,3,30,1,1,0,2,0,30,5,10,0,15,2,30,6,9,0,15,5,30,6,0,0,6,1,-15,3,1
2,4,27,0,30,7,8,0,15,3,30,1,1,0,2,0,30,5,10,0,15,2,30,6,9,0,15,5,30,6,0,0,6,1,-15,3,1
2,4,29,1,30,9,5,0,14,5,30,11,1,0,12,0,30,6,8,0,14,0,30,0,14,0,14,0,30,7,2,0,9,1,-15,3,1
2,3,45,0,30,5,8,0,13,9,30,10,0,0,10,0,30,1,12,0,13,0,30,4,9,0,13,3,30,5,0,0,5,1,-15,3,1
2,1,13,6,30,7,0,0,7,1,30,4,0,0,4,1,30,6,1,0,7,3,30,3,4,0,7,3,30,4,0,0,4,1,-15,3,1
2,2,13,6,30,7,0,0,7,1,30,4,0,0,4,1,30,6,1,0,7,3,30,3,4,0,7,3,30,4,0,0,4,1,-15,3,1
2,1,17,4,30,6,8,0,14,2,30,6,0,0,6,0,30,6,8,0,14,2,30,7,7,0,14,6,30,4,0,0,4,1,-15,3,1
2,2,17,4,30,6,8,0,14,2,30,6,0,0,6,0,30,6,8,0,14,2,30,7,7,0,14,6,30,4,0,0,4,1,-15,3,1
2,3,17,4,30,6,8,0,14,2,30,6,0,0,6,0,30,6,8,0,14,2,30,7,7,0,14,6,30,4,0,0,4,1,-15,3,1
2,4,25,0,30,10,4,0,14,2,30,6,0,0,6,0,30,8,6,0,14,1,30,5,9,0,14,3,30,5,1,0,6,1,-15,3,1
2,1,27,1,30,4,11,0,15,2,30,2,0,0,2,0,30,10,5,0,15,2,30,3,12,0,15,3,30,6,0,0,6,1,-15,3,1
2,4,3,0,30,0,4,0,4,2,30,4,0,0,4,0,30,1,3,0,4,3,30,3,1,0,4,0,30,1,2,0,3,0,-27,3,0
2,0,5,2,30,4,1,0,5,4,30,0,4,0,4,0,30,0,5,0,5,0,30,1,4,0,5,0,30,2,0,0,2,0,-27,3,0
2,1,5,2,30,4,1,0,5,4,30,0,4,0,4,0,30,0,5,0,5,0,30,1,4,0,5,0,30,2,0,0,2,0,-27,3,0
2,1,17,3,30,10,4,0,14,4,30,6,0,0,6,0,30,4,10,0,14,3,30,7,7,0,14,1,30,4,0,0,4,1,-15,3,1
2,2,17,3,30,10,4,0,14,4,30,6,0,0,6,0,30,4,10,0,14,3,30,7,7,0,14,1,30,4,0,0,4,1,-15,3,1
2,0,19,1,30,4,9,0,13,3,30,7,1,0,8,3,30,4,9,0,13,0,30,7,6,0,13,1,30,8,1,0,9,1,-15,3,1
2,1,19,1,30,4,9,0,13,3,30,7,1,0,8,3,30,4,9,0,13,0,30,7,6,0,13,1,30,8,1,0,9,1,-15,3,1
2,2,19,1,30,4,9,0,13,3,30,7,1,0,8,3,30,4,9,0,13,0,30,7,6,0,13,1,30,8,1,0,9,1,-15,3,1
2,1,25,1,30,6,8,0,14,3,30,6,0,0,6,0,30,9,5,0,14,1,30,9,5,0,14,7,30,6,0,0,6,1,-15,3,1
2,3,27,0,30,4,11,0,15,4,30,2,0,0,2,0,30,2,13,0,15,2,30,2,13,0,15,4,30,6,0,0,6,1,-15,3,1
2,4,27,0,30,4,11,0,15,4,30,2,0,0,2,0,30,2,13,0,15,2,30,2,13,0,15,4,30,6,0,0,6,1,-15,3,1
2,3,29,0,30,6,8,0,14,5,30,12,0,0,12,0,30,6,8,0,14,0,30,1,13,0,14,0,30,7,2,0,9,1,-15,3,1
2,4,31,1,30,6,6,0,12,4,30,8,0,0,8,7,30,8,4,0,12,0,30,3,9,0,12,1,30,2,4,0,6,1,-15,3,1
2,0,6,1,30,8,1,0,9,4,30,2,0,0,2,0,30,2,7,0,9,0,30,4,5,0,9,0,30,4,1,0,5,0,-27,3,0
2,4,8,1,30,7,0,0,7,4,30,2,0,0,2,7,30,2,5,0,7,2,30,7,0,0,7,3,30,3,0,0,3,0,-27,3,0
2,3,11,1,30,4,8,0,12,0,30,4,0,0,4,0,30,7,5,0,12,5,30,6,6,0,12,6,30,4,0,0,4,1,-15,3,1
2,2,17,5,30,10,4,0,14,3,30,6,0,0,6,0,30,6,8,0,14,0,30,5,9,0,14,2,30,4,0,0,4,1,-15,3,1
2,3,17,5,30,10,4,0,14,3,30,6,0,0,6,0,30,6,8,0,14,0,30,5,9,0,14,2,30,4,0,0,4,1,-15,3,1
2,4,19,0,30,3,10,0,13,0,30,7,1,0,8,0,30,7,6,0,13,4,30,3,10,0,13,2,30,8,1,0,9,1,-15,3,1
2,4,31,3,30,7,5,0,12,3,30,8,0,0,8,3,30,11,1,0,12,0,30,3,9,0,12,0,30,2,4,0,6,1,-15,3,1
2,3,47,0,30,0,14,0,14,6,30,4,0,0,4,0,30,3,11,0,14,0,30,2,12,0,14,5,30,7,0,0,7,1,-15,3,1
2,2,17,2,30,10,4,0,14,3,30,6,0,0,6,3,30,5,9,0,14,2,30,4,10,0,14,4,30,4,0,0,4,1,-15,3,1
2,3,17,2,30,10,4,0,14,3,30,6,0,0,6,3,30,5,9,0,14,2,30,4,10,0,14,4,30,4,0,0,4,1,-15,3,1
2,3,19,0,30,3,10,0,13,2,30,7,1,0,8,0,30,6,7,0,13,3,30,4,9,0,13,2,30,7,2,0,9,1,-15,3,1
2,4,19,0,30,3,10,0,13,2,30,7,1,0,8,0,30,6,7,0,13,3,30,4,9,0,13,2,30,7,2,0,9,1,-15,3,1
2,3,23,1,30,5,8,0,13,0,30,6,0,0,6,3,30,13,0,0,13,0,30,6,7,0,13,2,30,6,0,0,6,1,-15,3,1
2,3,25,4,30,5,9,0,14,5,30,6,0,0,6,0,30,7,7,0,14,1,30,4,10,0,14,4,30,5,1,0,6,1,-15,3,1
2,4,26,0,30,7,2,0,9,5,30,4,0,0,4,5,30,0,9,0,9,0,30,3,6,0,9,4,30,3,0,0,3,1,-15,3,1
2,1,27,1,30,4,11,0,15,4,30,2,0,0,2,0,30,6,9,0,15,0,30,4,11,0,15,1,30,5,1,0,6,1,-15,3,1
2,2,27,1,30,4,11,0,15,4,30,2,0,0,2,0,30,6,9,0,15,0,30,4,11,0,15,1,30,5,1,0,6,1,-15,3,1
2,3,27,1,30,4,11,0,15,4,30,2,0,0,2,0,30,6,9,0,15,0,30,4,11,0,15,1,30,5,1,0,6,1,-15,3,1
2,4,27,1,30,4,11,0,15,4,30,2,0,0,2,0,30,6,9,0,15,0,30,4,11,0,15,1,30,5,1,0,6,1,-15,3,1
2,4,29,0,30,6,8,0,14,6,30,7,5,0,12,0,30,4,10,0,14,0,30,1,13,0,14,0,30,9,0,0,9,1,-15,3,1
2,2,36,0,30,4,5,0,9,6,30,0,2,0,2,6,30,3,6,0,9,0,30,4,5,0,9,6,30,3,0,0,3,1,-15,3,1
2,4,36,0,30,4,5,0,9,6,30,0,2,0,2,6,30,3,6,0,9,0,30,4,5,0,9,6,30,3,0,0,3,1,-15,3,1
2,2,43,0,30,5,9,0,14,7,30,6,0,0,6,0,30,4,10,0,14,1,30,1,13,0,14,7,30,5,0,0,5,1,-15,3,1
2,3,43,0,30,5,9,0,14,7,30,6,0,0,6,0,30,4,10,0,14,1,30,1,13,0,14,7,30,5,0,0,5,1,-15,3,1
2,3,1,0,30,4,6,0,10,4,30,2,0,0,2,3,30,5,5,0,10,4,30,10,0,0,10,6,30,6,0,0,6,0,-27,3,0
2,4,1,0,30,4,6,0,10,4,30,2,0,0,2,3,30,5,5,0,10,4,30,10,0,0,10,6,30,6,0,0,6,0,-27,3,0
2,2,4,0,30,8,0,0,8,4,30,4,0,0,4,1,30,1,7,0,8,0,30,5,3,0,8,4,30,4,0,0,4,0,-27,3,0
2,4,4,0,30,8,0,0,8,4,30,4,0,0,4,1,30,1,7,0,8,0,30,5,3,0,8,4,30,4,0,0,4,0,-27,3,0
2,4,8,1,30,7,0,0,7,4,30,2,0,0,2,0,30,3,4,0,7,2,30,7,0,0,7,2,30,3,0,0,3,0,-27,3,0
2,1,13,1,30,6,1,0,7,0,30,4,0,0,4,2,30,6,1,0,7,11,30,6,1,0,7,6,30,4,0,0,4,1,-15,3,1
2,3,19,1,30,5,8,0,13,2,30,8,0,0,8,0,30,5,8,0,13,0,30,4,9,0,13,0,30,9,0,0,9,1,-15,3,1
2,1,23,1,30,5,8,0,13,1,30,6,0,0,6,5,30,13,0,0,13,0,30,6,7,0,13,3,30,6,0,0,6,1,-15,3,1
2,4,23,1,30,5,8,0,13,1,30,6,0,0,6,0,30,13,0,0,13,0,30,6,7,0,13,3,30,6,0,0,6,1,-15,3,1
2,3,25,1,30,3,11,0,14,4,30,6,0,0,6,0,30,4,10,0,14,2,30,6,8,0,14,3,30,6,0,0,6,1,-15,3,1
2,3,27,2,30,7,8,0,15,3,30,1,1,0,2,0,30,6,9,0,15,0,30,6,9,0,15,0,30,6,0,0,6,1,-15,3,1
2,4,27,2,30,7,8,0,15,3,30,1,1,0,2,0,30,6,9,0,15,0,30,6,9,0,15,0,30,6,0,0,6,1,-15,3,1
2,0,31,4,30,8,4,0,12,5,30,8,0,0,8,5,30,10,2,0,12,0,30,3,9,0,12,2,30,4,2,0,6,1,-15,3,1
2,1,31,4,30,8,4,0,12,5,30,8,0,0,8,5,30,10,2,0,12,0,30,3,9,0,12,2,30,4,2,0,6,1,-15,3,1
2,3,31,4,30,8,4,0,12,5,30,8,0,0,8,5,30,10,2,0,12,0,30,3,9,0,12,2,30,4,2,0,6,1,-15,3,1
2,3,32,0,30,6,3,0,9,3,30,2,0,0,2,0,30,9,0,0,9,1,30,3,6,0,9,5,30,2,0,0,2,1,-15,3,1
2,0,4,2,30,8,0,0,8,4,30,2,2,0,4,1,30,6,2,0,8,0,30,5,3,0,8,2,30,4,0,0,4,0,-27,3,0
2,2,4,2,30,8,0,0,8,4,30,2,2,0,4,1,30,6,2,0,8,0,30,5,3,0,8,0,30,4,0,0,4,0,-27,3,0
2,3,4,2,30,8,0,0,8,4,30,2,2,0,4,1,30,6,2,0,8,0,30,5,3,0,8,0,30,4,0,0,4,0,-27,3,0
2,4,4,2,30,8,0,0,8,4,30,2,2,0,4,1,30,6,2,0,8,0,30,5,3,0,8,0,30,4,0,0,4,0,-27,3,0
2,2,11,0,30,3,9,0,12,1,30,4,0,0,4,0,30,6,6,0,12,4,30,7,5,0,12,4,30,4,0,0,4,1,-15,3,1
2,3,11,0,30,3,9,0,12,1,30,4,0,0,4,0,30,6,6,0,12,4,30,7,5,0,12,4,30,4,0,0,4,1,-15,3,1
2,4,11,0,30,3,9,0,12,1,30,4,0,0,4,0,30,6,6,0,12,4,30,7,5,0,12,4,30,4,0,0,4,1,-15,3,1
2,1,13,1,30,5,2,0,7,0,30,4,0,0,4,3,30,6,1,0,7,5,30,6,1,0,7,4,30,4,0,0,4,1,-15,3,1
2,3,13,1,30,5,2,0,7,0,30,4,0,0,4,3,30,6,1,0,7,5,30,6,1,0,7,4,30,4,0,0,4,1,-15,3,1
2,2,19,0,30,7,6,0,13,2,30,4,4,0,8,0,30,4,9,0,13,2,30,5,8,0,13,3,30,9,0,0,9,1,-15,3,1
2,4,19,0,30,7,6,0,13,2,30,4,4,0,8,0,30,4,9,0,13,2,30,5,8,0,13,3,30,9,0,0,9,1,-15,3,1
2,2,27,1,30,3,12,0,15,5,30,2,0,0,2,0,30,6,9,0,15,0,30,5,10,0,15,6,30,6,0,0,6,1,-15,3,1
2,3,27,1,30,3,12,0,15,5,30,2,0,0,2,0,30,6,9,0,15,0,30,5,10,0,15,6,30,6,0,0,6,1,-15,3,1
2,2,35,1,30,9,4,0,13,5,30,2,0,0,2,4,30,3,10,0,13,0,30,1,12,0,13,5,30,8,0,0,8,1,-15,3,1
2,3,35,1,30,9,4,0,13,5,30,2,0,0,2,4,30,3,10,0,13,0,30,1,12,0,13,5,30,8,0,0,8,1,-15,3,1
2,1,6,0,30,9,0,0,9,3,30,2,0,0,2,0,30,2,7,0,9,0,30,3,6,0,9,4,30,5,0,0,5,0,-27,3,0
2,1,19,0,30,2,11,0,13,2,30,4,4,0,8,0,30,6,7,0,13,5,30,6,7,0,13,2,30,9,0,0,9,1,-15,3,1
2,2,25,1,30,3,11,0,14,4,30,6,0,0,6,0,30,10,4,0,14,2,30,6,8,0,14,3,30,5,1,0,6,1,-15,3,1
2,4,25,1,30,3,11,0,14,4,30,6,0,0,6,0,30,10,4,0,14,2,30,6,8,0,14,3,30,5,1,0,6,1,-15,3,1
2,1,27,0,30,5,10,0,15,1,30,2,0,0,2,0,30,5,10,0,15,3,30,4,11,0,15,5,30,6,0,0,6,1,-15,3,1
2,2,27,0,30,5,10,0,15,1,30,2,0,0,2,0,30,5,10,0,15,3,30,4,11,0,15,5,30,6,0,0,6,1,-15,3,1
2,4,27,0,30,5,10,0,15,1,30,2,0,0,2,0,30,5,10,0,15,3,30,4,11,0,15,1,30,6,0,0,6,1,-15,3,1
2,0,37,1,30,5,6,0,11,5,30,8,0,0,8,0,30,8,3,0,11,3,30,4,7,0,11,5,30,6,0,0,6,1,-15,3,1
2,2,37,1,30,5,6,0,11,5,30,8,0,0,8,0,30,8,3,0,11,3,30,4,7,0,11,5,30,6,0,0,6,1,-15,3,1
2,3,13,2,30,6,1,0,7,1,30,4,0,0,4,2,30,6,1,0,7,6,30,4,3,0,7,3,30,4,0,0,4,1,-15,3,1
2,4,13,2,30,6,1,0,7,1,30,4,0,0,4,2,30,6,1,0,7,6,30,4,3,0,7,3,30,4,0,0,4,1,-15,3,1
2,4,15,0,30,6,7,0,13,0,30,6,0,0,6,0,30,8,5,0,13,1,30,3,10,0,13,3,30,7,2,0,9,1,-15,3,1
2,3,25,0,30,6,8,0,14,3,30,6,0,0,6,0,30,8,6,0,14,1,30,6,8,0,14,2,30,6,0,0,6,1,-15,3,1
2,4,25,0,30,6,8,0,14,3,30,6,0,0,6,0,30,8,6,0,14,1,30,6,8,0,14,2,30,6,0,0,6,1,-15,3,1
2,2,27,1,30,9,6,0,15,2,30,2,0,0,2,0,30,3,12,0,15,0,30,3,12,0,15,3,30,6,0,0,6,1,-15,3,1
2,4,27,1,30,9,6,0,15,2,30,2,0,0,2,0,30,3,12,0,15,0,30,3,12,0,15,3,30,6,0,0,6,1,-15,3,1
2,3,39,0,30,4,7,0,11,6,30,6,0,0,6,0,30,7,4,0,11,1,30,3,8,0,11,4,30,5,0,0,5,1,-15,3,1
2,4,39,0,30,4,7,0,11,6,30,6,0,0,6,0,30,7,4,0,11,1,30,3,8,0,11,4,30,5,0,0,5,1,-15,3,1
2,4,3,1,30,4,7,0,11,4,30,8,0,0,8,0,30,1,10,0,11,12,30,4,7,0,11,2,30,3,4,0,7,0,-27,3,0
2,2,6,0,30,9,0,0,9,3,30,2,0,0,2,0,30,3,6,0,9,0,30,3,6,0,9,0,30,4,1,0,5,0,-27,3,0
2,3,6,0,30,9,0,0,9,3,30,2,0,0,2,0,30,3,6,0,9,0,30,3,6,0,9,0,30,4,1,0,5,0,-27,3,0
2,4,6,0,30,9,0,0,9,3,30,2,0,0,2,0,30,3,6,0,9,0,30,3,6,0,9,0,30,4,1,0,5,0,-27,3,0
2,4,13,3,30,7,0,0,7,0,30,4,0,0,4,2,30,6,1,0,7,8,30,4,3,0,7,4,30,4,0,0,4,1,-15,3,1
2,4,17,2,30,8,6,0,14,0,30,6,0,0,6,0,30,7,7,0,14,1,30,6,8,0,14,1,30,3,1,0,4,1,-15,3,1
2,2,21,2,30,7,3,0,10,4,30,5,1,0,6,0,30,3,7,0,10,2,30,5,5,0,10,5,30,4,0,0,4,1,-15,3,1
2,3,25,0,30,3,11,0,14,3,30,6,0,0,6,0,30,13,1,0,14,1,30,5,9,0,14,5,30,5,1,0,6,1,-15,3,1
2,4,25,0,30,3,11,0,14,3,30,6,0,0,6,0,30,13,1,0,14,1,30,5,9,0,14,5,30,5,1,0,6,1,-15,3,1
2,2,33,5,30,8,3,0,11,5,30,4,0,0,4,4,30,10,1,0,11,0,30,3,8,0,11,3,30,4,0,0,4,1,-15,3,1
2,3,33,5,30,8,3,0,11,5,30,4,0,0,4,4,30,10,1,0,11,0,30,3,8,0,11,3,30,4,0,0,4,1,-15,3,1
2,4,33,5,30,8,3,0,11,5,30,4,0,0,4,4,30,10,1,0,11,0,30,3,8,0,11,3,30,4,0,0,4,1,-15,3,1
2,4,36,0,30,1,8,0,9,4,30,2,0,0,2,0,30,7,2,0,9,1,30,1,8,0,9,6,30,3,0,0,3,1,-15,3,1
2,0,4,2,30,6,2,0,8,5,30,4,0,0,4,0,30,2,6,0,8,0,30,7,1,0,8,2,30,4,0,0,4,0,-27,3,0
2,1,4,2,30,6,2,0,8,5,30,4,0,0,4,0,30,2,6,0,8,0,30,7,1,0,8,2,30,4,0,0,4,0,-27,3,0
2,2,4,2,30,6,2,0,8,5,30,4,0,0,4,0,30,2,6,0,8,0,30,7,1,0,8,2,30,4,0,0,4,0,-27,3,0
2,4,8,1,30,7,0,0,7,4,30,2,0,0,2,2,30,5,2,0,7,2,30,7,0,0,7,0,30,3,0,0,3,0,-27,3,0
2,1,17,4,30,11,3,0,14,2,30,6,0,0,6,0,30,7,7,0,14,3,30,4,10,0,14,2,30,4,0,0,4,1,-15,3,1
2,2,17,4,30,11,3,0,14,2,30,6,0,0,6,0,30,7,7,0,14,3,30,4,10,0,14,2,30,4,0,0,4,1,-15,3,1
2,0,27,1,30,4,11,0,15,3,30,1,1,0,2,0,30,4,11,0,15,0,30,7,8,0,15,6,30,6,0,0,6,1,-15,3,1
2,1,27,1,30,4,11,0,15,3,30,1,1,0,2,0,30,4,11,0,15,0,30,7,8,0,15,6,30,6,0,0,6,1,-15,3,1
2,2,27,1,30,4,11,0,15,3,30,1,1,0,2,0,30,4,11,0,15,0,30,7,8,0,15,6,30,6,0,0,6,1,-15,3,1
2,4,27,1,30,4,11,0,15,3,30,1,1,0,2,0,30,4,11,0,15,0,30,7,8,0,15,6,30,6,0,0,6,1,-15,3,1
2,2,38,4,30,1,9,0,10,8,30,6,0,0,6,0,30,1,9,0,10,0,30,2,8,0,10,8,30,6,0,0,6,1,-15,3,1
2,0,41,0,30,10,2,0,12,6,30,8,0,0,8,0,30,3,9,0,12,0,30,2,10,0,12,5,30,7,0,0,7,1,-15,3,1
2,2,5,0,30,2,3,0,5,3,30,0,4,0,4,0,30,1,4,0,5,0,30,1,4,0,5,0,30,0,2,0,2,0,-27,3,0
2,3,5,0,30,2,3,0,5,3,30,0,4,0,4,0,30,1,4,0,5,0,30,1,4,0,5,0,30,0,2,0,2,0,-27,3,0
2,4,5,0,30,2,3,0,5,3,30,0,4,0,4,0,30,1,4,0,5,0,30,1,4,0,5,0,30,0,2,0,2,0,-27,3,0
2,3,6,2,30,8,1,0,9,4,30,2,0,0,2,0,30,2,7,0,9,0,30,4,5,0,9,0,30,3,2,0,5,0,-27,3,0
2,3,8,1,30,7,0,0,7,5,30,2,0,0,2,4,30,1,6,0,7,1,30,7,0,0,7,5,30,3,0,0,3,0,-27,3,0
2,4,8,1,30,7,0,0,7,5,30,2,0,0,2,4,30,1,6,0,7,1,30,7,0,0,7,5,30,3,0,0,3,0,-27,3,0
2,3,9,0,30,5,6,0,11,3,30,6,0,0,6,1,30,8,3,0,11,5,30,3,8,0,11,0,30,4,0,0,4,0,-27,3,0
2,4,9,0,30,5,6,0,11,3,30,6,0,0,6,1,30,8,3,0,11,5,30,3,8,0,11,0,30,4,0,0,4,0,-27,3,0
2,1,13,1,30,5,2,0,7,1,30,4,0,0,4,4,30,7,0,0,7,8,30,7,0,0,7,2,30,4,0,0,4,1,-15,3,1
2,1,17,4,30,9,5,0,14,1,30,6,0,0,6,0,30,6,8,0,14,1,30,7,7,0,14,6,30,4,0,0,4,1,-15,3,1
2,2,17,4,30,9,5,0,14,1,30,6,0,0,6,0,30,6,8,0,14,1,30,7,7,0,14,6,30,4,0,0,4,1,-15,3,1
2,2,19,1,30,3,10,0,13,0,30,5,3,0,8,0,30,4,9,0,13,9,30,3,10,0,13,0,30,9,0,0,9,1,-15,3,1
2,4,19,1,30,3,10,0,13,0,30,5,3,0,8,0,30,4,9,0,13,9,30,3,10,0,13,0,30,9,0,0,9,1,-15,3,1
2,2,23,0,30,6,7,0,13,2,30,6,0,0,6,5,30,12,1,0,13,2,30,4,9,0,13,5,30,6,0,0,6,1,-15,3,1
2,3,23,0,30,6,7,0,13,2,30,6,0,0,6,5,30,12,1,0,13,2,30,4,9,0,13,5,30,6,0,0,6,1,-15,3,1
2,2,29,0,30,6,8,0,14,6,30,12,0,0,12,0,30,4,10,0,14,0,30,1,13,0,14,1,30,9,0,0,9,1,-15,3,1
2,4,31,3,30,5,7,0,12,4,30,8,0,0,8,5,30,10,2,0,12,0,30,3,9,0,12,0,30,3,3,0,6,1,-15,3,1
2,3,32,0,30,8,1,0,9,4,30,2,0,0,2,0,30,9,0,0,9,1,30,3,6,0,9,3,30,2,0,0,2,1,-15,3,1
2,0,41,0,30,7,5,0,12,5,30,8,0,0,8,0,30,8,4,0,12,0,30,3,9,0,12,2,30,7,0,0,7,1,-15,3,1
2,1,41,0,30,7,5,0,12,5,30,8,0,0,8,0,30,8,4,0,12,0,30,3,9,0,12,2,30,7,0,0,7,1,-15,3,1
2,2,1,0,30,7,3,0,10,4,30,2,0,0,2,0,30,4,6,0,10,4,30,6,4,0,10,6,30,6,0,0,6,0,-27,3,0
2,2,13,3,30,5,2,0,7,0,30,4,0,0,4,1,30,6,1,0,7,9,30,6,1,0,7,5,30,4,0,0,4,1,-15,3,1
2,4,13,3,30,5,2,0,7,0,30,4,0,0,4,1,30,6,1,0,7,9,30,6,1,0,7,5,30,4,0,0,4,1,-15,3,1
2,4,27,1,30,3,12,0,15,5,30,2,0,0,2,0,30,8,7,0,15,0,30,6,9,0,15,2,30,6,0,0,6,1,-15,3,1
2,0,29,0,30,6,8,0,14,4,30,11,1,0,12,0,30,9,5,0,14,0,30,1,13,0,14,1,30,9,0,0,9,1,-15,3,1
2,3,29,0,30,6,8,0,14,4,30,11,1,0,12,0,30,9,5,0,14,0,30,1,13,0,14,0,30,9,0,0,9,1,-15,3,1
2,4,29,0,30,6,8,0,14,4,30,11,1,0,12,0,30,9,5,0,14,0,30,1,13,0,14,0,30,9,0,0,9,1,-15,3,1
2,4,35,0,30,9,4,0,13,6,30,2,0,0,2,3,30,3,10,0,13,0,30,1,12,0,13,0,30,8,0,0,8,1,-15,3,1
2,4,6,1,30,8,1,0,9,4,30,2,0,0,2,0,30,3,6,0,9,0,30,4,5,0,9,0,30,4,1,0,5,0,-27,3,0
2,3,11,2,30,3,9,0,12,0,30,4,0,0,4,0,30,8,4,0,12,2,30,2,10,0,12,0,30,4,0,0,4,1,-15,3,1
2,3,13,1,30,3,0,0,3,1,30,2,0,0,2,0,30,2,1,0,3,4,30,2,1,0,3,2,30,2,0,0,2,1,-15,3,1
2,4,13,1,30,3,0,0,3,1,30,2,0,0,2,0,30,2,1,0,3,4,30,2,1,0,3,2,30,2,0,0,2,1,-15,3,1
2,3,19,1,30,5,8,0,13,2,30,4,4,0,8,0,30,4,9,0,13,3,30,6,7,0,13,0,30,9,0,0,9,1,-15,3,1
2,4,19,1,30,5,8,0,13,2,30,4,4,0,8,0,30,4,9,0,13,3,30,6,7,0,13,0,30,9,0,0,9,1,-15,3,1
2,3,25,0,30,7,7,0,14,3,30,6,0,0,6,0,30,7,7,0,14,1,30,5,9,0,14,4,30,6,0,0,6,1,-15,3,1
2,4,25,0,30,7,7,0,14,3,30,6,0,0,6,0,30,7,7,0,14,1,30,5,9,0,14,4,30,6,0,0,6,1,-15,3,1
2,2,27,1,30,4,11,0,15,4,30,1,1,0,2,0,30,5,10,0,15,2,30,7,8,0,15,5,30,6,0,0,6,1,-15,3,1
2,4,29,0,30,5,9,0,14,5,30,11,1,0,12,0,30,3,11,0,14,0,30,0,14,0,14,0,30,6,3,0,9,1,-15,3,1
2,2,8,3,30,7,0,0,7,5,30,2,0,0,2,4,30,4,3,0,7,3,30,7,0,0,7,1,30,3,0,0,3,0,-27,3,0
2,3,8,3,30,7,0,0,7,5,30,2,0,0,2,4,30,4,3,0,7,3,30,7,0,0,7,1,30,3,0,0,3,0,-27,3,0
2,4,9,0,30,7,4,0,11,3,30,6,0,0,6,1,30,5,6,0,11,2,30,3,8,0,11,4,30,2,2,0,4,0,-27,3,0
2,1,13,1,30,7,0,0,7,1,30,4,0,0,4,4,30,7,0,0,7,4,30,6,1,0,7,5,30,4,0,0,4,1,-15,3,1
2,2,13,1,30,7,0,0,7,1,30,4,0,0,4,4,30,7,0,0,7,4,30,6,1,0,7,5,30,4,0,0,4,1,-15,3,1
2,3,13,1,30,7,0,0,7,1,30,4,0,0,4,4,30,7,0,0,7,4,30,6,1,0,7,5,30,4,0,0,4,1,-15,3,1
2,4,13,1,30,7,0,0,7,1,30,4,0,0,4,4,30,7,0,0,7,4,30,6,1,0,7,5,30,4,0,0,4,1,-15,3,1
2,0,17,3,30,10,4,0,14,3,30,6,0,0,6,0,30,5,9,0,14,5,30,6,8,0,14,3,30,4,0,0,4,1,-15,3,1
2,3,17,3,30,10,4,0,14,3,30,6,0,0,6,0,30,5,9,0,14,5,30,6,8,0,14,3,30,4,0,0,4,1,-15,3,1
2,2,19,0,30,4,9,0,13,2,30,5,3,0,8,0,30,4,9,0,13,3,30,7,6,0,13,0,30,8,1,0,9,1,-15,3,1
2,4,19,0,30,4,9,0,13,2,30,5,3,0,8,0,30,4,9,0,13,3,30,7,6,0,13,0,30,8,1,0,9,1,-15,3,1
2,2,25,1,30,5,9,0,14,2,30,6,0,0,6,0,30,14,0,0,14,1,30,5,9,0,14,3,30,5,1,0,6,1,-15,3,1
2,3,25,1,30,5,9,0,14,2,30,6,0,0,6,0,30,14,0,0,14,1,30,5,9,0,14,3,30,5,1,0,6,1,-15,3,1
2,4,25,1,30,5,9,0,14,2,30,6,0,0,6,0,30,14,0,0,14,1,30,5,9,0,14,3,30,5,1,0,6,1,-15,3,1
2,2,27,1,30,4,11,0,15,4,30,2,0,0,2,0,30,2,13,0,15,4,30,4,11,0,15,8,30,6,0,0,6,1,-15,3,1
2,1,5,0,30,3,2,0,5,3,30,1,3,0,4,0,30,0,5,0,5,0,30,1,4,0,5,0,30,0,2,0,2,0,-27,3,0
2,3,6,0,30,8,1,0,9,4,30,2,0,0,2,0,30,3,6,0,9,0,30,4,5,0,9,0,30,5,0,0,5,0,-27,3,0
2,4,7,0,30,3,6,0,9,2,30,4,0,0,4,2,30,8,1,0,9,8,30,3,6,0,9,1,30,5,1,0,6,0,-27,3,0
2,1,19,0,30,4,9,0,13,2,30,4,4,0,8,0,30,7,6,0,13,10,30,4,9,0,13,1,30,9,0,0,9,1,-15,3,1
2,4,19,0,30,4,9,0,13,2,30,4,4,0,8,0,30,7,6,0,13,10,30,4,9,0,13,1,30,9,0,0,9,1,-15,3,1
2,1,25,1,30,8,6,0,14,2,30,5,1,0,6,0,30,7,7,0,14,3,30,4,10,0,14,4,30,6,0,0,6,1,-15,3,1
2,2,27,0,30,2,13,0,15,5,30,2,0,0,2,0,30,5,10,0,15,2,30,4,11,0,15,5,30,6,0,0,6,1,-15,3,1
2,2,29,0,30,4,10,0,14,4,30,12,0,0,12,0,30,6,8,0,14,0,30,2,12,0,14,4,30,9,0,0,9,1,-15,3,1
2,4,29,0,30,4,10,0,14,4,30,12,0,0,12,0,30,6,8,0,14,0,30,2,12,0,14,4,30,9,0,0,9,1,-15,3,1
2,0,35,0,30,7,6,0,13,6,30,2,0,0,2,1,30,2,11,0,13,1,30,7,6,0,13,7,30,8,0,0,8,1,-15,3,1
2,1,35,0,30,7,6,0,13,6,30,2,0,0,2,1,30,2,11,0,13,1,30,7,6,0,13,7,30,8,0,0,8,1,-15,3,1
2,2,35,0,30,7,6,0,13,6,30,2,0,0,2,1,30,2,11,0,13,1,30,7,6,0,13,7,30,8,0,0,8,1,-15,3,1
2,3,35,0,30,7,6,0,13,6,30,2,0,0,2,1,30,2,11,0,13,1,30,7,6,0,13,7,30,8,0,0,8,1,-15,3,1
2,4,4,2,30,7,1,0,8,4,30,4,0,0,4,1,30,3,5,0,8,0,30,5,3,0,8,2,30,4,0,0,4,0,-27,3,0
2,0,5,2,30,2,3,0,5,3,30,4,0,0,4,0,30,0,5,0,5,0,30,1,4,0,5,0,30,0,2,0,2,0,-27,3,0
2,1,5,2,30,2,3,0,5,3,30,4,0,0,4,0,30,0,5,0,5,0,30,1,4,0,5,0,30,0,2,0,2,0,-27,3,0
2,4,5,2,30,2,3,0,5,3,30,4,0,0,4,0,30,0,5,0,5,0,30,1,4,0,5,0,30,0,2,0,2,0,-27,3,0
2,2,6,0,30,8,1,0,9,4,30,2,0,0,2,0,30,2,7,0,9,0,30,4,5,0,9,0,30,3,2,0,5,0,-27,3,0
2,3,7,0,30,2,7,0,9,2,30,4,0,0,4,2,30,6,3,0,9,6,30,3,6,0,9,5,30,3,3,0,6,0,-27,3,0
2,4,8,1,30,7,0,0,7,4,30,2,0,0,2,3,30,4,3,0,7,0,30,7,0,0,7,4,30,3,0,0,3,0,-27,3,0
2,2,13,3,30,6,1,0,7,0,30,4,0,0,4,1,30,6,1,0,7,12,30,7,0,0,7,5,30,4,0,0,4,1,-15,3,1
2,2,17,5,30,9,5,0,14,2,30,6,0,0,6,0,30,10,4,0,14,1,30,7,7,0,14,5,30,4,0,0,4,1,-15,3,1
2,3,17,5,30,9,5,0,14,2,30,6,0,0,6,0,30,10,4,0,14,1,30,7,7,0,14,5,30,4,0,0,4,1,-15,3,1
2,4,19,0,30,6,7,0,13,2,30,8,0,0,8,4,30,4,9,0,13,1,30,4,9,0,13,0,30,7,2,0,9,1,-15,3,1
2,0,38,0,30,2,8,0,10,7,30,6,0,0,6,0,30,1,9,0,10,0,30,4,6,0,10,8,30,6,0,0,6,1,-15,3,1
2,1,17,2,30,10,4,0,14,3,30,6,0,0,6,2,30,6,8,0,14,5,30,4,10,0,14,4,30,4,0,0,4,1,-15,3,1
2,2,17,2,30,10,4,0,14,3,30,6,0,0,6,2,30,6,8,0,14,5,30,4,10,0,14,4,30,4,0,0,4,1,-15,3,1
2,2,19,0,30,2,11,0,13,2,30,6,2,0,8,0,30,4,9,0,13,4,30,5,8,0,13,1,30,8,1,0,9,1,-15,3,1
2,3,23,1,30,8,5,0,13,1,30,6,0,0,6,4,30,11,2,0,13,0,30,5,8,0,13,2,30,5,1,0,6,1,-15,3,1
2,2,25,3,30,6,8,0,14,5,30,6,0,0,6,0,30,8,6,0,14,1,30,5,9,0,14,3,30,5,1,0,6,1,-15,3,1
2,3,25,3,30,6,8,0,14,5,30,6,0,0,6,0,30,8,6,0,14,1,30,5,9,0,14,3,30,5,1,0,6,1,-15,3,1
2,2,27,0,30,4,11,0,15,2,30,2,0,0,2,0,30,4,11,0,15,2,30,4,11,0,15,3,30,6,0,0,6,1,-15,3,1
2,3,27,0,30,4,11,0,15,2,30,2,0,0,2,0,30,4,11,0,15,2,30,4,11,0,15,3,30,6,0,0,6,1,-15,3,1
2,4,27,0,30,4,11,0,15,2,30,2,0,0,2,0,30,4,11,0,15,2,30,4,11,0,15,3,30,6,0,0,6,1,-15,3,1
2,3,29,0,30,7,7,0,14,6,30,9,3,0,12,0,30,4,10,0,14,0,30,1,13,0,14,3,30,9,0,0,9,1,-15,3,1
2,2,47,0,30,0,14,0,14,10,30,4,0,0,4,0,30,3,11,0,14,7,30,4,10,0,14,3,30,7,0,0,7,1,-15,3,1
2,2,5,0,30,3,2,0,5,1,30,2,2,0,4,0,30,0,5,0,5,0,30,1,4,0,5,0,30,0,2,0,2,0,-27,3,0
2,3,5,0,30,3,2,0,5,1,30,2,2,0,4,0,30,0,5,0,5,0,30,1,4,0,5,0,30,0,2,0,2,0,-27,3,0
2,1,17,2,30,10,4,0,14,2,30,6,0,0,6,0,30,6,8,0,14,5,30,4,10,0,14,2,30,4,0,0,4,1,-15,3,1
2,4,17,2,30,10,4,0,14,2,30,6,0,0,6,0,30,6,8,0,14,5,30,4,10,0,14,2,30,4,0,0,4,1,-15,3,1
2,2,19,0,30,3,10,0,13,2,30,4,4,0,8,0,30,6,7,0,13,1,30,3,10,0,13,1,30,8,1,0,9,1,-15,3,1
2,4,27,1,30,3,12,0,15,2,30,1,1,0,2,0,30,8,7,0,15,0,30,3,12,0,15,0,30,6,0,0,6,1,-15,3,1
2,1,4,2,30,5,3,0,8,5,30,4,0,0,4,0,30,2,6,0,8,1,30,8,0,0,8,1,30,3,1,0,4,0,-27,3,0
2,3,4,2,30,5,3,0,8,5,30,4,0,0,4,0,30,2,6,0,8,1,30,8,0,0,8,1,30,3,1,0,4,0,-27,3,0
2,4,13,1,30,4,3,0,7,0,30,4,0,0,4,7,30,7,0,0,7,9,30,6,1,0,7,2,30,4,0,0,4,1,-15,3,1
2,2,15,1,30,7,6,0,13,0,30,5,1,0,6,0,30,3,10,0,13,0,30,3,10,0,13,2,30,9,0,0,9,1,-15,3,1
2,3,15,1,30,7,6,0,13,0,30,5,1,0,6,0,30,3,10,0,13,0,30,3,10,0,13,2,30,9,0,0,9,1,-15,3,1
2,2,17,3,30,10,4,0,14,2,30,6,0,0,6,0,30,5,9,0,14,4,30,5,9,0,14,4,30,4,0,0,4,1,-15,3,1
2,4,17,3,30,10,4,0,14,2,30,6,0,0,6,0,30,5,9,0,14,4,30,5,9,0,14,4,30,4,0,0,4,1,-15,3,1
2,0,19,3,30,2,11,0,13,2,30,8,0,0,8,0,30,7,6,0,13,7,30,4,9,0,13,0,30,5,4,0,9,1,-15,3,1
2,2,19,3,30,2,11,0,13,2,30,8,0,0,8,0,30,7,6,0,13,7,30,4,9,0,13,0,30,5,4,0,9,1,-15,3,1
2,4,22,1,30,7,1,0,8,3,30,2,0,0,2,6,30,5,3,0,8,1,30,4,4,0,8,3,30,1,3,0,4,1,-15,3,1
2,4,27,1,30,2,13,0,15,4,30,2,0,0,2,0,30,8,7,0,15,1,30,4,11,0,15,0,30,6,0,0,6,1,-15,3,1
2,2,29,0,30,7,7,0,14,6,30,9,3,0,12,0,30,3,11,0,14,0,30,1,13,0,14,4,30,9,0,0,9,1,-15,3,1
2,3,29,0,30,7,7,0,14,6,30,9,3,0,12,0,30,3,11,0,14,0,30,1,13,0,14,4,30,9,0,0,9,1,-15,3,1
2,2,36,5,30,8,1,0,9,6,30,2,0,0,2,6,30,5,4,0,9,1,30,1,8,0,9,6,30,3,0,0,3,1,-15,3,1
2,3,36,5,30,8,1,0,9,6,30,2,0,0,2,6,30,5,4,0,9,1,30,1,8,0,9,6,30,3,0,0,3,1,-15,3,1
2,4,36,5,30,8,1,0,9,6,30,2,0,0,2,6,30,5,4,0,9,1,30,1,8,0,9,6,30,3,0,0,3,1,-15,3,1
2,2,4,2,30,6,2,0,8,5,30,2,2,0,4,1,30,2,6,0,8,1,30,7,1,0,8,0,30,4,0,0,4,0,-27,3,0
2,1,11,2,30,7,5,0,12,2,30,4,0,0,4,0,30,5,7,0,12,2,30,6,6,0,12,2,30,4,0,0,4,1,-15,3,1
2,3,13,8,30,7,0,0,7,0,30,4,0,0,4,2,30,6,1,0,7,2,30,5,2,0,7,2,30,4,0,0,4,1,-15,3,1
2,4,13,8,30,7,0,0,7,0,30,4,0,0,4,2,30,6,1,0,7,2,30,5,2,0,7,2,30,4,0,0,4,1,-15,3,1
2,2,19,0,30,4,9,0,13,2,30,3,5,0,8,0,30,4,9,0,13,7,30,6,7,0,13,3,30,9,0,0,9,1,-15,3,1
2,1,21,3,30,9,1,0,10,4,30,5,1,0,6,1,30,3,7,0,10,4,30,6,4,0,10,2,30,4,0,0,4,1,-15,3,1
2,2,21,3,30,9,1,0,10,4,30,5,1,0,6,1,30,3,7,0,10,4,30,6,4,0,10,2,30,4,0,0,4,1,-15,3,1
2,3,21,3,30,9,1,0,10,4,30,5,1,0,6,1,30,3,7,0,10,4,30,6,4,0,10,2,30,4,0,0,4,1,-15,3,1
2,2,23,6,30,9,4,0,13,3,30,6,0,0,6,3,30,7,6,0,13,0,30,5,8,0,13,0,30,5,1,0,6,1,-15,3,1
2,3,23,6,30,9,4,0,13,3,30,6,0,0,6,3,30,7,6,0,13,0,30,5,8,0,13,0,30,5,1,0,6,1,-15,3,1
2,4,23,6,30,9,4,0,13,3,30,6,0,0,6,3,30,7,6,0,13,0,30,5,8,0,13,0,30,5,1,0,6,1,-15,3,1
2,4,39,0,30,0,11,0,11,6,30,6,0,0,6,0,30,10,1,0,11,2,30,5,6,0,11,2,30,5,0,0,5,1,-15,3,1
2,3,13,5,30,7,0,0,7,2,30,4,0,0,4,1,30,6,1,0,7,5,30,6,1,0,7,0,30,4,0,0,4,1,-15,3,1
2,4,13,5,30,7,0,0,7,2,30,4,0,0,4,1,30,6,1,0,7,5,30,6,1,0,7,0,30,4,0,0,4,1,-15,3,1
2,1,17,1,30,8,6,0,14,2,30,6,0,0,6,0,30,7,7,0,14,1,30,7,7,0,14,6,30,4,0,0,4,1,-15,3,1
2,1,19,0,30,4,9,0,13,1,30,8,0,0,8,0,30,4,9,0,13,0,30,4,9,0,13,1,30,7,2,0,9,1,-15,3,1
2,4,25,0,30,7,7,0,14,2,30,6,0,0,6,0,30,9,5,0,14,0,30,5,9,0,14,4,30,6,0,0,6,1,-15,3,1
2,1,27,2,30,7,8,0,15,3,30,1,1,0,2,0,30,3,12,0,15,2,30,4,11,0,15,7,30,6,0,0,6,1,-15,3,1
2,2,27,2,30,7,8,0,15,3,30,1,1,0,2,0,30,3,12,0,15,2,30,4,11,0,15,7,30,6,0,0,6,1,-15,3,1
2,3,27,2,30,7,8,0,15,3,30,1,1,0,2,0,30,3,12,0,15,2,30,4,11,0,15,7,30,6,0,0,6,1,-15,3,1
2,4,31,0,30,7,5,0,12,5,30,8,0,0,8,3,30,8,4,0,12,0,30,7,5,0,12,1,30,6,0,0,6,1,-15,3,1
2,2,33,2,30,8,3,0,11,4,30,4,0,0,4,5,30,9,2,0,11,0,30,3,8,0,11,5,30,4,0,0,4,1,-15,3,1
2,3,33,2,30,8,3,0,11,4,30,4,0,0,4,5,30,9,2,0,11,0,30,3,8,0,11,5,30,4,0,0,4,1,-15,3,1
2,2,39,0,30,3,8,0,11,6,30,6,0,0,6,0,30,6,5,0,11,1,30,3,8,0,11,7,30,5,0,0,5,1,-15,3,1
2,3,39,0,30,3,8,0,11,6,30,6,0,0,6,0,30,6,5,0,11,1,30,3,8,0,11,7,30,5,0,0,5,1,-15,3,1
2,3,47,0,30,1,13,0,14,6,30,4,0,0,4,0,30,3,11,0,14,0,30,3,11,0,14,8,30,7,0,0,7,1,-15,3,1
2,4,4,2,30,5,3,0,8,4,30,4,0,0,4,0,30,4,4,0,8,0,30,5,3,0,8,3,30,3,1,0,4,0,-27,3,0
2,4,19,1,30,6,7,0,13,0,30,4,4,0,8,0,30,7,6,0,13,6,30,8,5,0,13,5,30,7,2,0,9,1,-15,3,1
2,3,22,2,30,8,0,0,8,3,30,2,0,0,2,0,30,5,3,0,8,0,30,7,1,0,8,4,30,4,0,0,4,1,-15,3,1
2,4,22,2,30,8,0,0,8,3,30,2,0,0,2,0,30,5,3,0,8,0,30,7,1,0,8,4,30,4,0,0,4,1,-15,3,1
2,4,25,1,30,12,2,0,14,3,30,6,0,0,6,0,30,4,10,0,14,1,30,5,9,0,14,3,30,6,0,0,6,1,-15,3,1
2,2,27,1,30,7,8,0,15,4,30,2,0,0,2,0,30,8,7,0,15,3,30,5,10,0,15,0,30,5,1,0,6,1,-15,3,1
2,3,27,1,30,7,8,0,15,4,30,2,0,0,2,0,30,8,7,0,15,3,30,5,10,0,15,0,30,5,1,0,6,1,-15,3,1
2,2,29,0,30,8,6,0,14,6,30,12,0,0,12,0,30,5,9,0,14,0,30,1,13,0,14,0,30,9,0,0,9,1,-15,3,1
2,3,31,1,30,6,6,0,12,3,30,8,0,0,8,3,30,10,2,0,12,0,30,3,9,0,12,1,30,2,4,0,6,1,-15,3,1
2,4,31,1,30,6,6,0,12,3,30,8,0,0,8,3,30,10,2,0,12,0,30,3,9,0,12,1,30,2,4,0,6,1,-15,3,1
2,3,33,1,30,2,9,0,11,4,30,4,0,0,4,3,30,9,2,0,11,0,30,6,5,0,11,7,30,4,0,0,4,1,-15,3,1
2,3,7,0,30,1,3,0,4,2,30,2,0,0,2,0,30,1,3,0,4,0,30,0,4,0,4,2,30,1,1,0,2,0,-27,3,0
2,2,13,1,30,6,1,0,7,0,30,4,0,0,4,1,30,5,2,0,7,8,30,7,0,0,7,4,30,4,0,0,4,1,-15,3,1
2,4,13,1,30,6,1,0,7,0,30,4,0,0,4,1,30,5,2,0,7,8,30,7,0,0,7,4,30,4,0,0,4,1,-15,3,1
2,2,27,1,30,6,9,0,15,5,30,2,0,0,2,0,30,2,13,0,15,4,30,5,10,0,15,2,30,6,0,0,6,1,-15,3,1
2,4,27,1,30,6,9,0,15,5,30,2,0,0,2,0,30,2,13,0,15,4,30,5,10,0,15,2,30,6,0,0,6,1,-15,3,1
2,3,29,0,30,8,6,0,14,5,30,12,0,0,12,0,30,3,11,0,14,0,30,1,13,0,14,0,30,6,3,0,9,1,-15,3,1
2,4,35,0,30,7,6,0,13,4,30,2,0,0,2,0,30,2,11,0,13,0,30,1,12,0,13,3,30,8,0,0,8,1,-15,3,1
2,4,8,1,30,7,0,0,7,4,30,2,0,0,2,0,30,5,2,0,7,0,30,6,1,0,7,1,30,3,0,0,3,0,-27,3,0
2,2,13,1,30,5,2,0,7,0,30,4,0,0,4,3,30,6,1,0,7,13,30,5,2,0,7,1,30,4,0,0,4,1,-15,3,1
2,4,13,1,30,5,2,0,7,0,30,4,0,0,4,3,30,6,1,0,7,13,30,5,2,0,7,1,30,4,0,0,4,1,-15,3,1
2,2,19,0,30,4,9,0,13,2,30,8,0,0,8,0,30,4,9,0,13,7,30,3,10,0,13,3,30,9,0,0,9,1,-15,3,1
2,4,22,1,30,6,2,0,8,2,30,2,0,0,2,0,30,6,2,0,8,1,30,3,5,0,8,1,30,1,3,0,4,1,-15,3,1
2,3,25,1,30,6,8,0,14,5,30,6,0,0,6,0,30,8,6,0,14,1,30,7,7,0,14,5,30,6,0,0,6,1,-15,3,1
2,4,25,1,30,6,8,0,14,5,30,6,0,0,6,0,30,8,6,0,14,1,30,7,7,0,14,5,30,6,0,0,6,1,-15,3,1
2,3,26,0,30,6,3,0,9,5,30,4,0,0,4,2,30,0,9,0,9,0,30,2,7,0,9,4,30,3,0,0,3,1,-15,3,1
2,0,27,1,30,4,11,0,15,3,30,2,0,0,2,0,30,3,12,0,15,2,30,8,7,0,15,1,30,6,0,0,6,1,-15,3,1
2,4,29,0,30,11,3,0,14,4,30,11,1,0,12,0,30,4,10,0,14,0,30,1,13,0,14,0,30,8,1,0,9,1,-15,3,1
2,4,3,0,30,1,3,0,4,2,30,4,0,0,4,1,30,2,2,0,4,2,30,1,3,0,4,0,30,1,2,0,3,0,-27,3,0
2,0,4,2,30,6,2,0,8,5,30,4,0,0,4,2,30,2,6,0,8,0,30,6,2,0,8,1,30,3,1,0,4,0,-27,3,0
2,1,4,2,30,6,2,0,8,5,30,4,0,0,4,2,30,2,6,0,8,0,30,6,2,0,8,1,30,3,1,0,4,0,-27,3,0
2,3,4,2,30,6,2,0,8,5,30,4,0,0,4,2,30,2,6,0,8,0,30,6,2,0,8,1,30,3,1,0,4,0,-27,3,0
2,4,4,2,30,6,2,0,8,5,30,4,0,0,4,2,30,2,6,0,8,0,30,6,2,0,8,1,30,3,1,0,4,0,-27,3,0
2,3,6,2,30,9,0,0,9,4,30,2,0,0,2,0,30,2,7,0,9,0,30,3,6,0,9,0,30,4,1,0,5,0,-27,3,0
2,4,6,2,30,9,0,0,9,4,30,2,0,0,2,0,30,2,7,0,9,0,30,3,6,0,9,0,30,4,1,0,5,0,-27,3,0
2,4,13,1,30,5,2,0,7,0,30,4,0,0,4,1,30,6,1,0,7,9,30,7,0,0,7,5,30,4,0,0,4,1,-15,3,1
2,4,23,2,30,5,8,0,13,2,30,6,0,0,6,0,30,13,0,0,13,4,30,6,7,0,13,4,30,6,0,0,6,1,-15,3,1
2,2,25,1,30,5,9,0,14,5,30,6,0,0,6,0,30,4,10,0,14,2,30,6,8,0,14,6,30,6,0,0,6,1,-15,3,1
2,0,27,1,30,6,9,0,15,5,30,1,1,0,2,0,30,3,12,0,15,1,30,7,8,0,15,2,30,6,0,0,6,1,-15,3,1
2,3,27,1,30,6,9,0,15,5,30,1,1,0,2,0,30,3,12,0,15,1,30,7,8,0,15,0,30,6,0,0,6,1,-15,3,1
2,4,27,1,30,6,9,0,15,5,30,1,1,0,2,0,30,3,12,0,15,1,30,7,8,0,15,0,30,6,0,0,6,1,-15,3,1
2,2,29,0,30,11,3,0,14,5,30,12,0,0,12,0,30,4,10,0,14,2,30,0,14,0,14,0,30,6,3,0,9,1,-15,3,1
2,4,29,0,30,11,3,0,14,5,30,12,0,0,12,0,30,4,10,0,14,2,30,0,14,0,14,0,30,6,3,0,9,1,-15,3,1
2,2,35,0,30,7,6,0,13,5,30,2,0,0,2,1,30,6,7,0,13,1,30,4,9,0,13,3,30,8,0,0,8,1,-15,3,1
2,2,43,0,30,9,5,0,14,7,30,6,0,0,6,0,30,4,10,0,14,1,30,1,13,0,14,7,30,5,0,0,5,1,-15,3,1
2,1,5,0,30,1,4,0,5,3,30,2,2,0,4,0,30,0,5,0,5,0,30,1,4,0,5,0,30,0,2,0,2,0,-27,3,0
2,4,23,1,30,6,7,0,13,0,30,6,0,0,6,2,30,11,2,0,13,0,30,5,8,0,13,2,30,6,0,0,6,1,-15,3,1
2,2,25,1,30,7,7,0,14,3,30,6,0,0,6,0,30,10,4,0,14,1,30,4,10,0,14,2,30,6,0,0,6,1,-15,3,1
2,3,25,1,30,7,7,0,14,3,30,6,0,0,6,0,30,10,4,0,14,1,30,4,10,0,14,2,30,6,0,0,6,1,-15,3,1
2,0,27,1,30,4,11,0,15,4,30,1,1,0,2,3,30,7,8,0,15,1,30,5,10,0,15,1,30,6,0,0,6,1,-15,3,1
2,2,27,1,30,4,11,0,15,4,30,1,1,0,2,1,30,7,8,0,15,1,30,5,10,0,15,1,30,6,0,0,6,1,-15,3,1
2,3,27,1,30,4,11,0,15,4,30,1,1,0,2,1,30,7,8,0,15,1,30,5,10,0,15,1,30,6,0,0,6,1,-15,3,1
2,4,27,1,30,4,11,0,15,4,30,1,1,0,2,1,30,7,8,0,15,1,30,5,10,0,15,1,30,6,0,0,6,1,-15,3,1
2,0,31,3,30,7,5,0,12,4,30,8,0,0,8,6,30,9,3,0,12,0,30,3,9,0,12,1,30,6,0,0,6,1,-15,3,1
2,2,31,3,30,7,5,0,12,4,30,8,0,0,8,6,30,9,3,0,12,0,30,3,9,0,12,1,30,6,0,0,6,1,-15,3,1
2,4,2,3,30,9,1,0,10,3,30,4,0,0,4,3,30,4,6,0,10,0,30,1,9,0,10,1,30,2,6,0,8,0,-27,3,0
2,4,5,0,30,2,3,0,5,3,30,1,3,0,4,0,30,0,5,0,5,0,30,1,4,0,5,1,30,2,0,0,2,0,-27,3,0
2,4,6,0,30,4,5,0,9,4,30,2,0,0,2,0,30,2,7,0,9,0,30,5,4,0,9,4,30,5,0,0,5,0,-27,3,0
2,2,13,3,30,6,1,0,7,1,30,4,0,0,4,0,30,6,1,0,7,8,30,6,1,0,7,4,30,4,0,0,4,1,-15,3,1
2,4,13,3,30,6,1,0,7,1,30,4,0,0,4,0,30,6,1,0,7,8,30,6,1,0,7,4,30,4,0,0,4,1,-15,3,1
2,3,15,0,30,4,9,0,13,1,30,5,1,0,6,0,30,3,10,0,13,1,30,7,6,0,13,1,30,9,0,0,9,1,-15,3,1
2,1,17,3,30,12,2,0,14,2,30,6,0,0,6,1,30,7,7,0,14,0,30,5,9,0,14,3,30,4,0,0,4,1,-15,3,1
2,2,17,3,30,12,2,0,14,2,30,6,0,0,6,1,30,7,7,0,14,0,30,5,9,0,14,3,30,4,0,0,4,1,-15,3,1
2,2,19,0,30,2,11,0,13,2,30,5,3,0,8,0,30,6,7,0,13,3,30,5,8,0,13,0,30,8,1,0,9,1,-15,3,1
2,4,19,0,30,2,11,0,13,2,30,5,3,0,8,0,30,6,7,0,13,3,30,5,8,0,13,0,30,8,1,0,9,1,-15,3,1
2,3,25,1,30,2,12,0,14,4,30,6,0,0,6,0,30,4,10,0,14,3,30,7,7,0,14,7,30,6,0,0,6,1,-15,3,1
2,0,27,3,30,5,10,0,15,3,30,1,1,0,2,0,30,7,8,0,15,3,30,9,6,0,15,1,30,2,4,0,6,1,-15,3,1
2,1,27,3,30,5,10,0,15,3,30,1,1,0,2,0,30,7,8,0,15,3,30,9,6,0,15,1,30,2,4,0,6,1,-15,3,1
2,3,27,3,30,5,10,0,15,3,30,1,1,0,2,0,30,7,8,0,15,3,30,9,6,0,15,1,30,2,4,0,6,1,-15,3,1
2,4,27,3,30,5,10,0,15,3,30,1,1,0,2,0,30,7,8,0,15,3,30,9,6,0,15,1,30,2,4,0,6,1,-15,3,1
2,3,38,0,30,2,8,0,10,7,30,6,0,0,6,0,30,1,9,0,10,0,30,4,6,0,10,7,30,6,0,0,6,1,-15,3,1
2,2,13,4,30,5,2,0,7,0,30,4,0,0,4,4,30,7,0,0,7,5,30,7,0,0,7,3,30,4,0,0,4,1,-15,3,1
2,4,23,2,30,6,7,0,13,0,30,6,0,0,6,6,30,11,2,0,13,0,30,4,9,0,13,1,30,6,0,0,6,1,-15,3,1
2,2,31,1,30,4,8,0,12,7,30,8,0,0,8,3,30,4,8,0,12,0,30,10,2,0,12,5,30,6,0,0,6,1,-15,3,1
2,0,4,2,30,7,1,0,8,4,30,4,0,0,4,0,30,4,4,0,8,0,30,5,3,0,8,2,30,4,0,0,4,0,-27,3,0
2,1,4,2,30,7,1,0,8,4,30,4,0,0,4,0,30,4,4,0,8,0,30,5,3,0,8,2,30,4,0,0,4,0,-27,3,0
2,4,4,2,30,7,1,0,8,4,30,4,0,0,4,0,30,4,4,0,8,0,30,5,3,0,8,2,30,4,0,0,4,0,-27,3,0
2,1,6,0,30,6,3,0,9,3,30,2,0,0,2,0,30,4,5,0,9,0,30,4,5,0,9,1,30,5,0,0,5,0,-27,3,0
2,1,8,1,30,7,0,0,7,3,30,2,0,0,2,0,30,4,3,0,7,0,30,7,0,0,7,3,30,3,0,0,3,0,-27,3,0
2,2,8,1,30,7,0,0,7,3,30,2,0,0,2,0,30,4,3,0,7,0,30,7,0,0,7,3,30,3,0,0,3,0,-27,3,0
2,1,13,1,30,6,1,0,7,0,30,4,0,0,4,6,30,7,0,0,7,6,30,6,1,0,7,5,30,4,0,0,4,1,-15,3,1
2,2,13,1,30,6,1,0,7,0,30,4,0,0,4,6,30,7,0,0,7,6,30,6,1,0,7,5,30,4,0,0,4,1,-15,3,1
2,3,13,1,30,6,1,0,7,0,30,4,0,0,4,6,30,7,0,0,7,6,30,6,1,0,7,5,30,4,0,0,4,1,-15,3,1
2,4,13,1,30,6,1,0,7,0,30,4,0,0,4,6,30,7,0,0,7,6,30,6,1,0,7,5,30,4,0,0,4,1,-15,3,1
2,3,25,2,30,8,6,0,14,1,30,6,0,0,6,0,30,11,3,0,14,1,30,5,9,0,14,4,30,5,1,0,6,1,-15,3,1
2,0,27,1,30,4,11,0,15,5,30,2,0,0,2,0,30,2,13,0,15,0,30,6,9,0,15,2,30,5,1,0,6,1,-15,3,1
2,2,27,1,30,4,11,0,15,5,30,2,0,0,2,0,30,2,13,0,15,0,30,6,9,0,15,2,30,5,1,0,6,1,-15,3,1
2,4,29,0,30,4,10,0,14,5,30,12,0,0,12,0,30,6,8,0,14,0,30,1,13,0,14,0,30,7,2,0,9,1,-15,3,1
2,3,6,0,30,5,4,0,9,4,30,2,0,0,2,0,30,2,7,0,9,0,30,5,4,0,9,4,30,5,0,0,5,0,-27,3,0
2,4,13,8,30,3,0,0,3,2,30,2,0,0,2,0,30,2,1,0,3,3,30,2,1,0,3,3,30,2,0,0,2,1,-15,3,1
2,2,13,8,30,7,0,0,7,2,30,4,0,0,4,1,30,5,2,0,7,3,30,6,1,0,7,3,30,4,0,0,4,1,-15,3,1
2,2,23,2,30,7,6,0,13,3,30,6,0,0,6,5,30,13,0,0,13,0,30,4,9,0,13,2,30,5,1,0,6,1,-15,3,1
2,2,25,0,30,12,2,0,14,4,30,6,0,0,6,0,30,4,10,0,14,1,30,4,10,0,14,5,30,6,0,0,6,1,-15,3,1
2,3,25,0,30,12,2,0,14,4,30,6,0,0,6,0,30,4,10,0,14,1,30,4,10,0,14,5,30,6,0,0,6,1,-15,3,1
2,4,27,1,30,4,11,0,15,4,30,2,0,0,2,0,30,3,12,0,15,2,30,3,12,0,15,5,30,6,0,0,6,1,-15,3,1
2,1,29,0,30,5,9,0,14,5,30,12,0,0,12,0,30,9,5,0,14,0,30,1,13,0,14,0,30,7,2,0,9,1,-15,3,1
2,2,31,3,30,8,4,0,12,6,30,8,0,0,8,3,30,5,7,0,12,0,30,3,9,0,12,5,30,3,3,0,6,1,-15,3,1
2,3,32,0,30,5,4,0,9,4,30,2,0,0,2,0,30,7,2,0,9,1,30,3,6,0,9,7,30,2,0,0,2,1,-15,3,1
2,2,5,0,30,0,5,0,5,3,30,0,4,0,4,0,30,0,5,0,5,0,30,1,4,0,5,0,30,2,0,0,2,0,-27,3,0
2,4,5,0,30,0,5,0,5,3,30,0,4,0,4,0,30,0,5,0,5,0,30,1,4,0,5,0,30,2,0,0,2,0,-27,3,0
2,2,13,1,30,4,3,0,7,0,30,4,0,0,4,6,30,7,0,0,7,8,30,5,2,0,7,5,30,4,0,0,4,1,-15,3,1
2,4,13,1,30,4,3,0,7,0,30,4,0,0,4,6,30,7,0,0,7,8,30,5,2,0,7,5,30,4,0,0,4,1,-15,3,1
2,3,19,0,30,5,8,0,13,2,30,8,0,0,8,0,30,5,8,0,13,3,30,4,9,0,13,0,30,7,2,0,9,1,-15,3,1
2,4,25,2,30,6,8,0,14,1,30,6,0,0,6,0,30,10,4,0,14,1,30,5,9,0,14,2,30,6,0,0,6,1,-15,3,1
2,3,27,2,30,4,11,0,15,5,30,2,0,0,2,0,30,4,11,0,15,0,30,7,8,0,15,0,30,6,0,0,6,1,-15,3,1
2,3,29,0,30,5,9,0,14,5,30,12,0,0,12,0,30,4,10,0,14,0,30,1,13,0,14,0,30,6,3,0,9,1,-15,3,1
2,4,29,0,30,5,9,0,14,5,30,12,0,0,12,0,30,4,10,0,14,0,30,1,13,0,14,0,30,6,3,0,9,1,-15,3,1
2,2,47,0,30,1,13,0,14,7,30,4,0,0,4,0,30,3,11,0,14,0,30,2,12,0,14,10,30,7,0,0,7,1,-15,3,1
2,0,5,0,30,4,1,0,5,3,30,2,2,0,4,0,30,0,5,0,5,0,30,1,4,0,5,0,30,1,1,0,2,0,-27,3,0
2,1,5,0,30,4,1,0,5,3,30,2,2,0,4,0,30,0,5,0,5,0,30,1,4,0,5,0,30,1,1,0,2,0,-27,3,0
2,3,17,3,30,9,5,0,14,3,30,6,0,0,6,0,30,4,10,0,14,0,30,5,9,0,14,5,30,4,0,0,4,1,-15,3,1
2,4,17,3,30,9,5,0,14,3,30,6,0,0,6,0,30,4,10,0,14,0,30,5,9,0,14,5,30,4,0,0,4,1,-15,3,1
2,1,27,1,30,3,12,0,15,2,30,2,0,0,2,0,30,9,6,0,15,4,30,5,10,0,15,4,30,6,0,0,6,1,-15,3,1
2,3,27,1,30,3,12,0,15,2,30,2,0,0,2,0,30,9,6,0,15,4,30,5,10,0,15,4,30,6,0,0,6,1,-15,3,1
2,3,31,4,30,5,7,0,12,8,30,8,0,0,8,3,30,4,8,0,12,0,30,9,3,0,12,3,30,6,0,0,6,1,-15,3,1
2,4,31,4,30,5,7,0,12,8,30,8,0,0,8,3,30,4,8,0,12,0,30,9,3,0,12,3,30,6,0,0,6,1,-15,3,1
2,4,39,1,30,3,8,0,11,6,30,6,0,0,6,0,30,4,7,0,11,0,30,2,9,0,11,5,30,5,0,0,5,1,-15,3,1
2,4,8,3,30,7,0,0,7,3,30,2,0,0,2,3,30,5,2,0,7,0,30,5,2,0,7,0,30,3,0,0,3,0,-27,3,0
2,3,19,0,30,4,9,0,13,2,30,5,3,0,8,0,30,7,6,0,13,5,30,5,8,0,13,2,30,9,0,0,9,1,-15,3,1
2,4,19,0,30,4,9,0,13,2,30,5,3,0,8,0,30,7,6,0,13,5,30,5,8,0,13,2,30,9,0,0,9,1,-15,3,1
2,3,23,1,30,5,8,0,13,0,30,6,0,0,6,4,30,13,0,0,13,0,30,5,8,0,13,3,30,5,1,0,6,1,-15,3,1
2,4,23,1,30,5,8,0,13,0,30,6,0,0,6,4,30,13,0,0,13,0,30,5,8,0,13,3,30,5,1,0,6,1,-15,3,1
2,1,27,1,30,3,12,0,15,3,30,2,0,0,2,0,30,6,9,0,15,2,30,5,10,0,15,3,30,6,0,0,6,1,-15,3,1
2,4,27,1,30,3,12,0,15,3,30,2,0,0,2,0,30,6,9,0,15,0,30,5,10,0,15,3,30,6,0,0,6,1,-15,3,1
2,0,29,0,30,10,4,0,14,6,30,11,1,0,12,0,30,4,10,0,14,0,30,1,13,0,14,1,30,9,0,0,9,1,-15,3,1
2,2,29,0,30,10,4,0,14,6,30,11,1,0,12,0,30,4,10,0,14,0,30,1,13,0,14,0,30,9,0,0,9,1,-15,3,1
2,4,29,0,30,10,4,0,14,6,30,11,1,0,12,0,30,4,10,0,14,0,30,1,13,0,14,0,30,9,0,0,9,1,-15,3,1
2,1,37,1,30,7,4,0,11,6,30,8,0,0,8,0,30,3,8,0,11,6,30,4,7,0,11,9,30,6,0,0,6,1,-15,3,1
2,3,37,1,30,7,4,0,11,6,30,8,0,0,8,0,30,3,8,0,11,6,30,4,7,0,11,9,30,6,0,0,6,1,-15,3,1
2,4,11,0,30,4,8,0,12,0,30,4,0,0,4,0,30,7,5,0,12,7,30,5,7,0,12,6,30,4,0,0,4,1,-15,3,1
2,1,13,3,30,7,0,0,7,0,30,4,0,0,4,2,30,6,1,0,7,11,30,6,1,0,7,7,30,4,0,0,4,1,-15,3,1
2,2,13,3,30,7,0,0,7,0,30,4,0,0,4,2,30,6,1,0,7,11,30,6,1,0,7,7,30,4,0,0,4,1,-15,3,1
2,3,15,2,30,5,8,0,13,1,30,6,0,0,6,0,30,3,10,0,13,1,30,2,11,0,13,2,30,9,0,0,9,1,-15,3,1
2,4,15,2,30,5,8,0,13,1,30,6,0,0,6,0,30,3,10,0,13,1,30,2,11,0,13,2,30,9,0,0,9,1,-15,3,1
2,4,17,1,30,9,5,0,14,2,30,6,0,0,6,0,30,7,7,0,14,2,30,5,9,0,14,0,30,4,0,0,4,1,-15,3,1
2,4,23,1,30,5,8,0,13,3,30,6,0,0,6,6,30,10,3,0,13,0,30,5,8,0,13,0,30,6,0,0,6,1,-15,3,1
2,2,27,2,30,6,9,0,15,0,30,2,0,0,2,0,30,5,10,0,15,0,30,4,11,0,15,2,30,6,0,0,6,1,-15,3,1
2,3,27,2,30,6,9,0,15,0,30,2,0,0,2,0,30,5,10,0,15,0,30,4,11,0,15,2,30,6,0,0,6,1,-15,3,1
2,4,29,0,30,7,7,0,14,5,30,12,0,0,12,0,30,3,11,0,14,0,30,1,13,0,14,0,30,5,4,0,9,1,-15,3,1
2,1,31,4,30,8,4,0,12,4,30,8,0,0,8,3,30,8,4,0,12,0,30,3,9,0,12,0,30,2,4,0,6,1,-15,3,1
2,4,31,4,30,8,4,0,12,4,30,8,0,0,8,3,30,8,4,0,12,0,30,3,9,0,12,0,30,2,4,0,6,1,-15,3,1
2,4,5,0,30,2,3,0,5,4,30,0,4,0,4,0,30,0,5,0,5,0,30,1,4,0,5,0,30,1,1,0,2,0,-27,3,0
2,4,7,0,30,1,3,0,4,2,30,2,0,0,2,0,30,1,3,0,4,1,30,2,2,0,4,2,30,2,0,0,2,0,-27,3,0
2,2,11,0,30,5,7,0,12,3,30,4,0,0,4,0,30,1,11,0,12,3,30,7,5,0,12,4,30,4,0,0,4,1,-15,3,1
2,1,13,3,30,7,0,0,7,0,30,4,0,0,4,2,30,6,1,0,7,5,30,7,0,0,7,3,30,4,0,0,4,1,-15,3,1
2,2,13,3,30,7,0,0,7,0,30,4,0,0,4,2,30,6,1,0,7,5,30,7,0,0,7,3,30,4,0,0,4,1,-15,3,1
2,4,13,3,30,7,0,0,7,0,30,4,0,0,4,2,30,6,1,0,7,5,30,7,0,0,7,3,30,4,0,0,4,1,-15,3,1
2,4,25,1,30,8,6,0,14,0,30,6,0,0,6,0,30,10,4,0,14,1,30,5,9,0,14,3,30,5,1,0,6,1,-15,3,1
2,4,3,0,30,0,4,0,4,2,30,4,0,0,4,0,30,1,3,0,4,2,30,1,3,0,4,0,30,1,2,0,3,0,-27,3,0
2,1,17,3,30,9,5,0,14,3,30,6,0,0,6,0,30,4,10,0,14,2,30,5,9,0,14,1,30,4,0,0,4,1,-15,3,1
2,2,19,0,30,4,9,0,13,1,30,7,1,0,8,1,30,7,6,0,13,0,30,8,5,0,13,0,30,6,3,0,9,1,-15,3,1
2,3,19,0,30,4,9,0,13,1,30,7,1,0,8,1,30,7,6,0,13,0,30,8,5,0,13,0,30,6,3,0,9,1,-15,3,1
2,4,23,1,30,3,10,0,13,3,30,6,0,0,6,4,30,13,0,0,13,2,30,4,9,0,13,5,30,6,0,0,6,1,-15,3,1
2,1,25,0,30,5,9,0,14,4,30,6,0,0,6,0,30,6,8,0,14,1,30,9,5,0,14,8,30,6,0,0,6,1,-15,3,1
2,2,25,0,30,5,9,0,14,4,30,6,0,0,6,0,30,6,8,0,14,1,30,9,5,0,14,8,30,6,0,0,6,1,-15,3,1
2,2,27,1,30,7,8,0,15,3,30,2,0,0,2,3,30,5,10,0,15,0,30,10,5,0,15,0,30,4,2,0,6,1,-15,3,1
2,3,27,1,30,7,8,0,15,3,30,2,0,0,2,3,30,5,10,0,15,0,30,10,5,0,15,0,30,4,2,0,6,1,-15,3,1
2,4,27,1,30,7,8,0,15,3,30,2,0,0,2,3,30,5,10,0,15,0,30,10,5,0,15,0,30,4,2,0,6,1,-15,3,1
2,0,4,2,30,7,1,0,8,5,30,4,0,0,4,1,30,1,7,0,8,3,30,8,0,0,8,2,30,3,1,0,4,0,-27,3,0
2,0,17,2,30,8,6,0,14,2,30,6,0,0,6,0,30,7,7,0,14,4,30,8,6,0,14,8,30,4,0,0,4,1,-15,3,1
2,3,19,0,30,6,7,0,13,2,30,6,2,0,8,0,30,4,9,0,13,0,30,6,7,0,13,0,30,8,1,0,9,1,-15,3,1
2,4,19,0,30,6,7,0,13,2,30,6,2,0,8,0,30,4,9,0,13,0,30,6,7,0,13,0,30,8,1,0,9,1,-15,3,1
2,3,22,1,30,6,2,0,8,2,30,2,0,0,2,5,30,6,2,0,8,4,30,2,6,0,8,1,30,1,3,0,4,1,-15,3,1
2,4,22,1,30,6,2,0,8,2,30,2,0,0,2,5,30,6,2,0,8,4,30,2,6,0,8,1,30,1,3,0,4,1,-15,3,1
2,3,23,1,30,6,7,0,13,1,30,6,0,0,6,3,30,13,0,0,13,0,30,6,7,0,13,2,30,6,0,0,6,1,-15,3,1
2,0,27,1,30,3,12,0,15,4,30,1,1,0,2,0,30,3,12,0,15,1,30,6,9,0,15,2,30,6,0,0,6,1,-15,3,1
2,1,27,1,30,3,12,0,15,4,30,1,1,0,2,0,30,3,12,0,15,1,30,6,9,0,15,2,30,6,0,0,6,1,-15,3,1
2,4,29,0,30,5,9,0,14,5,30,12,0,0,12,0,30,6,8,0,14,0,30,0,14,0,14,0,30,6,3,0,9,1,-15,3,1
2,1,31,7,30,7,5,0,12,5,30,8,0,0,8,3,30,8,4,0,12,0,30,3,9,0,12,1,30,2,4,0,6,1,-15,3,1
2,4,8,2,30,7,0,0,7,4,30,2,0,0,2,3,30,5,2,0,7,0,30,6,1,0,7,0,30,3,0,0,3,0,-27,3,0
2,0,11,0,30,5,7,0,12,3,30,4,0,0,4,0,30,2,10,0,12,6,30,8,4,0,12,5,30,4,0,0,4,1,-15,3,1
2,1,11,0,30,5,7,0,12,3,30,4,0,0,4,0,30,2,10,0,12,6,30,8,4,0,12,5,30,4,0,0,4,1,-15,3,1
2,2,23,2,30,6,7,0,13,3,30,6,0,0,6,5,30,12,1,0,13,0,30,5,8,0,13,0,30,6,0,0,6,1,-15,3,1
2,0,27,1,30,5,10,0,15,2,30,1,1,0,2,0,30,7,8,0,15,2,30,4,11,0,15,2,30,6,0,0,6,1,-15,3,1
2,4,27,1,30,5,10,0,15,2,30,1,1,0,2,0,30,7,8,0,15,2,30,4,11,0,15,2,30,6,0,0,6,1,-15,3,1
2,4,29,1,30,7,7,0,14,6,30,8,4,0,12,0,30,3,11,0,14,0,30,0,14,0,14,3,30,9,0,0,9,1,-15,3,1
2,3,8,2,30,7,0,0,7,3,30,2,0,0,2,0,30,2,5,0,7,0,30,5,2,0,7,2,30,3,0,0,3,0,-27,3,0
2,4,11,1,30,5,7,0,12,0,30,4,0,0,4,0,30,9,3,0,12,6,30,4,8,0,12,5,30,4,0,0,4,1,-15,3,1
2,1,13,1,30,7,0,0,7,0,30,4,0,0,4,2,30,5,2,0,7,11,30,5,2,0,7,3,30,4,0,0,4,1,-15,3,1
2,2,13,1,30,7,0,0,7,0,30,4,0,0,4,2,30,5,2,0,7,11,30,5,2,0,7,3,30,4,0,0,4,1,-15,3,1
2,4,15,0,30,3,10,0,13,0,30,6,0,0,6,0,30,4,9,0,13,1,30,7,6,0,13,0,30,7,2,0,9,1,-15,3,1
2,4,17,5,30,10,4,0,14,3,30,6,0,0,6,0,30,5,9,0,14,0,30,5,9,0,14,2,30,4,0,0,4,1,-15,3,1
2,3,19,0,30,3,10,0,13,2,30,8,0,0,8,0,30,10,3,0,13,1,30,4,9,0,13,2,30,7,2,0,9,1,-15,3,1
2,3,23,1,30,7,6,0,13,3,30,6,0,0,6,5,30,13,0,0,13,0,30,5,8,0,13,2,30,6,0,0,6,1,-15,3,1
2,1,25,1,30,4,10,0,14,5,30,6,0,0,6,0,30,3,11,0,14,1,30,9,5,0,14,5,30,6,0,0,6,1,-15,3,1
2,2,25,1,30,4,10,0,14,5,30,6,0,0,6,0,30,3,11,0,14,1,30,9,5,0,14,5,30,6,0,0,6,1,-15,3,1
2,2,27,1,30,5,10,0,15,4,30,2,0,0,2,0,30,7,8,0,15,0,30,7,8,0,15,5,30,6,0,0,6,1,-15,3,1
2,4,29,0,30,5,9,0,14,6,30,12,0,0,12,0,30,4,10,0,14,0,30,1,13,0,14,3,30,9,0,0,9,1,-15,3,1
2,3,31,1,30,9,3,0,12,3,30,8,0,0,8,3,30,9,3,0,12,1,30,3,9,0,12,0,30,5,1,0,6,1,-15,3,1
2,3,32,0,30,5,4,0,9,4,30,2,0,0,2,3,30,8,1,0,9,1,30,4,5,0,9,3,30,2,0,0,2,1,-15,3,1
2,4,32,0,30,5,4,0,9,4,30,2,0,0,2,3,30,8,1,0,9,1,30,4,5,0,9,3,30,2,0,0,2,1,-15,3,1
2,2,35,3,30,6,7,0,13,5,30,1,1,0,2,1,30,8,5,0,13,1,30,2,11,0,13,0,30,8,0,0,8,1,-15,3,1
2,4,5,0,30,2,3,0,5,2,30,4,0,0,4,0,30,1,4,0,5,1,30,2,3,0,5,0,30,0,2,0,2,0,-27,3,0
2,4,7,0,30,3,1,0,4,2,30,2,0,0,2,0,30,2,2,0,4,0,30,1,3,0,4,1,30,1,1,0,2,0,-27,3,0
2,4,9,0,30,2,2,0,4,2,30,2,0,0,2,0,30,0,4,0,4,0,30,0,4,0,4,2,30,1,0,0,1,0,-27,3,0
2,2,13,5,30,7,0,0,7,3,30,4,0,0,4,2,30,6,1,0,7,4,30,7,0,0,7,3,30,4,0,0,4,1,-15,3,1
2,4,13,5,30,7,0,0,7,3,30,4,0,0,4,2,30,6,1,0,7,4,30,7,0,0,7,3,30,4,0,0,4,1,-15,3,1
2,3,17,3,30,8,6,0,14,1,30,6,0,0,6,0,30,8,6,0,14,1,30,6,8,0,14,3,30,4,0,0,4,1,-15,3,1
2,4,17,3,30,8,6,0,14,1,30,6,0,0,6,0,30,8,6,0,14,1,30,6,8,0,14,3,30,4,0,0,4,1,-15,3,1
2,0,27,1,30,3,12,0,15,4,30,2,0,0,2,0,30,9,6,0,15,0,30,5,10,0,15,1,30,6,0,0,6,1,-15,3,1
2,0,29,0,30,6,8,0,14,6,30,11,1,0,12,0,30,5,9,0,14,0,30,2,12,0,14,2,30,9,0,0,9,1,-15,3,1
2,4,31,1,30,7,5,0,12,4,30,8,0,0,8,4,30,11,1,0,12,0,30,3,9,0,12,0,30,6,0,0,6,1,-15,3,1
2,0,33,1,30,6,5,0,11,4,30,4,0,0,4,0,30,6,5,0,11,4,30,4,7,0,11,8,30,4,0,0,4,1,-15,3,1
2,1,33,1,30,6,5,0,11,4,30,4,0,0,4,0,30,6,5,0,11,4,30,4,7,0,11,8,30,4,0,0,4,1,-15,3,1
2,2,33,1,30,6,5,0,11,4,30,4,0,0,4,0,30,6,5,0,11,4,30,4,7,0,11,8,30,4,0,0,4,1,-15,3,1
2,3,33,1,30,6,5,0,11,4,30,4,0,0,4,0,30,6,5,0,11,4,30,4,7,0,11,8,30,4,0,0,4,1,-15,3,1
2,1,37,1,30,4,7,0,11,5,30,8,0,0,8,2,30,9,2,0,11,0,30,3,8,0,11,3,30,5,1,0,6,1,-15,3,1
2,2,37,1,30,4,7,0,11,5,30,8,0,0,8,2,30,9,2,0,11,0,30,3,8,0,11,3,30,5,1,0,6,1,-15,3,1
2,4,37,1,30,4,7,0,11,5,30,8,0,0,8,2,30,9,2,0,11,0,30,3,8,0,11,3,30,5,1,0,6,1,-15,3,1
2,0,39,2,30,1,10,0,11,6,30,6,0,0,6,0,30,7,4,0,11,0,30,2,9,0,11,5,30,5,0,0,5,1,-15,3,1
2,1,39,2,30,1,10,0,11,6,30,6,0,0,6,0,30,7,4,0,11,0,30,2,9,0,11,5,30,5,0,0,5,1,-15,3,1
2,2,39,2,30,1,10,0,11,6,30,6,0,0,6,0,30,7,4,0,11,0,30,2,9,0,11,5,30,5,0,0,5,1,-15,3,1
2,3,39,2,30,1,10,0,11,6,30,6,0,0,6,0,30,7,4,0,11,0,30,2,9,0,11,5,30,5,0,0,5,1,-15,3,1
2,0,4,2,30,7,1,0,8,4,30,4,0,0,4,1,30,2,6,0,8,0,30,5,3,0,8,1,30,3,1,0,4,0,-27,3,0
2,2,4,2,30,7,1,0,8,4,30,4,0,0,4,1,30,2,6,0,8,0,30,5,3,0,8,1,30,3,1,0,4,0,-27,3,0
2,4,8,2,30,7,0,0,7,2,30,2,0,0,2,0,30,7,0,0,7,5,30,7,0,0,7,1,30,3,0,0,3,0,-27,3,0
2,1,9,0,30,2,2,0,4,2,30,2,0,0,2,0,30,0,4,0,4,0,30,1,3,0,4,0,30,1,0,0,1,0,-27,3,0
2,3,13,2,30,6,1,0,7,0,30,4,0,0,4,2,30,6,1,0,7,5,30,6,1,0,7,5,30,4,0,0,4,1,-15,3,1
2,2,19,0,30,3,10,0,13,2,30,4,4,0,8,4,30,5,8,0,13,0,30,8,5,0,13,1,30,8,1,0,9,1,-15,3,1
2,4,22,5,30,8,0,0,8,3,30,2,0,0,2,0,30,4,4,0,8,0,30,5,3,0,8,1,30,2,2,0,4,1,-15,3,1
2,3,23,2,30,8,5,0,13,2,30,6,0,0,6,3,30,11,2,0,13,0,30,5,8,0,13,2,30,6,0,0,6,1,-15,3,1
2,4,23,2,30,8,5,0,13,2,30,6,0,0,6,3,30,11,2,0,13,0,30,5,8,0,13,2,30,6,0,0,6,1,-15,3,1
2,3,27,5,30,4,11,0,15,3,30,2,0,0,2,0,30,7,8,0,15,0,30,4,11,0,15,0,30,4,2,0,6,1,-15,3,1
2,0,29,0,30,5,9,0,14,6,30,10,2,0,12,0,30,6,8,0,14,0,30,1,13,0,14,3,30,9,0,0,9,1,-15,3,1
2,2,29,0,30,5,9,0,14,6,30,10,2,0,12,0,30,6,8,0,14,0,30,1,13,0,14,0,30,9,0,0,9,1,-15,3,1
2,3,39,0,30,2,9,0,11,6,30,6,0,0,6,0,30,7,4,0,11,3,30,3,8,0,11,4,30,5,0,0,5,1,-15,3,1
2,3,8,2,30,7,0,0,7,5,30,2,0,0,2,0,30,2,5,0,7,0,30,7,0,0,7,6,30,3,0,0,3,0,-27,3,0
2,2,13,2,30,7,0,0,7,0,30,4,0,0,4,6,30,6,1,0,7,5,30,5,2,0,7,2,30,4,0,0,4,1,-15,3,1
2,4,17,2,30,10,4,0,14,3,30,6,0,0,6,0,30,5,9,0,14,0,30,8,6,0,14,6,30,4,0,0,4,1,-15,3,1
2,4,19,0,30,3,10,0,13,2,30,6,2,0,8,0,30,4,9,0,13,4,30,6,7,0,13,1,30,8,1,0,9,1,-15,3,1
2,0,27,1,30,10,5,0,15,3,30,2,0,0,2,4,30,4,11,0,15,0,30,4,11,0,15,1,30,5,1,0,6,1,-15,3,1
2,1,27,1,30,10,5,0,15,3,30,2,0,0,2,4,30,4,11,0,15,0,30,4,11,0,15,1,30,5,1,0,6,1,-15,3,1
2,2,27,1,30,10,5,0,15,3,30,2,0,0,2,4,30,4,11,0,15,0,30,4,11,0,15,1,30,5,1,0,6,1,-15,3,1
2,2,29,0,30,5,9,0,14,3,30,12,0,0,12,0,30,7,7,0,14,0,30,1,13,0,14,0,30,8,1,0,9,1,-15,3,1
2,4,32,0,30,6,3,0,9,4,30,2,0,0,2,2,30,8,1,0,9,1,30,3,6,0,9,5,30,2,0,0,2,1,-15,3,1
2,0,45,0,30,5,8,0,13,9,30,10,0,0,10,0,30,2,11,0,13,3,30,7,6,0,13,10,30,5,0,0,5,1,-15,3,1
2,3,45,0,30,5,8,0,13,9,30,10,0,0,10,0,30,2,11,0,13,3,30,7,6,0,13,10,30,5,0,0,5,1,-15,3,1
2,1,4,2,30,5,3,0,8,5,30,4,0,0,4,0,30,1,7,0,8,1,30,8,0,0,8,2,30,4,0,0,4,0,-27,3,0
2,2,10,0,30,4,5,0,9,1,30,3,1,0,4,1,30,2,7,0,9,4,30,2,7,0,9,3,30,5,0,0,5,1,-15,3,1
2,1,13,2,30,7,0,0,7,0,30,4,0,0,4,2,30,7,0,0,7,7,30,5,2,0,7,4,30,4,0,0,4,1,-15,3,1
2,2,13,2,30,7,0,0,7,0,30,4,0,0,4,2,30,7,0,0,7,7,30,5,2,0,7,4,30,4,0,0,4,1,-15,3,1
2,4,13,2,30,7,0,0,7,0,30,4,0,0,4,2,30,7,0,0,7,7,30,5,2,0,7,4,30,4,0,0,4,1,-15,3,1
2,3,23,1,30,7,6,0,13,3,30,6,0,0,6,3,30,9,4,0,13,0,30,10,3,0,13,0,30,6,0,0,6,1,-15,3,1
2,4,23,1,30,7,6,0,13,3,30,6,0,0,6,3,30,9,4,0,13,0,30,10,3,0,13,0,30,6,0,0,6,1,-15,3,1
2,3,25,1,30,13,1,0,14,4,30,6,0,0,6,0,30,5,9,0,14,1,30,5,9,0,14,4,30,5,1,0,6,1,-15,3,1
2,4,25,1,30,13,1,0,14,4,30,6,0,0,6,0,30,5,9,0,14,1,30,5,9,0,14,4,30,5,1,0,6,1,-15,3,1
2,0,31,1,30,5,7,0,12,6,30,8,0,0,8,3,30,4,8,0,12,0,30,7,5,0,12,2,30,6,0,0,6,1,-15,3,1
2,1,31,1,30,5,7,0,12,6,30,8,0,0,8,3,30,4,8,0,12,0,30,7,5,0,12,2,30,6,0,0,6,1,-15,3,1
2,2,31,1,30,5,7,0,12,6,30,8,0,0,8,3,30,4,8,0,12,0,30,7,5,0,12,2,30,6,0,0,6,1,-15,3,1
2,3,31,1,30,5,7,0,12,6,30,8,0,0,8,3,30,4,8,0,12,0,30,7,5,0,12,2,30,6,0,0,6,1,-15,3,1
2,4,31,1,30,5,7,0,12,6,30,8,0,0,8,3,30,4,8,0,12,0,30,7,5,0,12,2,30,6,0,0,6,1,-15,3,1
2,2,35,0,30,8,5,0,13,3,30,2,0,0,2,1,30,9,4,0,13,0,30,1,12,0,13,3,30,8,0,0,8,1,-15,3,1
2,2,39,0,30,4,7,0,11,6,30,6,0,0,6,0,30,6,5,0,11,2,30,4,7,0,11,3,30,5,0,0,5,1,-15,3,1
2,3,1,0,30,8,2,0,10,5,30,2,0,0,2,1,30,3,7,0,10,4,30,6,4,0,10,5,30,6,0,0,6,0,-27,3,0
2,1,5,0,30,2,3,0,5,3,30,1,3,0,4,0,30,2,3,0,5,0,30,1,4,0,5,0,30,2,0,0,2,0,-27,3,0
2,2,5,0,30,2,3,0,5,3,30,1,3,0,4,0,30,2,3,0,5,0,30,1,4,0,5,0,30,2,0,0,2,0,-27,3,0
2,2,9,0,30,5,6,0,11,3,30,6,0,0,6,1,30,6,5,0,11,7,30,3,8,0,11,4,30,4,0,0,4,0,-27,3,0
2,1,13,6,30,7,0,0,7,2,30,4,0,0,4,1,30,5,2,0,7,0,30,5,2,0,7,3,30,4,0,0,4,1,-15,3,1
2,4,13,6,30,7,0,0,7,2,30,4,0,0,4,1,30,5,2,0,7,0,30,5,2,0,7,3,30,4,0,0,4,1,-15,3,1
2,1,19,0,30,3,10,0,13,2,30,5,3,0,8,0,30,7,6,0,13,7,30,4,9,0,13,3,30,9,0,0,9,1,-15,3,1
2,2,19,0,30,3,10,0,13,2,30,5,3,0,8,0,30,7,6,0,13,7,30,4,9,0,13,3,30,9,0,0,9,1,-15,3,1
2,4,19,0,30,3,10,0,13,2,30,5,3,0,8,0,30,7,6,0,13,7,30,4,9,0,13,3,30,9,0,0,9,1,-15,3,1
2,0,4,2,30,8,0,0,8,4,30,4,0,0,4,0,30,2,6,0,8,0,30,5,3,0,8,2,30,4,0,0,4,0,-27,3,0
2,1,4,2,30,8,0,0,8,4,30,4,0,0,4,0,30,2,6,0,8,0,30,5,3,0,8,2,30,4,0,0,4,0,-27,3,0
2,3,8,2,30,7,0,0,7,3,30,2,0,0,2,6,30,4,3,0,7,1,30,7,0,0,7,3,30,3,0,0,3,0,-27,3,0
2,3,9,0,30,6,5,0,11,3,30,6,0,0,6,3,30,7,4,0,11,4,30,2,9,0,11,3,30,4,0,0,4,0,-27,3,0
2,1,11,3,30,2,10,0,12,2,30,4,0,0,4,0,30,2,10,0,12,8,30,6,6,0,12,8,30,4,0,0,4,1,-15,3,1
2,2,11,3,30,2,10,0,12,2,30,4,0,0,4,0,30,2,10,0,12,8,30,6,6,0,12,8,30,4,0,0,4,1,-15,3,1
2,1,13,3,30,7,0,0,7,0,30,4,0,0,4,2,30,6,1,0,7,12,30,4,3,0,7,3,30,4,0,0,4,1,-15,3,1
2,3,19,0,30,2,11,0,13,2,30,3,5,0,8,0,30,13,0,0,13,0,30,6,7,0,13,2,30,8,1,0,9,1,-15,3,1
2,4,19,0,30,2,11,0,13,2,30,3,5,0,8,0,30,13,0,0,13,0,30,6,7,0,13,2,30,8,1,0,9,1,-15,3,1
2,2,23,1,30,4,9,0,13,5,30,6,0,0,6,0,30,4,9,0,13,8,30,6,7,0,13,5,30,6,0,0,6,1,-15,3,1
2,3,27,0,30,5,10,0,15,2,30,2,0,0,2,0,30,6,9,0,15,2,30,4,11,0,15,0,30,4,2,0,6,1,-15,3,1
2,0,29,2,30,11,3,0,14,5,30,8,4,0,12,0,30,3,11,0,14,2,30,3,11,0,14,1,30,9,0,0,9,1,-15,3,1
2,4,39,0,30,5,6,0,11,6,30,6,0,0,6,0,30,6,5,0,11,0,30,2,9,0,11,4,30,5,0,0,5,1,-15,3,1
2,2,4,4,30,8,0,0,8,5,30,4,0,0,4,0,30,3,5,0,8,0,30,4,4,0,8,4,30,4,0,0,4,0,-27,3,0
2,3,4,4,30,8,0,0,8,5,30,4,0,0,4,0,30,3,5,0,8,0,30,4,4,0,8,4,30,4,0,0,4,0,-27,3,0
2,3,17,3,30,10,4,0,14,3,30,6,0,0,6,0,30,5,9,0,14,2,30,6,8,0,14,5,30,4,0,0,4,1,-15,3,1
2,4,19,0,30,3,10,0,13,2,30,6,2,0,8,0,30,8,5,0,13,4,30,4,9,0,13,1,30,8,1,0,9,1,-15,3,1
2,2,23,1,30,5,8,0,13,3,30,6,0,0,6,5,30,13,0,0,13,0,30,6,7,0,13,2,30,6,0,0,6,1,-15,3,1
2,4,23,1,30,5,8,0,13,3,30,6,0,0,6,5,30,13,0,0,13,0,30,6,7,0,13,2,30,6,0,0,6,1,-15,3,1
2,1,27,1,30,7,8,0,15,4,30,1,1,0,2,0,30,8,7,0,15,2,30,6,9,0,15,1,30,6,0,0,6,1,-15,3,1
2,4,27,1,30,7,8,0,15,4,30,1,1,0,2,0,30,8,7,0,15,0,30,6,9,0,15,1,30,6,0,0,6,1,-15,3,1
2,1,33,1,30,4,7,0,11,5,30,4,0,0,4,3,30,11,0,0,11,0,30,3,8,0,11,7,30,4,0,0,4,1,-15,3,1
2,3,33,1,30,4,7,0,11,5,30,4,0,0,4,3,30,11,0,0,11,0,30,3,8,0,11,7,30,4,0,0,4,1,-15,3,1
2,2,47,0,30,1,13,0,14,7,30,4,0,0,4,0,30,3,11,0,14,0,30,9,5,0,14,9,30,7,0,0,7,1,-15,3,1
2,3,11,0,30,6,6,0,12,0,30,4,0,0,4,0,30,9,3,0,12,3,30,7,5,0,12,6,30,4,0,0,4,1,-15,3,1
2,1,13,2,30,6,1,0,7,0,30,4,0,0,4,4,30,7,0,0,7,9,30,6,1,0,7,2,30,4,0,0,4,1,-15,3,1
2,2,13,2,30,6,1,0,7,0,30,4,0,0,4,4,30,7,0,0,7,9,30,6,1,0,7,2,30,4,0,0,4,1,-15,3,1
2,4,13,2,30,6,1,0,7,0,30,4,0,0,4,4,30,7,0,0,7,9,30,6,1,0,7,2,30,4,0,0,4,1,-15,3,1
2,3,15,1,30,4,9,0,13,1,30,6,0,0,6,0,30,3,10,0,13,1,30,6,7,0,13,2,30,8,1,0,9,1,-15,3,1
2,2,19,0,30,3,10,0,13,1,30,4,4,0,8,0,30,6,7,0,13,9,30,8,5,0,13,1,30,8,1,0,9,1,-15,3,1
2,0,27,1,30,5,10,0,15,5,30,2,0,0,2,0,30,5,10,0,15,4,30,6,9,0,15,2,30,4,2,0,6,1,-15,3,1
2,2,27,1,30,5,10,0,15,5,30,2,0,0,2,0,30,5,10,0,15,4,30,6,9,0,15,2,30,4,2,0,6,1,-15,3,1
2,3,27,1,30,5,10,0,15,5,30,2,0,0,2,0,30,5,10,0,15,4,30,6,9,0,15,2,30,4,2,0,6,1,-15,3,1
2,2,29,0,30,6,8,0,14,6,30,11,1,0,12,0,30,4,10,0,14,0,30,1,13,0,14,3,30,9,0,0,9,1,-15,3,1
2,3,29,0,30,6,8,0,14,6,30,11,1,0,12,0,30,4,10,0,14,0,30,1,13,0,14,3,30,9,0,0,9,1,-15,3,1
2,2,41,0,30,8,4,0,12,7,30,8,0,0,8,0,30,3,9,0,12,0,30,3,9,0,12,1,30,4,3,0,7,1,-15,3,1
2,4,15,2,30,5,8,0,13,2,30,6,0,0,6,0,30,4,9,0,13,1,30,7,6,0,13,0,30,5,4,0,9,1,-15,3,1
2,1,17,4,30,10,4,0,14,2,30,6,0,0,6,0,30,7,7,0,14,1,30,3,11,0,14,5,30,4,0,0,4,1,-15,3,1
2,2,17,4,30,10,4,0,14,2,30,6,0,0,6,0,30,7,7,0,14,1,30,3,11,0,14,5,30,4,0,0,4,1,-15,3,1
2,4,17,4,30,10,4,0,14,2,30,6,0,0,6,0,30,7,7,0,14,1,30,3,11,0,14,5,30,4,0,0,4,1,-15,3,1
2,4,19,0,30,2,11,0,13,3,30,6,2,0,8,0,30,4,9,0,13,8,30,5,8,0,13,1,30,8,1,0,9,1,-15,3,1
2,2,25,2,30,5,9,0,14,3,30,6,0,0,6,1,30,9,5,0,14,1,30,5,9,0,14,3,30,5,1,0,6,1,-15,3,1
2,3,25,2,30,5,9,0,14,3,30,6,0,0,6,1,30,9,5,0,14,1,30,5,9,0,14,3,30,5,1,0,6,1,-15,3,1
2,1,27,1,30,4,11,0,15,4,30,1,1,0,2,0,30,6,9,0,15,4,30,5,10,0,15,2,30,6,0,0,6,1,-15,3,1
2,2,27,1,30,4,11,0,15,4,30,1,1,0,2,0,30,6,9,0,15,4,30,5,10,0,15,2,30,6,0,0,6,1,-15,3,1
2,2,37,1,30,7,4,0,11,4,30,8,0,0,8,0,30,11,0,0,11,6,30,3,8,0,11,7,30,6,0,0,6,1,-15,3,1
2,2,43,6,30,11,3,0,14,9,30,6,0,0,6,0,30,4,10,0,14,1,30,1,13,0,14,0,30,5,0,0,5,1,-15,3,1
2,4,47,0,30,0,14,0,14,8,30,4,0,0,4,0,30,4,10,0,14,0,30,2,12,0,14,1,30,4,3,0,7,1,-15,3,1
2,3,2,6,30,8,2,0,10,4,30,3,1,0,4,3,30,3,7,0,10,0,30,6,4,0,10,1,30,2,6,0,8,0,-27,3,0
2,4,8,2,30,7,0,0,7,3,30,2,0,0,2,0,30,6,1,0,7,0,30,6,1,0,7,1,30,3,0,0,3,0,-27,3,0
2,3,13,2,30,5,2,0,7,0,30,4,0,0,4,2,30,7,0,0,7,6,30,7,0,0,7,4,30,4,0,0,4,1,-15,3,1
2,4,19,0,30,3,10,0,13,2,30,8,0,0,8,0,30,6,7,0,13,3,30,7,6,0,13,1,30,7,2,0,9,1,-15,3,1
2,2,25,1,30,3,11,0,14,5,30,6,0,0,6,0,30,10,4,0,14,4,30,6,8,0,14,3,30,5,1,0,6,1,-15,3,1
2,1,27,3,30,5,10,0,15,2,30,1,1,0,2,0,30,7,8,0,15,0,30,6,9,0,15,2,30,6,0,0,6,1,-15,3,1
2,2,27,3,30,5,10,0,15,2,30,1,1,0,2,0,30,7,8,0,15,0,30,6,9,0,15,2,30,6,0,0,6,1,-15,3,1
2,4,39,0,30,2,9,0,11,6,30,6,0,0,6,0,30,6,5,0,11,0,30,2,9,0,11,4,30,5,0,0,5,1,-15,3,1
2,4,13,1,30,3,0,0,3,0,30,2,0,0,2,0,30,3,0,0,3,7,30,3,0,0,3,4,30,2,0,0,2,1,-15,3,1
2,2,13,2,30,6,1,0,7,0,30,4,0,0,4,3,30,6,1,0,7,6,30,7,0,0,7,4,30,4,0,0,4,1,-15,3,1
2,3,13,2,30,6,1,0,7,0,30,4,0,0,4,3,30,6,1,0,7,6,30,7,0,0,7,4,30,4,0,0,4,1,-15,3,1
2,4,13,2,30,6,1,0,7,0,30,4,0,0,4,3,30,6,1,0,7,6,30,7,0,0,7,4,30,4,0,0,4,1,-15,3,1
2,2,19,0,30,3,10,0,13,2,30,7,1,0,8,0,30,4,9,0,13,3,30,8,5,0,13,0,30,8,1,0,9,1,-15,3,1
2,3,25,1,30,5,9,0,14,3,30,6,0,0,6,0,30,9,5,0,14,1,30,5,9,0,14,5,30,6,0,0,6,1,-15,3,1
2,4,25,1,30,5,9,0,14,3,30,6,0,0,6,0,30,9,5,0,14,1,30,5,9,0,14,5,30,6,0,0,6,1,-15,3,1
2,0,27,2,30,4,11,0,15,4,30,2,0,0,2,0,30,6,9,0,15,0,30,6,9,0,15,6,30,6,0,0,6,1,-15,3,1
2,1,27,2,30,4,11,0,15,4,30,2,0,0,2,0,30,6,9,0,15,0,30,6,9,0,15,6,30,6,0,0,6,1,-15,3,1
2,3,31,1,30,5,7,0,12,5,30,8,0,0,8,3,30,8,4,0,12,0,30,7,5,0,12,0,30,5,1,0,6,1,-15,3,1
2,3,32,0,30,9,0,0,9,4,30,2,0,0,2,0,30,8,1,0,9,1,30,3,6,0,9,2,30,2,0,0,2,1,-15,3,1
2,1,5,0,30,2,3,0,5,3,30,2,2,0,4,0,30,1,4,0,5,0,30,1,4,0,5,0,30,0,2,0,2,0,-27,3,0
2,1,6,0,30,5,4,0,9,4,30,2,0,0,2,0,30,2,7,0,9,0,30,4,5,0,9,3,30,5,0,0,5,0,-27,3,0
2,2,6,0,30,5,4,0,9,4,30,2,0,0,2,0,30,2,7,0,9,0,30,4,5,0,9,3,30,5,0,0,5,0,-27,3,0
2,4,8,1,30,7,0,0,7,4,30,2,0,0,2,3,30,2,5,0,7,0,30,4,3,0,7,2,30,3,0,0,3,0,-27,3,0
2,2,11,2,30,10,2,0,12,2,30,4,0,0,4,0,30,3,9,0,12,2,30,4,8,0,12,5,30,4,0,0,4,1,-15,3,1
2,4,11,2,30,10,2,0,12,2,30,4,0,0,4,0,30,3,9,0,12,2,30,4,8,0,12,5,30,4,0,0,4,1,-15,3,1
2,3,15,0,30,8,5,0,13,0,30,5,1,0,6,0,30,5,8,0,13,1,30,6,7,0,13,2,30,6,3,0,9,1,-15,3,1
2,4,15,0,30,8,5,0,13,0,30,5,1,0,6,0,30,5,8,0,13,1,30,6,7,0,13,2,30,6,3,0,9,1,-15,3,1
2,2,19,0,30,3,10,0,13,2,30,8,0,0,8,0,30,9,4,0,13,2,30,5,8,0,13,2,30,8,1,0,9,1,-15,3,1
2,4,19,0,30,3,10,0,13,2,30,8,0,0,8,0,30,9,4,0,13,2,30,5,8,0,13,1,30,8,1,0,9,1,-15,3,1
2,2,33,1,30,4,7,0,11,4,30,4,0,0,4,0,30,10,1,0,11,1,30,6,5,0,11,3,30,4,0,0,4,1,-15,3,1
2,4,35,2,30,7,6,0,13,6,30,2,0,0,2,5,30,2,11,0,13,0,30,1,12,0,13,3,30,7,1,0,8,1,-15,3,1
2,3,4,1,30,7,1,0,8,3,30,4,0,0,4,0,30,1,7,0,8,0,30,1,7,0,8,0,30,4,0,0,4,0,-27,3,0
2,2,6,1,30,7,2,0,9,5,30,2,0,0,2,0,30,2,7,0,9,0,30,4,5,0,9,5,30,5,0,0,5,0,-27,3,0
2,3,6,1,30,7,2,0,9,5,30,2,0,0,2,0,30,2,7,0,9,0,30,4,5,0,9,5,30,5,0,0,5,0,-27,3,0
2,1,13,3,30,7,0,0,7,0,30,4,0,0,4,2,30,5,2,0,7,14,30,6,1,0,7,3,30,4,0,0,4,1,-15,3,1
2,2,13,3,30,7,0,0,7,0,30,4,0,0,4,2,30,5,2,0,7,14,30,6,1,0,7,3,30,4,0,0,4,1,-15,3,1
2,4,13,3,30,7,0,0,7,0,30,4,0,0,4,2,30,5,2,0,7,14,30,6,1,0,7,3,30,4,0,0,4,1,-15,3,1
2,1,17,3,30,10,4,0,14,3,30,6,0,0,6,0,30,4,10,0,14,3,30,7,7,0,14,1,30,4,0,0,4,1,-15,3,1
2,3,17,3,30,10,4,0,14,3,30,6,0,0,6,0,30,4,10,0,14,3,30,7,7,0,14,0,30,4,0,0,4,1,-15,3,1
2,4,17,3,30,10,4,0,14,3,30,6,0,0,6,0,30,4,10,0,14,3,30,7,7,0,14,0,30,4,0,0,4,1,-15,3,1
2,4,19,0,30,3,10,0,13,2,30,8,0,0,8,0,30,6,7,0,13,7,30,4,9,0,13,0,30,7,2,0,9,1,-15,3,1
2,2,23,1,30,5,8,0,13,1,30,6,0,0,6,0,30,12,1,0,13,6,30,9,4,0,13,5,30,6,0,0,6,1,-15,3,1
2,3,23,1,30,5,8,0,13,1,30,6,0,0,6,0,30,12,1,0,13,6,30,9,4,0,13,5,30,6,0,0,6,1,-15,3,1
2,3,27,2,30,6,9,0,15,0,30,2,0,0,2,0,30,10,5,0,15,0,30,5,10,0,15,0,30,3,3,0,6,1,-15,3,1
2,0,29,1,30,5,9,0,14,6,30,12,0,0,12,0,30,4,10,0,14,0,30,1,13,0,14,2,30,9,0,0,9,1,-15,3,1
2,1,29,1,30,5,9,0,14,6,30,12,0,0,12,0,30,4,10,0,14,0,30,1,13,0,14,2,30,9,0,0,9,1,-15,3,1
2,4,29,0,30,5,9,0,14,6,30,12,0,0,12,0,30,4,10,0,14,0,30,1,13,0,14,2,30,9,0,0,9,1,-15,3,1
2,4,39,0,30,1,10,0,11,6,30,6,0,0,6,0,30,4,7,0,11,0,30,2,9,0,11,1,30,4,1,0,5,1,-15,3,1
2,3,6,1,30,9,0,0,9,3,30,2,0,0,2,0,30,4,5,0,9,0,30,3,6,0,9,0,30,3,2,0,5,0,-27,3,0
2,2,9,0,30,5,6,0,11,3,30,6,0,0,6,1,30,6,5,0,11,5,30,4,7,0,11,2,30,4,0,0,4,0,-27,3,0
2,1,13,2,30,7,0,0,7,0,30,4,0,0,4,2,30,7,0,0,7,7,30,5,2,0,7,3,30,4,0,0,4,1,-15,3,1
2,2,13,2,30,7,0,0,7,0,30,4,0,0,4,2,30,7,0,0,7,7,30,5,2,0,7,3,30,4,0,0,4,1,-15,3,1
2,4,17,4,30,10,4,0,14,4,30,6,0,0,6,0,30,4,10,0,14,0,30,7,7,0,14,2,30,4,0,0,4,1,-15,3,1
2,4,23,4,30,5,8,0,13,4,30,6,0,0,6,5,30,12,1,0,13,0,30,5,8,0,13,4,30,6,0,0,6,1,-15,3,1
2,0,25,1,30,9,5,0,14,5,30,6,0,0,6,0,30,4,10,0,14,1,30,8,6,0,14,4,30,6,0,0,6,1,-15,3,1
2,1,25,1,30,9,5,0,14,5,30,6,0,0,6,0,30,4,10,0,14,1,30,8,6,0,14,4,30,6,0,0,6,1,-15,3,1
2,4,27,1,30,5,10,0,15,5,30,2,0,0,2,0,30,3,12,0,15,2,30,6,9,0,15,0,30,6,0,0,6,1,-15,3,1
2,4,29,0,30,8,6,0,14,4,30,12,0,0,12,0,30,7,7,0,14,0,30,1,13,0,14,0,30,6,3,0,9,1,-15,3,1
2,4,39,2,30,4,7,0,11,6,30,6,0,0,6,0,30,4,7,0,11,0,30,2,9,0,11,2,30,2,3,0,5,1,-15,3,1
2,2,43,0,30,8,6,0,14,7,30,6,0,0,6,0,30,8,6,0,14,1,30,7,7,0,14,3,30,5,0,0,5,1,-15,3,1
2,2,45,0,30,8,5,0,13,10,30,10,0,0,10,0,30,1,12,0,13,0,30,4,9,0,13,8,30,5,0,0,5,1,-15,3,1
2,2,47,0,30,0,14,0,14,6,30,4,0,0,4,0,30,5,9,0,14,0,30,2,12,0,14,8,30,7,0,0,7,1,-15,3,1
2,3,47,0,30,0,14,0,14,6,30,4,0,0,4,0,30,5,9,0,14,0,30,2,12,0,14,8,30,7,0,0,7,1,-15,3,1
2,3,9,1,30,6,5,0,11,4,30,6,0,0,6,7,30,4,7,0,11,2,30,4,7,0,11,2,30,3,1,0,4,0,-27,3,0
2,4,9,1,30,6,5,0,11,4,30,6,0,0,6,7,30,4,7,0,11,2,30,4,7,0,11,2,30,3,1,0,4,0,-27,3,0
2,4,13,3,30,7,0,0,7,0,30,4,0,0,4,2,30,5,2,0,7,9,30,6,1,0,7,0,30,4,0,0,4,1,-15,3,1
2,2,19,0,30,2,11,0,13,2,30,5,3,0,8,0,30,9,4,0,13,4,30,4,9,0,13,2,30,8,1,0,9,1,-15,3,1
2,4,19,0,30,2,11,0,13,2,30,5,3,0,8,0,30,9,4,0,13,4,30,4,9,0,13,2,30,8,1,0,9,1,-15,3,1
2,3,23,1,30,5,8,0,13,3,30,6,0,0,6,0,30,10,3,0,13,3,30,6,7,0,13,4,30,6,0,0,6,1,-15,3,1
2,3,25,1,30,10,4,0,14,4,30,6,0,0,6,1,30,7,7,0,14,2,30,7,7,0,14,0,30,5,1,0,6,1,-15,3,1
2,4,25,1,30,10,4,0,14,4,30,6,0,0,6,1,30,7,7,0,14,2,30,7,7,0,14,0,30,5,1,0,6,1,-15,3,1
2,4,26,0,30,4,5,0,9,5,30,4,0,0,4,5,30,2,7,0,9,0,30,3,6,0,9,3,30,2,1,0,3,1,-15,3,1
2,2,27,3,30,6,9,0,15,2,30,2,0,0,2,0,30,13,2,0,15,0,30,4,11,0,15,0,30,3,3,0,6,1,-15,3,1
2,3,35,0,30,5,8,0,13,4,30,2,0,0,2,1,30,10,3,0,13,2,30,5,8,0,13,5,30,8,0,0,8,1,-15,3,1
2,3,39,0,30,2,9,0,11,6,30,5,1,0,6,0,30,5,6,0,11,2,30,4,7,0,11,5,30,5,0,0,5,1,-15,3,1
2,4,39,0,30,2,9,0,11,6,30,5,1,0,6,0,30,5,6,0,11,2,30,4,7,0,11,5,30,5,0,0,5,1,-15,3,1
2,1,5,0,30,0,5,0,5,2,30,3,1,0,4,0,30,0,5,0,5,0,30,1,4,0,5,0,30,0,2,0,2,0,-27,3,0
2,3,13,3,30,6,1,0,7,0,30,4,0,0,4,2,30,7,0,0,7,4,30,7,0,0,7,3,30,4,0,0,4,1,-15,3,1
2,2,17,2,30,9,5,0,14,3,30,6,0,0,6,0,30,5,9,0,14,1,30,5,9,0,14,0,30,4,0,0,4,1,-15,3,1
2,3,17,2,30,9,5,0,14,3,30,6,0,0,6,0,30,5,9,0,14,1,30,5,9,0,14,0,30,4,0,0,4,1,-15,3,1
2,1,19,0,30,2,11,0,13,3,30,4,4,0,8,0,30,4,9,0,13,7,30,5,8,0,13,2,30,9,0,0,9,1,-15,3,1
2,2,19,0,30,2,11,0,13,3,30,4,4,0,8,0,30,4,9,0,13,7,30,5,8,0,13,2,30,9,0,0,9,1,-15,3,1
2,4,19,0,30,2,11,0,13,3,30,4,4,0,8,0,30,4,9,0,13,7,30,5,8,0,13,2,30,9,0,0,9,1,-15,3,1
2,3,25,2,30,5,9,0,14,4,30,6,0,0,6,0,30,7,7,0,14,1,30,5,9,0,14,5,30,4,2,0,6,1,-15,3,1
2,2,32,0,30,6,3,0,9,4,30,2,0,0,2,4,30,9,0,0,9,1,30,3,6,0,9,3,30,2,0,0,2,1,-15,3,1
2,4,37,2,30,8,3,0,11,6,30,7,1,0,8,4,30,6,5,0,11,0,30,3,8,0,11,1,30,2,4,0,6,1,-15,3,1
2,0,13,6,30,7,0,0,7,3,30,4,0,0,4,3,30,5,2,0,7,2,30,3,4,0,7,4,30,4,0,0,4,1,-15,3,1
2,2,17,4,30,11,3,0,14,3,30,6,0,0,6,0,30,5,9,0,14,1,30,6,8,0,14,4,30,4,0,0,4,1,-15,3,1
2,3,23,2,30,5,8,0,13,3,30,6,0,0,6,7,30,11,2,0,13,0,30,6,7,0,13,5,30,6,0,0,6,1,-15,3,1
2,1,25,0,30,4,10,0,14,4,30,6,0,0,6,0,30,9,5,0,14,1,30,9,5,0,14,6,30,6,0,0,6,1,-15,3,1
2,2,25,0,30,4,10,0,14,4,30,6,0,0,6,0,30,9,5,0,14,1,30,9,5,0,14,6,30,6,0,0,6,1,-15,3,1
2,2,27,1,30,6,9,0,15,5,30,2,0,0,2,0,30,3,12,0,15,1,30,4,11,0,15,7,30,6,0,0,6,1,-15,3,1
2,3,27,1,30,6,9,0,15,5,30,2,0,0,2,0,30,3,12,0,15,1,30,4,11,0,15,7,30,6,0,0,6,1,-15,3,1
2,0,29,0,30,6,8,0,14,6,30,12,0,0,12,0,30,4,10,0,14,0,30,1,13,0,14,4,30,9,0,0,9,1,-15,3,1
2,3,29,0,30,6,8,0,14,6,30,12,0,0,12,0,30,4,10,0,14,0,30,1,13,0,14,3,30,9,0,0,9,1,-15,3,1
2,4,29,0,30,6,8,0,14,6,30,12,0,0,12,0,30,4,10,0,14,0,30,1,13,0,14,3,30,9,0,0,9,1,-15,3,1
2,4,8,2,30,7,0,0,7,3,30,2,0,0,2,0,30,6,1,0,7,1,30,7,0,0,7,0,30,3,0,0,3,0,-27,3,0
2,2,17,4,30,8,6,0,14,3,30,6,0,0,6,0,30,6,8,0,14,3,30,5,9,0,14,5,30,4,0,0,4,1,-15,3,1
2,4,17,4,30,8,6,0,14,3,30,6,0,0,6,0,30,6,8,0,14,0,30,5,9,0,14,5,30,4,0,0,4,1,-15,3,1
2,4,19,0,30,3,10,0,13,1,30,8,0,0,8,1,30,7,6,0,13,3,30,5,8,0,13,0,30,8,1,0,9,1,-15,3,1
2,2,27,1,30,7,8,0,15,2,30,1,1,0,2,0,30,6,9,0,15,0,30,5,10,0,15,2,30,6,0,0,6,1,-15,3,1
2,3,27,1,30,7,8,0,15,2,30,1,1,0,2,0,30,6,9,0,15,0,30,5,10,0,15,2,30,6,0,0,6,1,-15,3,1
2,4,27,1,30,7,8,0,15,2,30,1,1,0,2,0,30,6,9,0,15,0,30,5,10,0,15,2,30,6,0,0,6,1,-15,3,1
2,3,29,0,30,5,9,0,14,6,30,12,0,0,12,0,30,3,11,0,14,0,30,0,14,0,14,2,30,9,0,0,9,1,-15,3,1
2,4,29,0,30,5,9,0,14,6,30,12,0,0,12,0,30,3,11,0,14,0,30,0,14,0,14,2,30,9,0,0,9,1,-15,3,1
2,2,38,0,30,2,8,0,10,7,30,6,0,0,6,0,30,1,9,0,10,0,30,3,7,0,10,2,30,6,0,0,6,1,-15,3,1
2,3,38,0,30,2,8,0,10,7,30,6,0,0,6,0,30,1,9,0,10,0,30,3,7,0,10,2,30,6,0,0,6,1,-15,3,1
2,4,39,0,30,3,8,0,11,6,30,6,0,0,6,0,30,4,7,0,11,0,30,2,9,0,11,0,30,4,1,0,5,1,-15,3,1
2,0,4,2,30,6,2,0,8,4,30,3,1,0,4,0,30,1,7,0,8,0,30,5,3,0,8,5,30,4,0,0,4,0,-27,3,0
2,1,4,2,30,6,2,0,8,4,30,3,1,0,4,0,30,1,7,0,8,0,30,5,3,0,8,5,30,4,0,0,4,0,-27,3,0
2,3,4,2,30,6,2,0,8,4,30,3,1,0,4,0,30,1,7,0,8,0,30,5,3,0,8,5,30,4,0,0,4,0,-27,3,0
2,4,8,2,30,7,0,0,7,4,30,2,0,0,2,0,30,5,2,0,7,0,30,7,0,0,7,0,30,3,0,0,3,0,-27,3,0
2,4,15,0,30,6,7,0,13,0,30,5,1,0,6,0,30,4,9,0,13,1,30,2,11,0,13,2,30,7,2,0,9,1,-15,3,1
2,3,17,0,30,8,6,0,14,1,30,6,0,0,6,0,30,8,6,0,14,3,30,8,6,0,14,8,30,4,0,0,4,1,-15,3,1
2,2,25,1,30,5,9,0,14,5,30,6,0,0,6,0,30,7,7,0,14,2,30,7,7,0,14,5,30,6,0,0,6,1,-15,3,1
2,0,27,1,30,4,11,0,15,4,30,1,1,0,2,0,30,2,13,0,15,1,30,4,11,0,15,7,30,6,0,0,6,1,-15,3,1
2,1,27,1,30,4,11,0,15,4,30,1,1,0,2,0,30,2,13,0,15,1,30,4,11,0,15,7,30,6,0,0,6,1,-15,3,1
2,3,27,1,30,4,11,0,15,4,30,1,1,0,2,0,30,2,13,0,15,1,30,4,11,0,15,7,30,6,0,0,6,1,-15,3,1
2,4,29,0,30,4,10,0,14,6,30,12,0,0,12,0,30,3,11,0,14,0,30,1,13,0,14,1,30,9,0,0,9,1,-15,3,1
2,0,5,0,30,2,3,0,5,3,30,1,3,0,4,0,30,0,5,0,5,0,30,1,4,0,5,3,30,0,2,0,2,0,-27,3,0
2,3,5,0,30,2,3,0,5,3,30,1,3,0,4,0,30,0,5,0,5,0,30,1,4,0,5,3,30,0,2,0,2,0,-27,3,0
2,4,5,0,30,2,3,0,5,3,30,1,3,0,4,0,30,0,5,0,5,0,30,1,4,0,5,3,30,0,2,0,2,0,-27,3,0
2,4,8,0,30,7,0,0,7,3,30,2,0,0,2,3,30,3,4,0,7,0,30,7,0,0,7,3,30,3,0,0,3,0,-27,3,0
2,2,13,2,30,7,0,0,7,1,30,4,0,0,4,2,30,6,1,0,7,5,30,7,0,0,7,0,30,4,0,0,4,1,-15,3,1
2,3,13,2,30,7,0,0,7,1,30,4,0,0,4,2,30,6,1,0,7,5,30,7,0,0,7,0,30,4,0,0,4,1,-15,3,1
2,4,13,2,30,7,0,0,7,1,30,4,0,0,4,2,30,6,1,0,7,5,30,7,0,0,7,0,30,4,0,0,4,1,-15,3,1
2,4,23,2,30,9,4,0,13,1,30,6,0,0,6,5,30,12,1,0,13,0,30,5,8,0,13,1,30,6,0,0,6,1,-15,3,1
2,3,25,1,30,6,8,0,14,4,30,6,0,0,6,0,30,8,6,0,14,1,30,7,7,0,14,4,30,5,1,0,6,1,-15,3,1
2,0,27,1,30,5,10,0,15,1,30,1,1,0,2,0,30,9,6,0,15,3,30,5,10,0,15,4,30,6,0,0,6,1,-15,3,1
2,1,27,1,30,5,10,0,15,1,30,1,1,0,2,0,30,9,6,0,15,3,30,5,10,0,15,4,30,6,0,0,6,1,-15,3,1
2,2,27,1,30,5,10,0,15,1,30,1,1,0,2,0,30,9,6,0,15,3,30,5,10,0,15,4,30,6,0,0,6,1,-15,3,1
2,4,27,1,30,5,10,0,15,1,30,1,1,0,2,0,30,9,6,0,15,3,30,5,10,0,15,4,30,6,0,0,6,1,-15,3,1
2,3,29,0,30,4,10,0,14,5,30,9,3,0,12,0,30,8,6,0,14,0,30,0,14,0,14,0,30,8,1,0,9,1,-15,3,1
2,4,29,0,30,4,10,0,14,5,30,9,3,0,12,0,30,8,6,0,14,0,30,0,14,0,14,0,30,8,1,0,9,1,-15,3,1
2,4,38,0,30,2,8,0,10,7,30,6,0,0,6,3,30,2,8,0,10,0,30,2,8,0,10,5,30,6,0,0,6,1,-15,3,1
2,0,4,2,30,6,2,0,8,5,30,4,0,0,4,1,30,1,7,0,8,0,30,6,2,0,8,3,30,4,0,0,4,0,-27,3,0
2,1,4,2,30,6,2,0,8,5,30,4,0,0,4,1,30,1,7,0,8,0,30,6,2,0,8,3,30,4,0,0,4,0,-27,3,0
2,4,4,2,30,6,2,0,8,5,30,4,0,0,4,1,30,1,7,0,8,0,30,6,2,0,8,3,30,4,0,0,4,0,-27,3,0
2,4,6,0,30,5,4,0,9,4,30,2,0,0,2,1,30,2,7,0,9,0,30,4,5,0,9,1,30,5,0,0,5,0,-27,3,0
2,1,13,4,30,5,2,0,7,0,30,4,0,0,4,2,30,7,0,0,7,5,30,5,2,0,7,4,30,4,0,0,4,1,-15,3,1
2,2,13,4,30,5,2,0,7,0,30,4,0,0,4,2,30,7,0,0,7,5,30,5,2,0,7,4,30,4,0,0,4,1,-15,3,1
2,4,19,0,30,3,10,0,13,2,30,5,3,0,8,0,30,7,6,0,13,4,30,3,10,0,13,0,30,9,0,0,9,1,-15,3,1
2,3,23,1,30,7,6,0,13,3,30,6,0,0,6,5,30,10,3,0,13,0,30,5,8,0,13,3,30,6,0,0,6,1,-15,3,1
2,4,25,1,30,8,6,0,14,3,30,6,0,0,6,0,30,4,10,0,14,1,30,7,7,0,14,3,30,5,1,0,6,1,-15,3,1
2,0,27,1,30,5,10,0,15,2,30,2,0,0,2,0,30,5,10,0,15,2,30,6,9,0,15,3,30,6,0,0,6,1,-15,3,1
2,1,27,1,30,5,10,0,15,2,30,2,0,0,2,0,30,5,10,0,15,2,30,6,9,0,15,3,30,6,0,0,6,1,-15,3,1
2,3,27,1,30,5,10,0,15,2,30,2,0,0,2,0,30,5,10,0,15,2,30,6,9,0,15,3,30,6,0,0,6,1,-15,3,1
2,2,29,0,30,7,7,0,14,6,30,11,1,0,12,0,30,3,11,0,14,0,30,1,13,0,14,1,30,9,0,0,9,1,-15,3,1
2,4,29,0,30,7,7,0,14,6,30,11,1,0,12,0,30,3,11,0,14,0,30,1,13,0,14,0,30,9,0,0,9,1,-15,3,1
2,4,39,0,30,2,9,0,11,5,30,6,0,0,6,0,30,7,4,0,11,0,30,2,9,0,11,1,30,5,0,0,5,1,-15,3,1
2,3,47,0,30,0,14,0,14,5,30,4,0,0,4,0,30,5,9,0,14,0,30,2,12,0,14,2,30,7,0,0,7,1,-15,3,1
2,0,5,0,30,1,4,0,5,3,30,2,2,0,4,0,30,0,5,0,5,1,30,1,4,0,5,0,30,0,2,0,2,0,-27,3,0
2,3,5,0,30,1,4,0,5,3,30,2,2,0,4,0,30,0,5,0,5,1,30,1,4,0,5,0,30,0,2,0,2,0,-27,3,0
2,4,11,0,30,1,3,0,4,0,30,0,0,0,0,0,30,4,0,0,4,5,30,4,0,0,4,2,30,1,0,0,1,1,-15,3,1
2,2,13,4,30,7,0,0,7,0,30,4,0,0,4,0,30,5,2,0,7,5,30,7,0,0,7,5,30,4,0,0,4,1,-15,3,1
2,4,13,4,30,7,0,0,7,0,30,4,0,0,4,0,30,5,2,0,7,5,30,7,0,0,7,5,30,4,0,0,4,1,-15,3,1
2,4,17,4,30,8,6,0,14,3,30,6,0,0,6,0,30,7,7,0,14,5,30,4,10,0,14,0,30,4,0,0,4,1,-15,3,1
2,2,19,0,30,5,8,0,13,1,30,3,5,0,8,0,30,9,4,0,13,4,30,3,10,0,13,1,30,8,1,0,9,1,-15,3,1
2,4,19,0,30,5,8,0,13,1,30,3,5,0,8,0,30,9,4,0,13,4,30,3,10,0,13,1,30,8,1,0,9,1,-15,3,1
2,4,22,1,30,4,4,0,8,3,30,2,0,0,2,3,30,5,3,0,8,2,30,4,4,0,8,2,30,3,1,0,4,1,-15,3,1
2,0,25,2,30,8,6,0,14,5,30,6,0,0,6,0,30,7,7,0,14,1,30,5,9,0,14,4,30,5,1,0,6,1,-15,3,1
2,1,25,2,30,8,6,0,14,5,30,6,0,0,6,0,30,7,7,0,14,1,30,5,9,0,14,4,30,5,1,0,6,1,-15,3,1
2,3,25,2,30,8,6,0,14,5,30,6,0,0,6,0,30,7,7,0,14,1,30,5,9,0,14,4,30,5,1,0,6,1,-15,3,1
2,2,4,0,30,8,0,0,8,3,30,4,0,0,4,0,30,6,2,0,8,0,30,5,3,0,8,1,30,3,1,0,4,0,-27,3,0
2,3,4,0,30,8,0,0,8,3,30,4,0,0,4,0,30,6,2,0,8,0,30,5,3,0,8,1,30,3,1,0,4,0,-27,3,0
2,4,4,0,30,8,0,0,8,3,30,4,0,0,4,0,30,6,2,0,8,0,30,5,3,0,8,1,30,3,1,0,4,0,-27,3,0
2,4,5,0,30,2,3,0,5,2,30,2,2,0,4,0,30,3,2,0,5,0,30,1,4,0,5,0,30,0,2,0,2,0,-27,3,0
2,4,13,2,30,3,0,0,3,1,30,2,0,0,2,0,30,3,0,0,3,4,30,1,2,0,3,2,30,2,0,0,2,1,-15,3,1
2,2,17,3,30,9,5,0,14,3,30,6,0,0,6,0,30,5,9,0,14,2,30,7,7,0,14,5,30,4,0,0,4,1,-15,3,1
2,3,17,3,30,9,5,0,14,3,30,6,0,0,6,0,30,5,9,0,14,2,30,7,7,0,14,5,30,4,0,0,4,1,-15,3,1
2,3,23,1,30,3,10,0,13,4,30,6,0,0,6,4,30,10,3,0,13,2,30,6,7,0,13,2,30,6,0,0,6,1,-15,3,1
2,4,23,1,30,3,10,0,13,4,30,6,0,0,6,4,30,10,3,0,13,2,30,6,7,0,13,2,30,6,0,0,6,1,-15,3,1
2,3,25,1,30,9,5,0,14,5,30,6,0,0,6,0,30,5,9,0,14,1,30,6,8,0,14,4,30,5,1,0,6,1,-15,3,1
2,4,29,0,30,9,5,0,14,6,30,10,2,0,12,0,30,3,11,0,14,0,30,1,13,0,14,2,30,9,0,0,9,1,-15,3,1
2,4,31,0,30,11,1,0,12,3,30,8,0,0,8,3,30,10,2,0,12,0,30,3,9,0,12,0,30,3,3,0,6,1,-15,3,1
2,3,39,0,30,3,8,0,11,5,30,6,0,0,6,0,30,8,3,0,11,0,30,3,8,0,11,4,30,5,0,0,5,1,-15,3,1
2,4,39,0,30,3,8,0,11,5,30,6,0,0,6,0,30,8,3,0,11,0,30,3,8,0,11,4,30,5,0,0,5,1,-15,3,1
2,0,45,0,30,4,9,0,13,11,30,10,0,0,10,0,30,0,13,0,13,6,30,6,7,0,13,10,30,5,0,0,5,1,-15,3,1
2,4,47,0,30,3,11,0,14,7,30,4,0,0,4,0,30,7,7,0,14,0,30,6,8,0,14,6,30,7,0,0,7,1,-15,3,1
2,3,5,0,30,1,4,0,5,3,30,0,4,0,4,0,30,0,5,0,5,2,30,2,3,0,5,0,30,1,1,0,2,0,-27,3,0
2,1,13,3,30,7,0,0,7,1,30,4,0,0,4,2,30,5,2,0,7,12,30,6,1,0,7,6,30,4,0,0,4,1,-15,3,1
2,1,17,3,30,8,6,0,14,3,30,6,0,0,6,0,30,7,7,0,14,3,30,6,8,0,14,1,30,4,0,0,4,1,-15,3,1
2,4,17,3,30,8,6,0,14,3,30,6,0,0,6,0,30,7,7,0,14,3,30,6,8,0,14,1,30,4,0,0,4,1,-15,3,1
2,1,21,7,30,6,4,0,10,5,30,6,0,0,6,1,30,3,7,0,10,3,30,4,6,0,10,1,30,4,0,0,4,1,-15,3,1
2,4,21,7,30,6,4,0,10,5,30,6,0,0,6,0,30,3,7,0,10,3,30,4,6,0,10,1,30,4,0,0,4,1,-15,3,1
2,2,47,0,30,3,11,0,14,5,30,4,0,0,4,0,30,5,9,0,14,0,30,2,12,0,14,6,30,7,0,0,7,1,-15,3,1
2,0,5,0,30,2,3,0,5,3,30,2,2,0,4,0,30,1,4,0,5,0,30,1,4,0,5,0,30,2,0,0,2,0,-27,3,0
2,1,5,0,30,2,3,0,5,3,30,2,2,0,4,0,30,1,4,0,5,0,30,1,4,0,5,0,30,2,0,0,2,0,-27,3,0
2,2,5,0,30,2,3,0,5,3,30,2,2,0,4,0,30,1,4,0,5,0,30,1,4,0,5,0,30,2,0,0,2,0,-27,3,0
2,1,21,5,30,10,0,0,10,4,30,4,2,0,6,0,30,3,7,0,10,2,30,5,5,0,10,2,30,4,0,0,4,1,-15,3,1
2,3,23,1,30,7,6,0,13,1,30,6,0,0,6,6,30,13,0,0,13,0,30,4,9,0,13,2,30,5,1,0,6,1,-15,3,1
2,4,23,1,30,7,6,0,13,1,30,6,0,0,6,6,30,13,0,0,13,0,30,4,9,0,13,2,30,5,1,0,6,1,-15,3,1
2,0,27,1,30,4,11,0,15,3,30,1,1,0,2,0,30,6,9,0,15,3,30,7,8,0,15,6,30,6,0,0,6,1,-15,3,1
2,3,29,0,30,7,7,0,14,6,30,12,0,0,12,0,30,3,11,0,14,0,30,1,13,0,14,1,30,9,0,0,9,1,-15,3,1
2,4,31,2,30,6,6,0,12,4,30,8,0,0,8,5,30,10,2,0,12,0,30,3,9,0,12,0,30,2,4,0,6,1,-15,3,1
2,3,43,0,30,11,3,0,14,7,30,6,0,0,6,0,30,6,8,0,14,1,30,1,13,0,14,4,30,5,0,0,5,1,-15,3,1
2,4,43,0,30,11,3,0,14,7,30,6,0,0,6,0,30,6,8,0,14,1,30,1,13,0,14,4,30,5,0,0,5,1,-15,3,1
2,2,1,0,30,7,3,0,10,5,30,2,0,0,2,1,30,3,7,0,10,1,30,9,1,0,10,5,30,6,0,0,6,0,-27,3,0
2,4,1,0,30,7,3,0,10,5,30,2,0,0,2,1,30,3,7,0,10,1,30,9,1,0,10,5,30,6,0,0,6,0,-27,3,0
2,3,13,2,30,7,0,0,7,0,30,4,0,0,4,0,30,5,2,0,7,5,30,6,1,0,7,5,30,4,0,0,4,1,-15,3,1
2,1,17,3,30,9,5,0,14,3,30,6,0,0,6,0,30,4,10,0,14,3,30,5,9,0,14,3,30,4,0,0,4,1,-15,3,1
2,2,17,3,30,9,5,0,14,3,30,6,0,0,6,0,30,4,10,0,14,3,30,5,9,0,14,3,30,4,0,0,4,1,-15,3,1
2,3,22,2,30,8,0,0,8,3,30,2,0,0,2,0,30,4,4,0,8,1,30,3,5,0,8,1,30,2,2,0,4,1,-15,3,1
2,4,22,2,30,8,0,0,8,3,30,2,0,0,2,0,30,4,4,0,8,1,30,3,5,0,8,1,30,2,2,0,4,1,-15,3,1
2,3,23,1,30,7,6,0,13,0,30,6,0,0,6,4,30,13,0,0,13,0,30,6,7,0,13,2,30,5,1,0,6,1,-15,3,1
2,0,27,1,30,4,11,0,15,2,30,2,0,0,2,0,30,7,8,0,15,2,30,6,9,0,15,6,30,6,0,0,6,1,-15,3,1
2,1,27,1,30,4,11,0,15,2,30,2,0,0,2,0,30,7,8,0,15,2,30,6,9,0,15,6,30,6,0,0,6,1,-15,3,1
2,3,27,1,30,4,11,0,15,2,30,2,0,0,2,0,30,7,8,0,15,2,30,6,9,0,15,6,30,6,0,0,6,1,-15,3,1
2,4,27,1,30,4,11,0,15,2,30,2,0,0,2,0,30,7,8,0,15,2,30,6,9,0,15,6,30,6,0,0,6,1,-15,3,1
2,3,35,0,30,6,7,0,13,5,30,2,0,0,2,1,30,5,8,0,13,1,30,2,11,0,13,5,30,7,1,0,8,1,-15,3,1
2,2,41,0,30,10,2,0,12,6,30,5,3,0,8,0,30,3,9,0,12,2,30,3,9,0,12,4,30,7,0,0,7,1,-15,3,1
2,1,11,2,30,5,7,0,12,1,30,4,0,0,4,0,30,6,6,0,12,4,30,7,5,0,12,7,30,4,0,0,4,1,-15,3,1
2,2,11,2,30,5,7,0,12,1,30,4,0,0,4,0,30,6,6,0,12,4,30,7,5,0,12,7,30,4,0,0,4,1,-15,3,1
2,1,13,2,30,5,2,0,7,0,30,4,0,0,4,2,30,6,1,0,7,9,30,6,1,0,7,3,30,4,0,0,4,1,-15,3,1
2,4,13,2,30,5,2,0,7,0,30,4,0,0,4,2,30,6,1,0,7,9,30,6,1,0,7,3,30,4,0,0,4,1,-15,3,1
2,3,15,1,30,5,8,0,13,1,30,6,0,0,6,0,30,3,10,0,13,1,30,7,6,0,13,2,30,7,2,0,9,1,-15,3,1
2,4,15,1,30,5,8,0,13,1,30,6,0,0,6,0,30,3,10,0,13,1,30,7,6,0,13,2,30,7,2,0,9,1,-15,3,1
2,1,19,0,30,4,9,0,13,1,30,6,2,0,8,3,30,11,2,0,13,3,30,4,9,0,13,1,30,8,1,0,9,1,-15,3,1
2,2,19,0,30,4,9,0,13,1,30,6,2,0,8,3,30,11,2,0,13,3,30,4,9,0,13,1,30,8,1,0,9,1,-15,3,1
2,3,19,0,30,4,9,0,13,1,30,6,2,0,8,3,30,11,2,0,13,3,30,4,9,0,13,1,30,8,1,0,9,1,-15,3,1
2,3,23,1,30,5,8,0,13,1,30,6,0,0,6,5,30,12,1,0,13,0,30,4,9,0,13,3,30,6,0,0,6,1,-15,3,1
2,0,25,1,30,2,12,0,14,5,30,6,0,0,6,0,30,8,6,0,14,2,30,10,4,0,14,5,30,6,0,0,6,1,-15,3,1
2,1,25,1,30,2,12,0,14,5,30,6,0,0,6,0,30,8,6,0,14,2,30,10,4,0,14,5,30,6,0,0,6,1,-15,3,1
2,4,27,1,30,5,10,0,15,3,30,2,0,0,2,0,30,2,13,0,15,2,30,4,11,0,15,5,30,6,0,0,6,1,-15,3,1
2,3,1,0,30,7,3,0,10,5,30,2,0,0,2,1,30,3,7,0,10,2,30,9,1,0,10,5,30,6,0,0,6,0,-27,3,0
2,1,5,0,30,2,3,0,5,3,30,0,4,0,4,1,30,2,3,0,5,0,30,1,4,0,5,0,30,0,2,0,2,0,-27,3,0
2,2,5,0,30,2,3,0,5,3,30,0,4,0,4,1,30,2,3,0,5,0,30,1,4,0,5,0,30,0,2,0,2,0,-27,3,0
2,0,6,0,30,8,1,0,9,4,30,2,0,0,2,0,30,2,7,0,9,0,30,5,4,0,9,0,30,2,3,0,5,0,-27,3,0
2,2,6,0,30,8,1,0,9,4,30,2,0,0,2,0,30,2,7,0,9,0,30,5,4,0,9,0,30,2,3,0,5,0,-27,3,0
2,4,6,0,30,8,1,0,9,4,30,2,0,0,2,0,30,2,7,0,9,0,30,5,4,0,9,0,30,2,3,0,5,0,-27,3,0
2,4,8,1,30,7,0,0,7,3,30,2,0,0,2,1,30,5,2,0,7,3,30,5,2,0,7,1,30,3,0,0,3,0,-27,3,0
2,3,13,1,30,5,2,0,7,0,30,4,0,0,4,2,30,6,1,0,7,4,30,6,1,0,7,2,30,4,0,0,4,1,-15,3,1
2,3,17,0,30,8,6,0,14,2,30,6,0,0,6,0,30,6,8,0,14,1,30,3,11,0,14,5,30,4,0,0,4,1,-15,3,1
2,4,19,0,30,4,9,0,13,0,30,4,4,0,8,0,30,6,7,0,13,5,30,4,9,0,13,2,30,9,0,0,9,1,-15,3,1
2,3,23,1,30,6,7,0,13,0,30,6,0,0,6,2,30,10,3,0,13,2,30,4,9,0,13,4,30,5,1,0,6,1,-15,3,1
2,0,27,1,30,5,10,0,15,2,30,2,0,0,2,0,30,7,8,0,15,2,30,2,13,0,15,1,30,6,0,0,6,1,-15,3,1
2,1,27,1,30,5,10,0,15,2,30,2,0,0,2,0,30,7,8,0,15,2,30,2,13,0,15,1,30,6,0,0,6,1,-15,3,1
2,3,27,1,30,5,10,0,15,2,30,2,0,0,2,0,30,7,8,0,15,2,30,2,13,0,15,1,30,6,0,0,6,1,-15,3,1
2,4,27,1,30,5,10,0,15,2,30,2,0,0,2,0,30,7,8,0,15,2,30,2,13,0,15,1,30,6,0,0,6,1,-15,3,1
2,4,35,1,30,8,5,0,13,4,30,2,0,0,2,1,30,6,7,0,13,2,30,1,12,0,13,0,30,8,0,0,8,1,-15,3,1
2,3,5,0,30,1,4,0,5,3,30,1,3,0,4,0,30,0,5,0,5,0,30,1,4,0,5,3,30,2,0,0,2,0,-27,3,0
2,1,13,5,30,7,0,0,7,3,30,4,0,0,4,2,30,5,2,0,7,3,30,6,1,0,7,5,30,4,0,0,4,1,-15,3,1
2,3,13,5,30,7,0,0,7,3,30,4,0,0,4,2,30,5,2,0,7,3,30,6,1,0,7,5,30,4,0,0,4,1,-15,3,1
2,0,19,0,30,2,11,0,13,2,30,8,0,0,8,0,30,8,5,0,13,0,30,4,9,0,13,3,30,7,2,0,9,1,-15,3,1
2,2,21,1,30,7,3,0,10,4,30,6,0,0,6,1,30,3,7,0,10,1,30,5,5,0,10,5,30,4,0,0,4,1,-15,3,1
2,4,21,1,30,7,3,0,10,4,30,6,0,0,6,1,30,3,7,0,10,1,30,5,5,0,10,5,30,4,0,0,4,1,-15,3,1
2,2,23,1,30,3,10,0,13,5,30,6,0,0,6,0,30,7,6,0,13,7,30,11,2,0,13,3,30,6,0,0,6,1,-15,3,1
2,4,23,1,30,3,10,0,13,5,30,6,0,0,6,0,30,7,6,0,13,7,30,11,2,0,13,3,30,6,0,0,6,1,-15,3,1
2,4,25,1,30,11,3,0,14,3,30,6,0,0,6,0,30,7,7,0,14,0,30,5,9,0,14,2,30,5,1,0,6,1,-15,3,1
2,3,29,0,30,4,10,0,14,6,30,12,0,0,12,0,30,7,7,0,14,0,30,1,13,0,14,3,30,9,0,0,9,1,-15,3,1
2,4,29,0,30,4,10,0,14,6,30,12,0,0,12,0,30,7,7,0,14,0,30,1,13,0,14,3,30,9,0,0,9,1,-15,3,1
2,3,1,0,30,6,4,0,10,4,30,2,0,0,2,1,30,4,6,0,10,2,30,8,2,0,10,6,30,6,0,0,6,0,-27,3,0
2,3,5,2,30,2,3,0,5,3,30,4,0,0,4,0,30,0,5,0,5,0,30,1,4,0,5,0,30,0,2,0,2,0,-27,3,0
2,1,13,1,30,7,0,0,7,0,30,4,0,0,4,2,30,5,2,0,7,11,30,7,0,0,7,4,30,4,0,0,4,1,-15,3,1
2,0,19,3,30,4,9,0,13,3,30,3,5,0,8,0,30,5,8,0,13,5,30,4,9,0,13,2,30,8,1,0,9,1,-15,3,1
2,1,19,3,30,4,9,0,13,3,30,3,5,0,8,0,30,5,8,0,13,5,30,4,9,0,13,2,30,8,1,0,9,1,-15,3,1
2,2,19,3,30,4,9,0,13,3,30,3,5,0,8,0,30,5,8,0,13,5,30,4,9,0,13,2,30,8,1,0,9,1,-15,3,1
2,2,25,1,30,6,8,0,14,3,30,6,0,0,6,0,30,6,8,0,14,1,30,6,8,0,14,7,30,6,0,0,6,1,-15,3,1
2,3,27,1,30,5,10,0,15,4,30,1,1,0,2,0,30,5,10,0,15,2,30,4,11,0,15,4,30,6,0,0,6,1,-15,3,1
2,4,27,1,30,5,10,0,15,4,30,1,1,0,2,0,30,5,10,0,15,2,30,4,11,0,15,4,30,6,0,0,6,1,-15,3,1
2,3,29,5,30,6,8,0,14,5,30,12,0,0,12,0,30,4,10,0,14,0,30,0,14,0,14,0,30,6,3,0,9,1,-15,3,1
2,3,45,0,30,8,5,0,13,11,30,10,0,0,10,0,30,0,13,0,13,0,30,4,9,0,13,9,30,5,0,0,5,1,-15,3,1
2,0,4,2,30,7,1,0,8,5,30,4,0,0,4,1,30,1,7,0,8,0,30,8,0,0,8,2,30,3,1,0,4,0,-27,3,0
2,2,5,5,30,2,3,0,5,3,30,0,4,0,4,0,30,1,4,0,5,0,30,1,4,0,5,1,30,0,2,0,2,0,-27,3,0
2,3,6,3,30,9,0,0,9,4,30,2,0,0,2,0,30,2,7,0,9,0,30,4,5,0,9,0,30,4,1,0,5,0,-27,3,0
2,4,6,3,30,9,0,0,9,4,30,2,0,0,2,0,30,2,7,0,9,0,30,4,5,0,9,0,30,4,1,0,5,0,-27,3,0
2,3,9,0,30,2,2,0,4,2,30,2,0,0,2,4,30,4,0,0,4,4,30,3,1,0,4,0,30,1,0,0,1,0,-27,3,0
2,1,13,1,30,6,1,0,7,1,30,4,0,0,4,2,30,6,1,0,7,5,30,6,1,0,7,4,30,4,0,0,4,1,-15,3,1
2,2,13,1,30,6,1,0,7,1,30,4,0,0,4,2,30,6,1,0,7,5,30,6,1,0,7,4,30,4,0,0,4,1,-15,3,1
2,3,13,1,30,6,1,0,7,1,30,4,0,0,4,2,30,6,1,0,7,5,30,6,1,0,7,4,30,4,0,0,4,1,-15,3,1
2,4,13,1,30,6,1,0,7,1,30,4,0,0,4,2,30,6,1,0,7,5,30,6,1,0,7,4,30,4,0,0,4,1,-15,3,1
2,3,17,3,30,9,5,0,14,3,30,6,0,0,6,0,30,5,9,0,14,0,30,6,8,0,14,5,30,4,0,0,4,1,-15,3,1
2,4,17,3,30,9,5,0,14,3,30,6,0,0,6,0,30,5,9,0,14,0,30,6,8,0,14,5,30,4,0,0,4,1,-15,3,1
2,1,25,1,30,6,8,0,14,2,30,6,0,0,6,0,30,12,2,0,14,1,30,7,7,0,14,1,30,5,1,0,6,1,-15,3,1
2,4,25,1,30,6,8,0,14,2,30,6,0,0,6,0,30,12,2,0,14,1,30,7,7,0,14,1,30,5,1,0,6,1,-15,3,1
2,0,27,1,30,4,11,0,15,5,30,1,1,0,2,0,30,3,12,0,15,1,30,4,11,0,15,7,30,6,0,0,6,1,-15,3,1
2,1,27,1,30,4,11,0,15,5,30,1,1,0,2,0,30,3,12,0,15,1,30,4,11,0,15,7,30,6,0,0,6,1,-15,3,1
2,2,27,1,30,4,11,0,15,5,30,1,1,0,2,0,30,3,12,0,15,1,30,4,11,0,15,7,30,6,0,0,6,1,-15,3,1
2,3,35,0,30,8,5,0,13,4,30,2,0,0,2,5,30,2,11,0,13,0,30,1,12,0,13,1,30,7,1,0,8,1,-15,3,1
2,4,35,0,30,8,5,0,13,4,30,2,0,0,2,5,30,2,11,0,13,0,30,1,12,0,13,1,30,7,1,0,8,1,-15,3,1
2,3,4,6,30,8,0,0,8,3,30,4,0,0,4,0,30,4,4,0,8,0,30,2,6,0,8,0,30,3,1,0,4,0,-27,3,0
2,4,4,6,30,8,0,0,8,3,30,4,0,0,4,0,30,4,4,0,8,0,30,2,6,0,8,0,30,3,1,0,4,0,-27,3,0
2,1,13,7,30,7,0,0,7,1,30,4,0,0,4,2,30,6,1,0,7,5,30,2,5,0,7,6,30,4,0,0,4,1,-15,3,1
2,4,16,1,30,6,3,0,9,3,30,8,0,0,8,0,30,1,8,0,9,3,30,1,8,0,9,1,30,4,0,0,4,1,-15,3,1
2,4,17,3,30,8,6,0,14,2,30,6,0,0,6,0,30,8,6,0,14,1,30,5,9,0,14,1,30,2,2,0,4,1,-15,3,1
2,2,19,0,30,2,11,0,13,2,30,4,4,0,8,0,30,6,7,0,13,3,30,5,8,0,13,1,30,8,1,0,9,1,-15,3,1
2,3,19,0,30,2,11,0,13,2,30,4,4,0,8,0,30,6,7,0,13,3,30,5,8,0,13,1,30,8,1,0,9,1,-15,3,1
2,2,25,4,30,2,12,0,14,4,30,6,0,0,6,0,30,12,2,0,14,1,30,6,8,0,14,1,30,5,1,0,6,1,-15,3,1
2,4,29,1,30,9,5,0,14,6,30,8,4,0,12,0,30,3,11,0,14,0,30,1,13,0,14,3,30,9,0,0,9,1,-15,3,1
2,0,4,2,30,5,3,0,8,4,30,4,0,0,4,0,30,1,7,0,8,0,30,5,3,0,8,3,30,4,0,0,4,0,-27,3,0
2,1,4,2,30,5,3,0,8,4,30,4,0,0,4,0,30,1,7,0,8,0,30,5,3,0,8,3,30,4,0,0,4,0,-27,3,0
2,2,13,4,30,7,0,0,7,0,30,4,0,0,4,2,30,6,1,0,7,7,30,6,1,0,7,1,30,4,0,0,4,1,-15,3,1
2,4,13,4,30,7,0,0,7,0,30,4,0,0,4,2,30,6,1,0,7,7,30,6,1,0,7,1,30,4,0,0,4,1,-15,3,1
2,0,19,0,30,2,11,0,13,2,30,5,3,0,8,0,30,8,5,0,13,3,30,6,7,0,13,3,30,8,1,0,9,1,-15,3,1
2,1,19,0,30,2,11,0,13,2,30,5,3,0,8,0,30,8,5,0,13,3,30,6,7,0,13,3,30,8,1,0,9,1,-15,3,1
2,4,19,0,30,2,11,0,13,2,30,5,3,0,8,0,30,8,5,0,13,3,30,6,7,0,13,3,30,8,1,0,9,1,-15,3,1
2,3,23,3,30,5,8,0,13,4,30,6,0,0,6,6,30,12,1,0,13,0,30,5,8,0,13,5,30,6,0,0,6,1,-15,3,1
2,4,23,3,30,5,8,0,13,4,30,6,0,0,6,6,30,12,1,0,13,0,30,5,8,0,13,5,30,6,0,0,6,1,-15,3,1
2,2,27,1,30,3,12,0,15,4,30,2,0,0,2,0,30,5,10,0,15,2,30,4,11,0,15,1,30,4,2,0,6,1,-15,3,1
2,4,27,1,30,3,12,0,15,4,30,2,0,0,2,0,30,5,10,0,15,2,30,4,11,0,15,1,30,4,2,0,6,1,-15,3,1
2,2,29,0,30,7,7,0,14,6,30,12,0,0,12,0,30,4,10,0,14,0,30,1,13,0,14,1,30,9,0,0,9,1,-15,3,1
2,3,29,0,30,7,7,0,14,6,30,12,0,0,12,0,30,4,10,0,14,0,30,1,13,0,14,1,30,9,0,0,9,1,-15,3,1
2,2,39,2,30,7,4,0,11,7,30,4,2,0,6,0,30,5,6,0,11,0,30,2,9,0,11,4,30,5,0,0,5,1,-15,3,1
2,3,39,2,30,7,4,0,11,7,30,4,2,0,6,0,30,5,6,0,11,0,30,2,9,0,11,4,30,5,0,0,5,1,-15,3,1
2,4,39,2,30,7,4,0,11,7,30,4,2,0,6,0,30,5,6,0,11,0,30,2,9,0,11,4,30,5,0,0,5,1,-15,3,1
2,2,1,0,30,7,3,0,10,4,30,2,0,0,2,1,30,4,6,0,10,4,30,4,6,0,10,8,30,6,0,0,6,0,-27,3,0
2,2,5,0,30,3,2,0,5,3,30,1,3,0,4,0,30,1,4,0,5,0,30,1,4,0,5,1,30,2,0,0,2,0,-27,3,0
2,4,6,1,30,9,0,0,9,4,30,2,0,0,2,0,30,2,7,0,9,0,30,3,6,0,9,0,30,5,0,0,5,0,-27,3,0
2,4,13,5,30,7,0,0,7,2,30,4,0,0,4,2,30,5,2,0,7,10,30,5,2,0,7,2,30,4,0,0,4,1,-15,3,1
2,3,25,0,30,3,11,0,14,4,30,6,0,0,6,0,30,6,8,0,14,1,30,7,7,0,14,6,30,5,1,0,6,1,-15,3,1
2,3,27,0,30,3,12,0,15,3,30,2,0,0,2,0,30,7,8,0,15,5,30,4,11,0,15,0,30,6,0,0,6,1,-15,3,1
2,3,33,3,30,5,6,0,11,4,30,4,0,0,4,1,30,11,0,0,11,2,30,3,8,0,11,6,30,4,0,0,4,1,-15,3,1
2,2,36,0,30,0,9,0,9,5,30,2,0,0,2,5,30,6,3,0,9,1,30,7,2,0,9,9,30,3,0,0,3,1,-15,3,1
2,4,39,0,30,4,7,0,11,7,30,6,0,0,6,0,30,4,7,0,11,1,30,3,8,0,11,0,30,5,0,0,5,1,-15,3,1
2,4,2,0,30,5,5,0,10,3,30,4,0,0,4,3,30,2,8,0,10,0,30,2,8,0,10,1,30,8,0,0,8,0,-27,3,0
2,2,5,0,30,2,3,0,5,3,30,1,3,0,4,0,30,0,5,0,5,0,30,1,4,0,5,2,30,0,2,0,2,0,-27,3,0
2,1,13,3,30,6,1,0,7,0,30,4,0,0,4,2,30,6,1,0,7,6,30,3,4,0,7,5,30,4,0,0,4,1,-15,3,1
2,4,13,3,30,6,1,0,7,0,30,4,0,0,4,2,30,6,1,0,7,6,30,3,4,0,7,5,30,4,0,0,4,1,-15,3,1
2,4,22,2,30,7,1,0,8,3,30,2,0,0,2,0,30,4,4,0,8,1,30,0,8,0,8,2,30,1,3,0,4,1,-15,3,1
2,2,25,1,30,5,9,0,14,4,30,6,0,0,6,0,30,12,2,0,14,1,30,6,8,0,14,2,30,5,1,0,6,1,-15,3,1
2,4,25,0,30,5,9,0,14,4,30,6,0,0,6,0,30,12,2,0,14,1,30,6,8,0,14,2,30,5,1,0,6,1,-15,3,1
2,0,27,1,30,5,10,0,15,3,30,1,1,0,2,0,30,5,10,0,15,0,30,6,9,0,15,4,30,6,0,0,6,1,-15,3,1
2,3,27,1,30,5,10,0,15,3,30,1,1,0,2,0,30,5,10,0,15,0,30,6,9,0,15,0,30,6,0,0,6,1,-15,3,1
2,4,27,1,30,5,10,0,15,3,30,1,1,0,2,0,30,5,10,0,15,0,30,6,9,0,15,0,30,6,0,0,6,1,-15,3,1
2,3,29,0,30,8,6,0,14,6,30,12,0,0,12,0,30,3,11,0,14,0,30,0,14,0,14,2,30,9,0,0,9,1,-15,3,1
2,3,35,0,30,6,7,0,13,1,30,2,0,0,2,1,30,13,0,0,13,0,30,3,10,0,13,0,30,8,0,0,8,1,-15,3,1
2,4,35,0,30,6,7,0,13,1,30,2,0,0,2,1,30,13,0,0,13,0,30,3,10,0,13,0,30,8,0,0,8,1,-15,3,1
2,2,36,0,30,5,4,0,9,4,30,1,1,0,2,2,30,5,4,0,9,5,30,2,7,0,9,7,30,2,1,0,3,1,-15,3,1
2,3,9,0,30,2,2,0,4,2,30,2,0,0,2,0,30,4,0,0,4,1,30,4,0,0,4,2,30,1,0,0,1,0,-27,3,0
2,4,9,0,30,2,2,0,4,2,30,2,0,0,2,0,30,4,0,0,4,1,30,4,0,0,4,2,30,1,0,0,1,0,-27,3,0
2,1,17,3,30,8,6,0,14,3,30,6,0,0,6,0,30,5,9,0,14,4,30,5,9,0,14,5,30,4,0,0,4,1,-15,3,1
2,2,17,3,30,8,6,0,14,3,30,6,0,0,6,0,30,5,9,0,14,4,30,5,9,0,14,5,30,4,0,0,4,1,-15,3,1
2,3,17,3,30,8,6,0,14,3,30,6,0,0,6,0,30,5,9,0,14,4,30,5,9,0,14,5,30,4,0,0,4,1,-15,3,1
2,4,17,3,30,8,6,0,14,3,30,6,0,0,6,0,30,5,9,0,14,4,30,5,9,0,14,5,30,4,0,0,4,1,-15,3,1
2,3,19,0,30,5,8,0,13,2,30,5,3,0,8,0,30,4,9,0,13,5,30,4,9,0,13,0,30,8,1,0,9,1,-15,3,1
2,3,23,2,30,6,7,0,13,3,30,6,0,0,6,2,30,12,1,0,13,1,30,5,8,0,13,2,30,6,0,0,6,1,-15,3,1
2,4,23,2,30,6,7,0,13,3,30,6,0,0,6,2,30,12,1,0,13,1,30,5,8,0,13,2,30,6,0,0,6,1,-15,3,1
2,2,27,1,30,4,11,0,15,4,30,2,0,0,2,0,30,2,13,0,15,1,30,6,9,0,15,6,30,6,0,0,6,1,-15,3,1
2,3,27,1,30,4,11,0,15,4,30,2,0,0,2,0,30,2,13,0,15,1,30,6,9,0,15,6,30,6,0,0,6,1,-15,3,1
2,4,27,1,30,4,11,0,15,4,30,2,0,0,2,0,30,2,13,0,15,1,30,6,9,0,15,6,30,6,0,0,6,1,-15,3,1
2,3,29,1,30,9,5,0,14,6,30,8,4,0,12,0,30,4,10,0,14,0,30,1,13,0,14,0,30,8,1,0,9,1,-15,3,1
2,3,31,5,30,6,6,0,12,4,30,8,0,0,8,3,30,8,4,0,12,0,30,3,9,0,12,2,30,3,3,0,6,1,-15,3,1
2,2,38,0,30,3,7,0,10,7,30,6,0,0,6,0,30,1,9,0,10,0,30,4,6,0,10,9,30,6,0,0,6,1,-15,3,1
2,3,39,0,30,4,7,0,11,6,30,6,0,0,6,0,30,6,5,0,11,0,30,2,9,0,11,5,30,5,0,0,5,1,-15,3,1
2,4,13,1,30,6,1,0,7,0,30,4,0,0,4,2,30,6,1,0,7,8,30,7,0,0,7,5,30,4,0,0,4,1,-15,3,1
2,3,17,3,30,9,5,0,14,4,30,6,0,0,6,0,30,4,10,0,14,2,30,7,7,0,14,2,30,4,0,0,4,1,-15,3,1
2,1,19,1,30,5,8,0,13,2,30,7,1,0,8,4,30,6,7,0,13,0,30,6,7,0,13,0,30,8,1,0,9,1,-15,3,1
2,2,19,1,30,5,8,0,13,2,30,7,1,0,8,4,30,6,7,0,13,0,30,6,7,0,13,0,30,8,1,0,9,1,-15,3,1
2,3,19,1,30,5,8,0,13,2,30,7,1,0,8,4,30,6,7,0,13,0,30,6,7,0,13,0,30,8,1,0,9,1,-15,3,1
2,4,23,1,30,6,7,0,13,3,30,6,0,0,6,5,30,13,0,0,13,0,30,4,9,0,13,4,30,6,0,0,6,1,-15,3,1
2,3,25,1,30,7,7,0,14,4,30,6,0,0,6,0,30,7,7,0,14,1,30,9,5,0,14,4,30,6,0,0,6,1,-15,3,1
2,4,25,1,30,7,7,0,14,4,30,6,0,0,6,0,30,7,7,0,14,1,30,9,5,0,14,4,30,6,0,0,6,1,-15,3,1
2,2,27,1,30,5,10,0,15,3,30,2,0,0,2,0,30,6,9,0,15,3,30,5,10,0,15,4,30,6,0,0,6,1,-15,3,1
2,3,27,1,30,5,10,0,15,3,30,2,0,0,2,0,30,6,9,0,15,3,30,5,10,0,15,4,30,6,0,0,6,1,-15,3,1
2,4,27,1,30,5,10,0,15,3,30,2,0,0,2,0,30,6,9,0,15,3,30,5,10,0,15,4,30,6,0,0,6,1,-15,3,1
2,1,31,1,30,7,5,0,12,4,30,8,0,0,8,3,30,8,4,0,12,4,30,6,6,0,12,0,30,2,4,0,6,1,-15,3,1
2,2,31,1,30,7,5,0,12,4,30,8,0,0,8,3,30,8,4,0,12,4,30,6,6,0,12,0,30,2,4,0,6,1,-15,3,1
2,3,31,1,30,7,5,0,12,4,30,8,0,0,8,3,30,8,4,0,12,4,30,6,6,0,12,0,30,2,4,0,6,1,-15,3,1
2,4,31,1,30,7,5,0,12,4,30,8,0,0,8,3,30,8,4,0,12,4,30,6,6,0,12,0,30,2,4,0,6,1,-15,3,1
2,3,35,2,30,8,5,0,13,4,30,2,0,0,2,0,30,4,9,0,13,4,30,3,10,0,13,6,30,8,0,0,8,1,-15,3,1
2,4,35,2,30,8,5,0,13,4,30,2,0,0,2,0,30,4,9,0,13,4,30,3,10,0,13,6,30,8,0,0,8,1,-15,3,1
2,3,13,5,30,7,0,0,7,0,30,4,0,0,4,0,30,6,1,0,7,4,30,4,3,0,7,2,30,4,0,0,4,1,-15,3,1
2,4,13,5,30,7,0,0,7,0,30,4,0,0,4,0,30,6,1,0,7,4,30,4,3,0,7,2,30,4,0,0,4,1,-15,3,1
2,3,17,3,30,9,5,0,14,1,30,6,0,0,6,0,30,10,4,0,14,5,30,5,9,0,14,2,30,3,1,0,4,1,-15,3,1
2,4,17,3,30,9,5,0,14,1,30,6,0,0,6,0,30,10,4,0,14,5,30,5,9,0,14,2,30,3,1,0,4,1,-15,3,1
2,4,23,2,30,6,7,0,13,3,30,6,0,0,6,6,30,10,3,0,13,0,30,6,7,0,13,4,30,6,0,0,6,1,-15,3,1
2,2,25,1,30,9,5,0,14,3,30,6,0,0,6,0,30,5,9,0,14,1,30,5,9,0,14,4,30,4,2,0,6,1,-15,3,1
2,4,25,1,30,9,5,0,14,3,30,6,0,0,6,0,30,5,9,0,14,1,30,5,9,0,14,4,30,4,2,0,6,1,-15,3,1
2,3,33,1,30,8,3,0,11,4,30,4,0,0,4,3,30,11,0,0,11,1,30,4,7,0,11,7,30,4,0,0,4,1,-15,3,1
2,4,2,0,30,7,3,0,10,4,30,4,0,0,4,5,30,3,7,0,10,0,30,8,2,0,10,1,30,5,3,0,8,0,-27,3,0
2,4,6,0,30,7,2,0,9,4,30,2,0,0,2,0,30,2,7,0,9,0,30,4,5,0,9,3,30,5,0,0,5,0,-27,3,0
2,4,8,3,30,7,0,0,7,4,30,2,0,0,2,2,30,3,4,0,7,0,30,6,1,0,7,1,30,3,0,0,3,0,-27,3,0
2,4,13,1,30,5,2,0,7,0,30,4,0,0,4,2,30,5,2,0,7,6,30,6,1,0,7,5,30,4,0,0,4,1,-15,3,1
2,1,21,4,30,8,2,0,10,4,30,6,0,0,6,1,30,3,7,0,10,2,30,4,6,0,10,0,30,4,0,0,4,1,-15,3,1
2,2,21,4,30,8,2,0,10,4,30,6,0,0,6,1,30,3,7,0,10,2,30,4,6,0,10,0,30,4,0,0,4,1,-15,3,1
2,3,21,4,30,8,2,0,10,4,30,6,0,0,6,1,30,3,7,0,10,2,30,4,6,0,10,0,30,4,0,0,4,1,-15,3,1
2,4,21,4,30,8,2,0,10,4,30,6,0,0,6,1,30,3,7,0,10,2,30,4,6,0,10,0,30,4,0,0,4,1,-15,3,1
2,2,29,0,30,5,9,0,14,5,30,11,1,0,12,0,30,4,10,0,14,0,30,1,13,0,14,4,30,9,0,0,9,1,-15,3,1
2,1,5,0,30,1,4,0,5,2,30,2,2,0,4,0,30,1,4,0,5,0,30,1,4,0,5,0,30,2,0,0,2,0,-27,3,0
2,3,5,0,30,1,4,0,5,2,30,2,2,0,4,0,30,1,4,0,5,0,30,1,4,0,5,0,30,2,0,0,2,0,-27,3,0
2,3,11,0,30,1,3,0,4,0,30,0,0,0,0,0,30,1,3,0,4,4,30,2,2,0,4,1,30,1,0,0,1,1,-15,3,1
2,2,13,4,30,7,0,0,7,0,30,4,0,0,4,2,30,5,2,0,7,10,30,4,3,0,7,2,30,4,0,0,4,1,-15,3,1
2,4,13,4,30,7,0,0,7,0,30,4,0,0,4,2,30,5,2,0,7,10,30,4,3,0,7,2,30,4,0,0,4,1,-15,3,1
2,2,17,4,30,9,5,0,14,3,30,6,0,0,6,0,30,7,7,0,14,0,30,8,6,0,14,0,30,4,0,0,4,1,-15,3,1
2,4,17,4,30,9,5,0,14,3,30,6,0,0,6,0,30,7,7,0,14,0,30,8,6,0,14,0,30,4,0,0,4,1,-15,3,1
2,3,27,2,30,3,12,0,15,1,30,2,0,0,2,0,30,14,1,0,15,0,30,5,10,0,15,0,30,6,0,0,6,1,-15,3,1
2,2,35,1,30,9,4,0,13,3,30,2,0,0,2,1,30,7,6,0,13,2,30,2,11,0,13,5,30,8,0,0,8,1,-15,3,1
2,3,35,1,30,9,4,0,13,3,30,2,0,0,2,1,30,7,6,0,13,2,30,2,11,0,13,5,30,8,0,0,8,1,-15,3,1
2,2,39,0,30,9,2,0,11,7,30,6,0,0,6,0,30,4,7,0,11,0,30,2,9,0,11,0,30,4,1,0,5,1,-15,3,1
2,3,39,0,30,9,2,0,11,7,30,6,0,0,6,0,30,4,7,0,11,0,30,2,9,0,11,0,30,4,1,0,5,1,-15,3,1
2,0,4,4,30,8,0,0,8,5,30,4,0,0,4,0,30,2,6,0,8,3,30,7,1,0,8,1,30,3,1,0,4,0,-27,3,0
2,2,4,4,30,8,0,0,8,5,30,4,0,0,4,0,30,2,6,0,8,3,30,7,1,0,8,1,30,3,1,0,4,0,-27,3,0
2,3,4,4,30,8,0,0,8,5,30,4,0,0,4,0,30,2,6,0,8,3,30,7,1,0,8,1,30,3,1,0,4,0,-27,3,0
2,4,4,4,30,8,0,0,8,5,30,4,0,0,4,0,30,2,6,0,8,3,30,7,1,0,8,1,30,3,1,0,4,0,-27,3,0
2,0,5,0,30,3,2,0,5,3,30,4,0,0,4,0,30,0,5,0,5,0,30,1,4,0,5,0,30,1,1,0,2,0,-27,3,0
2,2,5,0,30,3,2,0,5,3,30,4,0,0,4,0,30,0,5,0,5,0,30,1,4,0,5,0,30,1,1,0,2,0,-27,3,0
2,3,5,0,30,3,2,0,5,3,30,4,0,0,4,0,30,0,5,0,5,0,30,1,4,0,5,0,30,1,1,0,2,0,-27,3,0
2,4,5,0,30,3,2,0,5,3,30,4,0,0,4,0,30,0,5,0,5,0,30,1,4,0,5,0,30,1,1,0,2,0,-27,3,0
2,3,8,9,30,7,0,0,7,5,30,2,0,0,2,1,30,3,4,0,7,0,30,1,6,0,7,1,30,3,0,0,3,0,-27,3,0
2,4,13,0,30,7,0,0,7,0,30,4,0,0,4,2,30,6,1,0,7,8,30,6,1,0,7,0,30,4,0,0,4,1,-15,3,1
2,1,17,2,30,8,6,0,14,2,30,6,0,0,6,0,30,6,8,0,14,1,30,5,9,0,14,5,30,4,0,0,4,1,-15,3,1
2,3,17,2,30,8,6,0,14,2,30,6,0,0,6,0,30,6,8,0,14,1,30,5,9,0,14,5,30,4,0,0,4,1,-15,3,1
2,3,19,0,30,4,9,0,13,2,30,8,0,0,8,0,30,4,9,0,13,6,30,6,7,0,13,2,30,8,1,0,9,1,-15,3,1
2,4,19,0,30,4,9,0,13,2,30,8,0,0,8,0,30,4,9,0,13,6,30,6,7,0,13,2,30,8,1,0,9,1,-15,3,1
2,4,23,1,30,6,7,0,13,1,30,6,0,0,6,6,30,13,0,0,13,0,30,5,8,0,13,2,30,5,1,0,6,1,-15,3,1
2,4,25,2,30,6,8,0,14,4,30,6,0,0,6,0,30,9,5,0,14,1,30,5,9,0,14,4,30,5,1,0,6,1,-15,3,1
2,3,27,0,30,4,11,0,15,1,30,1,1,0,2,0,30,4,11,0,15,0,30,6,9,0,15,5,30,6,0,0,6,1,-15,3,1
2,4,29,0,30,6,8,0,14,5,30,10,2,0,12,0,30,8,6,0,14,0,30,0,14,0,14,0,30,8,1,0,9,1,-15,3,1
2,0,9,0,30,4,0,0,4,2,30,2,0,0,2,0,30,0,4,0,4,0,30,2,2,0,4,0,30,1,0,0,1,0,-27,3,0
2,1,9,0,30,4,0,0,4,2,30,2,0,0,2,0,30,0,4,0,4,0,30,2,2,0,4,0,30,1,0,0,1,0,-27,3,0
2,4,13,2,30,7,0,0,7,0,30,4,0,0,4,2,30,6,1,0,7,9,30,6,1,0,7,5,30,4,0,0,4,1,-15,3,1
2,3,17,3,30,11,3,0,14,2,30,6,0,0,6,0,30,6,8,0,14,2,30,3,11,0,14,4,30,4,0,0,4,1,-15,3,1
2,4,17,3,30,11,3,0,14,2,30,6,0,0,6,0,30,6,8,0,14,2,30,3,11,0,14,4,30,4,0,0,4,1,-15,3,1
2,1,19,0,30,2,11,0,13,2,30,7,1,0,8,0,30,5,8,0,13,5,30,4,9,0,13,2,30,9,0,0,9,1,-15,3,1
2,3,19,0,30,2,11,0,13,2,30,7,1,0,8,0,30,5,8,0,13,5,30,4,9,0,13,2,30,9,0,0,9,1,-15,3,1
2,4,23,1,30,6,7,0,13,3,30,6,0,0,6,6,30,9,4,0,13,0,30,6,7,0,13,0,30,6,0,0,6,1,-15,3,1
2,2,29,0,30,4,10,0,14,6,30,9,3,0,12,0,30,3,11,0,14,0,30,0,14,0,14,0,30,9,0,0,9,1,-15,3,1
2,3,29,0,30,4,10,0,14,6,30,9,3,0,12,0,30,3,11,0,14,0,30,0,14,0,14,0,30,9,0,0,9,1,-15,3,1
2,0,41,0,30,7,5,0,12,7,30,8,0,0,8,1,30,4,8,0,12,0,30,3,9,0,12,2,30,6,1,0,7,1,-15,3,1
2,1,4,0,30,5,3,0,8,4,30,3,1,0,4,2,30,2,6,0,8,0,30,6,2,0,8,2,30,4,0,0,4,0,-27,3,0
2,3,6,0,30,8,1,0,9,4,30,2,0,0,2,0,30,2,7,0,9,0,30,3,6,0,9,2,30,5,0,0,5,0,-27,3,0
2,1,19,7,30,5,8,0,13,4,30,3,5,0,8,0,30,4,9,0,13,3,30,4,9,0,13,3,30,8,1,0,9,1,-15,3,1
2,4,19,7,30,5,8,0,13,4,30,3,5,0,8,0,30,4,9,0,13,3,30,4,9,0,13,3,30,8,1,0,9,1,-15,3,1
2,4,23,1,30,7,6,0,13,2,30,6,0,0,6,3,30,11,2,0,13,2,30,6,7,0,13,2,30,6,0,0,6,1,-15,3,1
2,3,25,0,30,9,5,0,14,3,30,6,0,0,6,0,30,6,8,0,14,0,30,5,9,0,14,4,30,6,0,0,6,1,-15,3,1
2,4,25,0,30,9,5,0,14,3,30,6,0,0,6,0,30,6,8,0,14,0,30,5,9,0,14,4,30,6,0,0,6,1,-15,3,1
2,3,27,1,30,2,13,0,15,5,30,1,1,0,2,0,30,6,9,0,15,1,30,7,8,0,15,0,30,6,0,0,6,1,-15,3,1
2,4,3,0,30,0,4,0,4,2,30,4,0,0,4,0,30,3,1,0,4,5,30,1,3,0,4,0,30,1,2,0,3,0,-27,3,0
2,4,8,2,30,7,0,0,7,5,30,2,0,0,2,3,30,2,5,0,7,3,30,6,1,0,7,2,30,3,0,0,3,0,-27,3,0
2,2,13,3,30,5,2,0,7,0,30,4,0,0,4,2,30,6,1,0,7,10,30,5,2,0,7,0,30,4,0,0,4,1,-15,3,1
2,4,13,3,30,5,2,0,7,0,30,4,0,0,4,2,30,6,1,0,7,10,30,5,2,0,7,0,30,4,0,0,4,1,-15,3,1
2,1,19,0,30,1,12,0,13,2,30,4,4,0,8,0,30,6,7,0,13,8,30,7,6,0,13,2,30,9,0,0,9,1,-15,3,1
2,1,25,5,30,10,4,0,14,3,30,5,1,0,6,0,30,8,6,0,14,1,30,4,10,0,14,2,30,6,0,0,6,1,-15,3,1
2,2,25,5,30,10,4,0,14,3,30,5,1,0,6,0,30,8,6,0,14,1,30,4,10,0,14,2,30,6,0,0,6,1,-15,3,1
2,3,25,5,30,10,4,0,14,3,30,5,1,0,6,0,30,8,6,0,14,1,30,4,10,0,14,2,30,6,0,0,6,1,-15,3,1
2,4,25,5,30,10,4,0,14,3,30,5,1,0,6,0,30,8,6,0,14,1,30,4,10,0,14,2,30,6,0,0,6,1,-15,3,1
2,2,27,0,30,5,10,0,15,3,30,2,0,0,2,0,30,3,12,0,15,0,30,6,9,0,15,0,30,6,0,0,6,1,-15,3,1
2,3,27,0,30,5,10,0,15,3,30,2,0,0,2,0,30,3,12,0,15,0,30,6,9,0,15,0,30,6,0,0,6,1,-15,3,1
2,4,27,0,30,5,10,0,15,3,30,2,0,0,2,0,30,3,12,0,15,0,30,6,9,0,15,0,30,6,0,0,6,1,-15,3,1
2,3,29,0,30,8,6,0,14,5,30,12,0,0,12,0,30,5,9,0,14,0,30,1,13,0,14,0,30,8,1,0,9,1,-15,3,1
2,4,29,0,30,8,6,0,14,5,30,12,0,0,12,0,30,5,9,0,14,0,30,1,13,0,14,0,30,8,1,0,9,1,-15,3,1
2,2,31,1,30,7,5,0,12,3,30,8,0,0,8,3,30,10,2,0,12,0,30,3,9,0,12,3,30,2,4,0,6,1,-15,3,1
2,4,31,1,30,7,5,0,12,3,30,8,0,0,8,0,30,10,2,0,12,0,30,3,9,0,12,3,30,2,4,0,6,1,-15,3,1
2,3,36,0,30,4,5,0,9,5,30,0,2,0,2,3,30,5,4,0,9,0,30,4,5,0,9,6,30,3,0,0,3,1,-15,3,1
2,4,36,0,30,4,5,0,9,5,30,0,2,0,2,3,30,5,4,0,9,0,30,4,5,0,9,6,30,3,0,0,3,1,-15,3,1
2,0,5,0,30,2,3,0,5,3,30,4,0,0,4,0,30,0,5,0,5,0,30,1,4,0,5,1,30,1,1,0,2,0,-27,3,0
2,4,6,0,30,6,3,0,9,4,30,2,0,0,2,0,30,2,7,0,9,0,30,3,6,0,9,3,30,5,0,0,5,0,-27,3,0
2,2,9,6,30,3,1,0,4,3,30,2,0,0,2,3,30,3,1,0,4,0,30,1,3,0,4,1,30,1,0,0,1,0,-27,3,0
2,4,9,6,30,3,1,0,4,3,30,2,0,0,2,3,30,3,1,0,4,0,30,1,3,0,4,1,30,1,0,0,1,0,-27,3,0
2,3,9,2,30,10,1,0,11,3,30,6,0,0,6,1,30,8,3,0,11,0,30,3,8,0,11,3,30,4,0,0,4,0,-27,3,0
2,4,9,2,30,10,1,0,11,3,30,6,0,0,6,1,30,8,3,0,11,0,30,3,8,0,11,3,30,4,0,0,4,0,-27,3,0
2,2,17,2,30,11,3,0,14,3,30,6,0,0,6,0,30,4,10,0,14,3,30,5,9,0,14,0,30,4,0,0,4,1,-15,3,1
2,3,17,2,30,11,3,0,14,3,30,6,0,0,6,0,30,4,10,0,14,3,30,5,9,0,14,0,30,4,0,0,4,1,-15,3,1
2,1,27,0,30,9,6,0,15,4,30,2,0,0,2,2,30,6,9,0,15,0,30,5,10,0,15,0,30,5,1,0,6,1,-15,3,1
2,3,27,0,30,9,6,0,15,4,30,2,0,0,2,2,30,6,9,0,15,0,30,5,10,0,15,0,30,5,1,0,6,1,-15,3,1
2,3,33,1,30,2,9,0,11,4,30,4,0,0,4,1,30,10,1,0,11,0,30,3,8,0,11,6,30,4,0,0,4,1,-15,3,1
2,1,4,3,30,7,1,0,8,3,30,4,0,0,4,0,30,5,3,0,8,2,30,5,3,0,8,1,30,4,0,0,4,0,-27,3,0
2,4,5,0,30,1,4,0,5,3,30,2,2,0,4,3,30,0,5,0,5,0,30,2,3,0,5,0,30,0,2,0,2,0,-27,3,0
2,3,8,1,30,7,0,0,7,4,30,2,0,0,2,0,30,1,6,0,7,0,30,6,1,0,7,2,30,3,0,0,3,0,-27,3,0
2,0,11,1,30,5,7,0,12,2,30,4,0,0,4,2,30,3,9,0,12,3,30,6,6,0,12,4,30,4,0,0,4,1,-15,3,1
2,2,11,1,30,5,7,0,12,2,30,4,0,0,4,2,30,3,9,0,12,3,30,6,6,0,12,4,30,4,0,0,4,1,-15,3,1
2,4,11,1,30,5,7,0,12,2,30,4,0,0,4,2,30,3,9,0,12,3,30,6,6,0,12,4,30,4,0,0,4,1,-15,3,1
2,1,13,2,30,7,0,0,7,0,30,4,0,0,4,2,30,6,1,0,7,7,30,6,1,0,7,5,30,4,0,0,4,1,-15,3,1
2,2,13,2,30,7,0,0,7,0,30,4,0,0,4,2,30,6,1,0,7,7,30,6,1,0,7,5,30,4,0,0,4,1,-15,3,1
2,4,23,1,30,6,7,0,13,3,30,6,0,0,6,3,30,11,2,0,13,0,30,5,8,0,13,1,30,5,1,0,6,1,-15,3,1
2,4,25,1,30,7,7,0,14,1,30,6,0,0,6,0,30,10,4,0,14,1,30,6,8,0,14,4,30,5,1,0,6,1,-15,3,1
2,4,29,0,30,4,10,0,14,5,30,7,5,0,12,0,30,3,11,0,14,0,30,1,13,0,14,0,30,9,0,0,9,1,-15,3,1
2,0,5,0,30,1,4,0,5,3,30,1,3,0,4,0,30,0,5,0,5,0,30,1,4,0,5,1,30,2,0,0,2,0,-27,3,0
2,2,5,0,30,1,4,0,5,3,30,1,3,0,4,0,30,0,5,0,5,0,30,1,4,0,5,1,30,2,0,0,2,0,-27,3,0
2,1,9,0,30,2,2,0,4,1,30,2,0,0,2,2,30,4,0,0,4,9,30,1,3,0,4,1,30,1,0,0,1,0,-27,3,0
2,2,13,11,30,7,0,0,7,4,30,4,0,0,4,5,30,7,0,0,7,0,30,5,2,0,7,0,30,3,1,0,4,1,-15,3,1
2,2,14,6,30,9,0,0,9,2,30,6,0,0,6,0,30,5,4,0,9,0,30,2,7,0,9,0,30,4,0,0,4,1,-15,3,1
2,3,14,6,30,9,0,0,9,2,30,6,0,0,6,0,30,5,4,0,9,0,30,2,7,0,9,0,30,4,0,0,4,1,-15,3,1
2,4,14,6,30,9,0,0,9,2,30,6,0,0,6,0,30,5,4,0,9,0,30,2,7,0,9,0,30,4,0,0,4,1,-15,3,1
2,0,19,0,30,3,10,0,13,2,30,4,4,0,8,0,30,10,3,0,13,4,30,5,8,0,13,2,30,9,0,0,9,1,-15,3,1
2,2,19,0,30,3,10,0,13,0,30,4,4,0,8,0,30,10,3,0,13,4,30,5,8,0,13,2,30,9,0,0,9,1,-15,3,1
2,1,21,2,30,7,3,0,10,4,30,6,0,0,6,1,30,3,7,0,10,6,30,5,5,0,10,4,30,4,0,0,4,1,-15,3,1
2,4,21,2,30,7,3,0,10,4,30,6,0,0,6,1,30,3,7,0,10,6,30,5,5,0,10,4,30,4,0,0,4,1,-15,3,1
2,4,23,2,30,5,8,0,13,4,30,6,0,0,6,5,30,11,2,0,13,0,30,4,9,0,13,2,30,6,0,0,6,1,-15,3,1
2,2,25,0,30,7,7,0,14,4,30,6,0,0,6,0,30,5,9,0,14,2,30,8,6,0,14,3,30,6,0,0,6,1,-15,3,1
2,1,26,0,30,7,2,0,9,5,30,4,0,0,4,5,30,0,9,0,9,0,30,3,6,0,9,5,30,3,0,0,3,1,-15,3,1
2,3,27,1,30,5,10,0,15,2,30,2,0,0,2,0,30,6,9,0,15,0,30,7,8,0,15,1,30,6,0,0,6,1,-15,3,1
2,4,27,1,30,5,10,0,15,2,30,2,0,0,2,0,30,6,9,0,15,0,30,7,8,0,15,1,30,6,0,0,6,1,-15,3,1
2,4,11,0,30,5,7,0,12,1,30,4,0,0,4,0,30,5,7,0,12,3,30,7,5,0,12,6,30,4,0,0,4,1,-15,3,1
2,1,13,2,30,6,1,0,7,0,30,4,0,0,4,2,30,6,1,0,7,11,30,4,3,0,7,3,30,4,0,0,4,1,-15,3,1
2,3,25,1,30,8,6,0,14,4,30,6,0,0,6,0,30,7,7,0,14,1,30,5,9,0,14,3,30,5,1,0,6,1,-15,3,1
2,0,27,1,30,4,11,0,15,4,30,2,0,0,2,0,30,5,10,0,15,6,30,4,11,0,15,2,30,6,0,0,6,1,-15,3,1
2,1,27,1,30,4,11,0,15,4,30,2,0,0,2,0,30,5,10,0,15,6,30,4,11,0,15,2,30,6,0,0,6,1,-15,3,1
2,2,35,0,30,5,8,0,13,3,30,2,0,0,2,2,30,13,0,0,13,2,30,3,10,0,13,6,30,8,0,0,8,1,-15,3,1
2,3,35,0,30,5,8,0,13,3,30,2,0,0,2,2,30,13,0,0,13,2,30,3,10,0,13,6,30,8,0,0,8,1,-15,3,1
2,0,39,2,30,2,9,0,11,6,30,6,0,0,6,0,30,8,3,0,11,0,30,2,9,0,11,2,30,5,0,0,5,1,-15,3,1
2,1,39,2,30,2,9,0,11,6,30,6,0,0,6,0,30,8,3,0,11,0,30,2,9,0,11,2,30,5,0,0,5,1,-15,3,1
2,2,39,2,30,2,9,0,11,6,30,6,0,0,6,0,30,8,3,0,11,0,30,2,9,0,11,2,30,5,0,0,5,1,-15,3,1
2,1,4,2,30,5,3,0,8,4,30,2,2,0,4,0,30,3,5,0,8,0,30,6,2,0,8,4,30,4,0,0,4,0,-27,3,0
2,4,6,0,30,6,3,0,9,4,30,2,0,0,2,0,30,3,6,0,9,0,30,5,4,0,9,0,30,5,0,0,5,0,-27,3,0
2,4,13,1,30,6,1,0,7,0,30,4,0,0,4,3,30,7,0,0,7,6,30,6,1,0,7,6,30,4,0,0,4,1,-15,3,1
2,1,17,3,30,11,3,0,14,5,30,6,0,0,6,0,30,2,12,0,14,2,30,8,6,0,14,7,30,4,0,0,4,1,-15,3,1
2,4,19,0,30,5,8,0,13,2,30,5,3,0,8,0,30,8,5,0,13,3,30,5,8,0,13,2,30,9,0,0,9,1,-15,3,1
2,4,25,1,30,9,5,0,14,4,30,6,0,0,6,0,30,6,8,0,14,1,30,5,9,0,14,3,30,5,1,0,6,1,-15,3,1
2,2,27,1,30,7,8,0,15,3,30,2,0,0,2,0,30,3,12,0,15,0,30,5,10,0,15,3,30,6,0,0,6,1,-15,3,1
2,3,27,1,30,7,8,0,15,3,30,2,0,0,2,0,30,3,12,0,15,0,30,5,10,0,15,3,30,6,0,0,6,1,-15,3,1
2,4,29,0,30,7,7,0,14,6,30,11,1,0,12,0,30,3,11,0,14,0,30,1,13,0,14,2,30,9,0,0,9,1,-15,3,1
2,4,32,1,30,9,0,0,9,4,30,2,0,0,2,7,30,9,0,0,9,0,30,3,6,0,9,2,30,2,0,0,2,1,-15,3,1
2,2,33,3,30,2,9,0,11,5,30,4,0,0,4,0,30,10,1,0,11,1,30,4,7,0,11,7,30,4,0,0,4,1,-15,3,1
2,3,33,3,30,2,9,0,11,5,30,4,0,0,4,0,30,10,1,0,11,1,30,4,7,0,11,7,30,4,0,0,4,1,-15,3,1
2,3,5,0,30,3,2,0,5,3,30,2,2,0,4,0,30,0,5,0,5,0,30,1,4,0,5,2,30,2,0,0,2,0,-27,3,0
2,2,19,0,30,5,8,0,13,2,30,5,3,0,8,0,30,5,8,0,13,7,30,3,10,0,13,1,30,9,0,0,9,1,-15,3,1
2,3,23,1,30,4,9,0,13,4,30,6,0,0,6,0,30,10,3,0,13,0,30,5,8,0,13,5,30,6,0,0,6,1,-15,3,1
2,4,23,1,30,4,9,0,13,4,30,6,0,0,6,0,30,10,3,0,13,0,30,5,8,0,13,5,30,6,0,0,6,1,-15,3,1
2,2,27,1,30,9,6,0,15,3,30,2,0,0,2,2,30,4,11,0,15,0,30,4,11,0,15,0,30,5,1,0,6,1,-15,3,1
2,3,29,0,30,4,10,0,14,4,30,12,0,0,12,0,30,4,10,0,14,0,30,1,13,0,14,0,30,8,1,0,9,1,-15,3,1
2,4,29,0,30,4,10,0,14,4,30,12,0,0,12,0,30,4,10,0,14,0,30,1,13,0,14,0,30,8,1,0,9,1,-15,3,1
2,0,31,2,30,5,7,0,12,4,30,8,0,0,8,3,30,11,1,0,12,0,30,3,9,0,12,1,30,6,0,0,6,1,-15,3,1
2,2,31,2,30,5,7,0,12,4,30,8,0,0,8,3,30,11,1,0,12,0,30,3,9,0,12,1,30,6,0,0,6,1,-15,3,1
2,4,31,2,30,5,7,0,12,4,30,8,0,0,8,3,30,11,1,0,12,0,30,3,9,0,12,1,30,6,0,0,6,1,-15,3,1
2,2,47,0,30,1,13,0,14,5,30,4,0,0,4,0,30,5,9,0,14,0,30,4,10,0,14,6,30,7,0,0,7,1,-15,3,1
2,4,11,0,30,4,8,0,12,0,30,4,0,0,4,0,30,7,5,0,12,8,30,2,10,0,12,4,30,4,0,0,4,1,-15,3,1
2,0,17,3,30,9,5,0,14,3,30,6,0,0,6,0,30,4,10,0,14,4,30,6,8,0,14,6,30,2,2,0,4,1,-15,3,1
2,4,17,3,30,9,5,0,14,3,30,6,0,0,6,0,30,4,10,0,14,4,30,6,8,0,14,6,30,2,2,0,4,1,-15,3,1
2,3,27,1,30,4,11,0,15,2,30,2,0,0,2,0,30,2,13,0,15,2,30,5,10,0,15,5,30,6,0,0,6,1,-15,3,1
2,4,29,0,30,5,9,0,14,6,30,11,1,0,12,0,30,3,11,0,14,0,30,1,13,0,14,3,30,9,0,0,9,1,-15,3,1
2,4,3,0,30,1,3,0,4,2,30,4,0,0,4,0,30,0,4,0,4,0,30,0,4,0,4,0,30,2,1,0,3,0,-27,3,0
2,3,4,2,30,5,3,0,8,4,30,4,0,0,4,0,30,2,6,0,8,0,30,4,4,0,8,3,30,4,0,0,4,0,-27,3,0
2,1,5,0,30,3,2,0,5,3,30,2,2,0,4,0,30,0,5,0,5,0,30,1,4,0,5,0,30,1,1,0,2,0,-27,3,0
2,2,5,0,30,3,2,0,5,3,30,2,2,0,4,0,30,0,5,0,5,0,30,1,4,0,5,0,30,1,1,0,2,0,-27,3,0
2,3,5,0,30,3,2,0,5,3,30,2,2,0,4,0,30,0,5,0,5,0,30,1,4,0,5,0,30,1,1,0,2,0,-27,3,0
2,4,5,0,30,3,2,0,5,3,30,2,2,0,4,0,30,0,5,0,5,0,30,1,4,0,5,0,30,1,1,0,2,0,-27,3,0
2,0,17,1,30,10,4,0,14,2,30,6,0,0,6,0,30,5,9,0,14,1,30,6,8,0,14,7,30,4,0,0,4,1,-15,3,1
2,3,25,1,30,10,4,0,14,3,30,6,0,0,6,1,30,4,10,0,14,1,30,5,9,0,14,4,30,5,1,0,6,1,-15,3,1
2,0,26,0,30,6,3,0,9,4,30,4,0,0,4,5,30,1,8,0,9,1,30,2,7,0,9,6,30,3,0,0,3,1,-15,3,1
2,1,26,0,30,6,3,0,9,4,30,4,0,0,4,5,30,1,8,0,9,1,30,2,7,0,9,6,30,3,0,0,3,1,-15,3,1
2,2,26,0,30,6,3,0,9,4,30,4,0,0,4,5,30,1,8,0,9,1,30,2,7,0,9,6,30,3,0,0,3,1,-15,3,1
2,3,26,0,30,6,3,0,9,4,30,4,0,0,4,5,30,1,8,0,9,1,30,2,7,0,9,6,30,3,0,0,3,1,-15,3,1
2,0,27,1,30,5,10,0,15,3,30,2,0,0,2,0,30,6,9,0,15,2,30,4,11,0,15,2,30,6,0,0,6,1,-15,3,1
2,2,29,0,30,6,8,0,14,6,30,12,0,0,12,0,30,6,8,0,14,0,30,1,13,0,14,0,30,9,0,0,9,1,-15,3,1
2,0,41,0,30,4,8,0,12,6,30,8,0,0,8,0,30,11,1,0,12,1,30,3,9,0,12,4,30,7,0,0,7,1,-15,3,1
2,1,41,0,30,4,8,0,12,6,30,8,0,0,8,0,30,11,1,0,12,1,30,3,9,0,12,4,30,7,0,0,7,1,-15,3,1
2,3,41,0,30,4,8,0,12,6,30,8,0,0,8,0,30,11,1,0,12,1,30,3,9,0,12,4,30,7,0,0,7,1,-15,3,1
2,4,41,0,30,4,8,0,12,6,30,8,0,0,8,0,30,11,1,0,12,1,30,3,9,0,12,4,30,7,0,0,7,1,-15,3,1
2,2,6,0,30,8,1,0,9,4,30,2,0,0,2,2,30,2,7,0,9,0,30,4,5,0,9,1,30,5,0,0,5,0,-27,3,0
2,3,6,0,30,8,1,0,9,4,30,2,0,0,2,2,30,2,7,0,9,0,30,4,5,0,9,1,30,5,0,0,5,0,-27,3,0
2,1,17,3,30,9,5,0,14,2,30,6,0,0,6,0,30,4,10,0,14,5,30,5,9,0,14,5,30,4,0,0,4,1,-15,3,1
2,2,17,3,30,9,5,0,14,2,30,6,0,0,6,0,30,4,10,0,14,5,30,5,9,0,14,5,30,4,0,0,4,1,-15,3,1
2,1,19,0,30,2,11,0,13,3,30,3,5,0,8,0,30,5,8,0,13,7,30,8,5,0,13,5,30,9,0,0,9,1,-15,3,1
2,2,19,0,30,2,11,0,13,3,30,3,5,0,8,0,30,5,8,0,13,7,30,8,5,0,13,5,30,9,0,0,9,1,-15,3,1
2,3,25,0,30,4,10,0,14,3,30,6,0,0,6,0,30,9,5,0,14,2,30,6,8,0,14,6,30,5,1,0,6,1,-15,3,1
2,3,27,1,30,4,11,0,15,1,30,2,0,0,2,0,30,5,10,0,15,0,30,6,9,0,15,5,30,6,0,0,6,1,-15,3,1
2,4,35,1,30,7,6,0,13,3,30,2,0,0,2,1,30,4,9,0,13,0,30,4,9,0,13,4,30,8,0,0,8,1,-15,3,1
2,3,45,0,30,3,10,0,13,11,30,10,0,0,10,0,30,0,13,0,13,2,30,9,4,0,13,12,30,5,0,0,5,1,-15,3,1
2,1,13,2,30,5,2,0,7,0,30,4,0,0,4,2,30,6,1,0,7,9,30,7,0,0,7,5,30,4,0,0,4,1,-15,3,1
2,2,13,2,30,5,2,0,7,0,30,4,0,0,4,2,30,6,1,0,7,9,30,7,0,0,7,5,30,4,0,0,4,1,-15,3,1
2,4,13,2,30,5,2,0,7,0,30,4,0,0,4,2,30,6,1,0,7,9,30,7,0,0,7,5,30,4,0,0,4,1,-15,3,1
2,4,17,3,30,9,5,0,14,3,30,6,0,0,6,0,30,5,9,0,14,3,30,5,9,0,14,4,30,4,0,0,4,1,-15,3,1
2,4,25,0,30,5,9,0,14,3,30,6,0,0,6,0,30,7,7,0,14,1,30,5,9,0,14,5,30,5,1,0,6,1,-15,3,1
2,2,27,1,30,4,11,0,15,3,30,1,1,0,2,0,30,6,9,0,15,0,30,6,9,0,15,3,30,6,0,0,6,1,-15,3,1
2,4,27,1,30,4,11,0,15,3,30,1,1,0,2,0,30,6,9,0,15,0,30,6,9,0,15,3,30,6,0,0,6,1,-15,3,1
2,3,28,0,30,4,4,0,8,5,30,4,0,0,4,0,30,1,7,0,8,0,30,2,6,0,8,4,30,4,0,0,4,1,-15,3,1
2,4,28,0,30,4,4,0,8,5,30,4,0,0,4,0,30,1,7,0,8,0,30,2,6,0,8,4,30,4,0,0,4,1,-15,3,1
2,0,29,0,30,6,8,0,14,6,30,12,0,0,12,0,30,7,7,0,14,0,30,0,14,0,14,5,30,9,0,0,9,1,-15,3,1
2,0,31,1,30,3,9,0,12,7,30,8,0,0,8,3,30,4,8,0,12,0,30,9,3,0,12,2,30,6,0,0,6,1,-15,3,1
2,3,31,0,30,3,9,0,12,7,30,8,0,0,8,3,30,4,8,0,12,0,30,9,3,0,12,2,30,6,0,0,6,1,-15,3,1
2,0,39,2,30,5,6,0,11,7,30,6,0,0,6,0,30,6,5,0,11,0,30,3,8,0,11,3,30,5,0,0,5,1,-15,3,1
2,4,39,2,30,5,6,0,11,7,30,6,0,0,6,0,30,6,5,0,11,0,30,3,8,0,11,3,30,5,0,0,5,1,-15,3,1
2,0,41,0,30,10,2,0,12,9,30,5,3,0,8,0,30,3,9,0,12,1,30,4,8,0,12,1,30,7,0,0,7,1,-15,3,1
2,3,41,0,30,10,2,0,12,9,30,5,3,0,8,0,30,3,9,0,12,1,30,4,8,0,12,1,30,7,0,0,7,1,-15,3,1
2,4,41,0,30,10,2,0,12,9,30,5,3,0,8,0,30,3,9,0,12,1,30,4,8,0,12,1,30,7,0,0,7,1,-15,3,1
2,3,6,0,30,9,0,0,9,4,30,2,0,0,2,0,30,2,7,0,9,0,30,4,5,0,9,3,30,4,1,0,5,0,-27,3,0
2,1,13,1,30,6,1,0,7,1,30,4,0,0,4,2,30,5,2,0,7,10,30,6,1,0,7,2,30,4,0,0,4,1,-15,3,1
2,2,13,1,30,6,1,0,7,1,30,4,0,0,4,2,30,5,2,0,7,10,30,6,1,0,7,2,30,4,0,0,4,1,-15,3,1
2,3,15,1,30,5,8,0,13,0,30,6,0,0,6,0,30,6,7,0,13,1,30,6,7,0,13,2,30,5,4,0,9,1,-15,3,1
2,1,17,3,30,10,4,0,14,3,30,6,0,0,6,0,30,6,8,0,14,4,30,6,8,0,14,0,30,4,0,0,4,1,-15,3,1
2,2,17,3,30,10,4,0,14,3,30,6,0,0,6,0,30,6,8,0,14,4,30,6,8,0,14,0,30,4,0,0,4,1,-15,3,1
2,3,17,3,30,10,4,0,14,3,30,6,0,0,6,0,30,6,8,0,14,4,30,6,8,0,14,0,30,4,0,0,4,1,-15,3,1
2,3,25,2,30,6,8,0,14,4,30,6,0,0,6,0,30,11,3,0,14,1,30,6,8,0,14,3,30,5,1,0,6,1,-15,3,1
2,4,25,2,30,6,8,0,14,4,30,6,0,0,6,0,30,11,3,0,14,1,30,6,8,0,14,3,30,5,1,0,6,1,-15,3,1
2,2,27,2,30,6,9,0,15,4,30,1,1,0,2,0,30,6,9,0,15,2,30,4,11,0,15,1,30,6,0,0,6,1,-15,3,1
2,4,27,2,30,6,9,0,15,4,30,1,1,0,2,0,30,6,9,0,15,2,30,4,11,0,15,1,30,6,0,0,6,1,-15,3,1
2,4,29,0,30,4,10,0,14,6,30,12,0,0,12,0,30,4,10,0,14,0,30,0,14,0,14,3,30,9,0,0,9,1,-15,3,1
2,3,1,0,30,7,3,0,10,3,30,2,0,0,2,1,30,3,7,0,10,0,30,4,6,0,10,5,30,6,0,0,6,0,-27,3,0
2,4,1,0,30,7,3,0,10,3,30,2,0,0,2,1,30,3,7,0,10,0,30,4,6,0,10,5,30,6,0,0,6,0,-27,3,0
2,0,5,0,30,2,3,0,5,3,30,0,4,0,4,0,30,1,4,0,5,0,30,1,4,0,5,0,30,0,2,0,2,0,-27,3,0
2,3,11,2,30,6,6,0,12,2,30,4,0,0,4,0,30,3,9,0,12,2,30,6,6,0,12,6,30,4,0,0,4,1,-15,3,1
2,4,11,2,30,6,6,0,12,2,30,4,0,0,4,0,30,3,9,0,12,2,30,6,6,0,12,6,30,4,0,0,4,1,-15,3,1
2,4,13,3,30,7,0,0,7,0,30,4,0,0,4,2,30,5,2,0,7,9,30,6,1,0,7,4,30,4,0,0,4,1,-15,3,1
2,0,17,4,30,9,5,0,14,4,30,6,0,0,6,0,30,4,10,0,14,2,30,8,6,0,14,3,30,4,0,0,4,1,-15,3,1
2,2,17,4,30,9,5,0,14,4,30,6,0,0,6,0,30,4,10,0,14,2,30,8,6,0,14,3,30,4,0,0,4,1,-15,3,1
2,4,17,4,30,9,5,0,14,4,30,6,0,0,6,0,30,4,10,0,14,2,30,8,6,0,14,3,30,4,0,0,4,1,-15,3,1
2,0,25,2,30,4,10,0,14,5,30,6,0,0,6,0,30,8,6,0,14,1,30,5,9,0,14,5,30,5,1,0,6,1,-15,3,1
2,1,25,2,30,4,10,0,14,5,30,6,0,0,6,0,30,8,6,0,14,1,30,5,9,0,14,5,30,5,1,0,6,1,-15,3,1
2,2,25,2,30,4,10,0,14,5,30,6,0,0,6,0,30,8,6,0,14,1,30,5,9,0,14,5,30,5,1,0,6,1,-15,3,1
2,2,26,0,30,6,3,0,9,5,30,4,0,0,4,5,30,0,9,0,9,0,30,2,7,0,9,6,30,3,0,0,3,1,-15,3,1
2,2,29,0,30,7,7,0,14,6,30,10,2,0,12,0,30,3,11,0,14,0,30,0,14,0,14,3,30,9,0,0,9,1,-15,3,1
2,3,29,0,30,7,7,0,14,6,30,10,2,0,12,0,30,3,11,0,14,0,30,0,14,0,14,3,30,9,0,0,9,1,-15,3,1
2,4,29,0,30,7,7,0,14,6,30,10,2,0,12,0,30,3,11,0,14,0,30,0,14,0,14,3,30,9,0,0,9,1,-15,3,1
2,2,7,0,30,1,3,0,4,2,30,2,0,0,2,0,30,1,3,0,4,0,30,0,4,0,4,2,30,2,0,0,2,0,-27,3,0
2,4,7,0,30,1,3,0,4,2,30,2,0,0,2,0,30,1,3,0,4,0,30,0,4,0,4,2,30,2,0,0,2,0,-27,3,0
2,1,17,4,30,10,4,0,14,3,30,6,0,0,6,3,30,6,8,0,14,0,30,6,8,0,14,1,30,2,2,0,4,1,-15,3,1
2,3,17,4,30,10,4,0,14,3,30,6,0,0,6,3,30,6,8,0,14,0,30,6,8,0,14,0,30,2,2,0,4,1,-15,3,1
2,4,17,4,30,10,4,0,14,3,30,6,0,0,6,3,30,6,8,0,14,0,30,6,8,0,14,0,30,2,2,0,4,1,-15,3,1
2,3,19,0,30,3,10,0,13,2,30,6,2,0,8,0,30,6,7,0,13,6,30,4,9,0,13,2,30,7,2,0,9,1,-15,3,1
2,1,21,1,30,6,4,0,10,3,30,6,0,0,6,1,30,4,6,0,10,1,30,4,6,0,10,3,30,4,0,0,4,1,-15,3,1
2,2,21,1,30,6,4,0,10,3,30,6,0,0,6,1,30,4,6,0,10,1,30,4,6,0,10,3,30,4,0,0,4,1,-15,3,1
2,3,21,1,30,6,4,0,10,3,30,6,0,0,6,1,30,4,6,0,10,1,30,4,6,0,10,3,30,4,0,0,4,1,-15,3,1
2,4,21,1,30,6,4,0,10,3,30,6,0,0,6,1,30,4,6,0,10,1,30,4,6,0,10,3,30,4,0,0,4,1,-15,3,1
2,1,25,0,30,6,8,0,14,5,30,6,0,0,6,0,30,6,8,0,14,1,30,7,7,0,14,6,30,6,0,0,6,1,-15,3,1
2,1,27,1,30,9,6,0,15,2,30,2,0,0,2,2,30,8,7,0,15,0,30,5,10,0,15,1,30,5,1,0,6,1,-15,3,1
2,3,27,1,30,9,6,0,15,2,30,2,0,0,2,0,30,8,7,0,15,0,30,5,10,0,15,1,30,5,1,0,6,1,-15,3,1
2,4,27,1,30,9,6,0,15,2,30,2,0,0,2,0,30,8,7,0,15,0,30,5,10,0,15,1,30,5,1,0,6,1,-15,3,1
2,4,3,0,30,1,3,0,4,3,30,4,0,0,4,0,30,0,4,0,4,4,30,2,2,0,4,3,30,2,1,0,3,0,-27,3,0
2,1,4,2,30,8,0,0,8,4,30,3,1,0,4,5,30,2,6,0,8,0,30,4,4,0,8,1,30,3,1,0,4,0,-27,3,0
2,2,13,2,30,7,0,0,7,0,30,4,0,0,4,2,30,6,1,0,7,6,30,7,0,0,7,2,30,4,0,0,4,1,-15,3,1
2,3,13,2,30,7,0,0,7,0,30,4,0,0,4,2,30,6,1,0,7,6,30,7,0,0,7,2,30,4,0,0,4,1,-15,3,1
2,3,19,0,30,7,6,0,13,1,30,4,4,0,8,0,30,4,9,0,13,0,30,4,9,0,13,0,30,9,0,0,9,1,-15,3,1
2,4,19,0,30,7,6,0,13,1,30,4,4,0,8,0,30,4,9,0,13,0,30,4,9,0,13,0,30,9,0,0,9,1,-15,3,1
2,4,23,1,30,4,9,0,13,3,30,6,0,0,6,4,30,9,4,0,13,5,30,9,4,0,13,1,30,5,1,0,6,1,-15,3,1
2,2,25,1,30,9,5,0,14,4,30,6,0,0,6,0,30,3,11,0,14,1,30,8,6,0,14,9,30,5,1,0,6,1,-15,3,1
2,0,27,1,30,3,12,0,15,2,30,2,0,0,2,0,30,5,10,0,15,4,30,5,10,0,15,3,30,6,0,0,6,1,-15,3,1
2,2,29,0,30,8,6,0,14,6,30,8,4,0,12,0,30,5,9,0,14,0,30,2,12,0,14,3,30,9,0,0,9,1,-15,3,1
2,3,29,0,30,8,6,0,14,6,30,8,4,0,12,0,30,5,9,0,14,0,30,2,12,0,14,3,30,9,0,0,9,1,-15,3,1
2,0,37,0,30,8,3,0,11,4,30,8,0,0,8,0,30,8,3,0,11,6,30,3,8,0,11,6,30,6,0,0,6,1,-15,3,1
2,3,37,0,30,8,3,0,11,4,30,8,0,0,8,0,30,8,3,0,11,6,30,3,8,0,11,6,30,6,0,0,6,1,-15,3,1
2,0,39,3,30,4,7,0,11,7,30,6,0,0,6,0,30,4,7,0,11,0,30,2,9,0,11,3,30,5,0,0,5,1,-15,3,1
2,4,39,3,30,4,7,0,11,7,30,6,0,0,6,0,30,4,7,0,11,0,30,2,9,0,11,3,30,5,0,0,5,1,-15,3,1
2,4,47,0,30,1,13,0,14,6,30,4,0,0,4,0,30,3,11,0,14,0,30,4,10,0,14,6,30,7,0,0,7,1,-15,3,1
2,2,5,0,30,1,4,0,5,2,30,2,2,0,4,0,30,1,4,0,5,0,30,1,4,0,5,0,30,0,2,0,2,0,-27,3,0
2,4,5,0,30,1,4,0,5,2,30,2,2,0,4,0,30,1,4,0,5,0,30,1,4,0,5,0,30,0,2,0,2,0,-27,3,0
2,3,7,0,30,1,3,0,4,2,30,2,0,0,2,2,30,2,2,0,4,2,30,1,3,0,4,3,30,2,0,0,2,0,-27,3,0
2,3,13,1,30,6,1,0,7,0,30,4,0,0,4,2,30,6,1,0,7,6,30,5,2,0,7,4,30,4,0,0,4,1,-15,3,1
2,4,13,1,30,6,1,0,7,0,30,4,0,0,4,2,30,6,1,0,7,6,30,5,2,0,7,4,30,4,0,0,4,1,-15,3,1
2,4,15,0,30,3,10,0,13,1,30,6,0,0,6,0,30,3,10,0,13,1,30,5,8,0,13,5,30,4,5,0,9,1,-15,3,1
2,1,17,3,30,9,5,0,14,3,30,6,0,0,6,0,30,3,11,0,14,1,30,3,11,0,14,4,30,4,0,0,4,1,-15,3,1
2,2,17,3,30,9,5,0,14,3,30,6,0,0,6,0,30,3,11,0,14,1,30,3,11,0,14,4,30,4,0,0,4,1,-15,3,1
2,3,17,3,30,9,5,0,14,3,30,6,0,0,6,0,30,3,11,0,14,1,30,3,11,0,14,4,30,4,0,0,4,1,-15,3,1
2,4,17,3,30,9,5,0,14,3,30,6,0,0,6,0,30,3,11,0,14,1,30,3,11,0,14,4,30,4,0,0,4,1,-15,3,1
2,0,19,0,30,2,11,0,13,3,30,5,3,0,8,0,30,4,9,0,13,7,30,3,10,0,13,3,30,9,0,0,9,1,-15,3,1
2,1,19,0,30,2,11,0,13,3,30,5,3,0,8,0,30,4,9,0,13,7,30,3,10,0,13,3,30,9,0,0,9,1,-15,3,1
2,2,21,3,30,9,1,0,10,4,30,6,0,0,6,1,30,3,7,0,10,2,30,5,5,0,10,0,30,3,1,0,4,1,-15,3,1
2,4,21,3,30,9,1,0,10,4,30,6,0,0,6,1,30,3,7,0,10,2,30,5,5,0,10,0,30,3,1,0,4,1,-15,3,1
2,3,25,1,30,6,8,0,14,3,30,6,0,0,6,0,30,6,8,0,14,1,30,5,9,0,14,2,30,5,1,0,6,1,-15,3,1
2,2,31,1,30,8,4,0,12,4,30,8,0,0,8,3,30,9,3,0,12,2,30,4,8,0,12,0,30,5,1,0,6,1,-15,3,1
2,4,31,1,30,8,4,0,12,4,30,8,0,0,8,3,30,9,3,0,12,2,30,4,8,0,12,0,30,5,1,0,6,1,-15,3,1
2,3,43,0,30,8,6,0,14,6,30,6,0,0,6,0,30,4,10,0,14,1,30,1,13,0,14,0,30,5,0,0,5,1,-15,3,1
2,0,5,4,30,2,3,0,5,3,30,0,4,0,4,0,30,0,5,0,5,0,30,1,4,0,5,0,30,0,2,0,2,0,-27,3,0
2,2,5,4,30,2,3,0,5,3,30,0,4,0,4,0,30,0,5,0,5,0,30,1,4,0,5,0,30,0,2,0,2,0,-27,3,0
2,4,13,0,30,7,0,0,7,0,30,4,0,0,4,2,30,5,2,0,7,5,30,5,2,0,7,4,30,4,0,0,4,1,-15,3,1
2,1,19,0,30,2,11,0,13,2,30,4,4,0,8,0,30,6,7,0,13,4,30,8,5,0,13,2,30,8,1,0,9,1,-15,3,1
2,2,19,0,30,2,11,0,13,2,30,4,4,0,8,0,30,6,7,0,13,4,30,8,5,0,13,2,30,8,1,0,9,1,-15,3,1
2,2,27,1,30,2,13,0,15,3,30,1,1,0,2,0,30,5,10,0,15,1,30,4,11,0,15,3,30,6,0,0,6,1,-15,3,1
2,4,27,1,30,2,13,0,15,3,30,1,1,0,2,0,30,5,10,0,15,1,30,4,11,0,15,3,30,6,0,0,6,1,-15,3,1
2,4,29,0,30,5,9,0,14,6,30,11,1,0,12,0,30,6,8,0,14,0,30,0,14,0,14,3,30,9,0,0,9,1,-15,3,1
2,2,31,1,30,7,5,0,12,4,30,8,0,0,8,6,30,9,3,0,12,0,30,3,9,0,12,1,30,4,2,0,6,1,-15,3,1
2,3,31,1,30,7,5,0,12,4,30,8,0,0,8,6,30,9,3,0,12,0,30,3,9,0,12,1,30,4,2,0,6,1,-15,3,1
2,4,31,1,30,7,5,0,12,4,30,8,0,0,8,6,30,9,3,0,12,0,30,3,9,0,12,1,30,4,2,0,6,1,-15,3,1
2,0,5,0,30,3,2,0,5,3,30,3,1,0,4,0,30,0,5,0,5,0,30,2,3,0,5,0,30,0,2,0,2,0,-27,3,0
2,1,5,0,30,3,2,0,5,3,30,3,1,0,4,0,30,0,5,0,5,0,30,2,3,0,5,0,30,0,2,0,2,0,-27,3,0
2,2,5,0,30,3,2,0,5,3,30,3,1,0,4,0,30,0,5,0,5,0,30,2,3,0,5,0,30,0,2,0,2,0,-27,3,0
2,4,5,0,30,3,2,0,5,3,30,3,1,0,4,0,30,0,5,0,5,0,30,2,3,0,5,0,30,0,2,0,2,0,-27,3,0
2,3,6,2,30,6,3,0,9,4,30,2,0,0,2,0,30,2,7,0,9,0,30,4,5,0,9,0,30,4,1,0,5,0,-27,3,0
2,4,8,2,30,7,0,0,7,4,30,2,0,0,2,5,30,2,5,0,7,1,30,7,0,0,7,0,30,3,0,0,3,0,-27,3,0
2,2,13,2,30,5,2,0,7,0,30,4,0,0,4,2,30,6,1,0,7,7,30,5,2,0,7,4,30,4,0,0,4,1,-15,3,1
2,2,15,0,30,2,11,0,13,0,30,6,0,0,6,0,30,3,10,0,13,1,30,7,6,0,13,3,30,9,0,0,9,1,-15,3,1
2,4,15,0,30,2,11,0,13,0,30,6,0,0,6,0,30,3,10,0,13,1,30,7,6,0,13,3,30,9,0,0,9,1,-15,3,1
2,1,17,4,30,11,3,0,14,4,30,6,0,0,6,0,30,3,11,0,14,1,30,8,6,0,14,1,30,4,0,0,4,1,-15,3,1
2,2,17,4,30,11,3,0,14,4,30,6,0,0,6,0,30,3,11,0,14,1,30,8,6,0,14,1,30,4,0,0,4,1,-15,3,1
2,3,17,4,30,11,3,0,14,4,30,6,0,0,6,0,30,3,11,0,14,1,30,8,6,0,14,1,30,4,0,0,4,1,-15,3,1
2,3,23,1,30,3,10,0,13,3,30,6,0,0,6,4,30,13,0,0,13,0,30,5,8,0,13,4,30,6,0,0,6,1,-15,3,1
2,1,25,1,30,3,11,0,14,3,30,6,0,0,6,0,30,4,10,0,14,4,30,10,4,0,14,10,30,6,0,0,6,1,-15,3,1
2,3,27,1,30,6,9,0,15,5,30,2,0,0,2,0,30,2,13,0,15,0,30,5,10,0,15,8,30,6,0,0,6,1,-15,3,1
2,2,39,2,30,3,8,0,11,6,30,6,0,0,6,0,30,8,3,0,11,0,30,4,7,0,11,4,30,5,0,0,5,1,-15,3,1
2,3,39,2,30,3,8,0,11,6,30,6,0,0,6,0,30,8,3,0,11,0,30,4,7,0,11,4,30,5,0,0,5,1,-15,3,1
2,3,47,0,30,1,13,0,14,6,30,4,0,0,4,0,30,3,11,0,14,0,30,2,12,0,14,8,30,7,0,0,7,1,-15,3,1
2,2,13,2,30,7,0,0,7,0,30,4,0,0,4,2,30,7,0,0,7,7,30,7,0,0,7,4,30,4,0,0,4,1,-15,3,1
2,2,17,3,30,10,4,0,14,3,30,6,0,0,6,0,30,4,10,0,14,1,30,5,9,0,14,5,30,4,0,0,4,1,-15,3,1
2,3,17,3,30,10,4,0,14,3,30,6,0,0,6,0,30,4,10,0,14,1,30,5,9,0,14,5,30,4,0,0,4,1,-15,3,1
2,4,23,1,30,6,7,0,13,1,30,6,0,0,6,7,30,11,2,0,13,0,30,6,7,0,13,1,30,6,0,0,6,1,-15,3,1
2,4,25,1,30,3,11,0,14,5,30,6,0,0,6,0,30,5,9,0,14,1,30,11,3,0,14,1,30,5,1,0,6,1,-15,3,1
2,0,26,0,30,7,2,0,9,5,30,4,0,0,4,2,30,1,8,0,9,0,30,2,7,0,9,6,30,3,0,0,3,1,-15,3,1
2,1,27,1,30,7,8,0,15,5,30,2,0,0,2,0,30,4,11,0,15,0,30,6,9,0,15,3,30,6,0,0,6,1,-15,3,1
2,3,27,1,30,7,8,0,15,5,30,2,0,0,2,0,30,4,11,0,15,0,30,6,9,0,15,3,30,6,0,0,6,1,-15,3,1
2,3,47,0,30,0,14,0,14,6,30,4,0,0,4,0,30,5,9,0,14,0,30,2,12,0,14,9,30,7,0,0,7,1,-15,3,1
2,4,7,1,30,4,5,0,9,2,30,4,0,0,4,1,30,7,2,0,9,5,30,3,6,0,9,1,30,4,2,0,6,0,-27,3,0
2,4,8,2,30,7,0,0,7,4,30,2,0,0,2,8,30,3,4,0,7,0,30,5,2,0,7,1,30,3,0,0,3,0,-27,3,0
2,4,15,0,30,5,8,0,13,0,30,6,0,0,6,0,30,5,8,0,13,1,30,4,9,0,13,2,30,6,3,0,9,1,-15,3,1
2,2,17,4,30,10,4,0,14,3,30,6,0,0,6,0,30,4,10,0,14,1,30,4,10,0,14,4,30,4,0,0,4,1,-15,3,1
2,4,19,0,30,5,8,0,13,0,30,6,2,0,8,0,30,6,7,0,13,0,30,4,9,0,13,0,30,9,0,0,9,1,-15,3,1
2,1,25,2,30,7,7,0,14,2,30,6,0,0,6,0,30,9,5,0,14,1,30,5,9,0,14,4,30,5,1,0,6,1,-15,3,1
2,2,25,2,30,7,7,0,14,2,30,6,0,0,6,0,30,9,5,0,14,1,30,5,9,0,14,4,30,5,1,0,6,1,-15,3,1
2,3,25,2,30,7,7,0,14,2,30,6,0,0,6,0,30,9,5,0,14,1,30,5,9,0,14,4,30,5,1,0,6,1,-15,3,1
2,3,27,1,30,4,11,0,15,3,30,2,0,0,2,0,30,5,10,0,15,2,30,4,11,0,15,5,30,6,0,0,6,1,-15,3,1
2,3,29,0,30,6,8,0,14,6,30,10,2,0,12,0,30,3,11,0,14,0,30,2,12,0,14,4,30,9,0,0,9,1,-15,3,1
2,4,29,0,30,6,8,0,14,6,30,10,2,0,12,0,30,3,11,0,14,0,30,2,12,0,14,4,30,9,0,0,9,1,-15,3,1
2,3,7,0,30,1,3,0,4,2,30,2,0,0,2,0,30,1,3,0,4,0,30,1,3,0,4,2,30,1,1,0,2,0,-27,3,0
2,4,13,0,30,6,1,0,7,0,30,4,0,0,4,2,30,7,0,0,7,12,30,6,1,0,7,3,30,4,0,0,4,1,-15,3,1
2,2,17,4,30,10,4,0,14,4,30,6,0,0,6,0,30,4,10,0,14,2,30,6,8,0,14,0,30,4,0,0,4,1,-15,3,1
2,3,17,4,30,10,4,0,14,4,30,6,0,0,6,0,30,4,10,0,14,2,30,6,8,0,14,0,30,4,0,0,4,1,-15,3,1
2,2,19,0,30,4,9,0,13,2,30,5,3,0,8,0,30,6,7,0,13,4,30,7,6,0,13,0,30,7,2,0,9,1,-15,3,1
2,4,21,3,30,8,2,0,10,3,30,5,1,0,6,1,30,5,5,0,10,2,30,4,6,0,10,1,30,4,0,0,4,1,-15,3,1
2,4,25,1,30,8,6,0,14,3,30,6,0,0,6,0,30,12,2,0,14,0,30,5,9,0,14,1,30,4,2,0,6,1,-15,3,1
2,2,6,1,30,7,2,0,9,3,30,2,0,0,2,0,30,4,5,0,9,0,30,3,6,0,9,0,30,5,0,0,5,0,-27,3,0
2,3,6,1,30,7,2,0,9,3,30,2,0,0,2,0,30,4,5,0,9,0,30,3,6,0,9,0,30,5,0,0,5,0,-27,3,0
2,2,13,4,30,7,0,0,7,0,30,4,0,0,4,4,30,6,1,0,7,4,30,4,3,0,7,0,30,3,1,0,4,1,-15,3,1
2,3,13,4,30,7,0,0,7,0,30,4,0,0,4,4,30,6,1,0,7,4,30,4,3,0,7,0,30,3,1,0,4,1,-15,3,1
2,4,13,4,30,7,0,0,7,0,30,4,0,0,4,4,30,6,1,0,7,4,30,4,3,0,7,0,30,3,1,0,4,1,-15,3,1
2,2,17,4,30,8,6,0,14,3,30,6,0,0,6,0,30,6,8,0,14,4,30,6,8,0,14,1,30,4,0,0,4,1,-15,3,1
2,3,17,4,30,8,6,0,14,3,30,6,0,0,6,0,30,6,8,0,14,4,30,6,8,0,14,1,30,4,0,0,4,1,-15,3,1
2,2,19,0,30,3,10,0,13,2,30,5,3,0,8,0,30,10,3,0,13,1,30,6,7,0,13,3,30,8,1,0,9,1,-15,3,1
2,4,21,2,30,7,3,0,10,4,30,5,1,0,6,1,30,3,7,0,10,10,30,5,5,0,10,0,30,3,1,0,4,1,-15,3,1
2,4,23,3,30,9,4,0,13,2,30,6,0,0,6,1,30,11,2,0,13,0,30,5,8,0,13,2,30,6,0,0,6,1,-15,3,1
2,1,25,1,30,10,4,0,14,3,30,6,0,0,6,0,30,8,6,0,14,1,30,5,9,0,14,2,30,5,1,0,6,1,-15,3,1
2,4,25,1,30,10,4,0,14,3,30,6,0,0,6,0,30,8,6,0,14,1,30,5,9,0,14,2,30,5,1,0,6,1,-15,3,1
2,2,27,1,30,4,11,0,15,4,30,2,0,0,2,0,30,3,12,0,15,4,30,3,12,0,15,1,30,6,0,0,6,1,-15,3,1
2,3,27,1,30,4,11,0,15,4,30,2,0,0,2,0,30,3,12,0,15,4,30,3,12,0,15,1,30,6,0,0,6,1,-15,3,1
2,4,27,1,30,4,11,0,15,4,30,2,0,0,2,0,30,3,12,0,15,4,30,3,12,0,15,1,30,6,0,0,6,1,-15,3,1
2,1,31,1,30,8,4,0,12,3,30,8,0,0,8,5,30,12,0,0,12,0,30,3,9,0,12,0,30,2,4,0,6,1,-15,3,1
2,2,31,1,30,8,4,0,12,3,30,8,0,0,8,5,30,12,0,0,12,0,30,3,9,0,12,0,30,2,4,0,6,1,-15,3,1
2,3,31,1,30,8,4,0,12,3,30,8,0,0,8,5,30,12,0,0,12,0,30,3,9,0,12,0,30,2,4,0,6,1,-15,3,1
2,4,31,1,30,8,4,0,12,3,30,8,0,0,8,5,30,12,0,0,12,0,30,3,9,0,12,0,30,2,4,0,6,1,-15,3,1
2,2,47,0,30,0,14,0,14,6,30,4,0,0,4,0,30,6,8,0,14,0,30,4,10,0,14,9,30,7,0,0,7,1,-15,3,1
2,4,1,0,30,7,3,0,10,4,30,2,0,0,2,1,30,4,6,0,10,4,30,6,4,0,10,5,30,6,0,0,6,0,-27,3,0
2,3,4,2,30,7,1,0,8,4,30,4,0,0,4,0,30,2,6,0,8,0,30,4,4,0,8,0,30,4,0,0,4,0,-27,3,0
2,0,5,5,30,2,3,0,5,4,30,4,0,0,4,0,30,0,5,0,5,0,30,1,4,0,5,0,30,0,2,0,2,0,-27,3,0
2,1,17,3,30,10,4,0,14,3,30,6,0,0,6,0,30,5,9,0,14,2,30,4,10,0,14,3,30,4,0,0,4,1,-15,3,1
2,2,17,3,30,10,4,0,14,3,30,6,0,0,6,0,30,5,9,0,14,2,30,4,10,0,14,3,30,4,0,0,4,1,-15,3,1
2,3,17,3,30,10,4,0,14,3,30,6,0,0,6,0,30,5,9,0,14,2,30,4,10,0,14,3,30,4,0,0,4,1,-15,3,1
2,2,19,0,30,3,10,0,13,2,30,8,0,0,8,0,30,4,9,0,13,3,30,8,5,0,13,1,30,7,2,0,9,1,-15,3,1
2,3,19,0,30,3,10,0,13,2,30,8,0,0,8,0,30,4,9,0,13,3,30,8,5,0,13,1,30,7,2,0,9,1,-15,3,1
2,3,23,2,30,6,7,0,13,2,30,6,0,0,6,2,30,13,0,0,13,0,30,5,8,0,13,2,30,5,1,0,6,1,-15,3,1
2,4,23,2,30,6,7,0,13,2,30,6,0,0,6,2,30,13,0,0,13,0,30,5,8,0,13,2,30,5,1,0,6,1,-15,3,1
2,2,27,1,30,4,11,0,15,2,30,2,0,0,2,0,30,6,9,0,15,2,30,5,10,0,15,5,30,6,0,0,6,1,-15,3,1
2,1,37,0,30,7,4,0,11,6,30,6,2,0,8,0,30,6,5,0,11,4,30,5,6,0,11,7,30,6,0,0,6,1,-15,3,1
2,2,37,0,30,7,4,0,11,6,30,6,2,0,8,0,30,6,5,0,11,4,30,5,6,0,11,7,30,6,0,0,6,1,-15,3,1
2,3,37,0,30,7,4,0,11,6,30,6,2,0,8,0,30,6,5,0,11,4,30,5,6,0,11,7,30,6,0,0,6,1,-15,3,1
2,2,12,0,30,3,4,0,7,1,30,2,4,0,6,0,30,3,4,0,7,7,30,7,0,0,7,5,30,3,0,0,3,1,-15,3,1
2,4,12,0,30,3,4,0,7,1,30,2,4,0,6,0,30,3,4,0,7,7,30,7,0,0,7,5,30,3,0,0,3,1,-15,3,1
2,3,13,4,30,7,0,0,7,2,30,4,0,0,4,6,30,7,0,0,7,4,30,7,0,0,7,4,30,4,0,0,4,1,-15,3,1
2,4,13,4,30,7,0,0,7,2,30,4,0,0,4,6,30,7,0,0,7,4,30,7,0,0,7,4,30,4,0,0,4,1,-15,3,1
2,4,15,0,30,5,8,0,13,1,30,5,1,0,6,0,30,3,10,0,13,1,30,4,9,0,13,3,30,9,0,0,9,1,-15,3,1
2,3,23,1,30,5,8,0,13,2,30,6,0,0,6,3,30,11,2,0,13,0,30,5,8,0,13,3,30,6,0,0,6,1,-15,3,1
2,4,23,1,30,5,8,0,13,2,30,6,0,0,6,3,30,11,2,0,13,0,30,5,8,0,13,3,30,6,0,0,6,1,-15,3,1
2,0,27,1,30,3,12,0,15,4,30,2,0,0,2,0,30,5,10,0,15,1,30,5,10,0,15,2,30,6,0,0,6,1,-15,3,1
2,1,27,1,30,3,12,0,15,4,30,2,0,0,2,0,30,5,10,0,15,1,30,5,10,0,15,2,30,6,0,0,6,1,-15,3,1
2,4,27,1,30,3,12,0,15,4,30,2,0,0,2,0,30,5,10,0,15,1,30,5,10,0,15,2,30,6,0,0,6,1,-15,3,1
2,4,32,0,30,6,3,0,9,4,30,2,0,0,2,0,30,9,0,0,9,1,30,2,7,0,9,2,30,2,0,0,2,1,-15,3,1
2,1,4,7,30,8,0,0,8,5,30,4,0,0,4,0,30,2,6,0,8,0,30,4,4,0,8,2,30,3,1,0,4,0,-27,3,0
2,3,4,7,30,8,0,0,8,5,30,4,0,0,4,0,30,2,6,0,8,0,30,4,4,0,8,2,30,3,1,0,4,0,-27,3,0
2,2,5,0,30,2,3,0,5,3,30,4,0,0,4,0,30,0,5,0,5,4,30,3,2,0,5,0,30,0,2,0,2,0,-27,3,0
2,4,7,0,30,0,4,0,4,2,30,2,0,0,2,3,30,1,3,0,4,0,30,1,3,0,4,1,30,1,1,0,2,0,-27,3,0
2,4,8,2,30,7,0,0,7,3,30,2,0,0,2,4,30,2,5,0,7,0,30,6,1,0,7,0,30,3,0,0,3,0,-27,3,0
2,1,19,0,30,4,9,0,13,2,30,6,2,0,8,0,30,5,8,0,13,5,30,5,8,0,13,2,30,9,0,0,9,1,-15,3,1
2,2,19,0,30,4,9,0,13,2,30,6,2,0,8,0,30,5,8,0,13,5,30,5,8,0,13,2,30,9,0,0,9,1,-15,3,1
2,3,23,1,30,4,9,0,13,3,30,6,0,0,6,3,30,12,1,0,13,1,30,5,8,0,13,0,30,6,0,0,6,1,-15,3,1
2,0,27,1,30,5,10,0,15,4,30,2,0,0,2,0,30,7,8,0,15,1,30,4,11,0,15,4,30,6,0,0,6,1,-15,3,1
2,1,27,1,30,5,10,0,15,4,30,2,0,0,2,0,30,7,8,0,15,1,30,4,11,0,15,4,30,6,0,0,6,1,-15,3,1
2,3,27,1,30,5,10,0,15,4,30,2,0,0,2,0,30,7,8,0,15,1,30,4,11,0,15,0,30,6,0,0,6,1,-15,3,1
2,4,27,1,30,5,10,0,15,4,30,2,0,0,2,0,30,7,8,0,15,1,30,4,11,0,15,0,30,6,0,0,6,1,-15,3,1
2,1,5,0,30,4,1,0,5,3,30,3,1,0,4,0,30,0,5,0,5,0,30,1,4,0,5,3,30,1,1,0,2,0,-27,3,0
2,2,5,0,30,4,1,0,5,3,30,3,1,0,4,0,30,0,5,0,5,0,30,1,4,0,5,3,30,1,1,0,2,0,-27,3,0
2,3,8,2,30,7,0,0,7,3,30,2,0,0,2,0,30,6,1,0,7,0,30,6,1,0,7,0,30,3,0,0,3,0,-27,3,0
2,4,8,2,30,7,0,0,7,3,30,2,0,0,2,0,30,6,1,0,7,0,30,6,1,0,7,0,30,3,0,0,3,0,-27,3,0
2,4,13,2,30,3,0,0,3,0,30,2,0,0,2,0,30,3,0,0,3,7,30,3,0,0,3,4,30,2,0,0,2,1,-15,3,1
2,2,13,2,30,7,0,0,7,0,30,4,0,0,4,2,30,6,1,0,7,9,30,7,0,0,7,4,30,4,0,0,4,1,-15,3,1
2,4,13,2,30,7,0,0,7,0,30,4,0,0,4,2,30,6,1,0,7,9,30,7,0,0,7,4,30,4,0,0,4,1,-15,3,1
2,3,22,2,30,8,0,0,8,2,30,2,0,0,2,0,30,4,4,0,8,0,30,2,6,0,8,2,30,4,0,0,4,1,-15,3,1
2,4,22,2,30,8,0,0,8,2,30,2,0,0,2,0,30,4,4,0,8,0,30,2,6,0,8,2,30,4,0,0,4,1,-15,3,1
2,3,23,1,30,7,6,0,13,2,30,6,0,0,6,2,30,11,2,0,13,0,30,4,9,0,13,0,30,6,0,0,6,1,-15,3,1
2,4,25,1,30,6,8,0,14,3,30,6,0,0,6,0,30,8,6,0,14,0,30,5,9,0,14,2,30,5,1,0,6,1,-15,3,1
2,4,27,1,30,3,12,0,15,2,30,1,1,0,2,0,30,9,6,0,15,0,30,6,9,0,15,3,30,6,0,0,6,1,-15,3,1
2,2,35,0,30,8,5,0,13,6,30,2,0,0,2,1,30,2,11,0,13,2,30,6,7,0,13,9,30,8,0,0,8,1,-15,3,1
2,4,3,0,30,1,3,0,4,2,30,4,0,0,4,0,30,0,4,0,4,2,30,1,3,0,4,0,30,1,2,0,3,0,-27,3,0
2,4,7,1,30,4,0,0,4,2,30,2,0,0,2,0,30,1,3,0,4,0,30,1,3,0,4,1,30,1,1,0,2,0,-27,3,0
2,2,11,0,30,3,1,0,4,0,30,0,0,0,0,0,30,4,0,0,4,2,30,4,0,0,4,1,30,1,0,0,1,1,-15,3,1
2,1,13,2,30,6,1,0,7,1,30,4,0,0,4,2,30,5,2,0,7,8,30,7,0,0,7,4,30,4,0,0,4,1,-15,3,1
2,4,13,2,30,6,1,0,7,1,30,4,0,0,4,2,30,5,2,0,7,8,30,7,0,0,7,4,30,4,0,0,4,1,-15,3,1
2,2,17,4,30,10,4,0,14,2,30,6,0,0,6,0,30,5,9,0,14,0,30,3,11,0,14,6,30,4,0,0,4,1,-15,3,1
2,3,21,2,30,7,3,0,10,4,30,6,0,0,6,1,30,3,7,0,10,2,30,5,5,0,10,5,30,3,1,0,4,1,-15,3,1
2,4,23,0,30,5,8,0,13,1,30,6,0,0,6,8,30,13,0,0,13,0,30,6,7,0,13,5,30,6,0,0,6,1,-15,3,1
2,0,27,0,30,5,10,0,15,4,30,2,0,0,2,0,30,3,12,0,15,4,30,9,6,0,15,4,30,6,0,0,6,1,-15,3,1
2,1,27,0,30,5,10,0,15,4,30,2,0,0,2,0,30,3,12,0,15,4,30,9,6,0,15,4,30,6,0,0,6,1,-15,3,1
2,2,27,0,30,5,10,0,15,4,30,2,0,0,2,0,30,3,12,0,15,4,30,9,6,0,15,4,30,6,0,0,6,1,-15,3,1
2,3,27,0,30,5,10,0,15,4,30,2,0,0,2,0,30,3,12,0,15,4,30,9,6,0,15,4,30,6,0,0,6,1,-15,3,1
2,4,27,0,30,5,10,0,15,4,30,2,0,0,2,0,30,3,12,0,15,4,30,9,6,0,15,4,30,6,0,0,6,1,-15,3,1
2,0,45,0,30,9,4,0,13,11,30,10,0,0,10,0,30,0,13,0,13,0,30,4,9,0,13,6,30,5,0,0,5,1,-15,3,1
2,2,45,0,30,9,4,0,13,11,30,10,0,0,10,0,30,0,13,0,13,0,30,4,9,0,13,6,30,5,0,0,5,1,-15,3,1
2,1,5,0,30,1,4,0,5,3,30,3,1,0,4,0,30,0,5,0,5,0,30,1,4,0,5,1,30,2,0,0,2,0,-27,3,0
2,2,5,0,30,1,4,0,5,3,30,3,1,0,4,0,30,0,5,0,5,0,30,1,4,0,5,1,30,2,0,0,2,0,-27,3,0
2,4,5,0,30,1,4,0,5,3,30,3,1,0,4,0,30,0,5,0,5,0,30,1,4,0,5,1,30,2,0,0,2,0,-27,3,0
2,2,13,1,30,6,1,0,7,0,30,4,0,0,4,2,30,7,0,0,7,3,30,7,0,0,7,6,30,4,0,0,4,1,-15,3,1
2,4,17,2,30,9,5,0,14,3,30,6,0,0,6,0,30,6,8,0,14,2,30,6,8,0,14,6,30,4,0,0,4,1,-15,3,1
2,1,19,0,30,5,8,0,13,2,30,4,4,0,8,0,30,4,9,0,13,7,30,6,7,0,13,1,30,9,0,0,9,1,-15,3,1
2,4,19,0,30,5,8,0,13,2,30,4,4,0,8,0,30,4,9,0,13,7,30,6,7,0,13,1,30,9,0,0,9,1,-15,3,1
2,4,22,1,30,7,1,0,8,2,30,2,0,0,2,0,30,5,3,0,8,0,30,4,4,0,8,1,30,1,3,0,4,1,-15,3,1
2,4,23,1,30,7,6,0,13,0,30,6,0,0,6,4,30,12,1,0,13,0,30,6,7,0,13,2,30,6,0,0,6,1,-15,3,1
2,2,25,1,30,7,7,0,14,1,30,6,0,0,6,0,30,10,4,0,14,1,30,7,7,0,14,5,30,5,1,0,6,1,-15,3,1
2,4,25,1,30,7,7,0,14,1,30,6,0,0,6,0,30,10,4,0,14,1,30,7,7,0,14,5,30,5,1,0,6,1,-15,3,1
2,0,27,1,30,6,9,0,15,3,30,1,1,0,2,0,30,6,9,0,15,0,30,8,7,0,15,4,30,6,0,0,6,1,-15,3,1
2,1,27,1,30,6,9,0,15,3,30,1,1,0,2,0,30,6,9,0,15,0,30,8,7,0,15,4,30,6,0,0,6,1,-15,3,1
2,3,27,1,30,6,9,0,15,3,30,1,1,0,2,0,30,6,9,0,15,0,30,8,7,0,15,4,30,6,0,0,6,1,-15,3,1
2,4,5,0,30,2,3,0,5,3,30,2,2,0,4,0,30,0,5,0,5,0,30,1,4,0,5,0,30,2,0,0,2,0,-27,3,0
2,4,8,1,30,7,0,0,7,4,30,2,0,0,2,0,30,4,3,0,7,0,30,7,0,0,7,3,30,3,0,0,3,0,-27,3,0
2,1,13,1,30,5,2,0,7,2,30,4,0,0,4,2,30,5,2,0,7,8,30,7,0,0,7,0,30,4,0,0,4,1,-15,3,1
2,3,19,0,30,3,10,0,13,1,30,5,3,0,8,0,30,9,4,0,13,4,30,7,6,0,13,2,30,9,0,0,9,1,-15,3,1
2,0,21,2,30,7,3,0,10,4,30,5,1,0,6,1,30,3,7,0,10,2,30,6,4,0,10,3,30,4,0,0,4,1,-15,3,1
2,4,22,2,30,8,0,0,8,3,30,2,0,0,2,0,30,3,5,0,8,0,30,3,5,0,8,1,30,3,1,0,4,1,-15,3,1
2,4,23,1,30,7,6,0,13,0,30,6,0,0,6,5,30,12,1,0,13,0,30,4,9,0,13,2,30,5,1,0,6,1,-15,3,1
2,4,8,0,30,7,0,0,7,3,30,2,0,0,2,0,30,5,2,0,7,0,30,4,3,0,7,2,30,3,0,0,3,0,-27,3,0
2,1,13,3,30,7,0,0,7,0,30,4,0,0,4,6,30,5,2,0,7,4,30,4,3,0,7,6,30,4,0,0,4,1,-15,3,1
2,2,13,3,30,7,0,0,7,0,30,4,0,0,4,6,30,5,2,0,7,4,30,4,3,0,7,6,30,4,0,0,4,1,-15,3,1
2,3,13,3,30,7,0,0,7,0,30,4,0,0,4,6,30,5,2,0,7,4,30,4,3,0,7,6,30,4,0,0,4,1,-15,3,1
2,0,19,4,30,2,11,0,13,3,30,6,2,0,8,0,30,6,7,0,13,0,30,3,10,0,13,1,30,9,0,0,9,1,-15,3,1
2,3,23,1,30,6,7,0,13,1,30,6,0,0,6,5,30,13,0,0,13,0,30,6,7,0,13,3,30,6,0,0,6,1,-15,3,1
2,2,25,0,30,5,9,0,14,5,30,5,1,0,6,0,30,6,8,0,14,1,30,6,8,0,14,4,30,5,1,0,6,1,-15,3,1
2,3,25,0,30,5,9,0,14,5,30,5,1,0,6,0,30,6,8,0,14,1,30,6,8,0,14,4,30,5,1,0,6,1,-15,3,1
2,1,27,0,30,6,9,0,15,2,30,2,0,0,2,1,30,7,8,0,15,0,30,8,7,0,15,1,30,4,2,0,6,1,-15,3,1
2,2,27,0,30,6,9,0,15,2,30,2,0,0,2,1,30,7,8,0,15,0,30,8,7,0,15,1,30,4,2,0,6,1,-15,3,1
2,0,29,1,30,8,6,0,14,6,30,8,4,0,12,0,30,3,11,0,14,0,30,1,13,0,14,3,30,9,0,0,9,1,-15,3,1
2,3,29,1,30,8,6,0,14,6,30,8,4,0,12,0,30,3,11,0,14,0,30,1,13,0,14,3,30,9,0,0,9,1,-15,3,1
2,2,39,0,30,4,7,0,11,7,30,6,0,0,6,0,30,4,7,0,11,0,30,4,7,0,11,1,30,5,0,0,5,1,-15,3,1
2,3,39,0,30,4,7,0,11,7,30,6,0,0,6,0,30,4,7,0,11,0,30,4,7,0,11,1,30,5,0,0,5,1,-15,3,1
2,2,17,3,30,10,4,0,14,2,30,6,0,0,6,0,30,8,6,0,14,2,30,5,9,0,14,3,30,4,0,0,4,1,-15,3,1
2,3,17,3,30,10,4,0,14,2,30,6,0,0,6,0,30,8,6,0,14,2,30,5,9,0,14,3,30,4,0,0,4,1,-15,3,1
2,4,17,3,30,10,4,0,14,2,30,6,0,0,6,0,30,8,6,0,14,2,30,5,9,0,14,3,30,4,0,0,4,1,-15,3,1
2,2,23,2,30,4,9,0,13,4,30,6,0,0,6,6,30,12,1,0,13,0,30,4,9,0,13,2,30,5,1,0,6,1,-15,3,1
2,4,25,1,30,6,8,0,14,4,30,6,0,0,6,0,30,6,8,0,14,1,30,10,4,0,14,4,30,5,1,0,6,1,-15,3,1
2,2,35,0,30,6,7,0,13,4,30,2,0,0,2,1,30,2,11,0,13,5,30,2,11,0,13,10,30,8,0,0,8,1,-15,3,1
2,0,38,0,30,2,8,0,10,7,30,6,0,0,6,0,30,1,9,0,10,1,30,5,5,0,10,9,30,6,0,0,6,1,-15,3,1
2,3,38,0,30,2,8,0,10,7,30,6,0,0,6,0,30,1,9,0,10,1,30,5,5,0,10,9,30,6,0,0,6,1,-15,3,1
2,0,4,2,30,7,1,0,8,5,30,4,0,0,4,0,30,2,6,0,8,2,30,8,0,0,8,1,30,2,2,0,4,0,-27,3,0
2,1,4,2,30,7,1,0,8,5,30,4,0,0,4,0,30,2,6,0,8,2,30,8,0,0,8,1,30,2,2,0,4,0,-27,3,0
2,3,4,2,30,7,1,0,8,5,30,4,0,0,4,0,30,2,6,0,8,2,30,8,0,0,8,1,30,2,2,0,4,0,-27,3,0
2,1,13,1,30,7,0,0,7,1,30,4,0,0,4,2,30,5,2,0,7,9,30,5,2,0,7,1,30,4,0,0,4,1,-15,3,1
2,2,13,1,30,7,0,0,7,1,30,4,0,0,4,2,30,5,2,0,7,9,30,5,2,0,7,1,30,4,0,0,4,1,-15,3,1
2,1,17,2,30,9,5,0,14,3,30,6,0,0,6,0,30,2,12,0,14,1,30,6,8,0,14,7,30,4,0,0,4,1,-15,3,1
2,2,19,0,30,4,9,0,13,2,30,8,0,0,8,0,30,4,9,0,13,3,30,4,9,0,13,1,30,9,0,0,9,1,-15,3,1
2,4,19,0,30,4,9,0,13,2,30,8,0,0,8,0,30,4,9,0,13,3,30,4,9,0,13,1,30,9,0,0,9,1,-15,3,1
2,1,25,0,30,7,7,0,14,4,30,6,0,0,6,0,30,8,6,0,14,1,30,6,8,0,14,4,30,6,0,0,6,1,-15,3,1
2,2,25,0,30,7,7,0,14,4,30,6,0,0,6,0,30,8,6,0,14,1,30,6,8,0,14,4,30,6,0,0,6,1,-15,3,1
2,2,35,1,30,7,6,0,13,4,30,2,0,0,2,4,30,13,0,0,13,0,30,2,11,0,13,2,30,7,1,0,8,1,-15,3,1
2,2,17,4,30,8,6,0,14,2,30,6,0,0,6,0,30,7,7,0,14,3,30,6,8,0,14,5,30,4,0,0,4,1,-15,3,1
2,1,19,0,30,4,9,0,13,1,30,6,2,0,8,0,30,5,8,0,13,0,30,4,9,0,13,0,30,7,2,0,9,1,-15,3,1
2,3,19,0,30,4,9,0,13,1,30,6,2,0,8,0,30,5,8,0,13,0,30,4,9,0,13,0,30,7,2,0,9,1,-15,3,1
2,4,23,0,30,5,8,0,13,1,30,6,0,0,6,1,30,13,0,0,13,0,30,3,10,0,13,2,30,6,0,0,6,1,-15,3,1
2,3,6,1,30,9,0,0,9,4,30,2,0,0,2,0,30,3,6,0,9,0,30,4,5,0,9,0,30,5,0,0,5,0,-27,3,0
2,2,17,3,30,8,6,0,14,1,30,6,0,0,6,0,30,9,5,0,14,1,30,6,8,0,14,5,30,4,0,0,4,1,-15,3,1
2,1,19,1,30,6,7,0,13,1,30,7,1,0,8,0,30,7,6,0,13,0,30,3,10,0,13,1,30,7,2,0,9,1,-15,3,1
2,2,19,1,30,6,7,0,13,1,30,7,1,0,8,0,30,7,6,0,13,0,30,3,10,0,13,1,30,7,2,0,9,1,-15,3,1
2,4,19,1,30,6,7,0,13,1,30,7,1,0,8,0,30,7,6,0,13,0,30,3,10,0,13,1,30,7,2,0,9,1,-15,3,1
2,4,23,1,30,8,5,0,13,0,30,6,0,0,6,3,30,13,0,0,13,0,30,4,9,0,13,2,30,5,1,0,6,1,-15,3,1
2,1,27,1,30,4,11,0,15,2,30,1,1,0,2,0,30,9,6,0,15,1,30,4,11,0,15,3,30,6,0,0,6,1,-15,3,1
2,3,27,1,30,4,11,0,15,2,30,1,1,0,2,0,30,9,6,0,15,1,30,4,11,0,15,3,30,6,0,0,6,1,-15,3,1
2,2,38,0,30,2,8,0,10,7,30,6,0,0,6,0,30,1,9,0,10,0,30,5,5,0,10,8,30,6,0,0,6,1,-15,3,1
2,3,39,0,30,4,7,0,11,7,30,6,0,0,6,0,30,5,6,0,11,4,30,2,9,0,11,3,30,5,0,0,5,1,-15,3,1
2,4,39,0,30,4,7,0,11,7,30,6,0,0,6,0,30,5,6,0,11,4,30,2,9,0,11,3,30,5,0,0,5,1,-15,3,1
2,4,43,0,30,10,4,0,14,7,30,6,0,0,6,0,30,4,10,0,14,1,30,1,13,0,14,2,30,5,0,0,5,1,-15,3,1
2,4,3,0,30,1,3,0,4,2,30,4,0,0,4,0,30,0,4,0,4,5,30,1,3,0,4,0,30,1,2,0,3,0,-27,3,0
2,4,11,0,30,1,3,0,4,1,30,0,0,0,0,0,30,0,4,0,4,3,30,3,1,0,4,0,30,1,0,0,1,1,-15,3,1
2,4,32,0,30,4,5,0,9,5,30,2,0,0,2,0,30,7,2,0,9,3,30,4,5,0,9,2,30,2,0,0,2,1,-15,3,1
2,2,35,0,30,11,2,0,13,5,30,2,0,0,2,1,30,2,11,0,13,2,30,3,10,0,13,4,30,8,0,0,8,1,-15,3,1
2,1,41,0,30,9,3,0,12,6,30,8,0,0,8,0,30,7,5,0,12,0,30,3,9,0,12,2,30,3,4,0,7,1,-15,3,1
2,4,41,0,30,9,3,0,12,6,30,8,0,0,8,0,30,7,5,0,12,0,30,3,9,0,12,2,30,3,4,0,7,1,-15,3,1
2,3,47,0,30,2,12,0,14,8,30,4,0,0,4,0,30,4,10,0,14,0,30,8,6,0,14,6,30,7,0,0,7,1,-15,3,1
2,2,6,0,30,7,2,0,9,4,30,2,0,0,2,0,30,3,6,0,9,0,30,4,5,0,9,4,30,5,0,0,5,0,-27,3,0
2,4,13,3,30,7,0,0,7,0,30,4,0,0,4,2,30,7,0,0,7,11,30,7,0,0,7,3,30,4,0,0,4,1,-15,3,1
2,4,23,1,30,3,10,0,13,3,30,6,0,0,6,6,30,12,1,0,13,2,30,5,8,0,13,1,30,6,0,0,6,1,-15,3,1
2,4,25,2,30,9,5,0,14,4,30,6,0,0,6,0,30,7,7,0,14,1,30,5,9,0,14,4,30,5,1,0,6,1,-15,3,1
2,0,27,1,30,4,11,0,15,4,30,2,0,0,2,0,30,3,12,0,15,2,30,4,11,0,15,4,30,6,0,0,6,1,-15,3,1
2,1,27,1,30,4,11,0,15,4,30,2,0,0,2,0,30,3,12,0,15,2,30,4,11,0,15,4,30,6,0,0,6,1,-15,3,1
2,2,27,1,30,4,11,0,15,4,30,2,0,0,2,0,30,3,12,0,15,2,30,4,11,0,15,4,30,6,0,0,6,1,-15,3,1
2,3,27,1,30,4,11,0,15,4,30,2,0,0,2,0,30,3,12,0,15,2,30,4,11,0,15,4,30,6,0,0,6,1,-15,3,1
2,1,13,6,30,7,0,0,7,0,30,4,0,0,4,2,30,7,0,0,7,3,30,6,1,0,7,6,30,4,0,0,4,1,-15,3,1
2,3,13,6,30,7,0,0,7,0,30,4,0,0,4,2,30,7,0,0,7,3,30,6,1,0,7,6,30,4,0,0,4,1,-15,3,1
2,4,13,6,30,7,0,0,7,0,30,4,0,0,4,2,30,7,0,0,7,3,30,6,1,0,7,6,30,4,0,0,4,1,-15,3,1
2,1,19,0,30,3,10,0,13,1,30,7,1,0,8,0,30,7,6,0,13,0,30,6,7,0,13,1,30,6,3,0,9,1,-15,3,1
2,4,22,3,30,8,0,0,8,3,30,2,0,0,2,0,30,3,5,0,8,1,30,1,7,0,8,2,30,4,0,0,4,1,-15,3,1
2,2,29,0,30,10,4,0,14,5,30,8,4,0,12,0,30,3,11,0,14,0,30,0,14,0,14,1,30,9,0,0,9,1,-15,3,1
2,3,29,0,30,10,4,0,14,5,30,8,4,0,12,0,30,3,11,0,14,0,30,0,14,0,14,1,30,9,0,0,9,1,-15,3,1
2,4,29,0,30,10,4,0,14,5,30,8,4,0,12,0,30,3,11,0,14,0,30,0,14,0,14,1,30,9,0,0,9,1,-15,3,1
2,3,32,0,30,7,2,0,9,4,30,2,0,0,2,3,30,9,0,0,9,1,30,2,7,0,9,1,30,2,0,0,2,1,-15,3,1
2,1,5,0,30,5,0,0,5,3,30,0,4,0,4,0,30,0,5,0,5,0,30,1,4,0,5,0,30,0,2,0,2,0,-27,3,0
2,2,5,0,30,5,0,0,5,3,30,0,4,0,4,0,30,0,5,0,5,0,30,1,4,0,5,0,30,0,2,0,2,0,-27,3,0
2,4,5,0,30,5,0,0,5,3,30,0,4,0,4,0,30,0,5,0,5,0,30,1,4,0,5,0,30,0,2,0,2,0,-27,3,0
2,3,8,2,30,7,0,0,7,4,30,2,0,0,2,0,30,2,5,0,7,0,30,7,0,0,7,2,30,3,0,0,3,0,-27,3,0
2,4,8,2,30,7,0,0,7,4,30,2,0,0,2,0,30,2,5,0,7,0,30,7,0,0,7,2,30,3,0,0,3,0,-27,3,0
2,4,13,1,30,3,0,0,3,1,30,2,0,0,2,0,30,3,0,0,3,4,30,2,1,0,3,2,30,2,0,0,2,1,-15,3,1
2,4,15,0,30,4,9,0,13,1,30,6,0,0,6,0,30,3,10,0,13,1,30,3,10,0,13,2,30,8,1,0,9,1,-15,3,1
2,2,17,2,30,8,6,0,14,2,30,6,0,0,6,0,30,6,8,0,14,1,30,5,9,0,14,4,30,4,0,0,4,1,-15,3,1
2,3,17,2,30,8,6,0,14,2,30,6,0,0,6,0,30,6,8,0,14,1,30,5,9,0,14,4,30,4,0,0,4,1,-15,3,1
2,4,19,0,30,4,9,0,13,0,30,4,4,0,8,0,30,4,9,0,13,13,30,4,9,0,13,0,30,8,1,0,9,1,-15,3,1
2,3,22,3,30,8,0,0,8,3,30,2,0,0,2,0,30,4,4,0,8,0,30,4,4,0,8,0,30,1,3,0,4,1,-15,3,1
2,3,23,2,30,9,4,0,13,2,30,6,0,0,6,1,30,12,1,0,13,0,30,5,8,0,13,1,30,5,1,0,6,1,-15,3,1
2,2,25,1,30,5,9,0,14,3,30,6,0,0,6,0,30,7,7,0,14,2,30,10,4,0,14,4,30,6,0,0,6,1,-15,3,1
2,3,25,1,30,5,9,0,14,3,30,6,0,0,6,0,30,7,7,0,14,2,30,10,4,0,14,4,30,6,0,0,6,1,-15,3,1
2,3,27,2,30,6,9,0,15,0,30,1,1,0,2,0,30,6,9,0,15,0,30,5,10,0,15,0,30,5,1,0,6,1,-15,3,1
2,4,27,2,30,6,9,0,15,0,30,1,1,0,2,0,30,6,9,0,15,0,30,5,10,0,15,0,30,5,1,0,6,1,-15,3,1
2,4,29,0,30,8,6,0,14,5,30,12,0,0,12,1,30,8,6,0,14,0,30,0,14,0,14,0,30,9,0,0,9,1,-15,3,1
2,2,31,1,30,8,4,0,12,4,30,8,0,0,8,3,30,8,4,0,12,0,30,3,9,0,12,1,30,3,3,0,6,1,-15,3,1
2,4,31,1,30,8,4,0,12,4,30,8,0,0,8,3,30,8,4,0,12,0,30,3,9,0,12,0,30,3,3,0,6,1,-15,3,1
2,0,4,2,30,7,1,0,8,4,30,2,2,0,4,4,30,2,6,0,8,0,30,8,0,0,8,2,30,4,0,0,4,0,-27,3,0
2,3,5,0,30,2,3,0,5,1,30,0,4,0,4,0,30,0,5,0,5,0,30,1,4,0,5,0,30,1,1,0,2,0,-27,3,0
2,2,13,1,30,5,2,0,7,0,30,4,0,0,4,2,30,7,0,0,7,7,30,6,1,0,7,4,30,4,0,0,4,1,-15,3,1
2,4,13,1,30,5,2,0,7,0,30,4,0,0,4,2,30,7,0,0,7,7,30,6,1,0,7,4,30,4,0,0,4,1,-15,3,1
2,2,17,3,30,9,5,0,14,4,30,6,0,0,6,0,30,3,11,0,14,5,30,6,8,0,14,3,30,4,0,0,4,1,-15,3,1
2,2,19,0,30,5,8,0,13,2,30,4,4,0,8,0,30,4,9,0,13,7,30,4,9,0,13,1,30,8,1,0,9,1,-15,3,1
2,1,26,0,30,8,1,0,9,5,30,4,0,0,4,5,30,0,9,0,9,0,30,2,7,0,9,7,30,3,0,0,3,1,-15,3,1
2,2,26,0,30,8,1,0,9,5,30,4,0,0,4,5,30,0,9,0,9,0,30,2,7,0,9,7,30,3,0,0,3,1,-15,3,1
2,2,27,0,30,5,10,0,15,2,30,1,1,0,2,0,30,6,9,0,15,0,30,4,11,0,15,3,30,6,0,0,6,1,-15,3,1
2,2,38,0,30,3,7,0,10,7,30,6,0,0,6,0,30,1,9,0,10,3,30,1,9,0,10,7,30,6,0,0,6,1,-15,3,1
2,3,38,0,30,3,7,0,10,7,30,6,0,0,6,0,30,1,9,0,10,3,30,1,9,0,10,7,30,6,0,0,6,1,-15,3,1
2,4,1,2,30,5,5,0,10,4,30,2,0,0,2,1,30,4,6,0,10,2,30,8,2,0,10,6,30,6,0,0,6,0,-27,3,0
2,2,4,2,30,6,2,0,8,5,30,3,1,0,4,0,30,2,6,0,8,0,30,5,3,0,8,3,30,4,0,0,4,0,-27,3,0
2,3,4,2,30,6,2,0,8,5,30,3,1,0,4,0,30,2,6,0,8,0,30,5,3,0,8,3,30,4,0,0,4,0,-27,3,0
2,4,4,2,30,6,2,0,8,5,30,3,1,0,4,0,30,2,6,0,8,0,30,5,3,0,8,3,30,4,0,0,4,0,-27,3,0
2,2,6,0,30,4,5,0,9,4,30,2,0,0,2,0,30,2,7,0,9,0,30,5,4,0,9,2,30,5,0,0,5,0,-27,3,0
2,4,6,0,30,4,5,0,9,4,30,2,0,0,2,0,30,2,7,0,9,0,30,5,4,0,9,2,30,5,0,0,5,0,-27,3,0
2,1,13,6,30,3,0,0,3,2,30,2,0,0,2,1,30,3,0,0,3,4,30,2,1,0,3,2,30,2,0,0,2,1,-15,3,1
2,3,13,1,30,7,0,0,7,0,30,4,0,0,4,3,30,7,0,0,7,5,30,6,1,0,7,4,30,4,0,0,4,1,-15,3,1
2,4,17,1,30,8,6,0,14,2,30,6,0,0,6,0,30,7,7,0,14,3,30,6,8,0,14,5,30,4,0,0,4,1,-15,3,1
2,4,25,1,30,8,6,0,14,3,30,6,0,0,6,0,30,6,8,0,14,1,30,5,9,0,14,4,30,5,1,0,6,1,-15,3,1
2,0,27,1,30,4,11,0,15,3,30,2,0,0,2,0,30,6,9,0,15,2,30,4,11,0,15,5,30,6,0,0,6,1,-15,3,1
2,2,27,1,30,4,11,0,15,3,30,2,0,0,2,0,30,6,9,0,15,2,30,4,11,0,15,5,30,6,0,0,6,1,-15,3,1
2,1,3,2,30,4,7,0,11,3,30,7,1,0,8,2,30,4,7,0,11,9,30,3,8,0,11,2,30,2,5,0,7,0,-27,3,0
2,0,5,1,30,2,3,0,5,3,30,1,3,0,4,0,30,1,4,0,5,0,30,1,4,0,5,0,30,0,2,0,2,0,-27,3,0
2,3,5,1,30,2,3,0,5,3,30,1,3,0,4,0,30,1,4,0,5,0,30,1,4,0,5,0,30,0,2,0,2,0,-27,3,0
2,2,8,1,30,7,0,0,7,4,30,2,0,0,2,0,30,2,5,0,7,1,30,7,0,0,7,5,30,3,0,0,3,0,-27,3,0
2,4,8,1,30,7,0,0,7,4,30,2,0,0,2,0,30,2,5,0,7,1,30,7,0,0,7,5,30,3,0,0,3,0,-27,3,0
2,2,9,0,30,6,5,0,11,2,30,6,0,0,6,1,30,7,4,0,11,6,30,3,8,0,11,4,30,4,0,0,4,0,-27,3,0
2,0,17,4,30,11,3,0,14,2,30,6,0,0,6,0,30,5,9,0,14,3,30,7,7,0,14,6,30,4,0,0,4,1,-15,3,1
2,2,17,4,30,11,3,0,14,2,30,6,0,0,6,0,30,5,9,0,14,3,30,7,7,0,14,6,30,4,0,0,4,1,-15,3,1
2,3,17,4,30,11,3,0,14,2,30,6,0,0,6,0,30,5,9,0,14,3,30,7,7,0,14,6,30,4,0,0,4,1,-15,3,1
2,4,17,4,30,11,3,0,14,2,30,6,0,0,6,0,30,5,9,0,14,3,30,7,7,0,14,6,30,4,0,0,4,1,-15,3,1
2,4,22,1,30,6,2,0,8,3,30,2,0,0,2,3,30,4,4,0,8,1,30,4,4,0,8,1,30,1,3,0,4,1,-15,3,1
2,1,23,1,30,6,7,0,13,2,30,6,0,0,6,5,30,12,1,0,13,0,30,6,7,0,13,1,30,5,1,0,6,1,-15,3,1
2,0,25,1,30,6,8,0,14,4,30,6,0,0,6,0,30,9,5,0,14,1,30,5,9,0,14,3,30,5,1,0,6,1,-15,3,1
2,2,25,0,30,6,8,0,14,4,30,6,0,0,6,0,30,9,5,0,14,1,30,5,9,0,14,3,30,5,1,0,6,1,-15,3,1
2,2,29,0,30,6,8,0,14,6,30,10,2,0,12,0,30,3,11,0,14,0,30,8,6,0,14,3,30,9,0,0,9,1,-15,3,1
2,3,29,0,30,6,8,0,14,6,30,10,2,0,12,0,30,3,11,0,14,0,30,8,6,0,14,3,30,9,0,0,9,1,-15,3,1
2,2,39,2,30,3,8,0,11,5,30,6,0,0,6,0,30,11,0,0,11,0,30,2,9,0,11,2,30,4,1,0,5,1,-15,3,1
2,2,4,2,30,6,2,0,8,5,30,4,0,0,4,1,30,1,7,0,8,0,30,5,3,0,8,1,30,4,0,0,4,0,-27,3,0
2,1,19,0,30,6,7,0,13,1,30,6,2,0,8,0,30,5,8,0,13,4,30,6,7,0,13,1,30,9,0,0,9,1,-15,3,1
2,2,19,0,30,6,7,0,13,1,30,6,2,0,8,0,30,5,8,0,13,4,30,6,7,0,13,1,30,9,0,0,9,1,-15,3,1
2,4,22,3,30,8,0,0,8,2,30,2,0,0,2,0,30,4,4,0,8,1,30,2,6,0,8,1,30,2,2,0,4,1,-15,3,1
2,0,27,1,30,3,12,0,15,3,30,2,0,0,2,0,30,5,10,0,15,2,30,5,10,0,15,6,30,6,0,0,6,1,-15,3,1
2,3,27,1,30,3,12,0,15,3,30,2,0,0,2,0,30,5,10,0,15,2,30,5,10,0,15,6,30,6,0,0,6,1,-15,3,1
2,4,29,0,30,5,9,0,14,5,30,7,5,0,12,0,30,8,6,0,14,0,30,2,12,0,14,0,30,9,0,0,9,1,-15,3,1
2,1,17,4,30,10,4,0,14,3,30,6,0,0,6,0,30,5,9,0,14,1,30,7,7,0,14,6,30,4,0,0,4,1,-15,3,1
2,3,19,0,30,4,9,0,13,2,30,6,2,0,8,0,30,4,9,0,13,5,30,4,9,0,13,2,30,9,0,0,9,1,-15,3,1
2,3,23,1,30,6,7,0,13,2,30,6,0,0,6,3,30,13,0,0,13,2,30,6,7,0,13,3,30,5,1,0,6,1,-15,3,1
2,4,23,1,30,6,7,0,13,2,30,6,0,0,6,3,30,13,0,0,13,2,30,6,7,0,13,3,30,5,1,0,6,1,-15,3,1
2,1,25,2,30,7,7,0,14,3,30,6,0,0,6,0,30,8,6,0,14,1,30,5,9,0,14,4,30,5,1,0,6,1,-15,3,1
2,2,25,2,30,7,7,0,14,3,30,6,0,0,6,0,30,8,6,0,14,1,30,5,9,0,14,4,30,5,1,0,6,1,-15,3,1
2,0,27,1,30,4,11,0,15,5,30,1,1,0,2,0,30,3,12,0,15,2,30,6,9,0,15,3,30,6,0,0,6,1,-15,3,1
2,1,4,3,30,8,0,0,8,4,30,4,0,0,4,0,30,2,6,0,8,0,30,4,4,0,8,1,30,4,0,0,4,0,-27,3,0
2,4,4,0,30,8,0,0,8,4,30,4,0,0,4,0,30,2,6,0,8,0,30,4,4,0,8,1,30,4,0,0,4,0,-27,3,0
2,4,8,1,30,7,0,0,7,4,30,2,0,0,2,6,30,4,3,0,7,0,30,6,1,0,7,0,30,3,0,0,3,0,-27,3,0
2,1,13,0,30,3,0,0,3,0,30,2,0,0,2,1,30,3,0,0,3,8,30,2,1,0,3,5,30,2,0,0,2,1,-15,3,1
2,2,13,0,30,3,0,0,3,0,30,2,0,0,2,1,30,3,0,0,3,8,30,2,1,0,3,5,30,2,0,0,2,1,-15,3,1
2,2,13,3,30,6,1,0,7,0,30,4,0,0,4,1,30,7,0,0,7,8,30,6,1,0,7,4,30,4,0,0,4,1,-15,3,1
2,3,15,1,30,5,8,0,13,1,30,6,0,0,6,0,30,3,10,0,13,1,30,2,11,0,13,2,30,9,0,0,9,1,-15,3,1
2,1,17,2,30,8,6,0,14,3,30,6,0,0,6,0,30,7,7,0,14,5,30,6,8,0,14,3,30,4,0,0,4,1,-15,3,1
2,2,17,2,30,8,6,0,14,3,30,6,0,0,6,0,30,7,7,0,14,5,30,6,8,0,14,3,30,4,0,0,4,1,-15,3,1
2,1,19,0,30,4,9,0,13,0,30,7,1,0,8,4,30,6,7,0,13,4,30,4,9,0,13,0,30,7,2,0,9,1,-15,3,1
2,4,19,0,30,4,9,0,13,0,30,7,1,0,8,4,30,6,7,0,13,4,30,4,9,0,13,0,30,7,2,0,9,1,-15,3,1
2,4,25,0,30,9,5,0,14,2,30,6,0,0,6,0,30,7,7,0,14,0,30,5,9,0,14,4,30,5,1,0,6,1,-15,3,1
2,4,27,1,30,3,12,0,15,4,30,2,0,0,2,0,30,6,9,0,15,3,30,6,9,0,15,3,30,6,0,0,6,1,-15,3,1
2,4,31,0,30,5,7,0,12,5,30,8,0,0,8,5,30,8,4,0,12,0,30,3,9,0,12,2,30,5,1,0,6,1,-15,3,1
2,0,4,3,30,8,0,0,8,5,30,4,0,0,4,0,30,2,6,0,8,2,30,6,2,0,8,1,30,3,1,0,4,0,-27,3,0
2,1,4,3,30,8,0,0,8,5,30,4,0,0,4,0,30,2,6,0,8,2,30,6,2,0,8,1,30,3,1,0,4,0,-27,3,0
2,2,4,3,30,8,0,0,8,5,30,4,0,0,4,0,30,2,6,0,8,2,30,6,2,0,8,1,30,3,1,0,4,0,-27,3,0
2,3,4,3,30,8,0,0,8,5,30,4,0,0,4,0,30,2,6,0,8,2,30,6,2,0,8,1,30,3,1,0,4,0,-27,3,0
2,4,4,3,30,8,0,0,8,5,30,4,0,0,4,0,30,2,6,0,8,2,30,6,2,0,8,1,30,3,1,0,4,0,-27,3,0
2,2,17,3,30,9,5,0,14,2,30,6,0,0,6,0,30,8,6,0,14,2,30,5,9,0,14,1,30,4,0,0,4,1,-15,3,1
2,2,19,0,30,3,10,0,13,2,30,4,4,0,8,0,30,4,9,0,13,0,30,8,5,0,13,1,30,8,1,0,9,1,-15,3,1
2,3,27,1,30,7,8,0,15,4,30,1,1,0,2,0,30,4,11,0,15,0,30,5,10,0,15,6,30,6,0,0,6,1,-15,3,1
2,4,27,1,30,7,8,0,15,4,30,1,1,0,2,0,30,4,11,0,15,0,30,5,10,0,15,6,30,6,0,0,6,1,-15,3,1
2,2,29,0,30,10,4,0,14,6,30,7,5,0,12,0,30,2,12,0,14,0,30,2,12,0,14,6,30,9,0,0,9,1,-15,3,1
2,3,29,0,30,10,4,0,14,6,30,7,5,0,12,0,30,2,12,0,14,0,30,2,12,0,14,6,30,9,0,0,9,1,-15,3,1
2,4,29,0,30,10,4,0,14,6,30,7,5,0,12,0,30,2,12,0,14,0,30,2,12,0,14,6,30,9,0,0,9,1,-15,3,1
2,2,31,1,30,1,11,0,12,7,30,8,0,0,8,3,30,6,6,0,12,0,30,11,1,0,12,2,30,6,0,0,6,1,-15,3,1
2,2,35,0,30,8,5,0,13,5,30,2,0,0,2,1,30,4,9,0,13,1,30,4,9,0,13,5,30,8,0,0,8,1,-15,3,1
2,4,35,0,30,8,5,0,13,5,30,2,0,0,2,1,30,4,9,0,13,1,30,4,9,0,13,5,30,8,0,0,8,1,-15,3,1
2,4,8,2,30,7,0,0,7,4,30,2,0,0,2,4,30,2,5,0,7,0,30,6,1,0,7,0,30,3,0,0,3,0,-27,3,0
2,1,13,3,30,7,0,0,7,0,30,4,0,0,4,2,30,7,0,0,7,9,30,6,1,0,7,5,30,4,0,0,4,1,-15,3,1
2,4,13,3,30,7,0,0,7,0,30,4,0,0,4,2,30,7,0,0,7,9,30,6,1,0,7,5,30,4,0,0,4,1,-15,3,1
2,2,17,2,30,10,4,0,14,3,30,6,0,0,6,0,30,5,9,0,14,5,30,5,9,0,14,1,30,3,1,0,4,1,-15,3,1
2,1,19,0,30,3,10,0,13,2,30,6,2,0,8,0,30,7,6,0,13,2,30,4,9,0,13,2,30,8,1,0,9,1,-15,3,1
2,2,19,0,30,3,10,0,13,2,30,6,2,0,8,0,30,7,6,0,13,2,30,4,9,0,13,2,30,8,1,0,9,1,-15,3,1
2,4,19,0,30,3,10,0,13,0,30,6,2,0,8,0,30,7,6,0,13,2,30,4,9,0,13,2,30,8,1,0,9,1,-15,3,1
2,2,25,2,30,5,9,0,14,1,30,6,0,0,6,0,30,13,1,0,14,1,30,5,9,0,14,4,30,5,1,0,6,1,-15,3,1
2,3,25,2,30,5,9,0,14,1,30,6,0,0,6,0,30,13,1,0,14,1,30,5,9,0,14,4,30,5,1,0,6,1,-15,3,1
2,4,25,2,30,5,9,0,14,1,30,6,0,0,6,0,30,13,1,0,14,1,30,5,9,0,14,4,30,5,1,0,6,1,-15,3,1
2,2,27,1,30,4,11,0,15,4,30,2,0,0,2,0,30,6,9,0,15,0,30,4,11,0,15,3,30,6,0,0,6,1,-15,3,1
2,4,27,1,30,4,11,0,15,4,30,2,0,0,2,0,30,6,9,0,15,0,30,4,11,0,15,3,30,6,0,0,6,1,-15,3,1
2,2,4,2,30,6,2,0,8,5,30,4,0,0,4,0,30,1,7,0,8,1,30,7,1,0,8,1,30,3,1,0,4,0,-27,3,0
2,4,11,0,30,5,7,0,12,1,30,4,0,0,4,0,30,6,6,0,12,6,30,6,6,0,12,5,30,4,0,0,4,1,-15,3,1
2,1,19,0,30,4,9,0,13,3,30,4,4,0,8,5,30,5,8,0,13,2,30,5,8,0,13,2,30,9,0,0,9,1,-15,3,1
2,2,19,0,30,4,9,0,13,3,30,4,4,0,8,5,30,5,8,0,13,2,30,5,8,0,13,2,30,9,0,0,9,1,-15,3,1
2,4,19,0,30,4,9,0,13,3,30,4,4,0,8,5,30,5,8,0,13,2,30,5,8,0,13,2,30,9,0,0,9,1,-15,3,1
2,2,23,1,30,5,8,0,13,4,30,6,0,0,6,5,30,9,4,0,13,0,30,6,7,0,13,3,30,6,0,0,6,1,-15,3,1
2,3,23,1,30,5,8,0,13,4,30,6,0,0,6,5,30,9,4,0,13,0,30,6,7,0,13,3,30,6,0,0,6,1,-15,3,1
2,3,27,0,30,6,9,0,15,2,30,2,0,0,2,0,30,6,9,0,15,0,30,6,9,0,15,0,30,4,2,0,6,1,-15,3,1
2,4,29,0,30,9,5,0,14,6,30,10,2,0,12,0,30,3,11,0,14,0,30,1,13,0,14,6,30,9,0,0,9,1,-15,3,1
2,4,6,1,30,9,0,0,9,4,30,2,0,0,2,0,30,2,7,0,9,0,30,3,6,0,9,1,30,5,0,0,5,0,-27,3,0
2,4,8,0,30,7,0,0,7,3,30,2,0,0,2,2,30,4,3,0,7,1,30,7,0,0,7,2,30,3,0,0,3,0,-27,3,0
2,2,13,2,30,6,1,0,7,0,30,4,0,0,4,2,30,6,1,0,7,4,30,6,1,0,7,3,30,4,0,0,4,1,-15,3,1
2,3,13,2,30,6,1,0,7,0,30,4,0,0,4,2,30,6,1,0,7,4,30,6,1,0,7,3,30,4,0,0,4,1,-15,3,1
2,4,13,2,30,6,1,0,7,0,30,4,0,0,4,2,30,6,1,0,7,4,30,6,1,0,7,3,30,4,0,0,4,1,-15,3,1
2,4,15,1,30,7,6,0,13,1,30,6,0,0,6,0,30,3,10,0,13,1,30,6,7,0,13,2,30,5,4,0,9,1,-15,3,1
2,2,19,0,30,4,9,0,13,2,30,7,1,0,8,2,30,4,9,0,13,0,30,6,7,0,13,1,30,7,2,0,9,1,-15,3,1
2,0,27,1,30,6,9,0,15,1,30,1,1,0,2,0,30,3,12,0,15,0,30,6,9,0,15,5,30,6,0,0,6,1,-15,3,1
2,3,27,1,30,6,9,0,15,1,30,1,1,0,2,0,30,3,12,0,15,0,30,6,9,0,15,5,30,6,0,0,6,1,-15,3,1
2,4,27,1,30,6,9,0,15,1,30,1,1,0,2,0,30,3,12,0,15,0,30,6,9,0,15,5,30,6,0,0,6,1,-15,3,1
2,2,33,1,30,5,6,0,11,4,30,4,0,0,4,0,30,9,2,0,11,0,30,3,8,0,11,5,30,4,0,0,4,1,-15,3,1
2,4,45,0,30,11,2,0,13,10,30,10,0,0,10,0,30,2,11,0,13,0,30,4,9,0,13,5,30,5,0,0,5,1,-15,3,1
2,0,5,0,30,2,3,0,5,3,30,0,4,0,4,0,30,0,5,0,5,1,30,1,4,0,5,3,30,2,0,0,2,0,-27,3,0
2,4,8,0,30,7,0,0,7,4,30,2,0,0,2,3,30,3,4,0,7,1,30,7,0,0,7,0,30,3,0,0,3,0,-27,3,0
2,4,11,6,30,4,8,0,12,0,30,4,0,0,4,0,30,10,2,0,12,1,30,4,8,0,12,3,30,4,0,0,4,1,-15,3,1
2,1,19,0,30,3,10,0,13,2,30,7,1,0,8,0,30,4,9,0,13,2,30,3,10,0,13,3,30,9,0,0,9,1,-15,3,1
2,0,27,1,30,4,11,0,15,5,30,2,0,0,2,5,30,3,12,0,15,2,30,3,12,0,15,1,30,6,0,0,6,1,-15,3,1
2,1,27,1,30,4,11,0,15,5,30,2,0,0,2,5,30,3,12,0,15,2,30,3,12,0,15,1,30,6,0,0,6,1,-15,3,1
2,4,27,1,30,4,11,0,15,5,30,2,0,0,2,5,30,3,12,0,15,2,30,3,12,0,15,0,30,6,0,0,6,1,-15,3,1
2,0,29,0,30,7,7,0,14,6,30,12,0,0,12,0,30,5,9,0,14,0,30,1,13,0,14,0,30,9,0,0,9,1,-15,3,1
2,1,29,0,30,7,7,0,14,6,30,12,0,0,12,0,30,5,9,0,14,0,30,1,13,0,14,0,30,9,0,0,9,1,-15,3,1
2,2,29,0,30,7,7,0,14,6,30,12,0,0,12,0,30,5,9,0,14,0,30,1,13,0,14,0,30,9,0,0,9,1,-15,3,1
2,0,33,2,30,3,8,0,11,5,30,4,0,0,4,1,30,10,1,0,11,0,30,5,6,0,11,5,30,4,0,0,4,1,-15,3,1
2,3,33,0,30,3,8,0,11,5,30,4,0,0,4,1,30,10,1,0,11,0,30,5,6,0,11,5,30,4,0,0,4,1,-15,3,1
2,0,5,0,30,2,3,0,5,3,30,0,4,0,4,0,30,1,4,0,5,3,30,1,4,0,5,0,30,0,2,0,2,0,-27,3,0
2,4,5,0,30,2,3,0,5,3,30,0,4,0,4,0,30,1,4,0,5,2,30,1,4,0,5,0,30,0,2,0,2,0,-27,3,0
2,3,17,3,30,10,4,0,14,2,30,6,0,0,6,0,30,5,9,0,14,6,30,5,9,0,14,8,30,4,0,0,4,1,-15,3,1
2,2,19,0,30,3,10,0,13,0,30,4,4,0,8,0,30,5,8,0,13,4,30,6,7,0,13,2,30,9,0,0,9,1,-15,3,1
2,3,23,1,30,7,6,0,13,2,30,6,0,0,6,0,30,12,1,0,13,0,30,5,8,0,13,2,30,5,1,0,6,1,-15,3,1
2,2,25,1,30,1,13,0,14,4,30,6,0,0,6,0,30,10,4,0,14,2,30,8,6,0,14,3,30,6,0,0,6,1,-15,3,1
2,3,25,1,30,1,13,0,14,4,30,6,0,0,6,0,30,10,4,0,14,2,30,8,6,0,14,3,30,6,0,0,6,1,-15,3,1
2,4,25,1,30,1,13,0,14,4,30,6,0,0,6,0,30,10,4,0,14,2,30,8,6,0,14,3,30,6,0,0,6,1,-15,3,1
2,0,27,1,30,5,10,0,15,3,30,2,0,0,2,0,30,6,9,0,15,4,30,5,10,0,15,1,30,6,0,0,6,1,-15,3,1
2,1,27,1,30,5,10,0,15,3,30,2,0,0,2,0,30,6,9,0,15,4,30,5,10,0,15,1,30,6,0,0,6,1,-15,3,1
2,3,27,1,30,5,10,0,15,3,30,2,0,0,2,0,30,6,9,0,15,4,30,5,10,0,15,0,30,6,0,0,6,1,-15,3,1
2,4,29,0,30,4,10,0,14,6,30,12,0,0,12,0,30,2,12,0,14,0,30,1,13,0,14,2,30,9,0,0,9,1,-15,3,1
2,3,31,5,30,7,5,0,12,4,30,7,1,0,8,6,30,11,1,0,12,0,30,3,9,0,12,0,30,2,4,0,6,1,-15,3,1
2,2,43,3,30,5,9,0,14,7,30,6,0,0,6,0,30,4,10,0,14,1,30,2,12,0,14,2,30,5,0,0,5,1,-15,3,1
2,3,43,3,30,5,9,0,14,7,30,6,0,0,6,0,30,4,10,0,14,1,30,2,12,0,14,2,30,5,0,0,5,1,-15,3,1
2,3,7,0,30,1,3,0,4,2,30,2,0,0,2,0,30,1,3,0,4,2,30,2,2,0,4,1,30,2,0,0,2,0,-27,3,0
2,4,7,0,30,1,3,0,4,2,30,2,0,0,2,0,30,1,3,0,4,2,30,2,2,0,4,1,30,2,0,0,2,0,-27,3,0
2,3,17,3,30,9,5,0,14,3,30,6,0,0,6,0,30,3,11,0,14,2,30,7,7,0,14,5,30,4,0,0,4,1,-15,3,1
2,4,17,3,30,9,5,0,14,3,30,6,0,0,6,0,30,3,11,0,14,2,30,7,7,0,14,5,30,4,0,0,4,1,-15,3,1
2,1,19,0,30,7,6,0,13,2,30,6,2,0,8,7,30,4,9,0,13,0,30,6,7,0,13,0,30,8,1,0,9,1,-15,3,1
2,3,19,0,30,7,6,0,13,2,30,6,2,0,8,7,30,4,9,0,13,0,30,6,7,0,13,0,30,8,1,0,9,1,-15,3,1
2,4,25,1,30,4,10,0,14,4,30,6,0,0,6,0,30,5,9,0,14,2,30,6,8,0,14,3,30,5,1,0,6,1,-15,3,1
2,3,27,1,30,6,9,0,15,5,30,2,0,0,2,0,30,5,10,0,15,5,30,4,11,0,15,1,30,5,1,0,6,1,-15,3,1
2,4,29,0,30,4,10,0,14,5,30,12,0,0,12,0,30,6,8,0,14,0,30,1,13,0,14,1,30,9,0,0,9,1,-15,3,1
2,2,36,0,30,5,4,0,9,4,30,2,0,0,2,1,30,8,1,0,9,1,30,1,8,0,9,6,30,3,0,0,3,1,-15,3,1
2,3,5,0,30,2,3,0,5,3,30,2,2,0,4,0,30,0,5,0,5,1,30,2,3,0,5,0,30,0,2,0,2,0,-27,3,0
2,4,7,1,30,8,1,0,9,3,30,4,0,0,4,2,30,6,3,0,9,4,30,3,6,0,9,1,30,4,2,0,6,0,-27,3,0
2,4,8,3,30,7,0,0,7,3,30,2,0,0,2,0,30,3,4,0,7,0,30,4,3,0,7,0,30,3,0,0,3,0,-27,3,0
2,4,9,7,30,2,2,0,4,4,30,2,0,0,2,0,30,4,0,0,4,0,30,1,3,0,4,0,30,1,0,0,1,0,-27,3,0
2,1,13,1,30,5,2,0,7,0,30,4,0,0,4,2,30,7,0,0,7,11,30,7,0,0,7,4,30,4,0,0,4,1,-15,3,1
2,4,13,1,30,5,2,0,7,0,30,4,0,0,4,2,30,7,0,0,7,11,30,7,0,0,7,4,30,4,0,0,4,1,-15,3,1
2,4,15,1,30,4,9,0,13,1,30,6,0,0,6,0,30,3,10,0,13,1,30,3,10,0,13,3,30,8,1,0,9,1,-15,3,1
2,2,25,1,30,7,7,0,14,3,30,6,0,0,6,0,30,7,7,0,14,2,30,8,6,0,14,4,30,6,0,0,6,1,-15,3,1
2,1,27,1,30,5,10,0,15,5,30,2,0,0,2,0,30,3,12,0,15,2,30,6,9,0,15,4,30,6,0,0,6,1,-15,3,1
2,2,27,1,30,5,10,0,15,5,30,2,0,0,2,0,30,3,12,0,15,2,30,6,9,0,15,4,30,6,0,0,6,1,-15,3,1
2,1,29,0,30,7,7,0,14,5,30,12,0,0,12,0,30,6,8,0,14,0,30,1,13,0,14,0,30,9,0,0,9,1,-15,3,1
2,4,29,0,30,7,7,0,14,5,30,12,0,0,12,0,30,6,8,0,14,0,30,1,13,0,14,0,30,9,0,0,9,1,-15,3,1
2,2,31,1,30,7,5,0,12,4,30,8,0,0,8,3,30,10,2,0,12,0,30,3,9,0,12,1,30,4,2,0,6,1,-15,3,1
2,2,4,3,30,8,0,0,8,4,30,4,0,0,4,0,30,2,6,0,8,0,30,3,5,0,8,3,30,4,0,0,4,0,-27,3,0
2,2,5,0,30,1,4,0,5,3,30,3,1,0,4,0,30,0,5,0,5,0,30,1,4,0,5,0,30,2,0,0,2,0,-27,3,0
2,1,19,0,30,7,6,0,13,1,30,4,4,0,8,0,30,4,9,0,13,8,30,5,8,0,13,0,30,9,0,0,9,1,-15,3,1
2,2,21,2,30,8,2,0,10,4,30,6,0,0,6,1,30,3,7,0,10,2,30,5,5,0,10,2,30,4,0,0,4,1,-15,3,1
2,3,21,2,30,8,2,0,10,4,30,6,0,0,6,1,30,3,7,0,10,2,30,5,5,0,10,2,30,4,0,0,4,1,-15,3,1
2,4,23,2,30,8,5,0,13,0,30,6,0,0,6,5,30,10,3,0,13,0,30,4,9,0,13,1,30,6,0,0,6,1,-15,3,1
2,3,25,0,30,4,10,0,14,3,30,6,0,0,6,0,30,10,4,0,14,1,30,4,10,0,14,4,30,5,1,0,6,1,-15,3,1
2,0,27,1,30,4,11,0,15,5,30,2,0,0,2,0,30,3,12,0,15,0,30,6,9,0,15,5,30,6,0,0,6,1,-15,3,1
2,4,27,1,30,4,11,0,15,5,30,2,0,0,2,0,30,3,12,0,15,0,30,6,9,0,15,5,30,6,0,0,6,1,-15,3,1
2,0,29,0,30,8,6,0,14,6,30,10,2,0,12,0,30,4,10,0,14,0,30,1,13,0,14,4,30,9,0,0,9,1,-15,3,1
2,1,29,0,30,8,6,0,14,6,30,10,2,0,12,0,30,4,10,0,14,0,30,1,13,0,14,4,30,9,0,0,9,1,-15,3,1
2,2,29,0,30,8,6,0,14,6,30,10,2,0,12,0,30,4,10,0,14,0,30,1,13,0,14,4,30,9,0,0,9,1,-15,3,1
2,4,32,0,30,4,5,0,9,4,30,2,0,0,2,0,30,8,1,0,9,1,30,2,7,0,9,3,30,2,0,0,2,1,-15,3,1
2,4,39,0,30,5,6,0,11,6,30,6,0,0,6,0,30,7,4,0,11,4,30,4,7,0,11,3,30,5,0,0,5,1,-15,3,1
2,1,19,0,30,2,11,0,13,2,30,2,6,0,8,1,30,8,5,0,13,7,30,6,7,0,13,3,30,9,0,0,9,1,-15,3,1
2,4,19,0,30,2,11,0,13,2,30,2,6,0,8,1,30,8,5,0,13,7,30,6,7,0,13,3,30,9,0,0,9,1,-15,3,1
2,1,25,1,30,9,5,0,14,3,30,6,0,0,6,2,30,10,4,0,14,1,30,5,9,0,14,2,30,5,1,0,6,1,-15,3,1
2,4,27,1,30,5,10,0,15,5,30,2,0,0,2,0,30,3,12,0,15,2,30,4,11,0,15,0,30,6,0,0,6,1,-15,3,1
2,0,29,0,30,7,7,0,14,5,30,12,0,0,12,0,30,6,8,0,14,0,30,1,13,0,14,0,30,8,1,0,9,1,-15,3,1
2,2,29,0,30,7,7,0,14,5,30,12,0,0,12,0,30,6,8,0,14,0,30,1,13,0,14,0,30,8,1,0,9,1,-15,3,1
2,4,29,0,30,7,7,0,14,5,30,12,0,0,12,0,30,6,8,0,14,0,30,1,13,0,14,0,30,8,1,0,9,1,-15,3,1
2,2,31,7,30,6,6,0,12,6,30,8,0,0,8,3,30,8,4,0,12,0,30,3,9,0,12,0,30,6,0,0,6,1,-15,3,1
2,1,1,0,30,7,3,0,10,4,30,2,0,0,2,1,30,4,6,0,10,3,30,7,3,0,10,0,30,6,0,0,6,0,-27,3,0
2,3,1,0,30,7,3,0,10,4,30,2,0,0,2,1,30,4,6,0,10,3,30,7,3,0,10,0,30,6,0,0,6,0,-27,3,0
2,2,6,0,30,9,0,0,9,4,30,2,0,0,2,0,30,2,7,0,9,0,30,4,5,0,9,0,30,3,2,0,5,0,-27,3,0
2,2,13,1,30,6,1,0,7,0,30,4,0,0,4,2,30,6,1,0,7,11,30,7,0,0,7,3,30,4,0,0,4,1,-15,3,1
2,3,17,2,30,10,4,0,14,2,30,6,0,0,6,0,30,6,8,0,14,4,30,5,9,0,14,4,30,4,0,0,4,1,-15,3,1
2,0,27,1,30,4,11,0,15,3,30,2,0,0,2,0,30,9,6,0,15,3,30,4,11,0,15,3,30,6,0,0,6,1,-15,3,1
2,1,27,1,30,4,11,0,15,3,30,2,0,0,2,0,30,9,6,0,15,3,30,4,11,0,15,3,30,6,0,0,6,1,-15,3,1
2,3,27,1,30,4,11,0,15,3,30,2,0,0,2,0,30,9,6,0,15,3,30,4,11,0,15,3,30,6,0,0,6,1,-15,3,1
2,1,29,0,30,8,6,0,14,5,30,8,4,0,12,0,30,3,11,0,14,0,30,1,13,0,14,4,30,9,0,0,9,1,-15,3,1
2,3,29,0,30,8,6,0,14,5,30,8,4,0,12,0,30,3,11,0,14,0,30,1,13,0,14,4,30,9,0,0,9,1,-15,3,1
2,3,31,6,30,8,4,0,12,6,30,8,0,0,8,3,30,7,5,0,12,0,30,7,5,0,12,0,30,4,2,0,6,1,-15,3,1
2,2,35,0,30,6,7,0,13,5,30,2,0,0,2,1,30,3,10,0,13,3,30,2,11,0,13,7,30,8,0,0,8,1,-15,3,1
2,3,35,0,30,6,7,0,13,5,30,2,0,0,2,1,30,3,10,0,13,3,30,2,11,0,13,7,30,8,0,0,8,1,-15,3,1
2,2,37,1,30,6,5,0,11,6,30,5,3,0,8,1,30,8,3,0,11,2,30,5,6,0,11,0,30,6,0,0,6,1,-15,3,1
2,1,11,2,30,4,8,0,12,2,30,4,0,0,4,0,30,4,8,0,12,5,30,5,7,0,12,4,30,4,0,0,4,1,-15,3,1
2,2,13,0,30,7,0,0,7,1,30,4,0,0,4,2,30,6,1,0,7,4,30,6,1,0,7,1,30,4,0,0,4,1,-15,3,1
2,3,17,3,30,9,5,0,14,4,30,6,0,0,6,0,30,4,10,0,14,2,30,7,7,0,14,4,30,4,0,0,4,1,-15,3,1
2,4,17,3,30,9,5,0,14,4,30,6,0,0,6,0,30,4,10,0,14,2,30,7,7,0,14,4,30,4,0,0,4,1,-15,3,1
2,2,19,1,30,5,8,0,13,2,30,3,5,0,8,0,30,4,9,0,13,0,30,7,6,0,13,1,30,8,1,0,9,1,-15,3,1
2,4,23,1,30,4,9,0,13,1,30,6,0,0,6,5,30,11,2,0,13,0,30,5,8,0,13,3,30,6,0,0,6,1,-15,3,1
2,2,25,2,30,5,9,0,14,3,30,6,0,0,6,0,30,14,0,0,14,1,30,5,9,0,14,4,30,5,1,0,6,1,-15,3,1
2,1,27,8,30,6,9,0,15,4,30,2,0,0,2,0,30,6,9,0,15,2,30,4,11,0,15,2,30,5,1,0,6,1,-15,3,1
2,3,27,8,30,6,9,0,15,4,30,2,0,0,2,0,30,6,9,0,15,2,30,4,11,0,15,2,30,5,1,0,6,1,-15,3,1
2,2,31,2,30,8,4,0,12,6,30,8,0,0,8,3,30,6,6,0,12,0,30,5,7,0,12,1,30,6,0,0,6,1,-15,3,1
2,3,31,2,30,8,4,0,12,6,30,8,0,0,8,3,30,6,6,0,12,0,30,5,7,0,12,1,30,6,0,0,6,1,-15,3,1
2,4,31,2,30,8,4,0,12,6,30,8,0,0,8,3,30,6,6,0,12,0,30,5,7,0,12,1,30,6,0,0,6,1,-15,3,1
2,3,35,0,30,7,6,0,13,5,30,2,0,0,2,1,30,2,11,0,13,2,30,5,8,0,13,2,30,8,0,0,8,1,-15,3,1
2,4,35,0,30,7,6,0,13,5,30,2,0,0,2,1,30,2,11,0,13,2,30,5,8,0,13,2,30,8,0,0,8,1,-15,3,1
2,0,41,0,30,7,5,0,12,8,30,8,0,0,8,0,30,2,10,0,12,1,30,4,8,0,12,6,30,7,0,0,7,1,-15,3,1
2,3,41,0,30,7,5,0,12,8,30,8,0,0,8,0,30,2,10,0,12,1,30,4,8,0,12,6,30,7,0,0,7,1,-15,3,1
2,2,5,3,30,2,3,0,5,4,30,0,4,0,4,0,30,0,5,0,5,0,30,1,4,0,5,0,30,2,0,0,2,0,-27,3,0
2,3,5,3,30,2,3,0,5,4,30,0,4,0,4,0,30,0,5,0,5,0,30,1,4,0,5,0,30,2,0,0,2,0,-27,3,0
2,4,5,3,30,2,3,0,5,4,30,0,4,0,4,0,30,0,5,0,5,0,30,1,4,0,5,0,30,2,0,0,2,0,-27,3,0
2,2,6,0,30,7,2,0,9,4,30,2,0,0,2,0,30,3,6,0,9,0,30,4,5,0,9,0,30,5,0,0,5,0,-27,3,0
2,3,6,0,30,7,2,0,9,4,30,2,0,0,2,0,30,3,6,0,9,0,30,4,5,0,9,0,30,5,0,0,5,0,-27,3,0
2,4,6,0,30,7,2,0,9,4,30,2,0,0,2,0,30,3,6,0,9,0,30,4,5,0,9,0,30,5,0,0,5,0,-27,3,0
2,1,13,10,30,7,0,0,7,2,30,4,0,0,4,2,30,6,1,0,7,4,30,3,4,0,7,6,30,4,0,0,4,1,-15,3,1
2,3,13,10,30,7,0,0,7,2,30,4,0,0,4,2,30,6,1,0,7,4,30,3,4,0,7,6,30,4,0,0,4,1,-15,3,1
2,4,13,10,30,7,0,0,7,2,30,4,0,0,4,2,30,6,1,0,7,4,30,3,4,0,7,6,30,4,0,0,4,1,-15,3,1
2,4,17,2,30,7,7,0,14,3,30,6,0,0,6,0,30,5,9,0,14,2,30,5,9,0,14,2,30,4,0,0,4,1,-15,3,1
2,0,19,0,30,3,10,0,13,1,30,4,4,0,8,1,30,6,7,0,13,7,30,8,5,0,13,2,30,8,1,0,9,1,-15,3,1
2,2,19,0,30,3,10,0,13,1,30,4,4,0,8,1,30,6,7,0,13,7,30,8,5,0,13,0,30,8,1,0,9,1,-15,3,1
2,4,19,0,30,3,10,0,13,1,30,4,4,0,8,1,30,6,7,0,13,7,30,8,5,0,13,0,30,8,1,0,9,1,-15,3,1
2,4,23,2,30,8,5,0,13,3,30,6,0,0,6,7,30,11,2,0,13,0,30,5,8,0,13,3,30,5,1,0,6,1,-15,3,1
2,3,25,2,30,7,7,0,14,4,30,6,0,0,6,0,30,10,4,0,14,1,30,5,9,0,14,0,30,5,1,0,6,1,-15,3,1
2,4,25,2,30,7,7,0,14,4,30,6,0,0,6,0,30,10,4,0,14,1,30,5,9,0,14,0,30,5,1,0,6,1,-15,3,1
2,0,26,3,30,5,4,0,9,5,30,4,0,0,4,6,30,0,9,0,9,0,30,2,7,0,9,4,30,2,1,0,3,1,-15,3,1
2,1,26,3,30,5,4,0,9,5,30,4,0,0,4,6,30,0,9,0,9,0,30,2,7,0,9,4,30,2,1,0,3,1,-15,3,1
2,2,26,3,30,5,4,0,9,5,30,4,0,0,4,6,30,0,9,0,9,0,30,2,7,0,9,4,30,2,1,0,3,1,-15,3,1
2,0,47,0,30,0,14,0,14,6,30,4,0,0,4,0,30,8,6,0,14,1,30,8,6,0,14,7,30,7,0,0,7,1,-15,3,1
2,1,47,0,30,0,14,0,14,6,30,4,0,0,4,0,30,8,6,0,14,1,30,8,6,0,14,7,30,7,0,0,7,1,-15,3,1
2,3,47,0,30,0,14,0,14,6,30,4,0,0,4,0,30,8,6,0,14,1,30,8,6,0,14,7,30,7,0,0,7,1,-15,3,1
2,4,13,2,30,6,1,0,7,0,30,4,0,0,4,2,30,5,2,0,7,9,30,3,4,0,7,5,30,4,0,0,4,1,-15,3,1
2,3,17,4,30,10,4,0,14,3,30,6,0,0,6,0,30,5,9,0,14,0,30,6,8,0,14,3,30,4,0,0,4,1,-15,3,1
2,4,19,0,30,4,9,0,13,2,30,8,0,0,8,0,30,5,8,0,13,3,30,4,9,0,13,0,30,6,3,0,9,1,-15,3,1
2,4,23,4,30,5,8,0,13,4,30,6,0,0,6,5,30,10,3,0,13,0,30,5,8,0,13,0,30,6,0,0,6,1,-15,3,1
2,2,33,1,30,3,8,0,11,4,30,4,0,0,4,1,30,11,0,0,11,2,30,3,8,0,11,6,30,4,0,0,4,1,-15,3,1
2,2,13,3,30,7,0,0,7,0,30,4,0,0,4,2,30,6,1,0,7,7,30,4,3,0,7,3,30,4,0,0,4,1,-15,3,1
2,3,17,4,30,9,5,0,14,3,30,6,0,0,6,0,30,5,9,0,14,2,30,6,8,0,14,7,30,4,0,0,4,1,-15,3,1
2,4,19,0,30,3,10,0,13,3,30,5,3,0,8,0,30,4,9,0,13,7,30,6,7,0,13,0,30,9,0,0,9,1,-15,3,1
2,4,23,1,30,8,5,0,13,0,30,5,1,0,6,7,30,11,2,0,13,0,30,5,8,0,13,2,30,5,1,0,6,1,-15,3,1
2,3,25,2,30,7,7,0,14,0,30,6,0,0,6,0,30,11,3,0,14,1,30,4,10,0,14,3,30,5,1,0,6,1,-15,3,1
2,4,29,0,30,6,8,0,14,6,30,11,1,0,12,0,30,1,13,0,14,0,30,0,14,0,14,3,30,9,0,0,9,1,-15,3,1
2,2,4,0,30,7,1,0,8,4,30,3,1,0,4,0,30,1,7,0,8,0,30,5,3,0,8,4,30,4,0,0,4,0,-27,3,0
2,0,5,0,30,3,2,0,5,3,30,4,0,0,4,0,30,0,5,0,5,0,30,1,4,0,5,0,30,2,0,0,2,0,-27,3,0
2,1,13,4,30,7,0,0,7,1,30,4,0,0,4,2,30,6,1,0,7,6,30,4,3,0,7,1,30,4,0,0,4,1,-15,3,1
2,3,13,4,30,7,0,0,7,1,30,4,0,0,4,0,30,6,1,0,7,6,30,4,3,0,7,1,30,4,0,0,4,1,-15,3,1
2,1,17,3,30,9,5,0,14,2,30,6,0,0,6,0,30,7,7,0,14,1,30,8,6,0,14,2,30,4,0,0,4,1,-15,3,1
2,4,17,0,30,9,5,0,14,2,30,6,0,0,6,0,30,7,7,0,14,1,30,8,6,0,14,2,30,4,0,0,4,1,-15,3,1
2,4,23,0,30,5,8,0,13,1,30,6,0,0,6,7,30,13,0,0,13,0,30,6,7,0,13,2,30,5,1,0,6,1,-15,3,1
2,3,28,3,30,8,0,0,8,5,30,4,0,0,4,0,30,1,7,0,8,0,30,2,6,0,8,4,30,4,0,0,4,1,-15,3,1
2,4,28,3,30,8,0,0,8,5,30,4,0,0,4,0,30,1,7,0,8,0,30,2,6,0,8,4,30,4,0,0,4,1,-15,3,1
2,0,31,5,30,7,5,0,12,7,30,8,0,0,8,3,30,6,6,0,12,0,30,6,6,0,12,2,30,4,2,0,6,1,-15,3,1
2,2,31,5,30,7,5,0,12,7,30,8,0,0,8,3,30,6,6,0,12,0,30,6,6,0,12,2,30,4,2,0,6,1,-15,3,1
2,4,31,5,30,7,5,0,12,7,30,8,0,0,8,1,30,6,6,0,12,0,30,6,6,0,12,2,30,4,2,0,6,1,-15,3,1
2,4,35,0,30,6,7,0,13,4,30,2,0,0,2,1,30,2,11,0,13,0,30,1,12,0,13,6,30,8,0,0,8,1,-15,3,1
2,4,38,0,30,1,9,0,10,7,30,6,0,0,6,0,30,1,9,0,10,0,30,4,6,0,10,6,30,6,0,0,6,1,-15,3,1
2,4,39,0,30,3,8,0,11,6,30,6,0,0,6,0,30,6,5,0,11,1,30,3,8,0,11,2,30,5,0,0,5,1,-15,3,1
2,1,5,0,30,2,3,0,5,3,30,2,2,0,4,0,30,0,5,0,5,0,30,2,3,0,5,0,30,1,1,0,2,0,-27,3,0
2,2,5,0,30,2,3,0,5,3,30,2,2,0,4,0,30,0,5,0,5,0,30,2,3,0,5,0,30,1,1,0,2,0,-27,3,0
2,3,5,0,30,2,3,0,5,3,30,2,2,0,4,0,30,0,5,0,5,0,30,2,3,0,5,0,30,1,1,0,2,0,-27,3,0
2,4,5,0,30,2,3,0,5,3,30,2,2,0,4,0,30,0,5,0,5,0,30,2,3,0,5,0,30,1,1,0,2,0,-27,3,0
2,4,8,2,30,7,0,0,7,4,30,2,0,0,2,3,30,2,5,0,7,3,30,5,2,0,7,0,30,3,0,0,3,0,-27,3,0
2,2,11,0,30,1,3,0,4,0,30,0,0,0,0,0,30,2,2,0,4,4,30,2,2,0,4,1,30,1,0,0,1,1,-15,3,1
2,3,11,0,30,1,3,0,4,0,30,0,0,0,0,0,30,2,2,0,4,4,30,2,2,0,4,1,30,1,0,0,1,1,-15,3,1
2,4,11,0,30,1,3,0,4,0,30,0,0,0,0,0,30,2,2,0,4,4,30,2,2,0,4,1,30,1,0,0,1,1,-15,3,1
2,1,17,4,30,11,3,0,14,3,30,6,0,0,6,0,30,5,9,0,14,2,30,5,9,0,14,5,30,4,0,0,4,1,-15,3,1
2,2,17,4,30,11,3,0,14,3,30,6,0,0,6,0,30,5,9,0,14,2,30,5,9,0,14,5,30,4,0,0,4,1,-15,3,1
2,4,17,4,30,11,3,0,14,3,30,6,0,0,6,0,30,5,9,0,14,2,30,5,9,0,14,5,30,4,0,0,4,1,-15,3,1
2,1,19,1,30,5,8,0,13,2,30,3,5,0,8,0,30,5,8,0,13,1,30,4,9,0,13,2,30,8,1,0,9,1,-15,3,1
2,2,19,1,30,5,8,0,13,2,30,3,5,0,8,0,30,5,8,0,13,1,30,4,9,0,13,2,30,8,1,0,9,1,-15,3,1
2,3,19,1,30,5,8,0,13,2,30,3,5,0,8,0,30,5,8,0,13,1,30,4,9,0,13,2,30,8,1,0,9,1,-15,3,1
2,3,25,0,30,13,1,0,14,2,30,6,0,0,6,0,30,6,8,0,14,1,30,6,8,0,14,3,30,6,0,0,6,1,-15,3,1
2,4,25,0,30,13,1,0,14,2,30,6,0,0,6,0,30,6,8,0,14,1,30,6,8,0,14,3,30,6,0,0,6,1,-15,3,1
2,1,27,1,30,8,7,0,15,0,30,1,1,0,2,0,30,5,10,0,15,2,30,4,11,0,15,0,30,5,1,0,6,1,-15,3,1
2,4,27,1,30,8,7,0,15,0,30,1,1,0,2,0,30,5,10,0,15,0,30,4,11,0,15,0,30,5,1,0,6,1,-15,3,1
2,0,5,3,30,2,3,0,5,4,30,3,1,0,4,0,30,0,5,0,5,1,30,1,4,0,5,1,30,2,0,0,2,0,-27,3,0
2,2,5,3,30,2,3,0,5,4,30,3,1,0,4,0,30,0,5,0,5,1,30,1,4,0,5,1,30,2,0,0,2,0,-27,3,0
2,3,5,3,30,2,3,0,5,4,30,3,1,0,4,0,30,0,5,0,5,1,30,1,4,0,5,1,30,2,0,0,2,0,-27,3,0
2,4,5,3,30,2,3,0,5,4,30,3,1,0,4,0,30,0,5,0,5,1,30,1,4,0,5,1,30,2,0,0,2,0,-27,3,0
2,3,8,4,30,7,0,0,7,4,30,2,0,0,2,0,30,5,2,0,7,0,30,3,4,0,7,0,30,3,0,0,3,0,-27,3,0
2,2,11,1,30,5,7,0,12,0,30,4,0,0,4,0,30,7,5,0,12,7,30,5,7,0,12,4,30,4,0,0,4,1,-15,3,1
2,1,13,2,30,7,0,0,7,1,30,4,0,0,4,2,30,5,2,0,7,12,30,7,0,0,7,2,30,4,0,0,4,1,-15,3,1
2,2,13,2,30,7,0,0,7,1,30,4,0,0,4,2,30,5,2,0,7,12,30,7,0,0,7,2,30,4,0,0,4,1,-15,3,1
2,1,19,1,30,4,9,0,13,2,30,5,3,0,8,0,30,6,7,0,13,0,30,4,9,0,13,2,30,8,1,0,9,1,-15,3,1
2,2,19,1,30,4,9,0,13,2,30,5,3,0,8,0,30,6,7,0,13,0,30,4,9,0,13,2,30,8,1,0,9,1,-15,3,1
2,0,27,1,30,5,10,0,15,4,30,2,0,0,2,0,30,5,10,0,15,2,30,4,11,0,15,3,30,6,0,0,6,1,-15,3,1
2,1,27,1,30,5,10,0,15,4,30,2,0,0,2,0,30,5,10,0,15,2,30,4,11,0,15,3,30,6,0,0,6,1,-15,3,1
2,2,27,1,30,5,10,0,15,4,30,2,0,0,2,0,30,5,10,0,15,2,30,4,11,0,15,3,30,6,0,0,6,1,-15,3,1
2,4,27,1,30,5,10,0,15,4,30,2,0,0,2,0,30,5,10,0,15,2,30,4,11,0,15,1,30,6,0,0,6,1,-15,3,1
2,4,29,0,30,9,5,0,14,5,30,12,0,0,12,0,30,3,11,0,14,0,30,1,13,0,14,0,30,7,2,0,9,1,-15,3,1
2,1,5,0,30,1,4,0,5,2,30,3,1,0,4,0,30,0,5,0,5,0,30,1,4,0,5,0,30,1,1,0,2,0,-27,3,0
2,4,5,0,30,1,4,0,5,2,30,3,1,0,4,0,30,0,5,0,5,0,30,1,4,0,5,0,30,1,1,0,2,0,-27,3,0
2,0,9,0,30,6,5,0,11,3,30,6,0,0,6,1,30,5,6,0,11,5,30,3,8,0,11,6,30,4,0,0,4,0,-27,3,0
2,1,9,0,30,6,5,0,11,3,30,6,0,0,6,1,30,5,6,0,11,5,30,3,8,0,11,6,30,4,0,0,4,0,-27,3,0
2,2,9,0,30,6,5,0,11,3,30,6,0,0,6,1,30,5,6,0,11,5,30,3,8,0,11,6,30,4,0,0,4,0,-27,3,0
2,4,15,1,30,6,7,0,13,0,30,6,0,0,6,0,30,6,7,0,13,1,30,4,9,0,13,2,30,5,4,0,9,1,-15,3,1
2,3,17,2,30,7,7,0,14,3,30,6,0,0,6,0,30,5,9,0,14,0,30,8,6,0,14,5,30,4,0,0,4,1,-15,3,1
2,3,23,3,30,9,4,0,13,1,30,6,0,0,6,4,30,11,2,0,13,0,30,5,8,0,13,1,30,6,0,0,6,1,-15,3,1
2,4,23,3,30,9,4,0,13,1,30,6,0,0,6,4,30,11,2,0,13,0,30,5,8,0,13,1,30,6,0,0,6,1,-15,3,1
2,3,25,3,30,6,8,0,14,3,30,6,0,0,6,0,30,6,8,0,14,1,30,5,9,0,14,4,30,5,1,0,6,1,-15,3,1
2,0,27,1,30,4,11,0,15,3,30,1,1,0,2,0,30,5,10,0,15,2,30,6,9,0,15,3,30,6,0,0,6,1,-15,3,1
2,2,27,1,30,4,11,0,15,3,30,1,1,0,2,0,30,5,10,0,15,2,30,6,9,0,15,3,30,6,0,0,6,1,-15,3,1
2,3,29,0,30,6,8,0,14,5,30,12,0,0,12,0,30,3,11,0,14,0,30,0,14,0,14,0,30,6,3,0,9,1,-15,3,1
2,4,29,0,30,6,8,0,14,5,30,12,0,0,12,0,30,3,11,0,14,0,30,0,14,0,14,0,30,6,3,0,9,1,-15,3,1
2,4,43,0,30,10,4,0,14,7,30,6,0,0,6,0,30,4,10,0,14,1,30,1,13,0,14,3,30,5,0,0,5,1,-15,3,1
2,4,17,3,30,9,5,0,14,3,30,6,0,0,6,0,30,5,9,0,14,2,30,5,9,0,14,0,30,4,0,0,4,1,-15,3,1
2,1,25,1,30,2,12,0,14,5,30,6,0,0,6,0,30,7,7,0,14,2,30,9,5,0,14,2,30,6,0,0,6,1,-15,3,1
2,4,25,1,30,2,12,0,14,5,30,6,0,0,6,0,30,7,7,0,14,2,30,9,5,0,14,2,30,6,0,0,6,1,-15,3,1
2,0,27,2,30,6,9,0,15,4,30,1,1,0,2,0,30,4,11,0,15,1,30,7,8,0,15,2,30,6,0,0,6,1,-15,3,1
2,3,27,2,30,6,9,0,15,4,30,1,1,0,2,0,30,4,11,0,15,1,30,7,8,0,15,2,30,6,0,0,6,1,-15,3,1
2,4,27,2,30,6,9,0,15,4,30,1,1,0,2,0,30,4,11,0,15,1,30,7,8,0,15,2,30,6,0,0,6,1,-15,3,1
2,4,30,2,30,2,3,0,5,4,30,2,0,0,2,1,30,2,3,0,5,9,30,1,4,0,5,0,30,2,1,0,3,1,-15,3,1
2,2,35,6,30,7,6,0,13,7,30,2,0,0,2,1,30,2,11,0,13,2,30,1,12,0,13,7,30,8,0,0,8,1,-15,3,1
2,2,5,4,30,4,1,0,5,4,30,0,4,0,4,0,30,0,5,0,5,0,30,1,4,0,5,0,30,0,2,0,2,0,-27,3,0
2,4,5,4,30,4,1,0,5,4,30,0,4,0,4,0,30,0,5,0,5,0,30,1,4,0,5,0,30,0,2,0,2,0,-27,3,0
2,2,6,0,30,7,2,0,9,4,30,2,0,0,2,1,30,3,6,0,9,0,30,4,5,0,9,1,30,4,1,0,5,0,-27,3,0
2,3,6,0,30,7,2,0,9,4,30,2,0,0,2,1,30,3,6,0,9,0,30,4,5,0,9,1,30,4,1,0,5,0,-27,3,0
2,4,8,1,30,7,0,0,7,4,30,2,0,0,2,3,30,3,4,0,7,0,30,5,2,0,7,1,30,3,0,0,3,0,-27,3,0
2,3,13,1,30,6,1,0,7,0,30,4,0,0,4,2,30,6,1,0,7,5,30,2,5,0,7,0,30,4,0,0,4,1,-15,3,1
2,2,17,0,30,9,5,0,14,3,30,6,0,0,6,0,30,4,10,0,14,6,30,6,8,0,14,4,30,4,0,0,4,1,-15,3,1
2,4,17,0,30,9,5,0,14,3,30,6,0,0,6,0,30,4,10,0,14,6,30,6,8,0,14,4,30,4,0,0,4,1,-15,3,1
2,1,23,1,30,5,8,0,13,4,30,6,0,0,6,8,30,12,1,0,13,0,30,6,7,0,13,5,30,6,0,0,6,1,-15,3,1
2,0,27,1,30,4,11,0,15,4,30,1,1,0,2,0,30,5,10,0,15,0,30,7,8,0,15,5,30,6,0,0,6,1,-15,3,1
2,2,27,1,30,4,11,0,15,4,30,1,1,0,2,0,30,5,10,0,15,0,30,7,8,0,15,5,30,6,0,0,6,1,-15,3,1
2,0,31,5,30,9,3,0,12,7,30,8,0,0,8,3,30,4,8,0,12,0,30,3,9,0,12,1,30,6,0,0,6,1,-15,3,1
2,2,31,5,30,9,3,0,12,7,30,8,0,0,8,3,30,4,8,0,12,0,30,3,9,0,12,1,30,6,0,0,6,1,-15,3,1
2,3,31,5,30,9,3,0,12,7,30,8,0,0,8,3,30,4,8,0,12,0,30,3,9,0,12,1,30,6,0,0,6,1,-15,3,1
2,4,31,5,30,9,3,0,12,7,30,8,0,0,8,3,30,4,8,0,12,0,30,3,9,0,12,1,30,6,0,0,6,1,-15,3,1
2,3,35,0,30,9,4,0,13,6,30,2,0,0,2,1,30,2,11,0,13,0,30,5,8,0,13,5,30,7,1,0,8,1,-15,3,1
2,2,5,0,30,5,0,0,5,3,30,2,2,0,4,0,30,0,5,0,5,0,30,1,4,0,5,1,30,2,0,0,2,0,-27,3,0
2,3,5,0,30,5,0,0,5,3,30,2,2,0,4,0,30,0,5,0,5,0,30,1,4,0,5,1,30,2,0,0,2,0,-27,3,0
2,4,11,1,30,4,8,0,12,0,30,4,0,0,4,0,30,6,6,0,12,4,30,4,8,0,12,4,30,4,0,0,4,1,-15,3,1
2,3,25,1,30,7,7,0,14,4,30,6,0,0,6,0,30,7,7,0,14,1,30,5,9,0,14,3,30,6,0,0,6,1,-15,3,1
2,4,25,1,30,7,7,0,14,4,30,6,0,0,6,0,30,7,7,0,14,1,30,5,9,0,14,3,30,6,0,0,6,1,-15,3,1
2,0,26,1,30,6,3,0,9,4,30,4,0,0,4,2,30,3,6,0,9,0,30,4,5,0,9,5,30,3,0,0,3,1,-15,3,1
2,1,27,1,30,5,10,0,15,4,30,2,0,0,2,0,30,3,12,0,15,4,30,4,11,0,15,2,30,6,0,0,6,1,-15,3,1
2,3,27,1,30,5,10,0,15,4,30,2,0,0,2,0,30,3,12,0,15,4,30,4,11,0,15,2,30,6,0,0,6,1,-15,3,1
2,3,29,0,30,7,7,0,14,5,30,12,0,0,12,0,30,5,9,0,14,0,30,1,13,0,14,0,30,8,1,0,9,1,-15,3,1
2,4,29,0,30,7,7,0,14,5,30,12,0,0,12,0,30,5,9,0,14,0,30,1,13,0,14,0,30,8,1,0,9,1,-15,3,1
2,1,31,1,30,7,5,0,12,4,30,8,0,0,8,3,30,10,2,0,12,0,30,3,9,0,12,4,30,2,4,0,6,1,-15,3,1
2,2,35,0,30,5,8,0,13,2,30,2,0,0,2,1,30,12,1,0,13,0,30,6,7,0,13,3,30,8,0,0,8,1,-15,3,1
2,4,35,0,30,5,8,0,13,2,30,2,0,0,2,1,30,12,1,0,13,0,30,6,7,0,13,3,30,8,0,0,8,1,-15,3,1
2,4,5,0,30,1,4,0,5,3,30,2,2,0,4,1,30,0,5,0,5,0,30,1,4,0,5,0,30,1,1,0,2,0,-27,3,0
2,2,9,0,30,1,3,0,4,1,30,2,0,0,2,1,30,4,0,0,4,6,30,1,3,0,4,1,30,1,0,0,1,0,-27,3,0
2,4,9,0,30,1,3,0,4,1,30,2,0,0,2,1,30,4,0,0,4,6,30,1,3,0,4,1,30,1,0,0,1,0,-27,3,0
2,2,27,0,30,4,11,0,15,4,30,2,0,0,2,0,30,6,9,0,15,1,30,5,10,0,15,1,30,6,0,0,6,1,-15,3,1
2,4,27,0,30,4,11,0,15,4,30,2,0,0,2,0,30,6,9,0,15,1,30,5,10,0,15,1,30,6,0,0,6,1,-15,3,1
2,3,8,2,30,7,0,0,7,3,30,2,0,0,2,4,30,3,4,0,7,0,30,7,0,0,7,5,30,3,0,0,3,0,-27,3,0
2,0,19,0,30,5,8,0,13,2,30,7,1,0,8,4,30,6,7,0,13,0,30,4,9,0,13,1,30,6,3,0,9,1,-15,3,1
2,0,25,1,30,2,12,0,14,3,30,6,0,0,6,0,30,6,8,0,14,1,30,8,6,0,14,7,30,6,0,0,6,1,-15,3,1
2,3,27,1,30,4,11,0,15,3,30,2,0,0,2,0,30,3,12,0,15,2,30,4,11,0,15,6,30,6,0,0,6,1,-15,3,1
2,4,27,1,30,4,11,0,15,3,30,2,0,0,2,0,30,3,12,0,15,2,30,4,11,0,15,6,30,6,0,0,6,1,-15,3,1
2,3,29,0,30,5,9,0,14,6,30,11,1,0,12,0,30,3,11,0,14,0,30,2,12,0,14,2,30,9,0,0,9,1,-15,3,1
2,4,29,0,30,5,9,0,14,6,30,11,1,0,12,0,30,3,11,0,14,0,30,2,12,0,14,2,30,9,0,0,9,1,-15,3,1
2,4,32,0,30,6,3,0,9,4,30,2,0,0,2,0,30,6,3,0,9,1,30,2,7,0,9,5,30,2,0,0,2,1,-15,3,1
2,0,39,4,30,5,6,0,11,7,30,6,0,0,6,0,30,5,6,0,11,0,30,1,10,0,11,0,30,5,0,0,5,1,-15,3,1
2,4,7,0,30,4,0,0,4,2,30,2,0,0,2,0,30,1,3,0,4,0,30,1,3,0,4,1,30,1,1,0,2,0,-27,3,0
2,3,11,1,30,4,8,0,12,0,30,4,0,0,4,0,30,9,3,0,12,2,30,7,5,0,12,5,30,4,0,0,4,1,-15,3,1
2,2,13,2,30,7,0,0,7,0,30,4,0,0,4,4,30,7,0,0,7,9,30,6,1,0,7,4,30,4,0,0,4,1,-15,3,1
2,4,13,2,30,7,0,0,7,0,30,4,0,0,4,4,30,7,0,0,7,9,30,6,1,0,7,4,30,4,0,0,4,1,-15,3,1
2,2,17,0,30,10,4,0,14,3,30,6,0,0,6,0,30,6,8,0,14,6,30,6,8,0,14,2,30,4,0,0,4,1,-15,3,1
2,4,19,0,30,3,10,0,13,0,30,8,0,0,8,0,30,4,9,0,13,1,30,4,9,0,13,1,30,9,0,0,9,1,-15,3,1
2,4,25,1,30,8,6,0,14,3,30,6,0,0,6,0,30,8,6,0,14,1,30,7,7,0,14,4,30,5,1,0,6,1,-15,3,1
2,3,27,1,30,5,10,0,15,3,30,2,0,0,2,0,30,3,12,0,15,0,30,4,11,0,15,1,30,3,3,0,6,1,-15,3,1
2,4,27,1,30,5,10,0,15,3,30,2,0,0,2,0,30,3,12,0,15,0,30,4,11,0,15,1,30,3,3,0,6,1,-15,3,1
2,3,29,0,30,6,8,0,14,6,30,10,2,0,12,0,30,5,9,0,14,0,30,1,13,0,14,0,30,9,0,0,9,1,-15,3,1
2,0,5,0,30,2,3,0,5,3,30,1,3,0,4,0,30,0,5,0,5,0,30,2,3,0,5,2,30,2,0,0,2,0,-27,3,0
2,1,5,0,30,2,3,0,5,3,30,1,3,0,4,0,30,0,5,0,5,0,30,2,3,0,5,2,30,2,0,0,2,0,-27,3,0
2,2,5,0,30,2,3,0,5,3,30,1,3,0,4,0,30,0,5,0,5,0,30,2,3,0,5,2,30,2,0,0,2,0,-27,3,0
2,4,5,0,30,2,3,0,5,3,30,1,3,0,4,0,30,0,5,0,5,0,30,2,3,0,5,2,30,2,0,0,2,0,-27,3,0
2,1,17,4,30,8,6,0,14,3,30,6,0,0,6,0,30,5,9,0,14,2,30,7,7,0,14,3,30,4,0,0,4,1,-15,3,1
2,4,17,3,30,8,6,0,14,3,30,6,0,0,6,0,30,5,9,0,14,2,30,7,7,0,14,3,30,4,0,0,4,1,-15,3,1
2,4,19,0,30,4,9,0,13,2,30,6,2,0,8,0,30,7,6,0,13,0,30,4,9,0,13,1,30,8,1,0,9,1,-15,3,1
2,3,23,1,30,5,8,0,13,4,30,6,0,0,6,10,30,9,4,0,13,0,30,6,7,0,13,1,30,5,1,0,6,1,-15,3,1
2,4,23,1,30,5,8,0,13,4,30,6,0,0,6,10,30,9,4,0,13,0,30,6,7,0,13,1,30,5,1,0,6,1,-15,3,1
2,1,25,1,30,5,9,0,14,4,30,6,0,0,6,0,30,9,5,0,14,1,30,5,9,0,14,3,30,5,1,0,6,1,-15,3,1
2,3,25,1,30,5,9,0,14,4,30,6,0,0,6,0,30,9,5,0,14,1,30,5,9,0,14,3,30,5,1,0,6,1,-15,3,1
2,0,27,1,30,4,11,0,15,3,30,2,0,0,2,0,30,4,11,0,15,2,30,4,11,0,15,7,30,6,0,0,6,1,-15,3,1
2,3,27,1,30,4,11,0,15,3,30,2,0,0,2,0,30,4,11,0,15,2,30,4,11,0,15,5,30,6,0,0,6,1,-15,3,1
2,3,31,0,30,6,6,0,12,7,30,8,0,0,8,3,30,4,8,0,12,0,30,8,4,0,12,1,30,6,0,0,6,1,-15,3,1
2,4,35,2,30,7,6,0,13,4,30,2,0,0,2,1,30,6,7,0,13,1,30,2,11,0,13,4,30,8,0,0,8,1,-15,3,1
2,2,47,0,30,0,14,0,14,7,30,4,0,0,4,0,30,6,8,0,14,0,30,7,7,0,14,1,30,7,0,0,7,1,-15,3,1
2,4,47,0,30,0,14,0,14,7,30,4,0,0,4,0,30,6,8,0,14,0,30,7,7,0,14,1,30,7,0,0,7,1,-15,3,1
2,1,4,2,30,8,0,0,8,5,30,4,0,0,4,0,30,1,7,0,8,0,30,8,0,0,8,3,30,2,2,0,4,0,-27,3,0
2,4,7,1,30,8,1,0,9,2,30,4,0,0,4,0,30,4,5,0,9,8,30,2,7,0,9,1,30,4,2,0,6,0,-27,3,0
2,3,23,1,30,5,8,0,13,3,30,5,1,0,6,7,30,13,0,0,13,0,30,3,10,0,13,4,30,6,0,0,6,1,-15,3,1
2,4,23,1,30,5,8,0,13,3,30,5,1,0,6,7,30,13,0,0,13,0,30,3,10,0,13,4,30,6,0,0,6,1,-15,3,1
2,0,25,0,30,5,9,0,14,4,30,6,0,0,6,0,30,6,8,0,14,3,30,7,7,0,14,4,30,5,1,0,6,1,-15,3,1
2,1,25,0,30,5,9,0,14,4,30,6,0,0,6,0,30,6,8,0,14,3,30,7,7,0,14,4,30,5,1,0,6,1,-15,3,1
2,2,25,0,30,5,9,0,14,4,30,6,0,0,6,0,30,6,8,0,14,3,30,7,7,0,14,4,30,5,1,0,6,1,-15,3,1
2,0,27,2,30,6,9,0,15,4,30,2,0,0,2,0,30,2,13,0,15,4,30,8,7,0,15,3,30,6,0,0,6,1,-15,3,1
2,3,13,1,30,6,1,0,7,0,30,4,0,0,4,3,30,7,0,0,7,6,30,6,1,0,7,0,30,4,0,0,4,1,-15,3,1
2,4,13,1,30,6,1,0,7,0,30,4,0,0,4,3,30,7,0,0,7,6,30,6,1,0,7,0,30,4,0,0,4,1,-15,3,1
2,1,17,5,30,9,5,0,14,3,30,6,0,0,6,0,30,5,9,0,14,1,30,5,9,0,14,4,30,4,0,0,4,1,-15,3,1
2,3,17,5,30,9,5,0,14,3,30,6,0,0,6,0,30,5,9,0,14,1,30,5,9,0,14,4,30,4,0,0,4,1,-15,3,1
2,2,23,2,30,4,9,0,13,3,30,6,0,0,6,6,30,13,0,0,13,0,30,6,7,0,13,2,30,5,1,0,6,1,-15,3,1
2,4,31,1,30,3,9,0,12,4,30,8,0,0,8,4,30,12,0,0,12,0,30,3,9,0,12,2,30,5,1,0,6,1,-15,3,1
2,3,5,2,30,2,3,0,5,3,30,3,1,0,4,0,30,0,5,0,5,0,30,2,3,0,5,0,30,0,2,0,2,0,-27,3,0
2,2,6,0,30,7,2,0,9,4,30,2,0,0,2,0,30,2,7,0,9,0,30,6,3,0,9,6,30,5,0,0,5,0,-27,3,0
2,3,6,0,30,7,2,0,9,4,30,2,0,0,2,0,30,2,7,0,9,0,30,6,3,0,9,6,30,5,0,0,5,0,-27,3,0
2,2,8,2,30,7,0,0,7,4,30,2,0,0,2,0,30,4,3,0,7,0,30,5,2,0,7,3,30,3,0,0,3,0,-27,3,0
2,1,13,3,30,7,0,0,7,2,30,4,0,0,4,1,30,5,2,0,7,2,30,6,1,0,7,3,30,4,0,0,4,1,-15,3,1
2,2,13,3,30,7,0,0,7,2,30,4,0,0,4,1,30,5,2,0,7,2,30,6,1,0,7,3,30,4,0,0,4,1,-15,3,1
2,4,13,3,30,7,0,0,7,2,30,4,0,0,4,1,30,5,2,0,7,2,30,6,1,0,7,2,30,4,0,0,4,1,-15,3,1
2,2,17,4,30,9,5,0,14,3,30,6,0,0,6,0,30,6,8,0,14,2,30,6,8,0,14,3,30,4,0,0,4,1,-15,3,1
2,4,17,4,30,9,5,0,14,3,30,6,0,0,6,0,30,6,8,0,14,2,30,6,8,0,14,3,30,4,0,0,4,1,-15,3,1
2,4,19,0,30,2,11,0,13,2,30,6,2,0,8,0,30,5,8,0,13,3,30,7,6,0,13,0,30,8,1,0,9,1,-15,3,1
2,4,23,1,30,4,9,0,13,4,30,6,0,0,6,8,30,11,2,0,13,0,30,5,8,0,13,2,30,5,1,0,6,1,-15,3,1
2,3,25,3,30,8,6,0,14,5,30,6,0,0,6,0,30,8,6,0,14,1,30,5,9,0,14,4,30,5,1,0,6,1,-15,3,1
2,1,27,1,30,4,11,0,15,4,30,1,1,0,2,0,30,6,9,0,15,3,30,5,10,0,15,3,30,6,0,0,6,1,-15,3,1
2,2,29,0,30,4,10,0,14,6,30,9,3,0,12,0,30,7,7,0,14,0,30,0,14,0,14,2,30,9,0,0,9,1,-15,3,1
2,0,37,0,30,8,3,0,11,7,30,8,0,0,8,0,30,2,9,0,11,6,30,5,6,0,11,10,30,6,0,0,6,1,-15,3,1
2,3,41,0,30,7,5,0,12,7,30,8,0,0,8,0,30,4,8,0,12,2,30,4,8,0,12,1,30,4,3,0,7,1,-15,3,1
2,0,4,1,30,7,1,0,8,5,30,4,0,0,4,2,30,1,7,0,8,3,30,7,1,0,8,1,30,4,0,0,4,0,-27,3,0
2,1,4,1,30,7,1,0,8,5,30,4,0,0,4,2,30,1,7,0,8,3,30,7,1,0,8,1,30,4,0,0,4,0,-27,3,0
2,2,7,0,30,1,3,0,4,2,30,1,1,0,2,0,30,1,3,0,4,0,30,0,4,0,4,2,30,2,0,0,2,0,-27,3,0
2,1,13,3,30,7,0,0,7,0,30,4,0,0,4,2,30,6,1,0,7,8,30,7,0,0,7,6,30,4,0,0,4,1,-15,3,1
2,2,13,3,30,7,0,0,7,0,30,4,0,0,4,2,30,6,1,0,7,8,30,7,0,0,7,6,30,4,0,0,4,1,-15,3,1
2,2,23,2,30,5,8,0,13,4,30,6,0,0,6,5,30,11,2,0,13,0,30,5,8,0,13,3,30,6,0,0,6,1,-15,3,1
2,4,23,2,30,5,8,0,13,4,30,6,0,0,6,5,30,11,2,0,13,0,30,5,8,0,13,3,30,6,0,0,6,1,-15,3,1
2,0,26,0,30,4,5,0,9,3,30,4,0,0,4,3,30,4,5,0,9,5,30,2,7,0,9,6,30,3,0,0,3,1,-15,3,1
2,1,26,0,30,4,5,0,9,3,30,4,0,0,4,3,30,4,5,0,9,5,30,2,7,0,9,6,30,3,0,0,3,1,-15,3,1
2,3,26,0,30,4,5,0,9,3,30,4,0,0,4,3,30,4,5,0,9,5,30,2,7,0,9,6,30,3,0,0,3,1,-15,3,1
2,1,27,1,30,6,9,0,15,5,30,1,1,0,2,0,30,6,9,0,15,3,30,8,7,0,15,2,30,6,0,0,6,1,-15,3,1
2,3,27,1,30,6,9,0,15,5,30,1,1,0,2,0,30,6,9,0,15,3,30,8,7,0,15,2,30,6,0,0,6,1,-15,3,1
2,4,27,1,30,6,9,0,15,5,30,1,1,0,2,0,30,6,9,0,15,3,30,8,7,0,15,2,30,6,0,0,6,1,-15,3,1
2,4,29,0,30,6,8,0,14,6,30,10,2,0,12,0,30,3,11,0,14,0,30,0,14,0,14,0,30,8,1,0,9,1,-15,3,1
2,1,4,2,30,6,2,0,8,5,30,4,0,0,4,2,30,2,6,0,8,4,30,8,0,0,8,1,30,3,1,0,4,0,-27,3,0
2,2,4,2,30,6,2,0,8,5,30,4,0,0,4,2,30,2,6,0,8,4,30,8,0,0,8,1,30,3,1,0,4,0,-27,3,0
2,4,4,2,30,6,2,0,8,5,30,4,0,0,4,2,30,2,6,0,8,4,30,8,0,0,8,1,30,3,1,0,4,0,-27,3,0
2,4,11,0,30,1,3,0,4,0,30,0,0,0,0,0,30,1,3,0,4,7,30,4,0,0,4,2,30,1,0,0,1,1,-15,3,1
2,0,19,0,30,3,10,0,13,2,30,6,2,0,8,0,30,8,5,0,13,5,30,4,9,0,13,3,30,8,1,0,9,1,-15,3,1
2,1,19,0,30,3,10,0,13,2,30,6,2,0,8,0,30,8,5,0,13,5,30,4,9,0,13,3,30,8,1,0,9,1,-15,3,1
2,1,27,1,30,4,11,0,15,2,30,2,0,0,2,0,30,6,9,0,15,1,30,7,8,0,15,2,30,6,0,0,6,1,-15,3,1
2,3,3,3,30,3,1,0,4,3,30,4,0,0,4,1,30,2,2,0,4,0,30,0,4,0,4,0,30,1,2,0,3,0,-27,3,0
2,4,3,3,30,3,1,0,4,3,30,4,0,0,4,1,30,2,2,0,4,0,30,0,4,0,4,0,30,1,2,0,3,0,-27,3,0
2,4,9,0,30,7,4,0,11,3,30,6,0,0,6,1,30,5,6,0,11,9,30,3,8,0,11,1,30,1,3,0,4,0,-27,3,0
2,4,15,0,30,5,8,0,13,0,30,6,0,0,6,0,30,3,10,0,13,1,30,2,11,0,13,2,30,7,2,0,9,1,-15,3,1
2,2,29,0,30,6,8,0,14,6,30,11,1,0,12,0,30,3,11,0,14,0,30,1,13,0,14,4,30,9,0,0,9,1,-15,3,1
2,3,29,0,30,6,8,0,14,6,30,11,1,0,12,0,30,3,11,0,14,0,30,1,13,0,14,4,30,9,0,0,9,1,-15,3,1
2,3,1,0,30,7,3,0,10,5,30,2,0,0,2,1,30,3,7,0,10,1,30,8,2,0,10,6,30,6,0,0,6,0,-27,3,0
2,3,6,0,30,7,2,0,9,4,30,2,0,0,2,0,30,2,7,0,9,0,30,3,6,0,9,0,30,4,1,0,5,0,-27,3,0
2,4,6,0,30,7,2,0,9,4,30,2,0,0,2,0,30,2,7,0,9,0,30,3,6,0,9,0,30,4,1,0,5,0,-27,3,0
2,1,13,3,30,7,0,0,7,0,30,4,0,0,4,2,30,5,2,0,7,4,30,7,0,0,7,5,30,4,0,0,4,1,-15,3,1
2,3,13,3,30,7,0,0,7,0,30,4,0,0,4,2,30,5,2,0,7,4,30,7,0,0,7,5,30,4,0,0,4,1,-15,3,1
2,2,17,3,30,7,7,0,14,2,30,6,0,0,6,0,30,5,9,0,14,1,30,5,9,0,14,6,30,4,0,0,4,1,-15,3,1
2,0,19,0,30,2,11,0,13,2,30,7,1,0,8,0,30,5,8,0,13,3,30,4,9,0,13,3,30,9,0,0,9,1,-15,3,1
2,4,23,1,30,7,6,0,13,2,30,6,0,0,6,0,30,13,0,0,13,0,30,3,10,0,13,2,30,5,1,0,6,1,-15,3,1
2,3,27,0,30,5,10,0,15,1,30,2,0,0,2,0,30,10,5,0,15,1,30,6,9,0,15,0,30,6,0,0,6,1,-15,3,1
2,2,29,0,30,9,5,0,14,5,30,9,3,0,12,0,30,2,12,0,14,0,30,1,13,0,14,5,30,9,0,0,9,1,-15,3,1
2,3,35,0,30,5,8,0,13,5,30,2,0,0,2,1,30,4,9,0,13,4,30,3,10,0,13,8,30,8,0,0,8,1,-15,3,1
2,2,13,1,30,5,2,0,7,0,30,4,0,0,4,0,30,7,0,0,7,6,30,4,3,0,7,1,30,4,0,0,4,1,-15,3,1
2,3,13,1,30,5,2,0,7,0,30,4,0,0,4,0,30,7,0,0,7,6,30,4,3,0,7,1,30,4,0,0,4,1,-15,3,1
2,1,17,4,30,13,1,0,14,3,30,6,0,0,6,0,30,3,11,0,14,1,30,5,9,0,14,1,30,2,2,0,4,1,-15,3,1
2,3,17,4,30,13,1,0,14,3,30,6,0,0,6,0,30,3,11,0,14,1,30,5,9,0,14,1,30,2,2,0,4,1,-15,3,1
2,4,17,4,30,13,1,0,14,3,30,6,0,0,6,0,30,3,11,0,14,1,30,5,9,0,14,1,30,2,2,0,4,1,-15,3,1
2,0,19,0,30,3,10,0,13,2,30,8,0,0,8,3,30,5,8,0,13,0,30,5,8,0,13,1,30,6,3,0,9,1,-15,3,1
2,4,19,0,30,3,10,0,13,2,30,8,0,0,8,3,30,5,8,0,13,0,30,5,8,0,13,1,30,6,3,0,9,1,-15,3,1
2,3,22,2,30,7,1,0,8,3,30,2,0,0,2,1,30,3,5,0,8,2,30,3,5,0,8,1,30,4,0,0,4,1,-15,3,1
2,3,23,1,30,5,8,0,13,1,30,6,0,0,6,5,30,11,2,0,13,0,30,6,7,0,13,2,30,6,0,0,6,1,-15,3,1
2,4,23,1,30,5,8,0,13,1,30,6,0,0,6,5,30,11,2,0,13,0,30,6,7,0,13,2,30,6,0,0,6,1,-15,3,1
2,4,25,2,30,8,6,0,14,4,30,6,0,0,6,0,30,8,6,0,14,1,30,5,9,0,14,4,30,5,1,0,6,1,-15,3,1
2,0,27,1,30,4,11,0,15,3,30,2,0,0,2,0,30,4,11,0,15,3,30,4,11,0,15,3,30,6,0,0,6,1,-15,3,1
2,3,27,1,30,4,11,0,15,0,30,2,0,0,2,0,30,4,11,0,15,3,30,4,11,0,15,3,30,6,0,0,6,1,-15,3,1
2,2,29,0,30,7,7,0,14,6,30,10,2,0,12,0,30,3,11,0,14,0,30,2,12,0,14,2,30,9,0,0,9,1,-15,3,1
2,4,29,0,30,7,7,0,14,6,30,10,2,0,12,0,30,3,11,0,14,0,30,2,12,0,14,2,30,9,0,0,9,1,-15,3,1
2,3,31,2,30,9,3,0,12,3,30,8,0,0,8,4,30,11,1,0,12,0,30,3,9,0,12,1,30,2,4,0,6,1,-15,3,1
2,2,33,1,30,2,9,0,11,5,30,4,0,0,4,0,30,6,5,0,11,6,30,3,8,0,11,8,30,4,0,0,4,1,-15,3,1
2,3,37,1,30,7,4,0,11,7,30,8,0,0,8,2,30,4,7,0,11,2,30,5,6,0,11,8,30,6,0,0,6,1,-15,3,1
2,1,13,3,30,7,0,0,7,0,30,4,0,0,4,3,30,6,1,0,7,9,30,6,1,0,7,4,30,4,0,0,4,1,-15,3,1
2,2,13,3,30,7,0,0,7,0,30,4,0,0,4,3,30,6,1,0,7,9,30,6,1,0,7,4,30,4,0,0,4,1,-15,3,1
2,4,13,3,30,7,0,0,7,0,30,4,0,0,4,3,30,6,1,0,7,9,30,6,1,0,7,4,30,4,0,0,4,1,-15,3,1
2,2,17,3,30,8,6,0,14,2,30,6,0,0,6,0,30,6,8,0,14,1,30,5,9,0,14,4,30,4,0,0,4,1,-15,3,1
2,1,19,0,30,6,7,0,13,1,30,6,2,0,8,0,30,5,8,0,13,4,30,4,9,0,13,0,30,7,2,0,9,1,-15,3,1
2,4,19,0,30,6,7,0,13,1,30,6,2,0,8,0,30,5,8,0,13,4,30,4,9,0,13,0,30,7,2,0,9,1,-15,3,1
2,0,27,1,30,15,0,0,15,4,30,2,0,0,2,0,30,2,13,0,15,4,30,3,12,0,15,5,30,6,0,0,6,1,-15,3,1
2,3,27,1,30,15,0,0,15,4,30,2,0,0,2,0,30,2,13,0,15,4,30,3,12,0,15,5,30,6,0,0,6,1,-15,3,1
2,4,31,5,30,5,7,0,12,6,30,8,0,0,8,8,30,7,5,0,12,0,30,3,9,0,12,0,30,3,3,0,6,1,-15,3,1
2,4,32,0,30,9,0,0,9,4,30,2,0,0,2,3,30,9,0,0,9,1,30,3,6,0,9,2,30,2,0,0,2,1,-15,3,1
2,1,33,7,30,2,9,0,11,5,30,4,0,0,4,1,30,10,1,0,11,2,30,3,8,0,11,4,30,4,0,0,4,1,-15,3,1
2,2,33,7,30,2,9,0,11,5,30,4,0,0,4,1,30,10,1,0,11,2,30,3,8,0,11,4,30,4,0,0,4,1,-15,3,1
2,3,33,7,30,2,9,0,11,5,30,4,0,0,4,1,30,10,1,0,11,2,30,3,8,0,11,4,30,4,0,0,4,1,-15,3,1
2,4,33,7,30,2,9,0,11,5,30,4,0,0,4,1,30,10,1,0,11,2,30,3,8,0,11,4,30,4,0,0,4,1,-15,3,1
2,3,35,0,30,8,5,0,13,3,30,2,0,0,2,1,30,2,11,0,13,5,30,1,12,0,13,6,30,8,0,0,8,1,-15,3,1
2,4,9,0,30,4,7,0,11,2,30,6,0,0,6,0,30,8,3,0,11,5,30,3,8,0,11,6,30,4,0,0,4,0,-27,3,0
2,0,19,1,30,2,11,0,13,3,30,4,4,0,8,2,30,8,5,0,13,3,30,4,9,0,13,3,30,8,1,0,9,1,-15,3,1
2,2,19,1,30,2,11,0,13,3,30,4,4,0,8,2,30,8,5,0,13,3,30,4,9,0,13,3,30,8,1,0,9,1,-15,3,1
2,4,19,1,30,2,11,0,13,3,30,4,4,0,8,2,30,8,5,0,13,3,30,4,9,0,13,3,30,8,1,0,9,1,-15,3,1
2,1,21,2,30,8,2,0,10,3,30,4,2,0,6,0,30,5,5,0,10,2,30,4,6,0,10,6,30,4,0,0,4,1,-15,3,1
2,2,21,2,30,8,2,0,10,3,30,4,2,0,6,0,30,5,5,0,10,2,30,4,6,0,10,6,30,4,0,0,4,1,-15,3,1
2,3,23,1,30,4,9,0,13,4,30,6,0,0,6,6,30,11,2,0,13,0,30,5,8,0,13,4,30,6,0,0,6,1,-15,3,1
2,2,25,1,30,4,10,0,14,4,30,6,0,0,6,0,30,9,5,0,14,1,30,9,5,0,14,3,30,6,0,0,6,1,-15,3,1
2,3,25,1,30,4,10,0,14,4,30,6,0,0,6,0,30,9,5,0,14,1,30,9,5,0,14,3,30,6,0,0,6,1,-15,3,1
2,4,25,1,30,4,10,0,14,4,30,6,0,0,6,0,30,9,5,0,14,1,30,9,5,0,14,3,30,6,0,0,6,1,-15,3,1
2,0,27,1,30,6,9,0,15,3,30,1,1,0,2,0,30,5,10,0,15,1,30,4,11,0,15,4,30,6,0,0,6,1,-15,3,1
2,4,27,1,30,6,9,0,15,3,30,1,1,0,2,0,30,5,10,0,15,0,30,4,11,0,15,4,30,6,0,0,6,1,-15,3,1
2,2,31,3,30,6,6,0,12,4,30,8,0,0,8,5,30,12,0,0,12,0,30,3,9,0,12,0,30,5,1,0,6,1,-15,3,1
2,4,31,3,30,6,6,0,12,4,30,8,0,0,8,5,30,12,0,0,12,0,30,3,9,0,12,0,30,5,1,0,6,1,-15,3,1
2,4,45,0,30,3,10,0,13,9,30,10,0,0,10,0,30,3,10,0,13,0,30,4,9,0,13,2,30,5,0,0,5,1,-15,3,1
2,4,1,0,30,7,3,0,10,5,30,2,0,0,2,0,30,3,7,0,10,3,30,7,3,0,10,5,30,6,0,0,6,0,-27,3,0
2,2,7,0,30,2,2,0,4,2,30,2,0,0,2,1,30,3,1,0,4,0,30,1,3,0,4,0,30,2,0,0,2,0,-27,3,0
2,4,7,0,30,2,2,0,4,2,30,2,0,0,2,1,30,3,1,0,4,0,30,1,3,0,4,0,30,2,0,0,2,0,-27,3,0
2,4,11,0,30,1,3,0,4,0,30,0,0,0,0,2,30,4,0,0,4,4,30,3,1,0,4,2,30,1,0,0,1,1,-15,3,1
2,3,13,8,30,7,0,0,7,0,30,4,0,0,4,2,30,5,2,0,7,1,30,6,1,0,7,5,30,4,0,0,4,1,-15,3,1
2,4,13,8,30,7,0,0,7,0,30,4,0,0,4,2,30,5,2,0,7,1,30,6,1,0,7,5,30,4,0,0,4,1,-15,3,1
2,3,23,1,30,6,7,0,13,2,30,6,0,0,6,2,30,13,0,0,13,3,30,6,7,0,13,2,30,6,0,0,6,1,-15,3,1
2,2,25,3,30,3,11,0,14,5,30,6,0,0,6,0,30,9,5,0,14,1,30,5,9,0,14,3,30,5,1,0,6,1,-15,3,1
2,4,25,3,30,3,11,0,14,5,30,6,0,0,6,0,30,9,5,0,14,1,30,5,9,0,14,0,30,5,1,0,6,1,-15,3,1
2,1,27,1,30,10,5,0,15,2,30,2,0,0,2,0,30,4,11,0,15,0,30,5,10,0,15,1,30,6,0,0,6,1,-15,3,1
2,2,27,1,30,10,5,0,15,2,30,2,0,0,2,0,30,4,11,0,15,0,30,5,10,0,15,1,30,6,0,0,6,1,-15,3,1
2,0,47,0,30,2,12,0,14,7,30,4,0,0,4,0,30,3,11,0,14,0,30,8,6,0,14,7,30,7,0,0,7,1,-15,3,1
2,2,47,0,30,2,12,0,14,7,30,4,0,0,4,0,30,3,11,0,14,0,30,8,6,0,14,7,30,7,0,0,7,1,-15,3,1
2,2,1,0,30,7,3,0,10,4,30,2,0,0,2,1,30,4,6,0,10,3,30,7,3,0,10,2,30,6,0,0,6,0,-27,3,0
2,3,6,1,30,7,2,0,9,4,30,2,0,0,2,0,30,2,7,0,9,0,30,4,5,0,9,3,30,5,0,0,5,0,-27,3,0
2,1,11,1,30,6,6,0,12,0,30,4,0,0,4,0,30,9,3,0,12,4,30,7,5,0,12,6,30,4,0,0,4,1,-15,3,1
2,3,11,1,30,6,6,0,12,0,30,4,0,0,4,0,30,9,3,0,12,4,30,7,5,0,12,6,30,4,0,0,4,1,-15,3,1
2,4,11,1,30,6,6,0,12,0,30,4,0,0,4,0,30,9,3,0,12,4,30,7,5,0,12,6,30,4,0,0,4,1,-15,3,1
2,3,25,1,30,6,8,0,14,5,30,6,0,0,6,0,30,8,6,0,14,0,30,5,9,0,14,3,30,6,0,0,6,1,-15,3,1
2,1,27,1,30,6,9,0,15,0,30,2,0,0,2,0,30,7,8,0,15,4,30,3,12,0,15,1,30,5,1,0,6,1,-15,3,1
2,0,29,0,30,6,8,0,14,6,30,11,1,0,12,0,30,3,11,0,14,0,30,1,13,0,14,5,30,9,0,0,9,1,-15,3,1
2,4,29,0,30,6,8,0,14,6,30,11,1,0,12,0,30,3,11,0,14,0,30,1,13,0,14,1,30,9,0,0,9,1,-15,3,1
2,3,4,2,30,5,3,0,8,4,30,4,0,0,4,0,30,5,3,0,8,1,30,7,1,0,8,1,30,4,0,0,4,0,-27,3,0
2,4,4,2,30,5,3,0,8,4,30,4,0,0,4,0,30,5,3,0,8,1,30,7,1,0,8,1,30,4,0,0,4,0,-27,3,0
2,2,6,1,30,7,2,0,9,3,30,2,0,0,2,0,30,6,3,0,9,0,30,3,6,0,9,0,30,4,1,0,5,0,-27,3,0
2,4,6,1,30,7,2,0,9,3,30,2,0,0,2,0,30,6,3,0,9,0,30,3,6,0,9,0,30,4,1,0,5,0,-27,3,0
2,3,7,0,30,2,2,0,4,2,30,2,0,0,2,0,30,2,2,0,4,0,30,1,3,0,4,2,30,1,1,0,2,0,-27,3,0
2,1,13,4,30,7,0,0,7,0,30,4,0,0,4,2,30,5,2,0,7,6,30,5,2,0,7,1,30,4,0,0,4,1,-15,3,1
2,2,13,4,30,7,0,0,7,0,30,4,0,0,4,2,30,5,2,0,7,6,30,5,2,0,7,1,30,4,0,0,4,1,-15,3,1
2,3,13,4,30,7,0,0,7,0,30,4,0,0,4,2,30,5,2,0,7,6,30,5,2,0,7,1,30,4,0,0,4,1,-15,3,1
2,2,15,0,30,6,7,0,13,0,30,6,0,0,6,0,30,3,10,0,13,1,30,4,9,0,13,2,30,5,4,0,9,1,-15,3,1
2,3,19,0,30,3,10,0,13,2,30,6,2,0,8,0,30,7,6,0,13,0,30,3,10,0,13,1,30,9,0,0,9,1,-15,3,1
2,4,19,0,30,3,10,0,13,2,30,6,2,0,8,0,30,7,6,0,13,0,30,3,10,0,13,1,30,9,0,0,9,1,-15,3,1
2,3,22,1,30,6,2,0,8,2,30,2,0,0,2,0,30,5,3,0,8,1,30,5,3,0,8,6,30,4,0,0,4,1,-15,3,1
2,1,27,0,30,6,9,0,15,3,30,2,0,0,2,0,30,5,10,0,15,4,30,4,11,0,15,0,30,5,1,0,6,1,-15,3,1
2,4,27,0,30,6,9,0,15,3,30,2,0,0,2,0,30,5,10,0,15,4,30,4,11,0,15,0,30,5,1,0,6,1,-15,3,1
2,4,32,0,30,7,2,0,9,5,30,2,0,0,2,0,30,5,4,0,9,1,30,3,6,0,9,2,30,2,0,0,2,1,-15,3,1
2,1,39,3,30,5,6,0,11,5,30,6,0,0,6,0,30,10,1,0,11,2,30,2,9,0,11,3,30,5,0,0,5,1,-15,3,1
2,2,39,3,30,5,6,0,11,5,30,6,0,0,6,0,30,10,1,0,11,2,30,2,9,0,11,3,30,5,0,0,5,1,-15,3,1
2,3,8,2,30,7,0,0,7,4,30,2,0,0,2,0,30,1,6,0,7,0,30,5,2,0,7,0,30,3,0,0,3,0,-27,3,0
2,2,17,3,30,9,5,0,14,4,30,6,0,0,6,0,30,4,10,0,14,1,30,10,4,0,14,3,30,4,0,0,4,1,-15,3,1
2,4,17,3,30,9,5,0,14,4,30,6,0,0,6,0,30,4,10,0,14,1,30,10,4,0,14,3,30,4,0,0,4,1,-15,3,1
2,2,19,1,30,5,8,0,13,2,30,5,3,0,8,0,30,6,7,0,13,0,30,8,5,0,13,0,30,9,0,0,9,1,-15,3,1
2,1,23,1,30,5,8,0,13,2,30,6,0,0,6,7,30,13,0,0,13,0,30,5,8,0,13,2,30,6,0,0,6,1,-15,3,1
2,2,25,1,30,10,4,0,14,4,30,6,0,0,6,0,30,6,8,0,14,1,30,9,5,0,14,3,30,5,1,0,6,1,-15,3,1
2,0,26,0,30,5,4,0,9,5,30,4,0,0,4,2,30,0,9,0,9,0,30,3,6,0,9,4,30,3,0,0,3,1,-15,3,1
2,4,26,0,30,5,4,0,9,5,30,4,0,0,4,2,30,0,9,0,9,0,30,3,6,0,9,4,30,3,0,0,3,1,-15,3,1
2,2,27,1,30,6,9,0,15,0,30,2,0,0,2,0,30,6,9,0,15,2,30,4,11,0,15,0,30,5,1,0,6,1,-15,3,1
2,3,27,1,30,6,9,0,15,0,30,2,0,0,2,0,30,6,9,0,15,2,30,4,11,0,15,0,30,5,1,0,6,1,-15,3,1
2,4,27,1,30,6,9,0,15,0,30,2,0,0,2,0,30,6,9,0,15,2,30,4,11,0,15,0,30,5,1,0,6,1,-15,3,1
2,0,29,0,30,7,7,0,14,6,30,12,0,0,12,0,30,4,10,0,14,0,30,1,13,0,14,1,30,9,0,0,9,1,-15,3,1
2,1,29,0,30,7,7,0,14,6,30,12,0,0,12,0,30,4,10,0,14,0,30,1,13,0,14,1,30,9,0,0,9,1,-15,3,1
2,3,39,0,30,2,9,0,11,6,30,6,0,0,6,0,30,7,4,0,11,0,30,4,7,0,11,5,30,5,0,0,5,1,-15,3,1
2,4,39,0,30,2,9,0,11,6,30,6,0,0,6,0,30,7,4,0,11,0,30,4,7,0,11,5,30,5,0,0,5,1,-15,3,1
2,1,13,3,30,7,0,0,7,1,30,4,0,0,4,2,30,6,1,0,7,3,30,6,1,0,7,5,30,4,0,0,4,1,-15,3,1
2,1,19,0,30,2,11,0,13,2,30,5,3,0,8,0,30,5,8,0,13,4,30,5,8,0,13,1,30,9,0,0,9,1,-15,3,1
2,4,23,2,30,5,8,0,13,1,30,6,0,0,6,7,30,11,2,0,13,0,30,5,8,0,13,2,30,6,0,0,6,1,-15,3,1
2,2,25,2,30,5,9,0,14,3,30,6,0,0,6,0,30,10,4,0,14,1,30,5,9,0,14,3,30,5,1,0,6,1,-15,3,1
2,1,27,1,30,4,11,0,15,2,30,2,0,0,2,0,30,6,9,0,15,2,30,5,10,0,15,6,30,6,0,0,6,1,-15,3,1
2,0,29,0,30,4,10,0,14,4,30,11,1,0,12,0,30,3,11,0,14,0,30,2,12,0,14,3,30,9,0,0,9,1,-15,3,1
2,2,29,0,30,4,10,0,14,4,30,11,1,0,12,0,30,3,11,0,14,0,30,2,12,0,14,3,30,9,0,0,9,1,-15,3,1
2,2,43,0,30,4,10,0,14,7,30,6,0,0,6,0,30,4,10,0,14,1,30,1,13,0,14,7,30,5,0,0,5,1,-15,3,1
2,3,43,0,30,4,10,0,14,7,30,6,0,0,6,0,30,4,10,0,14,1,30,1,13,0,14,7,30,5,0,0,5,1,-15,3,1
2,1,13,1,30,6,1,0,7,0,30,4,0,0,4,2,30,7,0,0,7,6,30,6,1,0,7,4,30,4,0,0,4,1,-15,3,1
2,4,13,0,30,6,1,0,7,0,30,4,0,0,4,2,30,7,0,0,7,6,30,6,1,0,7,4,30,4,0,0,4,1,-15,3,1
2,4,17,5,30,10,4,0,14,3,30,6,0,0,6,0,30,6,8,0,14,1,30,5,9,0,14,3,30,4,0,0,4,1,-15,3,1
2,1,19,0,30,4,9,0,13,2,30,6,2,0,8,0,30,4,9,0,13,9,30,7,6,0,13,0,30,7,2,0,9,1,-15,3,1
2,4,22,6,30,8,0,0,8,4,30,2,0,0,2,0,30,4,4,0,8,0,30,4,4,0,8,0,30,1,3,0,4,1,-15,3,1
2,4,23,1,30,10,3,0,13,2,30,6,0,0,6,2,30,11,2,0,13,0,30,4,9,0,13,1,30,6,0,0,6,1,-15,3,1
2,3,25,3,30,6,8,0,14,4,30,6,0,0,6,0,30,7,7,0,14,1,30,5,9,0,14,7,30,5,1,0,6,1,-15,3,1
2,1,5,0,30,3,2,0,5,3,30,3,1,0,4,1,30,0,5,0,5,0,30,1,4,0,5,0,30,0,2,0,2,0,-27,3,0
2,2,11,0,30,5,7,0,12,0,30,4,0,0,4,0,30,8,4,0,12,7,30,4,8,0,12,4,30,4,0,0,4,1,-15,3,1
2,3,13,2,30,6,1,0,7,0,30,4,0,0,4,3,30,7,0,0,7,4,30,7,0,0,7,5,30,4,0,0,4,1,-15,3,1
2,3,17,2,30,8,6,0,14,3,30,6,0,0,6,0,30,5,9,0,14,0,30,10,4,0,14,5,30,4,0,0,4,1,-15,3,1
2,2,19,1,30,4,9,0,13,2,30,7,1,0,8,0,30,8,5,0,13,0,30,3,10,0,13,0,30,9,0,0,9,1,-15,3,1
2,4,19,1,30,4,9,0,13,2,30,7,1,0,8,0,30,8,5,0,13,0,30,3,10,0,13,0,30,9,0,0,9,1,-15,3,1
2,3,23,2,30,4,9,0,13,2,30,6,0,0,6,2,30,13,0,0,13,0,30,6,7,0,13,2,30,6,0,0,6,1,-15,3,1
2,4,23,2,30,4,9,0,13,2,30,6,0,0,6,2,30,13,0,0,13,0,30,6,7,0,13,2,30,6,0,0,6,1,-15,3,1
2,3,25,1,30,5,9,0,14,5,30,6,0,0,6,0,30,8,6,0,14,1,30,7,7,0,14,4,30,6,0,0,6,1,-15,3,1
2,4,25,1,30,5,9,0,14,5,30,6,0,0,6,0,30,8,6,0,14,1,30,7,7,0,14,4,30,6,0,0,6,1,-15,3,1
2,1,27,1,30,4,11,0,15,5,30,2,0,0,2,4,30,4,11,0,15,0,30,4,11,0,15,1,30,2,4,0,6,1,-15,3,1
2,2,27,1,30,4,11,0,15,5,30,2,0,0,2,4,30,4,11,0,15,0,30,4,11,0,15,1,30,2,4,0,6,1,-15,3,1
2,4,27,0,30,4,11,0,15,5,30,2,0,0,2,4,30,4,11,0,15,0,30,4,11,0,15,1,30,2,4,0,6,1,-15,3,1
2,2,29,0,30,6,8,0,14,6,30,11,1,0,12,0,30,8,6,0,14,0,30,1,13,0,14,4,30,9,0,0,9,1,-15,3,1
2,1,5,0,30,2,3,0,5,3,30,0,4,0,4,0,30,0,5,0,5,0,30,1,4,0,5,1,30,2,0,0,2,0,-27,3,0
2,2,13,3,30,7,0,0,7,0,30,4,0,0,4,6,30,7,0,0,7,6,30,6,1,0,7,3,30,4,0,0,4,1,-15,3,1
2,4,13,3,30,7,0,0,7,0,30,4,0,0,4,6,30,7,0,0,7,6,30,6,1,0,7,0,30,4,0,0,4,1,-15,3,1
2,4,15,0,30,3,10,0,13,1,30,6,0,0,6,0,30,4,9,0,13,1,30,5,8,0,13,2,30,9,0,0,9,1,-15,3,1
2,2,19,0,30,3,10,0,13,2,30,4,4,0,8,0,30,4,9,0,13,0,30,6,7,0,13,1,30,9,0,0,9,1,-15,3,1
2,4,19,0,30,3,10,0,13,2,30,4,4,0,8,0,30,4,9,0,13,0,30,6,7,0,13,1,30,9,0,0,9,1,-15,3,1
2,4,25,1,30,6,8,0,14,1,30,6,0,0,6,0,30,11,3,0,14,1,30,5,9,0,14,3,30,5,1,0,6,1,-15,3,1
2,3,31,4,30,6,6,0,12,5,30,8,0,0,8,4,30,12,0,0,12,0,30,3,9,0,12,1,30,6,0,0,6,1,-15,3,1
2,2,4,4,30,7,1,0,8,3,30,4,0,0,4,0,30,1,7,0,8,0,30,2,6,0,8,3,30,4,0,0,4,0,-27,3,0
2,1,13,2,30,6,1,0,7,0,30,4,0,0,4,2,30,6,1,0,7,8,30,5,2,0,7,5,30,4,0,0,4,1,-15,3,1
2,2,13,2,30,6,1,0,7,0,30,4,0,0,4,2,30,6,1,0,7,8,30,5,2,0,7,5,30,4,0,0,4,1,-15,3,1
2,0,17,3,30,9,5,0,14,2,30,6,0,0,6,0,30,4,10,0,14,1,30,5,9,0,14,6,30,3,1,0,4,1,-15,3,1
2,3,17,3,30,9,5,0,14,2,30,6,0,0,6,0,30,4,10,0,14,1,30,5,9,0,14,6,30,3,1,0,4,1,-15,3,1
2,4,17,3,30,9,5,0,14,2,30,6,0,0,6,0,30,4,10,0,14,1,30,5,9,0,14,6,30,3,1,0,4,1,-15,3,1
2,0,4,2,30,7,1,0,8,4,30,4,0,0,4,0,30,3,5,0,8,2,30,4,4,0,8,1,30,3,1,0,4,0,-27,3,0
2,1,4,2,30,7,1,0,8,4,30,4,0,0,4,0,30,3,5,0,8,2,30,4,4,0,8,1,30,3,1,0,4,0,-27,3,0
2,4,7,0,30,2,2,0,4,2,30,2,0,0,2,0,30,1,3,0,4,0,30,0,4,0,4,2,30,2,0,0,2,0,-27,3,0
2,1,11,3,30,8,4,0,12,1,30,4,0,0,4,2,30,7,5,0,12,3,30,4,8,0,12,2,30,4,0,0,4,1,-15,3,1
2,4,11,3,30,8,4,0,12,1,30,4,0,0,4,2,30,7,5,0,12,3,30,4,8,0,12,0,30,4,0,0,4,1,-15,3,1
2,4,15,0,30,2,11,0,13,1,30,6,0,0,6,0,30,6,7,0,13,1,30,5,8,0,13,3,30,9,0,0,9,1,-15,3,1
2,3,19,1,30,6,7,0,13,2,30,8,0,0,8,0,30,4,9,0,13,0,30,5,8,0,13,2,30,8,1,0,9,1,-15,3,1
2,2,26,4,30,9,0,0,9,4,30,1,3,0,4,2,30,0,9,0,9,0,30,2,7,0,9,4,30,1,2,0,3,1,-15,3,1
2,4,27,1,30,5,10,0,15,3,30,2,0,0,2,0,30,7,8,0,15,3,30,4,11,0,15,1,30,6,0,0,6,1,-15,3,1
2,2,35,2,30,11,2,0,13,6,30,2,0,0,2,1,30,3,10,0,13,0,30,3,10,0,13,8,30,8,0,0,8,1,-15,3,1
2,3,35,2,30,11,2,0,13,6,30,2,0,0,2,1,30,3,10,0,13,0,30,3,10,0,13,8,30,8,0,0,8,1,-15,3,1
2,4,15,0,30,3,10,0,13,1,30,6,0,0,6,0,30,3,10,0,13,1,30,5,8,0,13,1,30,9,0,0,9,1,-15,3,1
2,3,25,0,30,7,7,0,14,4,30,6,0,0,6,1,30,8,6,0,14,1,30,5,9,0,14,3,30,5,1,0,6,1,-15,3,1
2,2,27,1,30,4,11,0,15,3,30,2,0,0,2,0,30,5,10,0,15,0,30,4,11,0,15,0,30,5,1,0,6,1,-15,3,1
2,3,27,1,30,4,11,0,15,3,30,2,0,0,2,0,30,5,10,0,15,0,30,4,11,0,15,0,30,5,1,0,6,1,-15,3,1
2,3,29,0,30,7,7,0,14,6,30,10,2,0,12,0,30,3,11,0,14,0,30,7,7,0,14,4,30,9,0,0,9,1,-15,3,1
2,4,29,0,30,7,7,0,14,6,30,10,2,0,12,0,30,3,11,0,14,0,30,7,7,0,14,4,30,9,0,0,9,1,-15,3,1
2,4,31,2,30,3,9,0,12,5,30,8,0,0,8,6,30,10,2,0,12,0,30,3,9,0,12,2,30,5,1,0,6,1,-15,3,1
2,3,8,0,30,7,0,0,7,3,30,2,0,0,2,4,30,3,4,0,7,0,30,5,2,0,7,2,30,3,0,0,3,0,-27,3,0
2,1,13,4,30,7,0,0,7,0,30,4,0,0,4,2,30,5,2,0,7,9,30,5,2,0,7,4,30,4,0,0,4,1,-15,3,1
2,2,13,4,30,7,0,0,7,0,30,4,0,0,4,2,30,5,2,0,7,9,30,5,2,0,7,4,30,4,0,0,4,1,-15,3,1
2,4,13,4,30,7,0,0,7,0,30,4,0,0,4,2,30,5,2,0,7,9,30,5,2,0,7,4,30,4,0,0,4,1,-15,3,1
2,2,17,3,30,11,3,0,14,3,30,6,0,0,6,0,30,5,9,0,14,1,30,6,8,0,14,4,30,4,0,0,4,1,-15,3,1
2,3,17,3,30,11,3,0,14,3,30,6,0,0,6,0,30,5,9,0,14,1,30,6,8,0,14,4,30,4,0,0,4,1,-15,3,1
2,4,17,3,30,11,3,0,14,3,30,6,0,0,6,0,30,5,9,0,14,1,30,6,8,0,14,4,30,4,0,0,4,1,-15,3,1
2,3,19,0,30,4,9,0,13,2,30,5,3,0,8,1,30,4,9,0,13,0,30,6,7,0,13,0,30,8,1,0,9,1,-15,3,1
2,4,22,2,30,5,3,0,8,3,30,2,0,0,2,0,30,3,5,0,8,0,30,5,3,0,8,1,30,4,0,0,4,1,-15,3,1
2,3,27,1,30,4,11,0,15,3,30,2,0,0,2,0,30,8,7,0,15,3,30,5,10,0,15,0,30,6,0,0,6,1,-15,3,1
2,3,29,0,30,7,7,0,14,6,30,9,3,0,12,0,30,3,11,0,14,0,30,6,8,0,14,3,30,9,0,0,9,1,-15,3,1
2,4,29,0,30,7,7,0,14,6,30,9,3,0,12,0,30,3,11,0,14,0,30,6,8,0,14,3,30,9,0,0,9,1,-15,3,1
2,3,33,7,30,5,6,0,11,5,30,4,0,0,4,3,30,7,4,0,11,0,30,3,8,0,11,5,30,4,0,0,4,1,-15,3,1
2,4,38,0,30,1,9,0,10,6,30,6,0,0,6,4,30,6,4,0,10,0,30,4,6,0,10,0,30,6,0,0,6,1,-15,3,1
2,4,5,0,30,0,5,0,5,3,30,3,1,0,4,0,30,0,5,0,5,0,30,1,4,0,5,0,30,2,0,0,2,0,-27,3,0
2,3,8,2,30,7,0,0,7,3,30,2,0,0,2,3,30,6,1,0,7,3,30,6,1,0,7,3,30,3,0,0,3,0,-27,3,0
2,4,8,2,30,7,0,0,7,3,30,2,0,0,2,3,30,6,1,0,7,3,30,6,1,0,7,3,30,3,0,0,3,0,-27,3,0
2,4,15,1,30,2,11,0,13,1,30,6,0,0,6,0,30,5,8,0,13,1,30,6,7,0,13,2,30,7,2,0,9,1,-15,3,1
2,3,17,3,30,11,3,0,14,4,30,6,0,0,6,0,30,2,12,0,14,1,30,8,6,0,14,3,30,4,0,0,4,1,-15,3,1
2,3,19,0,30,4,9,0,13,2,30,7,1,0,8,0,30,8,5,0,13,1,30,3,10,0,13,2,30,8,1,0,9,1,-15,3,1
2,4,19,0,30,4,9,0,13,2,30,7,1,0,8,0,30,8,5,0,13,1,30,3,10,0,13,2,30,8,1,0,9,1,-15,3,1
2,4,22,1,30,5,3,0,8,3,30,2,0,0,2,4,30,4,4,0,8,1,30,6,2,0,8,0,30,2,2,0,4,1,-15,3,1
2,3,23,2,30,3,10,0,13,3,30,6,0,0,6,0,30,11,2,0,13,0,30,8,5,0,13,2,30,6,0,0,6,1,-15,3,1
2,4,23,2,30,3,10,0,13,3,30,6,0,0,6,0,30,11,2,0,13,0,30,8,5,0,13,2,30,6,0,0,6,1,-15,3,1
2,2,25,2,30,9,5,0,14,2,30,6,0,0,6,0,30,8,6,0,14,3,30,5,9,0,14,3,30,6,0,0,6,1,-15,3,1
2,3,25,2,30,9,5,0,14,2,30,6,0,0,6,0,30,8,6,0,14,3,30,5,9,0,14,3,30,6,0,0,6,1,-15,3,1
2,4,25,2,30,9,5,0,14,2,30,6,0,0,6,0,30,8,6,0,14,3,30,5,9,0,14,3,30,6,0,0,6,1,-15,3,1
2,4,27,3,30,4,11,0,15,4,30,2,0,0,2,0,30,6,9,0,15,0,30,6,9,0,15,1,30,5,1,0,6,1,-15,3,1
2,4,6,0,30,8,1,0,9,4,30,2,0,0,2,0,30,2,7,0,9,0,30,3,6,0,9,3,30,5,0,0,5,0,-27,3,0
2,3,17,3,30,11,3,0,14,3,30,6,0,0,6,0,30,6,8,0,14,3,30,7,7,0,14,6,30,4,0,0,4,1,-15,3,1
2,2,19,0,30,4,9,0,13,2,30,3,5,0,8,0,30,6,7,0,13,4,30,5,8,0,13,3,30,9,0,0,9,1,-15,3,1
2,3,19,0,30,4,9,0,13,2,30,3,5,0,8,0,30,6,7,0,13,4,30,5,8,0,13,3,30,9,0,0,9,1,-15,3,1
2,3,23,1,30,4,9,0,13,5,30,6,0,0,6,0,30,7,6,0,13,1,30,6,7,0,13,5,30,6,0,0,6,1,-15,3,1
2,2,27,1,30,10,5,0,15,3,30,2,0,0,2,2,30,7,8,0,15,0,30,4,11,0,15,2,30,3,3,0,6,1,-15,3,1
2,3,27,1,30,10,5,0,15,3,30,2,0,0,2,2,30,7,8,0,15,0,30,4,11,0,15,2,30,3,3,0,6,1,-15,3,1
2,4,27,1,30,10,5,0,15,3,30,2,0,0,2,2,30,7,8,0,15,0,30,4,11,0,15,2,30,3,3,0,6,1,-15,3,1
2,4,3,0,30,0,4,0,4,2,30,4,0,0,4,0,30,0,4,0,4,0,30,1,3,0,4,0,30,3,0,0,3,0,-27,3,0
2,2,4,2,30,8,0,0,8,5,30,2,2,0,4,0,30,2,6,0,8,0,30,5,3,0,8,1,30,4,0,0,4,0,-27,3,0
2,3,4,2,30,8,0,0,8,5,30,2,2,0,4,0,30,2,6,0,8,0,30,5,3,0,8,1,30,4,0,0,4,0,-27,3,0
2,2,13,2,30,5,2,0,7,0,30,4,0,0,4,2,30,7,0,0,7,9,30,6,1,0,7,5,30,4,0,0,4,1,-15,3,1
2,4,13,2,30,5,2,0,7,0,30,4,0,0,4,2,30,7,0,0,7,9,30,6,1,0,7,5,30,4,0,0,4,1,-15,3,1
2,0,19,1,30,3,10,0,13,3,30,6,2,0,8,0,30,4,9,0,13,6,30,6,7,0,13,0,30,9,0,0,9,1,-15,3,1
2,3,19,1,30,3,10,0,13,3,30,6,2,0,8,0,30,4,9,0,13,6,30,6,7,0,13,0,30,9,0,0,9,1,-15,3,1
2,2,23,1,30,6,7,0,13,3,30,6,0,0,6,1,30,9,4,0,13,4,30,10,3,0,13,3,30,6,0,0,6,1,-15,3,1
2,3,23,1,30,6,7,0,13,3,30,6,0,0,6,1,30,9,4,0,13,4,30,10,3,0,13,3,30,6,0,0,6,1,-15,3,1
2,2,25,1,30,10,4,0,14,4,30,6,0,0,6,0,30,5,9,0,14,1,30,6,8,0,14,4,30,4,2,0,6,1,-15,3,1
2,0,26,0,30,8,1,0,9,5,30,4,0,0,4,5,30,0,9,0,9,0,30,2,7,0,9,5,30,3,0,0,3,1,-15,3,1
2,1,27,1,30,10,5,0,15,3,30,2,0,0,2,0,30,5,10,0,15,0,30,3,12,0,15,1,30,3,3,0,6,1,-15,3,1
2,3,27,1,30,10,5,0,15,2,30,2,0,0,2,0,30,5,10,0,15,0,30,3,12,0,15,1,30,3,3,0,6,1,-15,3,1
2,4,27,1,30,10,5,0,15,2,30,2,0,0,2,0,30,5,10,0,15,0,30,3,12,0,15,1,30,3,3,0,6,1,-15,3,1
2,2,29,0,30,7,7,0,14,6,30,10,2,0,12,0,30,4,10,0,14,0,30,3,11,0,14,1,30,9,0,0,9,1,-15,3,1
2,3,29,0,30,7,7,0,14,6,30,10,2,0,12,0,30,4,10,0,14,0,30,3,11,0,14,1,30,9,0,0,9,1,-15,3,1
2,4,31,2,30,11,1,0,12,4,30,8,0,0,8,3,30,8,4,0,12,0,30,3,9,0,12,0,30,2,4,0,6,1,-15,3,1
2,1,4,2,30,5,3,0,8,5,30,4,0,0,4,1,30,1,7,0,8,0,30,8,0,0,8,1,30,4,0,0,4,0,-27,3,0
2,0,11,0,30,3,9,0,12,0,30,3,1,0,4,0,30,6,6,0,12,7,30,7,5,0,12,7,30,4,0,0,4,1,-15,3,1
2,2,11,0,30,3,9,0,12,0,30,3,1,0,4,0,30,6,6,0,12,7,30,7,5,0,12,7,30,4,0,0,4,1,-15,3,1
2,3,13,0,30,6,1,0,7,0,30,4,0,0,4,2,30,6,1,0,7,4,30,6,1,0,7,4,30,4,0,0,4,1,-15,3,1
2,1,19,0,30,2,11,0,13,2,30,6,2,0,8,0,30,7,6,0,13,0,30,3,10,0,13,1,30,9,0,0,9,1,-15,3,1
2,2,19,0,30,2,11,0,13,2,30,6,2,0,8,0,30,7,6,0,13,0,30,3,10,0,13,1,30,9,0,0,9,1,-15,3,1
2,3,25,1,30,11,3,0,14,3,30,6,0,0,6,0,30,10,4,0,14,1,30,5,9,0,14,1,30,5,1,0,6,1,-15,3,1
2,4,25,1,30,11,3,0,14,3,30,6,0,0,6,0,30,10,4,0,14,1,30,5,9,0,14,1,30,5,1,0,6,1,-15,3,1
2,4,8,3,30,7,0,0,7,4,30,2,0,0,2,3,30,5,2,0,7,0,30,4,3,0,7,2,30,3,0,0,3,0,-27,3,0
2,1,13,3,30,7,0,0,7,2,30,4,0,0,4,2,30,6,1,0,7,4,30,6,1,0,7,4,30,4,0,0,4,1,-15,3,1
2,2,13,3,30,7,0,0,7,2,30,4,0,0,4,2,30,6,1,0,7,4,30,6,1,0,7,4,30,4,0,0,4,1,-15,3,1
2,4,13,3,30,7,0,0,7,2,30,4,0,0,4,2,30,6,1,0,7,4,30,6,1,0,7,4,30,4,0,0,4,1,-15,3,1
2,3,19,0,30,5,8,0,13,0,30,5,3,0,8,0,30,5,8,0,13,2,30,6,7,0,13,2,30,9,0,0,9,1,-15,3,1
2,4,19,0,30,5,8,0,13,0,30,5,3,0,8,0,30,5,8,0,13,2,30,6,7,0,13,2,30,9,0,0,9,1,-15,3,1
2,2,21,2,30,6,4,0,10,4,30,6,0,0,6,1,30,3,7,0,10,4,30,5,5,0,10,2,30,4,0,0,4,1,-15,3,1
2,3,21,2,30,6,4,0,10,4,30,6,0,0,6,1,30,3,7,0,10,4,30,5,5,0,10,2,30,4,0,0,4,1,-15,3,1
2,1,23,2,30,5,8,0,13,2,30,6,0,0,6,6,30,13,0,0,13,0,30,5,8,0,13,2,30,5,1,0,6,1,-15,3,1
2,2,23,2,30,5,8,0,13,2,30,6,0,0,6,6,30,13,0,0,13,0,30,5,8,0,13,2,30,5,1,0,6,1,-15,3,1
2,4,23,2,30,5,8,0,13,2,30,6,0,0,6,6,30,13,0,0,13,0,30,5,8,0,13,2,30,5,1,0,6,1,-15,3,1
2,3,25,1,30,6,8,0,14,4,30,6,0,0,6,0,30,5,9,0,14,1,30,8,6,0,14,4,30,5,1,0,6,1,-15,3,1
2,3,27,1,30,6,9,0,15,4,30,2,0,0,2,2,30,5,10,0,15,0,30,4,11,0,15,1,30,3,3,0,6,1,-15,3,1
2,4,27,1,30,6,9,0,15,4,30,2,0,0,2,2,30,5,10,0,15,0,30,4,11,0,15,1,30,3,3,0,6,1,-15,3,1
2,2,4,2,30,7,1,0,8,5,30,4,0,0,4,0,30,2,6,0,8,2,30,6,2,0,8,1,30,3,1,0,4,0,-27,3,0
2,0,6,0,30,8,1,0,9,4,30,2,0,0,2,0,30,2,7,0,9,0,30,4,5,0,9,0,30,3,2,0,5,0,-27,3,0
2,3,9,1,30,9,2,0,11,3,30,6,0,0,6,3,30,6,5,0,11,5,30,3,8,0,11,0,30,2,2,0,4,0,-27,3,0
2,0,13,3,30,6,1,0,7,1,30,4,0,0,4,7,30,6,1,0,7,5,30,7,0,0,7,2,30,4,0,0,4,1,-15,3,1
2,3,13,3,30,6,1,0,7,0,30,4,0,0,4,7,30,6,1,0,7,5,30,7,0,0,7,2,30,4,0,0,4,1,-15,3,1
2,4,13,3,30,6,1,0,7,0,30,4,0,0,4,7,30,6,1,0,7,5,30,7,0,0,7,2,30,4,0,0,4,1,-15,3,1
2,3,17,9,30,8,6,0,14,4,30,6,0,0,6,0,30,4,10,0,14,2,30,4,10,0,14,9,30,4,0,0,4,1,-15,3,1
2,0,19,0,30,3,10,0,13,2,30,4,4,0,8,0,30,7,6,0,13,7,30,4,9,0,13,1,30,9,0,0,9,1,-15,3,1
2,4,19,0,30,3,10,0,13,0,30,4,4,0,8,0,30,7,6,0,13,7,30,4,9,0,13,0,30,9,0,0,9,1,-15,3,1
2,3,22,1,30,8,0,0,8,2,30,2,0,0,2,3,30,5,3,0,8,0,30,5,3,0,8,3,30,1,3,0,4,1,-15,3,1
2,4,22,1,30,8,0,0,8,2,30,2,0,0,2,3,30,5,3,0,8,0,30,5,3,0,8,3,30,1,3,0,4,1,-15,3,1
2,2,23,3,30,6,7,0,13,3,30,6,0,0,6,2,30,10,3,0,13,0,30,5,8,0,13,5,30,6,0,0,6,1,-15,3,1
2,4,23,3,30,6,7,0,13,3,30,6,0,0,6,2,30,10,3,0,13,0,30,5,8,0,13,5,30,6,0,0,6,1,-15,3,1
2,1,25,1,30,5,9,0,14,5,30,5,1,0,6,0,30,4,10,0,14,1,30,5,9,0,14,5,30,6,0,0,6,1,-15,3,1
2,2,25,1,30,5,9,0,14,5,30,5,1,0,6,0,30,4,10,0,14,1,30,5,9,0,14,5,30,6,0,0,6,1,-15,3,1
2,2,27,1,30,4,11,0,15,5,30,2,0,0,2,0,30,5,10,0,15,2,30,5,10,0,15,1,30,6,0,0,6,1,-15,3,1
2,3,27,1,30,4,11,0,15,5,30,2,0,0,2,0,30,5,10,0,15,2,30,5,10,0,15,1,30,6,0,0,6,1,-15,3,1
2,4,27,1,30,4,11,0,15,5,30,2,0,0,2,0,30,5,10,0,15,2,30,5,10,0,15,1,30,6,0,0,6,1,-15,3,1
2,4,29,0,30,7,7,0,14,6,30,9,3,0,12,0,30,2,12,0,14,0,30,7,7,0,14,0,30,7,2,0,9,1,-15,3,1
2,4,31,3,30,6,6,0,12,4,30,8,0,0,8,4,30,10,2,0,12,0,30,3,9,0,12,0,30,2,4,0,6,1,-15,3,1
2,3,33,1,30,2,9,0,11,5,30,4,0,0,4,5,30,9,2,0,11,1,30,4,7,0,11,6,30,4,0,0,4,1,-15,3,1
2,3,1,0,30,7,3,0,10,4,30,2,0,0,2,1,30,4,6,0,10,5,30,7,3,0,10,6,30,6,0,0,6,0,-27,3,0
2,3,5,0,30,2,3,0,5,3,30,1,3,0,4,5,30,1,4,0,5,0,30,1,4,0,5,0,30,0,2,0,2,0,-27,3,0
2,4,5,0,30,2,3,0,5,3,30,1,3,0,4,5,30,1,4,0,5,0,30,1,4,0,5,0,30,0,2,0,2,0,-27,3,0
2,3,8,0,30,7,0,0,7,4,30,2,0,0,2,3,30,2,5,0,7,0,30,6,1,0,7,7,30,3,0,0,3,0,-27,3,0
2,1,13,2,30,6,1,0,7,1,30,4,0,0,4,2,30,6,1,0,7,5,30,7,0,0,7,3,30,4,0,0,4,1,-15,3,1
2,3,13,2,30,6,1,0,7,1,30,4,0,0,4,2,30,6,1,0,7,5,30,7,0,0,7,3,30,4,0,0,4,1,-15,3,1
2,2,17,2,30,10,4,0,14,2,30,6,0,0,6,0,30,5,9,0,14,2,30,5,9,0,14,5,30,4,0,0,4,1,-15,3,1
2,3,17,2,30,10,4,0,14,2,30,6,0,0,6,0,30,5,9,0,14,2,30,5,9,0,14,5,30,4,0,0,4,1,-15,3,1
2,4,17,2,30,10,4,0,14,2,30,6,0,0,6,0,30,5,9,0,14,2,30,5,9,0,14,5,30,4,0,0,4,1,-15,3,1
2,3,23,1,30,7,6,0,13,3,30,6,0,0,6,8,30,13,0,0,13,0,30,5,8,0,13,3,30,6,0,0,6,1,-15,3,1
2,2,27,0,30,3,12,0,15,5,30,2,0,0,2,0,30,2,13,0,15,4,30,3,12,0,15,7,30,6,0,0,6,1,-15,3,1
2,4,3,3,30,2,2,0,4,3,30,4,0,0,4,0,30,0,4,0,4,0,30,0,4,0,4,0,30,1,2,0,3,0,-27,3,0
2,4,4,2,30,5,3,0,8,4,30,4,0,0,4,0,30,2,6,0,8,0,30,4,4,0,8,2,30,4,0,0,4,0,-27,3,0
2,3,6,0,30,4,5,0,9,4,30,2,0,0,2,0,30,2,7,0,9,2,30,4,5,0,9,1,30,5,0,0,5,0,-27,3,0
2,4,6,0,30,4,5,0,9,4,30,2,0,0,2,0,30,2,7,0,9,2,30,4,5,0,9,1,30,5,0,0,5,0,-27,3,0
2,3,8,2,30,7,0,0,7,3,30,2,0,0,2,0,30,3,4,0,7,0,30,4,3,0,7,3,30,3,0,0,3,0,-27,3,0
2,4,8,2,30,7,0,0,7,3,30,2,0,0,2,0,30,3,4,0,7,0,30,4,3,0,7,3,30,3,0,0,3,0,-27,3,0
2,2,9,0,30,2,2,0,4,2,30,2,0,0,2,0,30,2,2,0,4,2,30,4,0,0,4,3,30,1,0,0,1,0,-27,3,0
2,4,9,0,30,2,2,0,4,2,30,2,0,0,2,0,30,2,2,0,4,2,30,4,0,0,4,3,30,1,0,0,1,0,-27,3,0
2,2,13,1,30,7,0,0,7,0,30,4,0,0,4,2,30,6,1,0,7,8,30,6,1,0,7,2,30,4,0,0,4,1,-15,3,1
2,4,13,1,30,7,0,0,7,0,30,4,0,0,4,2,30,6,1,0,7,8,30,6,1,0,7,2,30,4,0,0,4,1,-15,3,1
2,1,15,2,30,4,9,0,13,0,30,6,0,0,6,0,30,3,10,0,13,1,30,3,10,0,13,2,30,6,3,0,9,1,-15,3,1
2,3,15,2,30,4,9,0,13,0,30,6,0,0,6,0,30,3,10,0,13,1,30,3,10,0,13,2,30,6,3,0,9,1,-15,3,1
2,0,26,1,30,8,1,0,9,4,30,4,0,0,4,2,30,3,6,0,9,0,30,2,7,0,9,5,30,3,0,0,3,1,-15,3,1
2,1,26,1,30,8,1,0,9,4,30,4,0,0,4,2,30,3,6,0,9,0,30,2,7,0,9,5,30,3,0,0,3,1,-15,3,1
2,2,26,1,30,8,1,0,9,4,30,4,0,0,4,2,30,3,6,0,9,0,30,2,7,0,9,5,30,3,0,0,3,1,-15,3,1
2,3,26,1,30,8,1,0,9,4,30,4,0,0,4,2,30,3,6,0,9,0,30,2,7,0,9,5,30,3,0,0,3,1,-15,3,1
2,4,26,1,30,8,1,0,9,4,30,4,0,0,4,2,30,3,6,0,9,0,30,2,7,0,9,5,30,3,0,0,3,1,-15,3,1
2,3,27,1,30,4,11,0,15,0,30,2,0,0,2,0,30,7,8,0,15,2,30,4,11,0,15,0,30,4,2,0,6,1,-15,3,1
2,3,29,0,30,9,5,0,14,4,30,8,4,0,12,0,30,3,11,0,14,0,30,2,12,0,14,0,30,8,1,0,9,1,-15,3,1
2,4,29,0,30,9,5,0,14,4,30,8,4,0,12,0,30,3,11,0,14,0,30,2,12,0,14,0,30,8,1,0,9,1,-15,3,1
2,3,30,2,30,3,2,0,5,5,30,2,0,0,2,4,30,1,4,0,5,6,30,1,4,0,5,0,30,2,1,0,3,1,-15,3,1
2,3,45,7,30,3,10,0,13,10,30,10,0,0,10,0,30,7,6,0,13,0,30,4,9,0,13,3,30,5,0,0,5,1,-15,3,1
2,4,45,7,30,3,10,0,13,10,30,10,0,0,10,0,30,7,6,0,13,0,30,4,9,0,13,3,30,5,0,0,5,1,-15,3,1
2,4,1,0,30,4,6,0,10,4,30,2,0,0,2,1,30,4,6,0,10,3,30,7,3,0,10,3,30,6,0,0,6,0,-27,3,0
2,4,6,0,30,5,4,0,9,4,30,2,0,0,2,0,30,2,7,0,9,3,30,4,5,0,9,0,30,5,0,0,5,0,-27,3,0
2,3,8,5,30,7,0,0,7,4,30,2,0,0,2,1,30,4,3,0,7,0,30,5,2,0,7,3,30,3,0,0,3,0,-27,3,0
2,2,9,0,30,7,4,0,11,3,30,6,0,0,6,1,30,6,5,0,11,1,30,3,8,0,11,4,30,4,0,0,4,0,-27,3,0
2,4,9,0,30,7,4,0,11,3,30,6,0,0,6,1,30,6,5,0,11,1,30,3,8,0,11,4,30,4,0,0,4,0,-27,3,0
2,3,19,0,30,4,9,0,13,1,30,6,2,0,8,0,30,7,6,0,13,2,30,6,7,0,13,2,30,7,2,0,9,1,-15,3,1
2,4,19,0,30,4,9,0,13,1,30,6,2,0,8,0,30,7,6,0,13,2,30,6,7,0,13,2,30,7,2,0,9,1,-15,3,1
2,0,21,3,30,7,3,0,10,4,30,4,2,0,6,0,30,3,7,0,10,5,30,5,5,0,10,3,30,4,0,0,4,1,-15,3,1
2,1,21,3,30,7,3,0,10,4,30,4,2,0,6,0,30,3,7,0,10,5,30,5,5,0,10,3,30,4,0,0,4,1,-15,3,1
2,4,21,3,30,7,3,0,10,4,30,4,2,0,6,0,30,3,7,0,10,5,30,5,5,0,10,3,30,4,0,0,4,1,-15,3,1
2,1,27,1,30,3,12,0,15,4,30,2,0,0,2,0,30,5,10,0,15,6,30,4,11,0,15,2,30,6,0,0,6,1,-15,3,1
2,4,27,1,30,3,12,0,15,4,30,2,0,0,2,0,30,5,10,0,15,0,30,4,11,0,15,2,30,6,0,0,6,1,-15,3,1
2,4,29,0,30,9,5,0,14,4,30,11,1,0,12,0,30,7,7,0,14,0,30,1,13,0,14,1,30,9,0,0,9,1,-15,3,1
2,2,39,0,30,5,6,0,11,7,30,6,0,0,6,0,30,4,7,0,11,1,30,2,9,0,11,3,30,5,0,0,5,1,-15,3,1
2,0,47,0,30,1,13,0,14,8,30,4,0,0,4,0,30,3,11,0,14,0,30,10,4,0,14,8,30,7,0,0,7,1,-15,3,1
2,2,47,0,30,1,13,0,14,8,30,4,0,0,4,0,30,3,11,0,14,0,30,10,4,0,14,8,30,7,0,0,7,1,-15,3,1
2,0,5,0,30,2,3,0,5,4,30,0,4,0,4,0,30,0,5,0,5,3,30,5,0,0,5,0,30,0,2,0,2,0,-27,3,0
2,2,5,0,30,2,3,0,5,4,30,0,4,0,4,0,30,0,5,0,5,3,30,5,0,0,5,0,30,0,2,0,2,0,-27,3,0
2,2,8,3,30,7,0,0,7,5,30,2,0,0,2,6,30,3,4,0,7,0,30,6,1,0,7,0,30,3,0,0,3,0,-27,3,0
2,3,8,3,30,7,0,0,7,5,30,2,0,0,2,6,30,3,4,0,7,0,30,6,1,0,7,0,30,3,0,0,3,0,-27,3,0
2,3,17,2,30,9,5,0,14,2,30,6,0,0,6,0,30,8,6,0,14,4,30,6,8,0,14,8,30,4,0,0,4,1,-15,3,1
2,2,19,0,30,3,10,0,13,3,30,8,0,0,8,0,30,4,9,0,13,7,30,6,7,0,13,1,30,9,0,0,9,1,-15,3,1
2,4,19,0,30,3,10,0,13,3,30,8,0,0,8,0,30,4,9,0,13,7,30,6,7,0,13,1,30,9,0,0,9,1,-15,3,1
2,0,27,2,30,5,10,0,15,3,30,1,1,0,2,0,30,7,8,0,15,0,30,4,11,0,15,2,30,6,0,0,6,1,-15,3,1
2,3,27,2,30,5,10,0,15,3,30,1,1,0,2,0,30,7,8,0,15,0,30,4,11,0,15,2,30,6,0,0,6,1,-15,3,1
2,2,31,2,30,7,5,0,12,4,30,8,0,0,8,5,30,11,1,0,12,0,30,3,9,0,12,0,30,6,0,0,6,1,-15,3,1
2,4,31,2,30,7,5,0,12,4,30,8,0,0,8,5,30,11,1,0,12,0,30,3,9,0,12,0,30,6,0,0,6,1,-15,3,1
2,2,43,0,30,5,9,0,14,10,30,6,0,0,6,0,30,4,10,0,14,1,30,9,5,0,14,7,30,5,0,0,5,1,-15,3,1
2,3,43,0,30,5,9,0,14,10,30,6,0,0,6,0,30,4,10,0,14,1,30,9,5,0,14,7,30,5,0,0,5,1,-15,3,1
2,3,47,0,30,1,13,0,14,4,30,4,0,0,4,0,30,14,0,0,14,0,30,2,12,0,14,4,30,7,0,0,7,1,-15,3,1
2,3,3,0,30,1,3,0,4,2,30,4,0,0,4,0,30,1,3,0,4,1,30,3,1,0,4,0,30,1,2,0,3,0,-27,3,0
2,4,3,0,30,1,3,0,4,2,30,4,0,0,4,0,30,1,3,0,4,1,30,3,1,0,4,0,30,1,2,0,3,0,-27,3,0
2,1,4,2,30,7,1,0,8,4,30,4,0,0,4,1,30,3,5,0,8,0,30,3,5,0,8,2,30,4,0,0,4,0,-27,3,0
2,4,22,5,30,8,0,0,8,3,30,2,0,0,2,0,30,4,4,0,8,0,30,3,5,0,8,1,30,1,3,0,4,1,-15,3,1
2,4,25,1,30,5,9,0,14,1,30,6,0,0,6,0,30,11,3,0,14,1,30,5,9,0,14,3,30,4,2,0,6,1,-15,3,1
2,1,27,1,30,4,11,0,15,5,30,2,0,0,2,0,30,6,9,0,15,0,30,5,10,0,15,5,30,6,0,0,6,1,-15,3,1
2,3,27,1,30,4,11,0,15,5,30,2,0,0,2,0,30,6,9,0,15,0,30,5,10,0,15,5,30,6,0,0,6,1,-15,3,1
2,4,27,1,30,4,11,0,15,5,30,2,0,0,2,0,30,6,9,0,15,0,30,5,10,0,15,5,30,6,0,0,6,1,-15,3,1
2,4,29,0,30,5,9,0,14,6,30,10,2,0,12,0,30,4,10,0,14,0,30,3,11,0,14,0,30,9,0,0,9,1,-15,3,1
2,0,31,3,30,6,6,0,12,8,30,8,0,0,8,3,30,4,8,0,12,0,30,9,3,0,12,4,30,6,0,0,6,1,-15,3,1
2,2,31,3,30,6,6,0,12,8,30,8,0,0,8,3,30,4,8,0,12,0,30,9,3,0,12,4,30,6,0,0,6,1,-15,3,1
2,4,3,0,30,0,4,0,4,2,30,4,0,0,4,2,30,1,3,0,4,2,30,4,0,0,4,0,30,2,1,0,3,0,-27,3,0
2,1,4,2,30,6,2,0,8,4,30,4,0,0,4,0,30,2,6,0,8,0,30,4,4,0,8,1,30,4,0,0,4,0,-27,3,0
2,3,4,2,30,6,2,0,8,4,30,4,0,0,4,0,30,2,6,0,8,0,30,4,4,0,8,1,30,4,0,0,4,0,-27,3,0
2,2,13,3,30,7,0,0,7,0,30,4,0,0,4,1,30,6,1,0,7,14,30,5,2,0,7,3,30,4,0,0,4,1,-15,3,1
2,4,13,3,30,7,0,0,7,0,30,4,0,0,4,1,30,6,1,0,7,14,30,5,2,0,7,3,30,4,0,0,4,1,-15,3,1
2,4,15,0,30,4,9,0,13,0,30,6,0,0,6,0,30,6,7,0,13,1,30,6,7,0,13,2,30,7,2,0,9,1,-15,3,1
2,2,17,3,30,11,3,0,14,2,30,6,0,0,6,0,30,6,8,0,14,1,30,3,11,0,14,4,30,4,0,0,4,1,-15,3,1
2,1,25,1,30,5,9,0,14,5,30,6,0,0,6,0,30,6,8,0,14,1,30,7,7,0,14,5,30,6,0,0,6,1,-15,3,1
2,4,25,1,30,5,9,0,14,5,30,6,0,0,6,0,30,6,8,0,14,1,30,7,7,0,14,5,30,6,0,0,6,1,-15,3,1
2,2,27,1,30,5,10,0,15,3,30,2,0,0,2,0,30,2,13,0,15,3,30,5,10,0,15,4,30,4,2,0,6,1,-15,3,1
2,3,27,1,30,5,10,0,15,3,30,2,0,0,2,0,30,2,13,0,15,3,30,5,10,0,15,4,30,4,2,0,6,1,-15,3,1
2,2,29,0,30,7,7,0,14,5,30,11,1,0,12,0,30,5,9,0,14,0,30,1,13,0,14,0,30,6,3,0,9,1,-15,3,1
2,4,29,0,30,7,7,0,14,5,30,11,1,0,12,0,30,5,9,0,14,0,30,1,13,0,14,0,30,6,3,0,9,1,-15,3,1
2,2,31,4,30,7,5,0,12,7,30,8,0,0,8,3,30,4,8,0,12,0,30,5,7,0,12,0,30,4,2,0,6,1,-15,3,1
2,3,31,4,30,7,5,0,12,7,30,8,0,0,8,3,30,4,8,0,12,0,30,5,7,0,12,0,30,4,2,0,6,1,-15,3,1
2,3,47,0,30,0,14,0,14,6,30,4,0,0,4,0,30,3,11,0,14,0,30,4,10,0,14,9,30,7,0,0,7,1,-15,3,1
2,2,6,4,30,9,0,0,9,4,30,2,0,0,2,0,30,2,7,0,9,0,30,4,5,0,9,0,30,4,1,0,5,0,-27,3,0
2,2,11,0,30,5,7,0,12,1,30,4,0,0,4,0,30,5,7,0,12,6,30,7,5,0,12,6,30,4,0,0,4,1,-15,3,1
2,3,11,0,30,5,7,0,12,1,30,4,0,0,4,0,30,5,7,0,12,6,30,7,5,0,12,6,30,4,0,0,4,1,-15,3,1
2,4,13,2,30,7,0,0,7,1,30,4,0,0,4,2,30,6,1,0,7,13,30,6,1,0,7,3,30,4,0,0,4,1,-15,3,1
2,2,19,0,30,5,8,0,13,2,30,8,0,0,8,0,30,4,9,0,13,1,30,6,7,0,13,0,30,7,2,0,9,1,-15,3,1
2,3,23,1,30,7,6,0,13,0,30,6,0,0,6,7,30,13,0,0,13,2,30,5,8,0,13,6,30,5,1,0,6,1,-15,3,1
2,4,25,1,30,6,8,0,14,3,30,6,0,0,6,0,30,6,8,0,14,1,30,6,8,0,14,6,30,6,0,0,6,1,-15,3,1
2,0,27,1,30,3,12,0,15,4,30,1,1,0,2,0,30,4,11,0,15,2,30,5,10,0,15,5,30,6,0,0,6,1,-15,3,1
2,2,27,1,30,3,12,0,15,4,30,1,1,0,2,0,30,4,11,0,15,2,30,5,10,0,15,5,30,6,0,0,6,1,-15,3,1
2,3,27,1,30,3,12,0,15,4,30,1,1,0,2,0,30,4,11,0,15,2,30,5,10,0,15,5,30,6,0,0,6,1,-15,3,1
2,4,27,1,30,3,12,0,15,4,30,1,1,0,2,0,30,4,11,0,15,2,30,5,10,0,15,5,30,6,0,0,6,1,-15,3,1
2,4,29,0,30,5,9,0,14,6,30,12,0,0,12,0,30,3,11,0,14,0,30,0,14,0,14,4,30,9,0,0,9,1,-15,3,1
2,3,31,3,30,6,6,0,12,4,30,8,0,0,8,7,30,11,1,0,12,0,30,3,9,0,12,0,30,1,5,0,6,1,-15,3,1
2,2,4,2,30,6,2,0,8,4,30,2,2,0,4,0,30,3,5,0,8,0,30,6,2,0,8,3,30,4,0,0,4,0,-27,3,0
2,4,13,0,30,7,0,0,7,0,30,4,0,0,4,2,30,5,2,0,7,7,30,6,1,0,7,3,30,4,0,0,4,1,-15,3,1
2,2,17,5,30,12,2,0,14,2,30,6,0,0,6,0,30,8,6,0,14,1,30,4,10,0,14,2,30,4,0,0,4,1,-15,3,1
2,1,25,1,30,2,12,0,14,2,30,6,0,0,6,1,30,11,3,0,14,1,30,5,9,0,14,4,30,6,0,0,6,1,-15,3,1
2,4,25,1,30,2,12,0,14,2,30,6,0,0,6,1,30,11,3,0,14,1,30,5,9,0,14,4,30,6,0,0,6,1,-15,3,1
2,2,27,1,30,4,11,0,15,2,30,2,0,0,2,0,30,5,10,0,15,3,30,5,10,0,15,6,30,6,0,0,6,1,-15,3,1
2,3,27,1,30,4,11,0,15,2,30,2,0,0,2,0,30,5,10,0,15,3,30,5,10,0,15,6,30,6,0,0,6,1,-15,3,1
2,3,33,3,30,6,5,0,11,5,30,4,0,0,4,2,30,10,1,0,11,0,30,3,8,0,11,4,30,4,0,0,4,1,-15,3,1
2,4,33,3,30,6,5,0,11,5,30,4,0,0,4,2,30,10,1,0,11,0,30,3,8,0,11,4,30,4,0,0,4,1,-15,3,1
2,2,35,1,30,6,7,0,13,5,30,2,0,0,2,1,30,4,9,0,13,4,30,3,10,0,13,4,30,8,0,0,8,1,-15,3,1
2,4,35,1,30,6,7,0,13,5,30,2,0,0,2,1,30,4,9,0,13,4,30,3,10,0,13,4,30,8,0,0,8,1,-15,3,1
2,2,39,0,30,5,6,0,11,6,30,6,0,0,6,0,30,6,5,0,11,1,30,3,8,0,11,4,30,5,0,0,5,1,-15,3,1
2,4,39,0,30,5,6,0,11,6,30,6,0,0,6,0,30,6,5,0,11,1,30,3,8,0,11,4,30,5,0,0,5,1,-15,3,1
2,0,5,0,30,1,4,0,5,3,30,0,4,0,4,0,30,1,4,0,5,0,30,1,4,0,5,0,30,1,1,0,2,0,-27,3,0
2,3,6,0,30,6,3,0,9,4,30,2,0,0,2,0,30,2,7,0,9,0,30,3,6,0,9,5,30,5,0,0,5,0,-27,3,0
2,0,9,0,30,6,5,0,11,3,30,5,1,0,6,8,30,6,5,0,11,7,30,4,7,0,11,2,30,2,2,0,4,0,-27,3,0
2,1,9,0,30,6,5,0,11,3,30,5,1,0,6,8,30,6,5,0,11,7,30,4,7,0,11,2,30,2,2,0,4,0,-27,3,0
2,4,9,0,30,6,5,0,11,3,30,5,1,0,6,8,30,6,5,0,11,7,30,4,7,0,11,2,30,2,2,0,4,0,-27,3,0
2,4,13,1,30,7,0,0,7,1,30,4,0,0,4,2,30,6,1,0,7,3,30,5,2,0,7,4,30,4,0,0,4,1,-15,3,1
2,1,19,0,30,1,12,0,13,2,30,7,1,0,8,0,30,4,9,0,13,1,30,6,7,0,13,2,30,9,0,0,9,1,-15,3,1
2,4,19,0,30,1,12,0,13,2,30,7,1,0,8,0,30,4,9,0,13,1,30,6,7,0,13,2,30,9,0,0,9,1,-15,3,1
2,3,23,2,30,5,8,0,13,3,30,6,0,0,6,6,30,13,0,0,13,0,30,6,7,0,13,2,30,5,1,0,6,1,-15,3,1
2,2,25,1,30,4,10,0,14,5,30,6,0,0,6,0,30,6,8,0,14,1,30,6,8,0,14,5,30,6,0,0,6,1,-15,3,1
2,3,25,1,30,4,10,0,14,5,30,6,0,0,6,0,30,6,8,0,14,1,30,6,8,0,14,5,30,6,0,0,6,1,-15,3,1
2,4,25,1,30,4,10,0,14,5,30,6,0,0,6,0,30,6,8,0,14,1,30,6,8,0,14,5,30,6,0,0,6,1,-15,3,1
2,0,27,1,30,4,11,0,15,4,30,2,0,0,2,0,30,4,11,0,15,1,30,7,8,0,15,3,30,6,0,0,6,1,-15,3,1
2,3,27,1,30,4,11,0,15,4,30,2,0,0,2,0,30,4,11,0,15,1,30,7,8,0,15,3,30,6,0,0,6,1,-15,3,1
2,1,5,1,30,1,4,0,5,3,30,1,3,0,4,0,30,1,4,0,5,0,30,1,4,0,5,0,30,0,2,0,2,0,-27,3,0
2,2,5,1,30,1,4,0,5,3,30,1,3,0,4,0,30,1,4,0,5,0,30,1,4,0,5,0,30,0,2,0,2,0,-27,3,0
2,2,23,2,30,6,7,0,13,3,30,6,0,0,6,2,30,12,1,0,13,0,30,4,9,0,13,4,30,6,0,0,6,1,-15,3,1
2,3,25,1,30,10,4,0,14,4,30,6,0,0,6,0,30,7,7,0,14,1,30,5,9,0,14,3,30,5,1,0,6,1,-15,3,1
2,4,35,1,30,6,7,0,13,3,30,2,0,0,2,1,30,9,4,0,13,2,30,3,10,0,13,2,30,8,0,0,8,1,-15,3,1
2,3,4,0,30,4,4,0,8,4,30,3,1,0,4,0,30,1,7,0,8,0,30,2,6,0,8,0,30,4,0,0,4,0,-27,3,0
2,4,4,0,30,4,4,0,8,4,30,3,1,0,4,0,30,1,7,0,8,0,30,2,6,0,8,0,30,4,0,0,4,0,-27,3,0
2,4,7,0,30,2,2,0,4,2,30,2,0,0,2,0,30,1,3,0,4,0,30,2,2,0,4,1,30,1,1,0,2,0,-27,3,0
2,4,13,2,30,3,0,0,3,0,30,2,0,0,2,1,30,3,0,0,3,7,30,3,0,0,3,5,30,2,0,0,2,1,-15,3,1
2,3,17,3,30,10,4,0,14,3,30,6,0,0,6,0,30,3,11,0,14,4,30,4,10,0,14,7,30,4,0,0,4,1,-15,3,1
2,4,19,1,30,3,10,0,13,1,30,7,1,0,8,0,30,12,1,0,13,0,30,3,10,0,13,0,30,6,3,0,9,1,-15,3,1
2,0,27,1,30,5,10,0,15,4,30,1,1,0,2,0,30,6,9,0,15,2,30,6,9,0,15,5,30,6,0,0,6,1,-15,3,1
2,0,29,0,30,5,9,0,14,6,30,8,4,0,12,0,30,6,8,0,14,0,30,5,9,0,14,3,30,9,0,0,9,1,-15,3,1
2,1,29,0,30,5,9,0,14,6,30,8,4,0,12,0,30,6,8,0,14,0,30,5,9,0,14,3,30,9,0,0,9,1,-15,3,1
2,4,31,3,30,6,6,0,12,4,30,8,0,0,8,4,30,11,1,0,12,0,30,3,9,0,12,1,30,4,2,0,6,1,-15,3,1
2,3,32,0,30,8,1,0,9,4,30,2,0,0,2,1,30,8,1,0,9,1,30,2,7,0,9,3,30,2,0,0,2,1,-15,3,1
2,0,38,0,30,5,5,0,10,8,30,6,0,0,6,0,30,0,10,0,10,0,30,4,6,0,10,10,30,6,0,0,6,1,-15,3,1
2,3,38,0,30,5,5,0,10,8,30,6,0,0,6,0,30,0,10,0,10,0,30,4,6,0,10,10,30,6,0,0,6,1,-15,3,1
2,4,5,0,30,1,4,0,5,3,30,4,0,0,4,0,30,0,5,0,5,0,30,1,4,0,5,0,30,0,2,0,2,0,-27,3,0
2,4,7,0,30,5,4,0,9,3,30,4,0,0,4,1,30,4,5,0,9,5,30,3,6,0,9,2,30,4,2,0,6,0,-27,3,0
2,2,13,1,30,6,1,0,7,0,30,4,0,0,4,2,30,6,1,0,7,5,30,6,1,0,7,6,30,4,0,0,4,1,-15,3,1
2,3,13,1,30,6,1,0,7,0,30,4,0,0,4,2,30,6,1,0,7,5,30,6,1,0,7,6,30,4,0,0,4,1,-15,3,1
2,4,13,1,30,6,1,0,7,0,30,4,0,0,4,2,30,6,1,0,7,5,30,6,1,0,7,6,30,4,0,0,4,1,-15,3,1
2,4,17,3,30,9,5,0,14,2,30,6,0,0,6,0,30,8,6,0,14,0,30,6,8,0,14,2,30,4,0,0,4,1,-15,3,1
2,1,19,0,30,4,9,0,13,2,30,6,2,0,8,0,30,6,7,0,13,3,30,5,8,0,13,1,30,9,0,0,9,1,-15,3,1
2,2,19,0,30,4,9,0,13,2,30,6,2,0,8,0,30,6,7,0,13,3,30,5,8,0,13,1,30,9,0,0,9,1,-15,3,1
2,3,19,0,30,4,9,0,13,2,30,6,2,0,8,0,30,6,7,0,13,3,30,5,8,0,13,1,30,9,0,0,9,1,-15,3,1
2,1,26,4,30,7,2,0,9,6,30,4,0,0,4,2,30,0,9,0,9,0,30,5,4,0,9,9,30,3,0,0,3,1,-15,3,1
2,2,29,2,30,10,4,0,14,5,30,9,3,0,12,0,30,6,8,0,14,0,30,1,13,0,14,0,30,7,2,0,9,1,-15,3,1
2,4,29,2,30,10,4,0,14,5,30,9,3,0,12,0,30,6,8,0,14,0,30,1,13,0,14,0,30,7,2,0,9,1,-15,3,1
2,3,33,1,30,2,9,0,11,5,30,4,0,0,4,1,30,9,2,0,11,2,30,3,8,0,11,5,30,4,0,0,4,1,-15,3,1
2,3,35,0,30,6,7,0,13,3,30,2,0,0,2,1,30,10,3,0,13,3,30,1,12,0,13,4,30,8,0,0,8,1,-15,3,1
2,4,35,0,30,6,7,0,13,3,30,2,0,0,2,1,30,10,3,0,13,3,30,1,12,0,13,4,30,8,0,0,8,1,-15,3,1
2,0,38,0,30,4,6,0,10,7,30,4,2,0,6,0,30,1,9,0,10,0,30,4,6,0,10,7,30,6,0,0,6,1,-15,3,1
2,3,7,0,30,2,2,0,4,2,30,2,0,0,2,0,30,1,3,0,4,0,30,2,2,0,4,3,30,2,0,0,2,0,-27,3,0
2,4,9,0,30,9,2,0,11,2,30,6,0,0,6,1,30,9,2,0,11,4,30,3,8,0,11,0,30,2,2,0,4,0,-27,3,0
2,1,13,1,30,6,1,0,7,0,30,4,0,0,4,2,30,6,1,0,7,5,30,7,0,0,7,2,30,4,0,0,4,1,-15,3,1
2,4,15,1,30,3,10,0,13,0,30,6,0,0,6,0,30,6,7,0,13,1,30,4,9,0,13,2,30,7,2,0,9,1,-15,3,1
2,2,19,0,30,4,9,0,13,2,30,8,0,0,8,0,30,6,7,0,13,0,30,3,10,0,13,2,30,8,1,0,9,1,-15,3,1
2,4,19,0,30,4,9,0,13,0,30,8,0,0,8,0,30,6,7,0,13,0,30,3,10,0,13,2,30,8,1,0,9,1,-15,3,1
2,4,25,2,30,10,4,0,14,2,30,6,0,0,6,0,30,8,6,0,14,1,30,5,9,0,14,4,30,5,1,0,6,1,-15,3,1
2,4,27,1,30,4,11,0,15,2,30,2,0,0,2,0,30,9,6,0,15,0,30,4,11,0,15,3,30,6,0,0,6,1,-15,3,1
2,0,37,2,30,8,3,0,11,6,30,8,0,0,8,2,30,8,3,0,11,4,30,3,8,0,11,2,30,6,0,0,6,1,-15,3,1
2,4,37,2,30,8,3,0,11,6,30,8,0,0,8,0,30,8,3,0,11,4,30,3,8,0,11,0,30,6,0,0,6,1,-15,3,1
2,2,47,0,30,1,13,0,14,7,30,4,0,0,4,0,30,2,12,0,14,0,30,3,11,0,14,8,30,7,0,0,7,1,-15,3,1
2,0,4,2,30,6,2,0,8,4,30,3,1,0,4,0,30,3,5,0,8,0,30,5,3,0,8,2,30,4,0,0,4,0,-27,3,0
2,1,4,2,30,6,2,0,8,4,30,3,1,0,4,0,30,3,5,0,8,0,30,5,3,0,8,2,30,4,0,0,4,0,-27,3,0
2,4,4,2,30,6,2,0,8,4,30,3,1,0,4,0,30,3,5,0,8,0,30,5,3,0,8,2,30,4,0,0,4,0,-27,3,0
2,4,6,0,30,4,5,0,9,3,30,2,0,0,2,0,30,3,6,0,9,1,30,4,5,0,9,0,30,4,1,0,5,0,-27,3,0
2,3,8,2,30,7,0,0,7,4,30,2,0,0,2,1,30,4,3,0,7,0,30,6,1,0,7,3,30,3,0,0,3,0,-27,3,0
2,4,8,2,30,7,0,0,7,4,30,2,0,0,2,1,30,4,3,0,7,0,30,6,1,0,7,3,30,3,0,0,3,0,-27,3,0
2,3,19,0,30,5,8,0,13,2,30,6,2,0,8,0,30,6,7,0,13,5,30,4,9,0,13,0,30,8,1,0,9,1,-15,3,1
2,4,19,0,30,5,8,0,13,2,30,6,2,0,8,0,30,6,7,0,13,5,30,4,9,0,13,0,30,8,1,0,9,1,-15,3,1
2,4,23,2,30,5,8,0,13,1,30,6,0,0,6,4,30,12,1,0,13,0,30,6,7,0,13,2,30,5,1,0,6,1,-15,3,1
2,3,25,0,30,4,10,0,14,4,30,6,0,0,6,0,30,3,11,0,14,1,30,6,8,0,14,4,30,6,0,0,6,1,-15,3,1
2,1,26,1,30,7,2,0,9,5,30,4,0,0,4,3,30,0,9,0,9,0,30,4,5,0,9,6,30,3,0,0,3,1,-15,3,1
2,1,27,2,30,7,8,0,15,2,30,1,1,0,2,0,30,7,8,0,15,1,30,7,8,0,15,2,30,6,0,0,6,1,-15,3,1
2,4,27,2,30,7,8,0,15,2,30,1,1,0,2,0,30,7,8,0,15,1,30,7,8,0,15,2,30,6,0,0,6,1,-15,3,1
2,4,1,0,30,7,3,0,10,4,30,2,0,0,2,0,30,4,6,0,10,9,30,9,1,0,10,6,30,6,0,0,6,0,-27,3,0
2,1,4,2,30,6,2,0,8,4,30,4,0,0,4,2,30,4,4,0,8,0,30,8,0,0,8,1,30,2,2,0,4,0,-27,3,0
2,1,13,1,30,5,2,0,7,0,30,4,0,0,4,2,30,5,2,0,7,13,30,6,1,0,7,6,30,4,0,0,4,1,-15,3,1
2,2,13,1,30,5,2,0,7,0,30,4,0,0,4,2,30,5,2,0,7,13,30,6,1,0,7,6,30,4,0,0,4,1,-15,3,1
2,3,15,0,30,5,8,0,13,1,30,6,0,0,6,0,30,3,10,0,13,1,30,6,7,0,13,2,30,6,3,0,9,1,-15,3,1
2,2,17,5,30,9,5,0,14,4,30,6,0,0,6,0,30,4,10,0,14,1,30,5,9,0,14,0,30,4,0,0,4,1,-15,3,1
2,2,23,2,30,5,8,0,13,0,30,6,0,0,6,3,30,13,0,0,13,2,30,6,7,0,13,1,30,6,0,0,6,1,-15,3,1
2,4,23,2,30,5,8,0,13,0,30,6,0,0,6,3,30,13,0,0,13,2,30,6,7,0,13,1,30,6,0,0,6,1,-15,3,1
2,2,25,1,30,9,5,0,14,4,30,6,0,0,6,0,30,7,7,0,14,1,30,7,7,0,14,5,30,6,0,0,6,1,-15,3,1
2,2,38,0,30,5,5,0,10,7,30,6,0,0,6,0,30,1,9,0,10,0,30,2,8,0,10,6,30,6,0,0,6,1,-15,3,1
2,3,38,0,30,5,5,0,10,7,30,6,0,0,6,0,30,1,9,0,10,0,30,2,8,0,10,6,30,6,0,0,6,1,-15,3,1
2,2,1,0,30,7,3,0,10,4,30,2,0,0,2,1,30,3,7,0,10,0,30,7,3,0,10,5,30,6,0,0,6,0,-27,3,0
2,3,1,0,30,7,3,0,10,4,30,2,0,0,2,1,30,3,7,0,10,0,30,7,3,0,10,5,30,6,0,0,6,0,-27,3,0
2,3,8,1,30,7,0,0,7,3,30,2,0,0,2,2,30,4,3,0,7,0,30,6,1,0,7,0,30,3,0,0,3,0,-27,3,0
2,2,13,10,30,3,0,0,3,2,30,2,0,0,2,0,30,2,1,0,3,4,30,3,0,0,3,1,30,2,0,0,2,1,-15,3,1
2,3,13,10,30,3,0,0,3,2,30,2,0,0,2,0,30,2,1,0,3,4,30,3,0,0,3,1,30,2,0,0,2,1,-15,3,1
2,4,13,10,30,3,0,0,3,2,30,2,0,0,2,0,30,2,1,0,3,4,30,3,0,0,3,1,30,2,0,0,2,1,-15,3,1
2,0,21,5,30,9,1,0,10,4,30,5,1,0,6,1,30,3,7,0,10,3,30,5,5,0,10,4,30,4,0,0,4,1,-15,3,1
2,3,23,1,30,5,8,0,13,2,30,6,0,0,6,4,30,9,4,0,13,0,30,5,8,0,13,2,30,5,1,0,6,1,-15,3,1
2,3,25,1,30,8,6,0,14,3,30,6,0,0,6,0,30,8,6,0,14,1,30,5,9,0,14,4,30,5,1,0,6,1,-15,3,1
2,4,25,1,30,8,6,0,14,3,30,6,0,0,6,0,30,8,6,0,14,1,30,5,9,0,14,4,30,5,1,0,6,1,-15,3,1
2,0,27,1,30,4,11,0,15,5,30,2,0,0,2,0,30,6,9,0,15,3,30,4,11,0,15,4,30,6,0,0,6,1,-15,3,1
2,3,27,1,30,4,11,0,15,5,30,2,0,0,2,0,30,6,9,0,15,3,30,4,11,0,15,4,30,6,0,0,6,1,-15,3,1
2,0,31,1,30,8,4,0,12,7,30,8,0,0,8,3,30,4,8,0,12,4,30,6,6,0,12,0,30,6,0,0,6,1,-15,3,1
2,4,35,1,30,10,3,0,13,2,30,2,0,0,2,1,30,6,7,0,13,2,30,1,12,0,13,2,30,8,0,0,8,1,-15,3,1
2,4,5,1,30,2,3,0,5,4,30,0,4,0,4,0,30,0,5,0,5,0,30,1,4,0,5,0,30,0,2,0,2,0,-27,3,0
2,1,17,5,30,11,3,0,14,3,30,6,0,0,6,0,30,5,9,0,14,1,30,5,9,0,14,2,30,4,0,0,4,1,-15,3,1
2,3,19,0,30,4,9,0,13,2,30,8,0,0,8,0,30,4,9,0,13,2,30,6,7,0,13,1,30,6,3,0,9,1,-15,3,1
2,2,23,1,30,5,8,0,13,3,30,6,0,0,6,5,30,12,1,0,13,2,30,6,7,0,13,5,30,6,0,0,6,1,-15,3,1
2,4,23,1,30,5,8,0,13,3,30,6,0,0,6,5,30,12,1,0,13,2,30,6,7,0,13,0,30,6,0,0,6,1,-15,3,1
2,2,25,1,30,13,1,0,14,1,30,6,0,0,6,0,30,10,4,0,14,1,30,5,9,0,14,4,30,5,1,0,6,1,-15,3,1
2,3,25,1,30,13,1,0,14,1,30,6,0,0,6,0,30,10,4,0,14,1,30,5,9,0,14,4,30,5,1,0,6,1,-15,3,1
2,0,37,1,30,7,4,0,11,7,30,8,0,0,8,3,30,6,5,0,11,4,30,3,8,0,11,6,30,6,0,0,6,1,-15,3,1
2,2,37,1,30,7,4,0,11,7,30,8,0,0,8,3,30,6,5,0,11,4,30,3,8,0,11,6,30,6,0,0,6,1,-15,3,1
2,1,38,0,30,1,9,0,10,5,30,6,0,0,6,0,30,9,1,0,10,0,30,4,6,0,10,5,30,6,0,0,6,1,-15,3,1
2,2,38,0,30,1,9,0,10,5,30,6,0,0,6,0,30,9,1,0,10,0,30,4,6,0,10,5,30,6,0,0,6,1,-15,3,1
2,3,41,0,30,6,6,0,12,5,30,7,1,0,8,0,30,9,3,0,12,0,30,3,9,0,12,3,30,7,0,0,7,1,-15,3,1
2,4,4,2,30,6,2,0,8,4,30,4,0,0,4,0,30,3,5,0,8,0,30,5,3,0,8,3,30,4,0,0,4,0,-27,3,0
2,4,8,1,30,7,0,0,7,0,30,2,0,0,2,6,30,4,3,0,7,3,30,7,0,0,7,5,30,3,0,0,3,0,-27,3,0
2,2,19,0,30,4,9,0,13,2,30,3,5,0,8,0,30,6,7,0,13,9,30,4,9,0,13,2,30,8,1,0,9,1,-15,3,1
2,2,27,1,30,2,13,0,15,2,30,1,1,0,2,0,30,2,13,0,15,0,30,8,7,0,15,7,30,6,0,0,6,1,-15,3,1
2,4,29,1,30,7,7,0,14,5,30,10,2,0,12,0,30,9,5,0,14,0,30,0,14,0,14,0,30,7,2,0,9,1,-15,3,1
2,0,4,4,30,7,1,0,8,5,30,2,2,0,4,0,30,1,7,0,8,1,30,5,3,0,8,1,30,3,1,0,4,0,-27,3,0
2,1,4,4,30,7,1,0,8,5,30,2,2,0,4,0,30,1,7,0,8,1,30,5,3,0,8,1,30,3,1,0,4,0,-27,3,0
2,2,6,0,30,6,3,0,9,4,30,2,0,0,2,0,30,2,7,0,9,0,30,4,5,0,9,1,30,5,0,0,5,0,-27,3,0
2,4,6,0,30,6,3,0,9,4,30,2,0,0,2,0,30,2,7,0,9,0,30,4,5,0,9,1,30,5,0,0,5,0,-27,3,0
2,3,19,0,30,3,10,0,13,2,30,8,0,0,8,5,30,13,0,0,13,1,30,4,9,0,13,1,30,7,2,0,9,1,-15,3,1
2,2,25,2,30,8,6,0,14,4,30,6,0,0,6,0,30,8,6,0,14,3,30,7,7,0,14,1,30,5,1,0,6,1,-15,3,1
2,3,25,2,30,8,6,0,14,4,30,6,0,0,6,0,30,8,6,0,14,3,30,7,7,0,14,1,30,5,1,0,6,1,-15,3,1
2,4,25,2,30,8,6,0,14,4,30,6,0,0,6,0,30,8,6,0,14,3,30,7,7,0,14,1,30,5,1,0,6,1,-15,3,1
2,2,27,0,30,6,9,0,15,3,30,2,0,0,2,0,30,2,13,0,15,3,30,5,10,0,15,1,30,6,0,0,6,1,-15,3,1
2,3,27,0,30,6,9,0,15,3,30,2,0,0,2,0,30,2,13,0,15,3,30,5,10,0,15,1,30,6,0,0,6,1,-15,3,1
2,4,27,0,30,6,9,0,15,3,30,2,0,0,2,0,30,2,13,0,15,3,30,5,10,0,15,1,30,6,0,0,6,1,-15,3,1
2,4,29,1,30,7,7,0,14,5,30,11,1,0,12,0,30,3,11,0,14,0,30,1,13,0,14,0,30,6,3,0,9,1,-15,3,1
2,0,5,0,30,2,3,0,5,3,30,1,3,0,4,0,30,0,5,0,5,0,30,1,4,0,5,0,30,2,0,0,2,0,-27,3,0
2,1,5,0,30,2,3,0,5,3,30,1,3,0,4,0,30,0,5,0,5,0,30,1,4,0,5,0,30,2,0,0,2,0,-27,3,0
2,2,5,0,30,2,3,0,5,3,30,1,3,0,4,0,30,0,5,0,5,0,30,1,4,0,5,0,30,2,0,0,2,0,-27,3,0
2,3,5,0,30,2,3,0,5,3,30,1,3,0,4,0,30,0,5,0,5,0,30,1,4,0,5,0,30,2,0,0,2,0,-27,3,0
2,3,13,2,30,5,2,0,7,0,30,4,0,0,4,2,30,6,1,0,7,6,30,6,1,0,7,3,30,4,0,0,4,1,-15,3,1
2,3,15,0,30,4,9,0,13,0,30,6,0,0,6,0,30,3,10,0,13,1,30,2,11,0,13,2,30,8,1,0,9,1,-15,3,1
2,3,17,3,30,9,5,0,14,2,30,6,0,0,6,0,30,6,8,0,14,1,30,6,8,0,14,1,30,4,0,0,4,1,-15,3,1
2,4,17,3,30,9,5,0,14,2,30,6,0,0,6,0,30,6,8,0,14,1,30,6,8,0,14,1,30,4,0,0,4,1,-15,3,1
2,3,19,0,30,4,9,0,13,2,30,5,3,0,8,0,30,7,6,0,13,0,30,4,9,0,13,1,30,8,1,0,9,1,-15,3,1
2,4,23,2,30,8,5,0,13,2,30,6,0,0,6,0,30,12,1,0,13,0,30,5,8,0,13,1,30,5,1,0,6,1,-15,3,1
2,2,25,1,30,4,10,0,14,4,30,6,0,0,6,0,30,6,8,0,14,1,30,5,9,0,14,4,30,6,0,0,6,1,-15,3,1
2,4,25,0,30,4,10,0,14,4,30,6,0,0,6,0,30,6,8,0,14,1,30,5,9,0,14,4,30,6,0,0,6,1,-15,3,1
2,0,27,1,30,4,11,0,15,3,30,2,0,0,2,0,30,5,10,0,15,0,30,6,9,0,15,3,30,6,0,0,6,1,-15,3,1
2,1,27,1,30,4,11,0,15,3,30,2,0,0,2,0,30,5,10,0,15,0,30,6,9,0,15,3,30,6,0,0,6,1,-15,3,1
2,4,27,0,30,4,11,0,15,3,30,2,0,0,2,0,30,5,10,0,15,0,30,6,9,0,15,0,30,6,0,0,6,1,-15,3,1
2,1,47,0,30,1,13,0,14,6,30,4,0,0,4,0,30,7,7,0,14,0,30,8,6,0,14,3,30,7,0,0,7,1,-15,3,1
2,3,4,2,30,7,1,0,8,5,30,4,0,0,4,0,30,1,7,0,8,0,30,5,3,0,8,3,30,4,0,0,4,0,-27,3,0
2,0,19,0,30,2,11,0,13,3,30,5,3,0,8,0,30,4,9,0,13,4,30,5,8,0,13,4,30,9,0,0,9,1,-15,3,1
2,2,23,2,30,7,6,0,13,3,30,6,0,0,6,6,30,9,4,0,13,2,30,9,4,0,13,2,30,6,0,0,6,1,-15,3,1
2,3,29,0,30,2,12,0,14,5,30,12,0,0,12,0,30,11,3,0,14,0,30,0,14,0,14,0,30,9,0,0,9,1,-15,3,1
2,2,31,4,30,6,6,0,12,5,30,8,0,0,8,3,30,10,2,0,12,0,30,3,9,0,12,2,30,4,2,0,6,1,-15,3,1
2,3,31,4,30,6,6,0,12,5,30,8,0,0,8,3,30,10,2,0,12,0,30,3,9,0,12,2,30,4,2,0,6,1,-15,3,1
2,4,39,0,30,1,10,0,11,6,30,6,0,0,6,1,30,6,5,0,11,0,30,2,9,0,11,5,30,5,0,0,5,1,-15,3,1
2,3,5,0,30,1,4,0,5,2,30,3,1,0,4,0,30,1,4,0,5,0,30,1,4,0,5,0,30,1,1,0,2,0,-27,3,0
2,2,13,3,30,6,1,0,7,1,30,4,0,0,4,1,30,6,1,0,7,11,30,7,0,0,7,5,30,4,0,0,4,1,-15,3,1
2,3,17,5,30,10,4,0,14,3,30,6,0,0,6,0,30,7,7,0,14,1,30,5,9,0,14,1,30,4,0,0,4,1,-15,3,1
2,4,19,0,30,6,7,0,13,2,30,4,4,0,8,0,30,4,9,0,13,4,30,2,11,0,13,1,30,8,1,0,9,1,-15,3,1
2,4,23,1,30,4,9,0,13,3,30,6,0,0,6,5,30,11,2,0,13,1,30,6,7,0,13,0,30,5,1,0,6,1,-15,3,1
2,3,1,0,30,7,3,0,10,5,30,2,0,0,2,1,30,3,7,0,10,6,30,8,2,0,10,5,30,6,0,0,6,0,-27,3,0
2,4,3,0,30,0,4,0,4,2,30,4,0,0,4,0,30,1,3,0,4,5,30,2,2,0,4,0,30,1,2,0,3,0,-27,3,0
2,0,5,0,30,1,4,0,5,3,30,1,3,0,4,0,30,1,4,0,5,0,30,1,4,0,5,0,30,1,1,0,2,0,-27,3,0
2,4,8,0,30,7,0,0,7,5,30,2,0,0,2,0,30,1,6,0,7,0,30,5,2,0,7,6,30,3,0,0,3,0,-27,3,0
2,3,15,0,30,5,8,0,13,0,30,6,0,0,6,0,30,9,4,0,13,0,30,4,9,0,13,3,30,8,1,0,9,1,-15,3,1
2,0,17,2,30,9,5,0,14,4,30,6,0,0,6,0,30,4,10,0,14,6,30,8,6,0,14,5,30,4,0,0,4,1,-15,3,1
2,2,17,2,30,9,5,0,14,4,30,6,0,0,6,0,30,4,10,0,14,6,30,8,6,0,14,5,30,4,0,0,4,1,-15,3,1
2,4,17,0,30,9,5,0,14,4,30,6,0,0,6,0,30,4,10,0,14,6,30,8,6,0,14,5,30,4,0,0,4,1,-15,3,1
2,2,19,0,30,3,10,0,13,2,30,3,5,0,8,0,30,6,7,0,13,5,30,7,6,0,13,2,30,9,0,0,9,1,-15,3,1
2,1,27,1,30,3,12,0,15,2,30,1,1,0,2,0,30,6,9,0,15,3,30,4,11,0,15,2,30,6,0,0,6,1,-15,3,1
2,3,27,1,30,3,12,0,15,2,30,1,1,0,2,0,30,6,9,0,15,3,30,4,11,0,15,2,30,6,0,0,6,1,-15,3,1
2,4,27,1,30,3,12,0,15,2,30,1,1,0,2,0,30,6,9,0,15,3,30,4,11,0,15,2,30,6,0,0,6,1,-15,3,1
2,3,45,0,30,7,6,0,13,11,30,10,0,0,10,0,30,0,13,0,13,0,30,4,9,0,13,10,30,5,0,0,5,1,-15,3,1
2,3,5,0,30,2,3,0,5,3,30,4,0,0,4,0,30,0,5,0,5,0,30,1,4,0,5,1,30,0,2,0,2,0,-27,3,0
2,2,11,2,30,9,3,0,12,0,30,4,0,0,4,0,30,7,5,0,12,3,30,2,10,0,12,3,30,2,2,0,4,1,-15,3,1
2,3,11,2,30,9,3,0,12,0,30,4,0,0,4,0,30,7,5,0,12,3,30,2,10,0,12,3,30,2,2,0,4,1,-15,3,1
2,3,13,1,30,7,0,0,7,0,30,4,0,0,4,3,30,7,0,0,7,5,30,6,1,0,7,3,30,4,0,0,4,1,-15,3,1
2,4,13,1,30,7,0,0,7,0,30,4,0,0,4,3,30,7,0,0,7,5,30,6,1,0,7,3,30,4,0,0,4,1,-15,3,1
2,2,17,2,30,9,5,0,14,3,30,6,0,0,6,0,30,6,8,0,14,4,30,5,9,0,14,0,30,4,0,0,4,1,-15,3,1
2,4,17,2,30,9,5,0,14,3,30,6,0,0,6,0,30,6,8,0,14,4,30,5,9,0,14,0,30,4,0,0,4,1,-15,3,1
2,3,23,3,30,6,7,0,13,1,30,6,0,0,6,5,30,11,2,0,13,0,30,4,9,0,13,3,30,6,0,0,6,1,-15,3,1
2,4,23,3,30,6,7,0,13,1,30,6,0,0,6,5,30,11,2,0,13,0,30,4,9,0,13,3,30,6,0,0,6,1,-15,3,1
2,0,25,2,30,6,8,0,14,5,30,6,0,0,6,0,30,8,6,0,14,1,30,5,9,0,14,4,30,5,1,0,6,1,-15,3,1
2,4,25,0,30,6,8,0,14,4,30,6,0,0,6,0,30,8,6,0,14,0,30,5,9,0,14,4,30,5,1,0,6,1,-15,3,1
2,1,38,0,30,2,8,0,10,6,30,6,0,0,6,0,30,3,7,0,10,0,30,4,6,0,10,5,30,6,0,0,6,1,-15,3,1
2,2,38,0,30,2,8,0,10,6,30,6,0,0,6,0,30,3,7,0,10,0,30,4,6,0,10,5,30,6,0,0,6,1,-15,3,1
2,2,9,7,30,8,3,0,11,5,30,6,0,0,6,1,30,3,8,0,11,0,30,3,8,0,11,5,30,3,1,0,4,0,-27,3,0
2,3,9,7,30,8,3,0,11,5,30,6,0,0,6,1,30,3,8,0,11,0,30,3,8,0,11,5,30,3,1,0,4,0,-27,3,0
2,4,9,7,30,8,3,0,11,5,30,6,0,0,6,1,30,3,8,0,11,0,30,3,8,0,11,5,30,3,1,0,4,0,-27,3,0
2,4,11,2,30,5,7,0,12,0,30,4,0,0,4,0,30,9,3,0,12,3,30,3,9,0,12,0,30,4,0,0,4,1,-15,3,1
2,1,17,2,30,10,4,0,14,3,30,6,0,0,6,0,30,6,8,0,14,2,30,6,8,0,14,1,30,4,0,0,4,1,-15,3,1
2,3,17,2,30,10,4,0,14,3,30,6,0,0,6,0,30,6,8,0,14,2,30,6,8,0,14,1,30,4,0,0,4,1,-15,3,1
2,4,22,5,30,8,0,0,8,1,30,2,0,0,2,0,30,7,1,0,8,0,30,3,5,0,8,1,30,1,3,0,4,1,-15,3,1
2,3,23,1,30,7,6,0,13,2,30,6,0,0,6,4,30,13,0,0,13,0,30,5,8,0,13,2,30,6,0,0,6,1,-15,3,1
2,1,27,0,30,5,10,0,15,4,30,1,1,0,2,0,30,6,9,0,15,0,30,6,9,0,15,4,30,6,0,0,6,1,-15,3,1
2,2,27,0,30,5,10,0,15,4,30,1,1,0,2,0,30,6,9,0,15,0,30,6,9,0,15,4,30,6,0,0,6,1,-15,3,1
2,4,27,0,30,5,10,0,15,4,30,1,1,0,2,0,30,6,9,0,15,0,30,6,9,0,15,4,30,6,0,0,6,1,-15,3,1
2,1,29,0,30,8,6,0,14,5,30,8,4,0,12,0,30,4,10,0,14,0,30,4,10,0,14,1,30,9,0,0,9,1,-15,3,1
2,2,29,0,30,8,6,0,14,5,30,8,4,0,12,0,30,4,10,0,14,0,30,4,10,0,14,1,30,9,0,0,9,1,-15,3,1
2,2,5,0,30,0,5,0,5,2,30,1,3,0,4,0,30,1,4,0,5,0,30,1,4,0,5,1,30,1,1,0,2,0,-27,3,0
2,4,5,0,30,0,5,0,5,2,30,1,3,0,4,0,30,1,4,0,5,0,30,1,4,0,5,1,30,1,1,0,2,0,-27,3,0
2,1,13,2,30,5,2,0,7,0,30,4,0,0,4,5,30,6,1,0,7,9,30,5,2,0,7,3,30,4,0,0,4,1,-15,3,1
2,4,13,2,30,5,2,0,7,0,30,4,0,0,4,5,30,6,1,0,7,9,30,5,2,0,7,3,30,4,0,0,4,1,-15,3,1
2,3,17,3,30,9,5,0,14,2,30,6,0,0,6,0,30,7,7,0,14,2,30,5,9,0,14,4,30,4,0,0,4,1,-15,3,1
2,4,17,3,30,9,5,0,14,2,30,6,0,0,6,0,30,7,7,0,14,2,30,5,9,0,14,4,30,4,0,0,4,1,-15,3,1
2,0,19,5,30,2,11,0,13,4,30,5,3,0,8,0,30,4,9,0,13,4,30,4,9,0,13,2,30,9,0,0,9,1,-15,3,1
2,3,23,1,30,6,7,0,13,0,30,6,0,0,6,4,30,11,2,0,13,0,30,4,9,0,13,1,30,6,0,0,6,1,-15,3,1
2,3,25,2,30,9,5,0,14,4,30,6,0,0,6,0,30,7,7,0,14,1,30,5,9,0,14,3,30,6,0,0,6,1,-15,3,1
2,3,27,2,30,3,12,0,15,2,30,2,0,0,2,0,30,6,9,0,15,1,30,4,11,0,15,3,30,6,0,0,6,1,-15,3,1
2,0,37,1,30,8,3,0,11,5,30,8,0,0,8,0,30,7,4,0,11,6,30,3,8,0,11,7,30,6,0,0,6,1,-15,3,1
2,1,37,1,30,8,3,0,11,5,30,8,0,0,8,0,30,7,4,0,11,6,30,3,8,0,11,7,30,6,0,0,6,1,-15,3,1
2,2,37,1,30,8,3,0,11,5,30,8,0,0,8,0,30,7,4,0,11,6,30,3,8,0,11,7,30,6,0,0,6,1,-15,3,1
2,4,39,0,30,3,8,0,11,6,30,6,0,0,6,0,30,5,6,0,11,1,30,3,8,0,11,0,30,5,0,0,5,1,-15,3,1
2,2,9,0,30,2,2,0,4,2,30,2,0,0,2,0,30,0,4,0,4,0,30,1,3,0,4,2,30,1,0,0,1,0,-27,3,0
2,1,13,1,30,6,1,0,7,0,30,4,0,0,4,2,30,6,1,0,7,6,30,5,2,0,7,5,30,4,0,0,4,1,-15,3,1
2,2,13,1,30,6,1,0,7,0,30,4,0,0,4,2,30,6,1,0,7,6,30,5,2,0,7,5,30,4,0,0,4,1,-15,3,1
2,4,13,1,30,6,1,0,7,0,30,4,0,0,4,2,30,6,1,0,7,6,30,5,2,0,7,5,30,4,0,0,4,1,-15,3,1
2,3,19,1,30,3,10,0,13,2,30,5,3,0,8,0,30,4,9,0,13,0,30,5,8,0,13,0,30,8,1,0,9,1,-15,3,1
2,4,19,1,30,3,10,0,13,2,30,5,3,0,8,0,30,4,9,0,13,0,30,5,8,0,13,0,30,8,1,0,9,1,-15,3,1
2,2,27,1,30,5,10,0,15,4,30,2,0,0,2,0,30,8,7,0,15,1,30,6,9,0,15,1,30,6,0,0,6,1,-15,3,1
2,1,29,0,30,6,8,0,14,6,30,12,0,0,12,0,30,3,11,0,14,1,30,1,13,0,14,3,30,9,0,0,9,1,-15,3,1
2,0,37,1,30,7,4,0,11,5,30,8,0,0,8,0,30,9,2,0,11,4,30,4,7,0,11,5,30,6,0,0,6,1,-15,3,1
2,1,37,1,30,7,4,0,11,5,30,8,0,0,8,0,30,9,2,0,11,4,30,4,7,0,11,5,30,6,0,0,6,1,-15,3,1
2,2,37,1,30,7,4,0,11,5,30,8,0,0,8,0,30,9,2,0,11,4,30,4,7,0,11,5,30,6,0,0,6,1,-15,3,1
2,3,37,1,30,7,4,0,11,5,30,8,0,0,8,0,30,9,2,0,11,4,30,4,7,0,11,5,30,6,0,0,6,1,-15,3,1
2,4,37,1,30,7,4,0,11,5,30,8,0,0,8,0,30,9,2,0,11,4,30,4,7,0,11,5,30,6,0,0,6,1,-15,3,1
2,4,6,0,30,7,2,0,9,4,30,2,0,0,2,0,30,2,7,0,9,0,30,3,6,0,9,6,30,5,0,0,5,0,-27,3,0
2,1,11,1,30,5,7,0,12,0,30,4,0,0,4,0,30,7,5,0,12,7,30,5,7,0,12,6,30,4,0,0,4,1,-15,3,1
2,1,13,2,30,7,0,0,7,0,30,4,0,0,4,1,30,6,1,0,7,6,30,6,1,0,7,6,30,4,0,0,4,1,-15,3,1
2,3,13,2,30,7,0,0,7,0,30,4,0,0,4,1,30,6,1,0,7,6,30,6,1,0,7,6,30,4,0,0,4,1,-15,3,1
2,4,13,2,30,7,0,0,7,0,30,4,0,0,4,1,30,6,1,0,7,6,30,6,1,0,7,6,30,4,0,0,4,1,-15,3,1
2,4,17,2,30,11,3,0,14,2,30,6,0,0,6,0,30,6,8,0,14,0,30,6,8,0,14,2,30,4,0,0,4,1,-15,3,1
2,4,27,1,30,4,11,0,15,2,30,2,0,0,2,0,30,3,12,0,15,2,30,3,12,0,15,0,30,6,0,0,6,1,-15,3,1
2,2,35,0,30,6,7,0,13,4,30,2,0,0,2,1,30,4,9,0,13,2,30,3,10,0,13,7,30,8,0,0,8,1,-15,3,1
2,2,47,0,30,0,14,0,14,5,30,4,0,0,4,0,30,3,11,0,14,0,30,2,12,0,14,7,30,7,0,0,7,1,-15,3,1
2,0,4,3,30,7,1,0,8,4,30,4,0,0,4,0,30,3,5,0,8,1,30,4,4,0,8,1,30,2,2,0,4,0,-27,3,0
2,2,4,3,30,7,1,0,8,4,30,4,0,0,4,0,30,3,5,0,8,1,30,4,4,0,8,1,30,2,2,0,4,0,-27,3,0
2,3,4,3,30,7,1,0,8,4,30,4,0,0,4,0,30,3,5,0,8,1,30,4,4,0,8,1,30,2,2,0,4,0,-27,3,0
2,4,8,0,30,7,0,0,7,3,30,2,0,0,2,0,30,6,1,0,7,0,30,1,6,0,7,1,30,3,0,0,3,0,-27,3,0
2,0,17,2,30,5,9,0,14,2,30,6,0,0,6,0,30,4,10,0,14,1,30,9,5,0,14,7,30,4,0,0,4,1,-15,3,1
2,1,17,2,30,5,9,0,14,2,30,6,0,0,6,0,30,4,10,0,14,1,30,9,5,0,14,7,30,4,0,0,4,1,-15,3,1
2,2,19,1,30,7,6,0,13,2,30,2,6,0,8,0,30,4,9,0,13,3,30,4,9,0,13,0,30,9,0,0,9,1,-15,3,1
2,3,19,1,30,7,6,0,13,2,30,2,6,0,8,0,30,4,9,0,13,3,30,4,9,0,13,0,30,9,0,0,9,1,-15,3,1
2,2,25,3,30,3,11,0,14,3,30,6,0,0,6,0,30,10,4,0,14,1,30,5,9,0,14,3,30,5,1,0,6,1,-15,3,1
2,0,27,1,30,4,11,0,15,3,30,2,0,0,2,0,30,6,9,0,15,0,30,7,8,0,15,2,30,6,0,0,6,1,-15,3,1
2,1,27,1,30,4,11,0,15,3,30,2,0,0,2,0,30,6,9,0,15,0,30,7,8,0,15,2,30,6,0,0,6,1,-15,3,1
2,2,27,1,30,4,11,0,15,3,30,2,0,0,2,0,30,6,9,0,15,0,30,7,8,0,15,2,30,6,0,0,6,1,-15,3,1
2,4,27,1,30,4,11,0,15,3,30,2,0,0,2,0,30,6,9,0,15,0,30,7,8,0,15,2,30,6,0,0,6,1,-15,3,1
2,4,31,4,30,6,6,0,12,5,30,8,0,0,8,3,30,8,4,0,12,0,30,8,4,0,12,0,30,2,4,0,6,1,-15,3,1
2,1,33,3,30,4,7,0,11,5,30,4,0,0,4,1,30,9,2,0,11,1,30,4,7,0,11,7,30,4,0,0,4,1,-15,3,1
2,3,33,3,30,4,7,0,11,5,30,4,0,0,4,1,30,9,2,0,11,1,30,4,7,0,11,7,30,4,0,0,4,1,-15,3,1
2,3,1,0,30,7,3,0,10,5,30,2,0,0,2,1,30,3,7,0,10,4,30,10,0,0,10,5,30,6,0,0,6,0,-27,3,0
2,2,19,1,30,4,9,0,13,2,30,5,3,0,8,0,30,7,6,0,13,0,30,4,9,0,13,1,30,9,0,0,9,1,-15,3,1
2,3,19,1,30,4,9,0,13,2,30,5,3,0,8,0,30,7,6,0,13,0,30,4,9,0,13,1,30,9,0,0,9,1,-15,3,1
2,4,23,2,30,4,9,0,13,1,30,6,0,0,6,3,30,12,1,0,13,0,30,5,8,0,13,2,30,5,1,0,6,1,-15,3,1
2,4,25,0,30,7,7,0,14,0,30,6,0,0,6,0,30,12,2,0,14,1,30,5,9,0,14,3,30,5,1,0,6,1,-15,3,1
2,2,31,1,30,5,7,0,12,7,30,8,0,0,8,3,30,4,8,0,12,3,30,10,2,0,12,6,30,6,0,0,6,1,-15,3,1
2,4,31,1,30,5,7,0,12,7,30,8,0,0,8,3,30,4,8,0,12,2,30,10,2,0,12,6,30,6,0,0,6,1,-15,3,1
2,4,32,0,30,4,5,0,9,4,30,2,0,0,2,0,30,6,3,0,9,1,30,4,5,0,9,6,30,2,0,0,2,1,-15,3,1
2,4,35,1,30,6,7,0,13,3,30,2,0,0,2,1,30,10,3,0,13,4,30,3,10,0,13,0,30,8,0,0,8,1,-15,3,1
2,1,6,1,30,7,2,0,9,3,30,2,0,0,2,0,30,4,5,0,9,2,30,4,5,0,9,0,30,1,4,0,5,0,-27,3,0
2,2,6,1,30,7,2,0,9,3,30,2,0,0,2,0,30,4,5,0,9,2,30,4,5,0,9,0,30,1,4,0,5,0,-27,3,0
2,4,6,1,30,7,2,0,9,3,30,2,0,0,2,0,30,4,5,0,9,2,30,4,5,0,9,0,30,1,4,0,5,0,-27,3,0
2,4,13,1,30,4,3,0,7,0,30,4,0,0,4,2,30,7,0,0,7,6,30,6,1,0,7,6,30,4,0,0,4,1,-15,3,1
2,3,15,0,30,4,9,0,13,1,30,6,0,0,6,0,30,4,9,0,13,0,30,6,7,0,13,3,30,9,0,0,9,1,-15,3,1
2,4,15,0,30,4,9,0,13,1,30,6,0,0,6,0,30,4,9,0,13,0,30,6,7,0,13,3,30,9,0,0,9,1,-15,3,1
2,2,19,0,30,4,9,0,13,1,30,6,2,0,8,0,30,4,9,0,13,1,30,4,9,0,13,0,30,6,3,0,9,1,-15,3,1
2,1,23,4,30,5,8,0,13,2,30,6,0,0,6,1,30,13,0,0,13,0,30,6,7,0,13,2,30,5,1,0,6,1,-15,3,1
2,2,23,4,30,5,8,0,13,2,30,6,0,0,6,1,30,13,0,0,13,0,30,6,7,0,13,2,30,5,1,0,6,1,-15,3,1
2,3,23,4,30,5,8,0,13,2,30,6,0,0,6,1,30,13,0,0,13,0,30,6,7,0,13,2,30,5,1,0,6,1,-15,3,1
2,4,25,1,30,6,8,0,14,5,30,6,0,0,6,0,30,7,7,0,14,1,30,7,7,0,14,0,30,6,0,0,6,1,-15,3,1
2,4,27,3,30,7,8,0,15,2,30,2,0,0,2,0,30,6,9,0,15,0,30,4,11,0,15,0,30,2,4,0,6,1,-15,3,1
2,1,29,0,30,7,7,0,14,5,30,12,0,0,12,0,30,7,7,0,14,0,30,1,13,0,14,2,30,9,0,0,9,1,-15,3,1
2,4,29,0,30,7,7,0,14,5,30,12,0,0,12,0,30,7,7,0,14,0,30,1,13,0,14,0,30,9,0,0,9,1,-15,3,1
2,4,7,1,30,4,5,0,9,3,30,4,0,0,4,0,30,5,4,0,9,4,30,3,6,0,9,1,30,4,2,0,6,0,-27,3,0
2,3,8,4,30,7,0,0,7,5,30,2,0,0,2,0,30,3,4,0,7,0,30,6,1,0,7,2,30,3,0,0,3,0,-27,3,0
2,3,23,2,30,13,0,0,13,1,30,6,0,0,6,2,30,11,2,0,13,0,30,5,8,0,13,4,30,5,1,0,6,1,-15,3,1
2,4,25,1,30,3,11,0,14,6,30,6,0,0,6,0,30,6,8,0,14,6,30,6,8,0,14,1,30,6,0,0,6,1,-15,3,1
2,0,27,2,30,4,11,0,15,3,30,2,0,0,2,3,30,11,4,0,15,0,30,5,10,0,15,1,30,3,3,0,6,1,-15,3,1
2,1,27,2,30,4,11,0,15,3,30,2,0,0,2,3,30,11,4,0,15,0,30,5,10,0,15,1,30,3,3,0,6,1,-15,3,1
2,3,29,0,30,6,8,0,14,6,30,12,0,0,12,0,30,4,10,0,14,0,30,1,13,0,14,6,30,9,0,0,9,1,-15,3,1
2,4,29,0,30,6,8,0,14,6,30,12,0,0,12,0,30,4,10,0,14,0,30,1,13,0,14,6,30,9,0,0,9,1,-15,3,1
2,0,41,0,30,7,5,0,12,6,30,8,0,0,8,0,30,3,9,0,12,0,30,3,9,0,12,5,30,7,0,0,7,1,-15,3,1
2,2,41,0,30,7,5,0,12,6,30,8,0,0,8,0,30,3,9,0,12,0,30,3,9,0,12,5,30,7,0,0,7,1,-15,3,1
2,4,41,0,30,7,5,0,12,6,30,8,0,0,8,0,30,3,9,0,12,0,30,3,9,0,12,5,30,7,0,0,7,1,-15,3,1
2,4,8,1,30,7,0,0,7,2,30,2,0,0,2,2,30,5,2,0,7,2,30,6,1,0,7,1,30,3,0,0,3,0,-27,3,0
2,4,15,0,30,6,7,0,13,1,30,6,0,0,6,0,30,3,10,0,13,1,30,5,8,0,13,3,30,7,2,0,9,1,-15,3,1
2,1,17,3,30,9,5,0,14,4,30,6,0,0,6,0,30,5,9,0,14,1,30,9,5,0,14,4,30,4,0,0,4,1,-15,3,1
2,2,19,3,30,3,10,0,13,3,30,6,2,0,8,0,30,5,8,0,13,9,30,5,8,0,13,0,30,7,2,0,9,1,-15,3,1
2,4,22,1,30,6,2,0,8,3,30,2,0,0,2,4,30,5,3,0,8,1,30,4,4,0,8,1,30,3,1,0,4,1,-15,3,1
2,0,25,2,30,8,6,0,14,4,30,6,0,0,6,0,30,8,6,0,14,1,30,5,9,0,14,5,30,5,1,0,6,1,-15,3,1
2,1,25,2,30,8,6,0,14,4,30,6,0,0,6,0,30,8,6,0,14,1,30,5,9,0,14,5,30,5,1,0,6,1,-15,3,1
2,3,25,2,30,8,6,0,14,4,30,6,0,0,6,0,30,8,6,0,14,1,30,5,9,0,14,5,30,5,1,0,6,1,-15,3,1
2,2,27,1,30,4,11,0,15,4,30,2,0,0,2,0,30,3,12,0,15,0,30,4,11,0,15,1,30,2,4,0,6,1,-15,3,1
2,3,27,1,30,4,11,0,15,4,30,2,0,0,2,0,30,3,12,0,15,0,30,4,11,0,15,1,30,2,4,0,6,1,-15,3,1
2,4,27,1,30,4,11,0,15,4,30,2,0,0,2,0,30,3,12,0,15,0,30,4,11,0,15,1,30,2,4,0,6,1,-15,3,1
2,1,30,11,30,2,3,0,5,5,30,2,0,0,2,1,30,1,4,0,5,1,30,2,3,0,5,1,30,3,0,0,3,1,-15,3,1
2,0,4,2,30,7,1,0,8,5,30,4,0,0,4,0,30,2,6,0,8,0,30,7,1,0,8,2,30,3,1,0,4,0,-27,3,0
2,3,4,2,30,7,1,0,8,5,30,4,0,0,4,0,30,2,6,0,8,0,30,7,1,0,8,0,30,3,1,0,4,0,-27,3,0
2,4,11,0,30,1,3,0,4,0,30,0,0,0,0,0,30,2,2,0,4,3,30,3,1,0,4,1,30,1,0,0,1,1,-15,3,1
2,2,13,2,30,7,0,0,7,0,30,4,0,0,4,0,30,6,1,0,7,8,30,6,1,0,7,5,30,4,0,0,4,1,-15,3,1
2,4,23,5,30,7,6,0,13,0,30,6,0,0,6,0,30,13,0,0,13,0,30,5,8,0,13,2,30,5,1,0,6,1,-15,3,1
2,4,25,1,30,4,10,0,14,5,30,6,0,0,6,3,30,6,8,0,14,1,30,6,8,0,14,2,30,5,1,0,6,1,-15,3,1
2,0,27,3,30,5,10,0,15,2,30,1,1,0,2,0,30,8,7,0,15,0,30,6,9,0,15,3,30,6,0,0,6,1,-15,3,1
2,1,27,3,30,5,10,0,15,2,30,1,1,0,2,0,30,8,7,0,15,0,30,6,9,0,15,3,30,6,0,0,6,1,-15,3,1
2,3,27,3,30,5,10,0,15,2,30,1,1,0,2,0,30,8,7,0,15,0,30,6,9,0,15,3,30,6,0,0,6,1,-15,3,1
2,1,29,1,30,4,10,0,14,6,30,11,1,0,12,0,30,3,11,0,14,0,30,0,14,0,14,0,30,9,0,0,9,1,-15,3,1
2,3,29,1,30,4,10,0,14,6,30,11,1,0,12,0,30,3,11,0,14,0,30,0,14,0,14,0,30,9,0,0,9,1,-15,3,1
2,2,31,4,30,7,5,0,12,4,30,8,0,0,8,6,30,11,1,0,12,0,30,5,7,0,12,0,30,2,4,0,6,1,-15,3,1
2,3,31,4,30,7,5,0,12,4,30,8,0,0,8,6,30,11,1,0,12,0,30,5,7,0,12,0,30,2,4,0,6,1,-15,3,1
2,1,33,1,30,3,8,0,11,5,30,4,0,0,4,1,30,9,2,0,11,4,30,4,7,0,11,6,30,4,0,0,4,1,-15,3,1
2,0,43,0,30,10,4,0,14,9,30,6,0,0,6,0,30,4,10,0,14,5,30,8,6,0,14,4,30,5,0,0,5,1,-15,3,1
2,2,43,0,30,10,4,0,14,9,30,6,0,0,6,0,30,4,10,0,14,5,30,8,6,0,14,4,30,5,0,0,5,1,-15,3,1
2,3,43,0,30,10,4,0,14,9,30,6,0,0,6,0,30,4,10,0,14,5,30,8,6,0,14,4,30,5,0,0,5,1,-15,3,1
2,4,43,0,30,10,4,0,14,9,30,6,0,0,6,0,30,4,10,0,14,5,30,8,6,0,14,4,30,5,0,0,5,1,-15,3,1
2,0,5,0,30,1,4,0,5,3,30,2,2,0,4,3,30,0,5,0,5,0,30,1,4,0,5,0,30,1,1,0,2,0,-27,3,0
2,4,5,0,30,1,4,0,5,3,30,2,2,0,4,3,30,0,5,0,5,0,30,1,4,0,5,0,30,1,1,0,2,0,-27,3,0
2,1,17,3,30,9,5,0,14,3,30,6,0,0,6,0,30,5,9,0,14,0,30,8,6,0,14,8,30,4,0,0,4,1,-15,3,1
2,1,19,0,30,2,11,0,13,2,30,5,3,0,8,0,30,4,9,0,13,3,30,6,7,0,13,3,30,9,0,0,9,1,-15,3,1
2,4,23,1,30,7,6,0,13,3,30,6,0,0,6,7,30,13,0,0,13,0,30,5,8,0,13,2,30,6,0,0,6,1,-15,3,1
2,0,25,6,30,7,7,0,14,5,30,5,1,0,6,0,30,6,8,0,14,1,30,6,8,0,14,5,30,5,1,0,6,1,-15,3,1
2,1,25,6,30,7,7,0,14,5,30,5,1,0,6,0,30,6,8,0,14,1,30,6,8,0,14,5,30,5,1,0,6,1,-15,3,1
2,2,25,6,30,7,7,0,14,5,30,5,1,0,6,0,30,6,8,0,14,1,30,6,8,0,14,5,30,5,1,0,6,1,-15,3,1
2,0,27,1,30,5,10,0,15,2,30,2,0,0,2,0,30,4,11,0,15,0,30,5,10,0,15,5,30,6,0,0,6,1,-15,3,1
2,2,27,1,30,5,10,0,15,2,30,2,0,0,2,0,30,4,11,0,15,0,30,5,10,0,15,0,30,6,0,0,6,1,-15,3,1
2,3,27,1,30,5,10,0,15,2,30,2,0,0,2,0,30,4,11,0,15,0,30,5,10,0,15,0,30,6,0,0,6,1,-15,3,1
2,4,29,0,30,5,9,0,14,5,30,12,0,0,12,0,30,2,12,0,14,0,30,1,13,0,14,0,30,6,3,0,9,1,-15,3,1
2,2,4,2,30,8,0,0,8,4,30,4,0,0,4,1,30,1,7,0,8,0,30,4,4,0,8,2,30,2,2,0,4,0,-27,3,0
2,4,4,2,30,8,0,0,8,4,30,4,0,0,4,1,30,1,7,0,8,0,30,4,4,0,8,2,30,2,2,0,4,0,-27,3,0
2,4,8,1,30,7,0,0,7,5,30,2,0,0,2,4,30,2,5,0,7,2,30,7,0,0,7,2,30,3,0,0,3,0,-27,3,0
2,3,15,1,30,4,9,0,13,1,30,6,0,0,6,0,30,3,10,0,13,1,30,7,6,0,13,4,30,9,0,0,9,1,-15,3,1
2,3,17,4,30,11,3,0,14,2,30,6,0,0,6,0,30,6,8,0,14,1,30,6,8,0,14,1,30,4,0,0,4,1,-15,3,1
2,3,23,1,30,7,6,0,13,2,30,6,0,0,6,3,30,13,0,0,13,0,30,5,8,0,13,2,30,5,1,0,6,1,-15,3,1
2,4,29,1,30,9,5,0,14,5,30,12,0,0,12,0,30,4,10,0,14,1,30,3,11,0,14,0,30,4,5,0,9,1,-15,3,1
2,2,33,1,30,2,9,0,11,4,30,4,0,0,4,3,30,9,2,0,11,1,30,3,8,0,11,4,30,4,0,0,4,1,-15,3,1
2,3,4,7,30,7,1,0,8,6,30,4,0,0,4,0,30,1,7,0,8,0,30,4,4,0,8,4,30,4,0,0,4,0,-27,3,0
2,4,4,7,30,7,1,0,8,6,30,4,0,0,4,0,30,1,7,0,8,0,30,4,4,0,8,4,30,4,0,0,4,0,-27,3,0
2,2,5,0,30,5,0,0,5,3,30,4,0,0,4,0,30,0,5,0,5,0,30,1,4,0,5,0,30,2,0,0,2,0,-27,3,0
2,2,11,0,30,4,8,0,12,0,30,4,0,0,4,0,30,5,7,0,12,7,30,5,7,0,12,7,30,4,0,0,4,1,-15,3,1
2,2,13,0,30,6,1,0,7,0,30,4,0,0,4,4,30,7,0,0,7,14,30,5,2,0,7,3,30,4,0,0,4,1,-15,3,1
2,4,15,0,30,3,10,0,13,1,30,6,0,0,6,0,30,4,9,0,13,1,30,6,7,0,13,4,30,8,1,0,9,1,-15,3,1
2,4,21,1,30,7,3,0,10,3,30,4,2,0,6,0,30,3,7,0,10,1,30,4,6,0,10,3,30,4,0,0,4,1,-15,3,1
2,2,23,2,30,4,9,0,13,4,30,6,0,0,6,4,30,12,1,0,13,0,30,5,8,0,13,3,30,6,0,0,6,1,-15,3,1
2,3,23,2,30,4,9,0,13,4,30,6,0,0,6,4,30,12,1,0,13,0,30,5,8,0,13,3,30,6,0,0,6,1,-15,3,1
2,4,23,2,30,4,9,0,13,4,30,6,0,0,6,4,30,12,1,0,13,0,30,5,8,0,13,3,30,6,0,0,6,1,-15,3,1
2,0,27,1,30,5,10,0,15,4,30,2,0,0,2,0,30,3,12,0,15,1,30,6,9,0,15,2,30,6,0,0,6,1,-15,3,1
2,2,27,1,30,5,10,0,15,4,30,2,0,0,2,0,30,3,12,0,15,1,30,6,9,0,15,2,30,6,0,0,6,1,-15,3,1
2,2,32,0,30,9,0,0,9,4,30,2,0,0,2,0,30,9,0,0,9,2,30,5,4,0,9,2,30,2,0,0,2,1,-15,3,1
2,0,37,4,30,9,2,0,11,6,30,4,4,0,8,0,30,8,3,0,11,0,30,4,7,0,11,4,30,6,0,0,6,1,-15,3,1
2,3,37,4,30,9,2,0,11,6,30,4,4,0,8,0,30,8,3,0,11,0,30,4,7,0,11,4,30,6,0,0,6,1,-15,3,1
2,2,39,0,30,3,8,0,11,6,30,6,0,0,6,0,30,7,4,0,11,1,30,5,6,0,11,4,30,5,0,0,5,1,-15,3,1
2,3,39,0,30,3,8,0,11,6,30,6,0,0,6,0,30,7,4,0,11,1,30,5,6,0,11,4,30,5,0,0,5,1,-15,3,1
2,4,39,0,30,3,8,0,11,6,30,6,0,0,6,0,30,7,4,0,11,1,30,5,6,0,11,4,30,5,0,0,5,1,-15,3,1
2,2,5,0,30,3,2,0,5,2,30,4,0,0,4,0,30,1,4,0,5,0,30,1,4,0,5,1,30,0,2,0,2,0,-27,3,0
2,4,5,0,30,3,2,0,5,2,30,4,0,0,4,0,30,1,4,0,5,0,30,1,4,0,5,1,30,0,2,0,2,0,-27,3,0
2,2,9,1,30,7,4,0,11,2,30,6,0,0,6,1,30,9,2,0,11,5,30,3,8,0,11,2,30,4,0,0,4,0,-27,3,0
2,4,13,0,30,5,2,0,7,0,30,4,0,0,4,2,30,5,2,0,7,8,30,6,1,0,7,5,30,4,0,0,4,1,-15,3,1
2,4,17,2,30,10,4,0,14,3,30,6,0,0,6,0,30,4,10,0,14,1,30,4,10,0,14,5,30,4,0,0,4,1,-15,3,1
2,1,19,1,30,2,11,0,13,2,30,7,1,0,8,0,30,5,8,0,13,1,30,4,9,0,13,1,30,8,1,0,9,1,-15,3,1
2,1,25,1,30,4,10,0,14,5,30,6,0,0,6,0,30,6,8,0,14,1,30,4,10,0,14,5,30,5,1,0,6,1,-15,3,1
2,0,27,1,30,4,11,0,15,3,30,2,0,0,2,0,30,8,7,0,15,0,30,5,10,0,15,1,30,6,0,0,6,1,-15,3,1
2,2,43,0,30,5,9,0,14,7,30,6,0,0,6,0,30,4,10,0,14,1,30,4,10,0,14,9,30,5,0,0,5,1,-15,3,1
2,4,5,0,30,1,4,0,5,2,30,2,2,0,4,1,30,1,4,0,5,0,30,1,4,0,5,0,30,0,2,0,2,0,-27,3,0
2,2,6,0,30,8,1,0,9,4,30,2,0,0,2,0,30,2,7,0,9,0,30,4,5,0,9,3,30,5,0,0,5,0,-27,3,0
2,1,13,2,30,5,2,0,7,0,30,4,0,0,4,2,30,6,1,0,7,6,30,7,0,0,7,7,30,4,0,0,4,1,-15,3,1
2,2,13,2,30,5,2,0,7,0,30,4,0,0,4,2,30,6,1,0,7,6,30,7,0,0,7,7,30,4,0,0,4,1,-15,3,1
2,3,13,2,30,5,2,0,7,0,30,4,0,0,4,2,30,6,1,0,7,6,30,7,0,0,7,7,30,4,0,0,4,1,-15,3,1
2,4,15,1,30,4,9,0,13,1,30,6,0,0,6,0,30,3,10,0,13,1,30,6,7,0,13,2,30,9,0,0,9,1,-15,3,1
2,3,17,3,30,8,6,0,14,3,30,6,0,0,6,0,30,5,9,0,14,1,30,5,9,0,14,1,30,3,1,0,4,1,-15,3,1
2,1,19,0,30,3,10,0,13,2,30,6,2,0,8,0,30,6,7,0,13,9,30,7,6,0,13,0,30,8,1,0,9,1,-15,3,1
2,4,19,0,30,3,10,0,13,2,30,6,2,0,8,0,30,6,7,0,13,9,30,7,6,0,13,0,30,8,1,0,9,1,-15,3,1
2,2,27,1,30,4,11,0,15,3,30,2,0,0,2,0,30,9,6,0,15,0,30,3,12,0,15,0,30,6,0,0,6,1,-15,3,1
2,4,29,0,30,6,8,0,14,6,30,10,2,0,12,0,30,2,12,0,14,0,30,1,13,0,14,3,30,9,0,0,9,1,-15,3,1
2,4,31,1,30,8,4,0,12,4,30,8,0,0,8,3,30,8,4,0,12,2,30,5,7,0,12,0,30,4,2,0,6,1,-15,3,1
2,3,37,0,30,6,5,0,11,5,30,7,1,0,8,0,30,11,0,0,11,4,30,8,3,0,11,2,30,3,3,0,6,1,-15,3,1
2,0,5,0,30,2,3,0,5,3,30,2,2,0,4,0,30,0,5,0,5,0,30,4,1,0,5,0,30,1,1,0,2,0,-27,3,0
2,2,5,0,30,2,3,0,5,3,30,2,2,0,4,0,30,0,5,0,5,0,30,4,1,0,5,0,30,1,1,0,2,0,-27,3,0
2,3,5,0,30,2,3,0,5,3,30,2,2,0,4,0,30,0,5,0,5,0,30,4,1,0,5,0,30,1,1,0,2,0,-27,3,0
2,4,8,3,30,7,0,0,7,4,30,2,0,0,2,4,30,5,2,0,7,0,30,5,2,0,7,0,30,2,1,0,3,0,-27,3,0
2,2,17,3,30,10,4,0,14,2,30,6,0,0,6,0,30,5,9,0,14,2,30,5,9,0,14,7,30,4,0,0,4,1,-15,3,1
2,1,19,0,30,3,10,0,13,3,30,5,3,0,8,0,30,4,9,0,13,9,30,5,8,0,13,2,30,9,0,0,9,1,-15,3,1
2,3,23,1,30,5,8,0,13,2,30,6,0,0,6,0,30,12,1,0,13,0,30,7,6,0,13,2,30,6,0,0,6,1,-15,3,1
2,3,25,1,30,6,8,0,14,4,30,6,0,0,6,0,30,7,7,0,14,1,30,5,9,0,14,5,30,5,1,0,6,1,-15,3,1
2,2,27,1,30,4,11,0,15,5,30,2,0,0,2,4,30,5,10,0,15,0,30,3,12,0,15,2,30,6,0,0,6,1,-15,3,1
2,2,31,1,30,5,7,0,12,5,30,8,0,0,8,4,30,7,5,0,12,0,30,4,8,0,12,2,30,3,3,0,6,1,-15,3,1
2,4,35,0,30,12,1,0,13,3,30,2,0,0,2,1,30,8,5,0,13,0,30,1,12,0,13,0,30,8,0,0,8,1,-15,3,1
2,0,47,0,30,7,7,0,14,7,30,4,0,0,4,0,30,10,4,0,14,0,30,2,12,0,14,2,30,7,0,0,7,1,-15,3,1
2,2,47,0,30,7,7,0,14,7,30,4,0,0,4,0,30,10,4,0,14,0,30,2,12,0,14,2,30,7,0,0,7,1,-15,3,1
2,3,3,0,30,0,4,0,4,3,30,4,0,0,4,0,30,0,4,0,4,3,30,2,2,0,4,3,30,3,0,0,3,0,-27,3,0
2,4,3,0,30,0,4,0,4,3,30,4,0,0,4,0,30,0,4,0,4,3,30,2,2,0,4,3,30,3,0,0,3,0,-27,3,0
2,0,4,2,30,7,1,0,8,4,30,4,0,0,4,0,30,1,7,0,8,0,30,5,3,0,8,2,30,2,2,0,4,0,-27,3,0
2,2,19,0,30,3,10,0,13,2,30,5,3,0,8,0,30,8,5,0,13,6,30,7,6,0,13,0,30,9,0,0,9,1,-15,3,1
2,3,19,0,30,3,10,0,13,2,30,5,3,0,8,0,30,8,5,0,13,6,30,7,6,0,13,0,30,9,0,0,9,1,-15,3,1
2,2,25,1,30,8,6,0,14,3,30,6,0,0,6,0,30,6,8,0,14,1,30,6,8,0,14,5,30,6,0,0,6,1,-15,3,1
2,3,27,1,30,8,7,0,15,3,30,1,1,0,2,0,30,3,12,0,15,2,30,8,7,0,15,0,30,6,0,0,6,1,-15,3,1
2,0,33,4,30,5,6,0,11,5,30,4,0,0,4,3,30,8,3,0,11,0,30,3,8,0,11,4,30,4,0,0,4,1,-15,3,1
2,1,33,4,30,5,6,0,11,5,30,4,0,0,4,3,30,8,3,0,11,0,30,3,8,0,11,4,30,4,0,0,4,1,-15,3,1
2,2,33,4,30,5,6,0,11,5,30,4,0,0,4,3,30,8,3,0,11,0,30,3,8,0,11,4,30,4,0,0,4,1,-15,3,1
2,3,33,4,30,5,6,0,11,5,30,4,0,0,4,3,30,8,3,0,11,0,30,3,8,0,11,4,30,4,0,0,4,1,-15,3,1
2,3,35,0,30,5,8,0,13,6,30,2,0,0,2,1,30,2,11,0,13,0,30,5,8,0,13,8,30,8,0,0,8,1,-15,3,1
2,3,47,0,30,0,14,0,14,6,30,4,0,0,4,0,30,10,4,0,14,0,30,7,7,0,14,7,30,7,0,0,7,1,-15,3,1
2,2,11,1,30,2,10,0,12,0,30,4,0,0,4,0,30,8,4,0,12,8,30,4,8,0,12,6,30,4,0,0,4,1,-15,3,1
2,4,17,2,30,8,6,0,14,2,30,6,0,0,6,0,30,7,7,0,14,2,30,5,9,0,14,2,30,4,0,0,4,1,-15,3,1
2,0,26,0,30,6,3,0,9,5,30,2,2,0,4,7,30,3,6,0,9,0,30,2,7,0,9,5,30,3,0,0,3,1,-15,3,1
2,1,26,0,30,6,3,0,9,5,30,2,2,0,4,7,30,3,6,0,9,0,30,2,7,0,9,5,30,3,0,0,3,1,-15,3,1
2,1,27,1,30,7,8,0,15,3,30,2,0,0,2,0,30,8,7,0,15,1,30,6,9,0,15,2,30,5,1,0,6,1,-15,3,1
2,2,27,1,30,7,8,0,15,3,30,2,0,0,2,0,30,8,7,0,15,1,30,6,9,0,15,2,30,5,1,0,6,1,-15,3,1
2,4,32,0,30,5,4,0,9,4,30,2,0,0,2,3,30,7,2,0,9,1,30,3,6,0,9,4,30,2,0,0,2,1,-15,3,1
2,4,39,0,30,4,7,0,11,6,30,6,0,0,6,0,30,5,6,0,11,0,30,4,7,0,11,5,30,5,0,0,5,1,-15,3,1
2,1,13,4,30,7,0,0,7,0,30,4,0,0,4,2,30,6,1,0,7,8,30,6,1,0,7,1,30,4,0,0,4,1,-15,3,1
2,2,13,4,30,7,0,0,7,0,30,4,0,0,4,2,30,6,1,0,7,8,30,6,1,0,7,1,30,4,0,0,4,1,-15,3,1
2,4,13,4,30,7,0,0,7,0,30,4,0,0,4,2,30,6,1,0,7,8,30,6,1,0,7,1,30,4,0,0,4,1,-15,3,1
2,4,17,0,30,8,6,0,14,2,30,6,0,0,6,0,30,6,8,0,14,1,30,9,5,0,14,4,30,4,0,0,4,1,-15,3,1
2,1,19,1,30,4,9,0,13,2,30,5,3,0,8,0,30,7,6,0,13,6,30,5,8,0,13,3,30,9,0,0,9,1,-15,3,1
2,4,22,7,30,8,0,0,8,3,30,2,0,0,2,0,30,5,3,0,8,0,30,1,7,0,8,2,30,1,3,0,4,1,-15,3,1
2,0,27,1,30,5,10,0,15,4,30,2,0,0,2,0,30,7,8,0,15,2,30,6,9,0,15,0,30,5,1,0,6,1,-15,3,1
2,2,27,1,30,5,10,0,15,4,30,2,0,0,2,0,30,7,8,0,15,2,30,6,9,0,15,0,30,5,1,0,6,1,-15,3,1
2,3,27,1,30,5,10,0,15,4,30,2,0,0,2,0,30,7,8,0,15,2,30,6,9,0,15,0,30,5,1,0,6,1,-15,3,1
2,4,27,1,30,5,10,0,15,4,30,2,0,0,2,0,30,7,8,0,15,2,30,6,9,0,15,0,30,5,1,0,6,1,-15,3,1
2,4,31,1,30,6,6,0,12,3,30,8,0,0,8,0,30,9,3,0,12,0,30,3,9,0,12,3,30,4,2,0,6,1,-15,3,1
2,1,5,0,30,2,3,0,5,3,30,1,3,0,4,0,30,2,3,0,5,0,30,1,4,0,5,0,30,0,2,0,2,0,-27,3,0
2,2,5,0,30,2,3,0,5,3,30,1,3,0,4,0,30,2,3,0,5,0,30,1,4,0,5,0,30,0,2,0,2,0,-27,3,0
2,3,5,0,30,2,3,0,5,3,30,1,3,0,4,0,30,2,3,0,5,0,30,1,4,0,5,0,30,0,2,0,2,0,-27,3,0
2,4,8,0,30,7,0,0,7,4,30,2,0,0,2,0,30,3,4,0,7,0,30,7,0,0,7,0,30,3,0,0,3,0,-27,3,0
2,2,13,1,30,5,2,0,7,0,30,4,0,0,4,2,30,7,0,0,7,12,30,5,2,0,7,2,30,4,0,0,4,1,-15,3,1
2,3,17,4,30,9,5,0,14,3,30,6,0,0,6,0,30,5,9,0,14,1,30,5,9,0,14,5,30,4,0,0,4,1,-15,3,1
2,2,25,1,30,7,7,0,14,3,30,6,0,0,6,0,30,6,8,0,14,1,30,7,7,0,14,7,30,6,0,0,6,1,-15,3,1
2,3,25,1,30,7,7,0,14,3,30,6,0,0,6,0,30,6,8,0,14,1,30,7,7,0,14,7,30,6,0,0,6,1,-15,3,1
2,2,29,0,30,6,8,0,14,6,30,12,0,0,12,0,30,3,11,0,14,0,30,1,13,0,14,1,30,9,0,0,9,1,-15,3,1
2,3,29,0,30,6,8,0,14,6,30,12,0,0,12,0,30,3,11,0,14,0,30,1,13,0,14,1,30,9,0,0,9,1,-15,3,1
2,0,4,2,30,7,1,0,8,4,30,3,1,0,4,0,30,4,4,0,8,0,30,7,1,0,8,5,30,4,0,0,4,0,-27,3,0
2,4,7,0,30,3,1,0,4,2,30,2,0,0,2,0,30,4,0,0,4,3,30,1,3,0,4,3,30,1,1,0,2,0,-27,3,0
2,4,8,1,30,7,0,0,7,4,30,2,0,0,2,4,30,3,4,0,7,1,30,5,2,0,7,2,30,3,0,0,3,0,-27,3,0
2,3,11,1,30,5,7,0,12,0,30,4,0,0,4,0,30,7,5,0,12,1,30,4,8,0,12,2,30,3,1,0,4,1,-15,3,1
2,4,15,0,30,4,9,0,13,0,30,6,0,0,6,0,30,3,10,0,13,1,30,4,9,0,13,2,30,9,0,0,9,1,-15,3,1
2,1,17,2,30,9,5,0,14,4,30,6,0,0,6,0,30,4,10,0,14,5,30,6,8,0,14,2,30,4,0,0,4,1,-15,3,1
2,3,19,1,30,4,9,0,13,3,30,7,1,0,8,0,30,4,9,0,13,5,30,6,7,0,13,0,30,8,1,0,9,1,-15,3,1
2,1,21,3,30,8,2,0,10,4,30,6,0,0,6,1,30,3,7,0,10,2,30,5,5,0,10,3,30,4,0,0,4,1,-15,3,1
2,4,31,1,30,6,6,0,12,4,30,8,0,0,8,3,30,8,4,0,12,0,30,3,9,0,12,0,30,4,2,0,6,1,-15,3,1
2,1,37,1,30,7,4,0,11,5,30,8,0,0,8,0,30,8,3,0,11,4,30,3,8,0,11,5,30,6,0,0,6,1,-15,3,1
2,3,37,1,30,7,4,0,11,5,30,8,0,0,8,0,30,8,3,0,11,4,30,3,8,0,11,5,30,6,0,0,6,1,-15,3,1
2,4,8,1,30,7,0,0,7,4,30,2,0,0,2,4,30,3,4,0,7,0,30,6,1,0,7,0,30,3,0,0,3,0,-27,3,0
2,4,13,0,30,6,1,0,7,0,30,4,0,0,4,0,30,6,1,0,7,6,30,6,1,0,7,4,30,4,0,0,4,1,-15,3,1
2,4,19,1,30,4,9,0,13,1,30,8,0,0,8,0,30,7,6,0,13,0,30,4,9,0,13,1,30,7,2,0,9,1,-15,3,1
2,0,25,1,30,5,9,0,14,5,30,6,0,0,6,0,30,6,8,0,14,1,30,7,7,0,14,6,30,6,0,0,6,1,-15,3,1
2,1,25,1,30,5,9,0,14,5,30,6,0,0,6,0,30,6,8,0,14,1,30,7,7,0,14,6,30,6,0,0,6,1,-15,3,1
2,2,25,1,30,5,9,0,14,5,30,6,0,0,6,0,30,6,8,0,14,1,30,7,7,0,14,6,30,6,0,0,6,1,-15,3,1
2,3,25,1,30,5,9,0,14,5,30,6,0,0,6,0,30,6,8,0,14,1,30,7,7,0,14,6,30,6,0,0,6,1,-15,3,1
2,4,25,1,30,5,9,0,14,5,30,6,0,0,6,0,30,6,8,0,14,1,30,7,7,0,14,6,30,6,0,0,6,1,-15,3,1
2,0,27,2,30,5,10,0,15,3,30,2,0,0,2,0,30,1,14,0,15,2,30,4,11,0,15,8,30,6,0,0,6,1,-15,3,1
2,1,27,2,30,5,10,0,15,3,30,2,0,0,2,0,30,1,14,0,15,2,30,4,11,0,15,8,30,6,0,0,6,1,-15,3,1
2,4,29,0,30,5,9,0,14,5,30,12,0,0,12,0,30,7,7,0,14,0,30,1,13,0,14,2,30,9,0,0,9,1,-15,3,1
2,0,31,1,30,6,6,0,12,4,30,8,0,0,8,3,30,11,1,0,12,0,30,3,9,0,12,1,30,4,2,0,6,1,-15,3,1
2,3,1,0,30,7,3,0,10,4,30,2,0,0,2,0,30,4,6,0,10,4,30,4,6,0,10,8,30,6,0,0,6,0,-27,3,0
2,2,4,0,30,6,2,0,8,4,30,4,0,0,4,1,30,3,5,0,8,0,30,6,2,0,8,1,30,4,0,0,4,0,-27,3,0
2,3,4,0,30,6,2,0,8,4,30,4,0,0,4,1,30,3,5,0,8,0,30,6,2,0,8,1,30,4,0,0,4,0,-27,3,0
2,2,5,0,30,2,3,0,5,3,30,3,1,0,4,0,30,0,5,0,5,4,30,1,4,0,5,0,30,0,2,0,2,0,-27,3,0
2,3,5,0,30,2,3,0,5,3,30,3,1,0,4,0,30,0,5,0,5,4,30,1,4,0,5,0,30,0,2,0,2,0,-27,3,0
2,4,5,0,30,2,3,0,5,3,30,3,1,0,4,0,30,0,5,0,5,4,30,1,4,0,5,0,30,0,2,0,2,0,-27,3,0
2,4,7,0,30,4,0,0,4,2,30,2,0,0,2,0,30,1,3,0,4,0,30,1,3,0,4,1,30,2,0,0,2,0,-27,3,0
2,3,8,3,30,7,0,0,7,4,30,2,0,0,2,0,30,1,6,0,7,0,30,4,3,0,7,3,30,3,0,0,3,0,-27,3,0
2,4,13,1,30,5,2,0,7,0,30,4,0,0,4,2,30,7,0,0,7,16,30,6,1,0,7,2,30,4,0,0,4,1,-15,3,1
2,4,17,4,30,11,3,0,14,3,30,6,0,0,6,0,30,4,10,0,14,0,30,5,9,0,14,3,30,4,0,0,4,1,-15,3,1
2,4,19,0,30,2,11,0,13,0,30,6,2,0,8,0,30,8,5,0,13,3,30,5,8,0,13,1,30,8,1,0,9,1,-15,3,1
2,4,23,2,30,9,4,0,13,1,30,6,0,0,6,3,30,10,3,0,13,0,30,4,9,0,13,1,30,5,1,0,6,1,-15,3,1
2,4,39,0,30,2,9,0,11,7,30,6,0,0,6,0,30,4,7,0,11,2,30,4,7,0,11,4,30,5,0,0,5,1,-15,3,1
2,1,4,2,30,8,0,0,8,5,30,4,0,0,4,0,30,2,6,0,8,0,30,8,0,0,8,4,30,4,0,0,4,0,-27,3,0
2,3,13,3,30,5,2,0,7,2,30,4,0,0,4,10,30,7,0,0,7,6,30,7,0,0,7,1,30,4,0,0,4,1,-15,3,1
2,1,17,2,30,9,5,0,14,2,30,6,0,0,6,0,30,5,9,0,14,3,30,7,7,0,14,8,30,4,0,0,4,1,-15,3,1
2,2,17,2,30,9,5,0,14,2,30,6,0,0,6,0,30,5,9,0,14,3,30,7,7,0,14,8,30,4,0,0,4,1,-15,3,1
2,3,22,1,30,8,0,0,8,3,30,2,0,0,2,3,30,4,4,0,8,0,30,1,7,0,8,1,30,3,1,0,4,1,-15,3,1
2,4,23,1,30,8,5,0,13,0,30,6,0,0,6,4,30,13,0,0,13,0,30,4,9,0,13,0,30,5,1,0,6,1,-15,3,1
2,0,27,1,30,4,11,0,15,4,30,2,0,0,2,0,30,9,6,0,15,1,30,4,11,0,15,1,30,5,1,0,6,1,-15,3,1
2,1,27,1,30,4,11,0,15,4,30,2,0,0,2,0,30,9,6,0,15,1,30,4,11,0,15,1,30,5,1,0,6,1,-15,3,1
2,4,32,0,30,7,2,0,9,4,30,2,0,0,2,0,30,8,1,0,9,1,30,2,7,0,9,3,30,2,0,0,2,1,-15,3,1
2,1,41,0,30,10,2,0,12,5,30,8,0,0,8,0,30,9,3,0,12,0,30,3,9,0,12,3,30,2,5,0,7,1,-15,3,1
2,2,41,0,30,10,2,0,12,5,30,8,0,0,8,0,30,9,3,0,12,0,30,3,9,0,12,3,30,2,5,0,7,1,-15,3,1
2,1,5,2,30,2,3,0,5,3,30,3,1,0,4,0,30,0,5,0,5,0,30,1,4,0,5,0,30,0,2,0,2,0,-27,3,0
2,3,5,2,30,2,3,0,5,3,30,3,1,0,4,0,30,0,5,0,5,0,30,1,4,0,5,0,30,0,2,0,2,0,-27,3,0
2,0,21,3,30,8,2,0,10,3,30,5,1,0,6,1,30,3,7,0,10,2,30,3,7,0,10,6,30,4,0,0,4,1,-15,3,1
2,3,21,3,30,8,2,0,10,3,30,5,1,0,6,1,30,3,7,0,10,2,30,3,7,0,10,6,30,4,0,0,4,1,-15,3,1
2,4,21,3,30,8,2,0,10,3,30,5,1,0,6,1,30,3,7,0,10,2,30,3,7,0,10,6,30,4,0,0,4,1,-15,3,1
2,0,27,1,30,6,9,0,15,5,30,1,1,0,2,0,30,2,13,0,15,2,30,6,9,0,15,3,30,6,0,0,6,1,-15,3,1
2,2,27,1,30,6,9,0,15,5,30,1,1,0,2,0,30,2,13,0,15,2,30,6,9,0,15,3,30,6,0,0,6,1,-15,3,1
2,3,27,1,30,6,9,0,15,5,30,1,1,0,2,0,30,2,13,0,15,2,30,6,9,0,15,3,30,6,0,0,6,1,-15,3,1
2,4,29,0,30,9,5,0,14,5,30,12,0,0,12,0,30,4,10,0,14,0,30,0,14,0,14,0,30,6,3,0,9,1,-15,3,1
2,0,5,0,30,2,3,0,5,3,30,2,2,0,4,3,30,0,5,0,5,0,30,1,4,0,5,0,30,0,2,0,2,0,-27,3,0
2,3,5,0,30,2,3,0,5,3,30,2,2,0,4,3,30,0,5,0,5,0,30,1,4,0,5,0,30,0,2,0,2,0,-27,3,0
2,4,5,0,30,2,3,0,5,3,30,2,2,0,4,3,30,0,5,0,5,0,30,1,4,0,5,0,30,0,2,0,2,0,-27,3,0
2,4,15,1,30,4,9,0,13,0,30,6,0,0,6,0,30,10,3,0,13,1,30,3,10,0,13,4,30,4,5,0,9,1,-15,3,1
2,1,17,3,30,8,6,0,14,3,30,6,0,0,6,0,30,3,11,0,14,0,30,8,6,0,14,5,30,4,0,0,4,1,-15,3,1
2,2,17,3,30,8,6,0,14,3,30,6,0,0,6,0,30,3,11,0,14,0,30,8,6,0,14,5,30,4,0,0,4,1,-15,3,1
2,2,19,0,30,5,8,0,13,2,30,4,4,0,8,0,30,4,9,0,13,7,30,8,5,0,13,3,30,9,0,0,9,1,-15,3,1
2,3,27,1,30,4,11,0,15,2,30,2,0,0,2,0,30,5,10,0,15,0,30,6,9,0,15,6,30,6,0,0,6,1,-15,3,1
2,4,27,1,30,4,11,0,15,2,30,2,0,0,2,0,30,5,10,0,15,0,30,6,9,0,15,6,30,6,0,0,6,1,-15,3,1
2,0,31,2,30,3,9,0,12,7,30,8,0,0,8,3,30,4,8,0,12,2,30,8,4,0,12,4,30,6,0,0,6,1,-15,3,1
2,2,31,2,30,3,9,0,12,7,30,8,0,0,8,3,30,4,8,0,12,2,30,8,4,0,12,4,30,6,0,0,6,1,-15,3,1
2,3,31,2,30,3,9,0,12,7,30,8,0,0,8,3,30,4,8,0,12,2,30,8,4,0,12,4,30,6,0,0,6,1,-15,3,1
2,3,37,1,30,5,6,0,11,5,30,4,4,0,8,3,30,11,0,0,11,2,30,2,9,0,11,0,30,6,0,0,6,1,-15,3,1
2,2,45,0,30,6,7,0,13,8,30,10,0,0,10,0,30,2,11,0,13,6,30,4,9,0,13,10,30,5,0,0,5,1,-15,3,1
2,0,47,0,30,2,12,0,14,9,30,4,0,0,4,0,30,3,11,0,14,0,30,8,6,0,14,7,30,7,0,0,7,1,-15,3,1
2,4,3,0,30,2,2,0,4,2,30,4,0,0,4,0,30,0,4,0,4,1,30,2,2,0,4,0,30,1,2,0,3,0,-27,3,0
2,0,5,0,30,2,3,0,5,3,30,1,3,0,4,1,30,2,3,0,5,0,30,5,0,0,5,0,30,0,2,0,2,0,-27,3,0
2,3,9,4,30,2,2,0,4,3,30,2,0,0,2,0,30,0,4,0,4,0,30,1,3,0,4,0,30,1,0,0,1,0,-27,3,0
2,1,13,4,30,5,2,0,7,0,30,4,0,0,4,2,30,6,1,0,7,8,30,7,0,0,7,6,30,4,0,0,4,1,-15,3,1
2,4,13,4,30,5,2,0,7,0,30,4,0,0,4,2,30,6,1,0,7,8,30,7,0,0,7,6,30,4,0,0,4,1,-15,3,1
2,2,17,3,30,8,6,0,14,2,30,6,0,0,6,0,30,8,6,0,14,4,30,6,8,0,14,0,30,4,0,0,4,1,-15,3,1
2,4,17,3,30,8,6,0,14,2,30,6,0,0,6,0,30,8,6,0,14,4,30,6,8,0,14,0,30,4,0,0,4,1,-15,3,1
2,3,19,0,30,4,9,0,13,1,30,4,4,0,8,0,30,4,9,0,13,1,30,4,9,0,13,2,30,8,1,0,9,1,-15,3,1
2,1,27,0,30,5,10,0,15,0,30,1,1,0,2,0,30,9,6,0,15,1,30,5,10,0,15,2,30,6,0,0,6,1,-15,3,1
2,1,31,5,30,5,7,0,12,5,30,8,0,0,8,3,30,10,2,0,12,0,30,7,5,0,12,0,30,4,2,0,6,1,-15,3,1
2,2,31,5,30,5,7,0,12,5,30,8,0,0,8,3,30,10,2,0,12,0,30,7,5,0,12,0,30,4,2,0,6,1,-15,3,1
2,3,31,5,30,5,7,0,12,5,30,8,0,0,8,3,30,10,2,0,12,0,30,7,5,0,12,0,30,4,2,0,6,1,-15,3,1
2,4,31,5,30,5,7,0,12,5,30,8,0,0,8,3,30,10,2,0,12,0,30,7,5,0,12,0,30,4,2,0,6,1,-15,3,1
2,1,4,0,30,7,1,0,8,5,30,4,0,0,4,0,30,1,7,0,8,0,30,6,2,0,8,4,30,4,0,0,4,0,-27,3,0
2,2,4,0,30,7,1,0,8,5,30,4,0,0,4,0,30,1,7,0,8,0,30,6,2,0,8,4,30,4,0,0,4,0,-27,3,0
2,3,4,0,30,7,1,0,8,5,30,4,0,0,4,0,30,1,7,0,8,0,30,6,2,0,8,4,30,4,0,0,4,0,-27,3,0
2,1,13,2,30,6,1,0,7,0,30,4,0,0,4,2,30,6,1,0,7,7,30,7,0,0,7,4,30,4,0,0,4,1,-15,3,1
2,4,15,0,30,6,7,0,13,0,30,5,1,0,6,0,30,4,9,0,13,1,30,4,9,0,13,2,30,9,0,0,9,1,-15,3,1
2,1,19,6,30,6,7,0,13,2,30,4,4,0,8,0,30,7,6,0,13,0,30,3,10,0,13,3,30,8,1,0,9,1,-15,3,1
2,3,19,6,30,6,7,0,13,2,30,4,4,0,8,0,30,7,6,0,13,0,30,3,10,0,13,3,30,8,1,0,9,1,-15,3,1
2,2,21,1,30,6,4,0,10,3,30,6,0,0,6,1,30,3,7,0,10,4,30,4,6,0,10,6,30,4,0,0,4,1,-15,3,1
2,3,21,1,30,6,4,0,10,3,30,6,0,0,6,1,30,3,7,0,10,4,30,4,6,0,10,6,30,4,0,0,4,1,-15,3,1
2,2,25,1,30,9,5,0,14,4,30,6,0,0,6,0,30,9,5,0,14,1,30,5,9,0,14,3,30,4,2,0,6,1,-15,3,1
2,1,27,1,30,4,11,0,15,4,30,2,0,0,2,0,30,6,9,0,15,1,30,5,10,0,15,4,30,6,0,0,6,1,-15,3,1
2,2,27,1,30,4,11,0,15,4,30,2,0,0,2,0,30,6,9,0,15,1,30,5,10,0,15,4,30,6,0,0,6,1,-15,3,1
2,0,29,0,30,7,7,0,14,6,30,9,3,0,12,0,30,3,11,0,14,0,30,1,13,0,14,4,30,9,0,0,9,1,-15,3,1
2,4,29,0,30,7,7,0,14,6,30,9,3,0,12,0,30,3,11,0,14,0,30,1,13,0,14,4,30,9,0,0,9,1,-15,3,1
2,2,5,0,30,5,0,0,5,3,30,2,2,0,4,0,30,0,5,0,5,0,30,1,4,0,5,0,30,0,2,0,2,0,-27,3,0
2,3,5,0,30,5,0,0,5,3,30,2,2,0,4,0,30,0,5,0,5,0,30,1,4,0,5,0,30,0,2,0,2,0,-27,3,0
2,2,6,1,30,8,1,0,9,4,30,2,0,0,2,0,30,2,7,0,9,0,30,4,5,0,9,1,30,4,1,0,5,0,-27,3,0
2,4,6,1,30,8,1,0,9,4,30,2,0,0,2,0,30,2,7,0,9,0,30,4,5,0,9,1,30,4,1,0,5,0,-27,3,0
2,3,8,0,30,7,0,0,7,3,30,2,0,0,2,3,30,3,4,0,7,1,30,7,0,0,7,1,30,3,0,0,3,0,-27,3,0
2,2,13,4,30,7,0,0,7,0,30,4,0,0,4,2,30,6,1,0,7,6,30,6,1,0,7,2,30,4,0,0,4,1,-15,3,1
2,3,13,4,30,7,0,0,7,0,30,4,0,0,4,2,30,6,1,0,7,6,30,6,1,0,7,2,30,4,0,0,4,1,-15,3,1
2,4,13,4,30,7,0,0,7,0,30,4,0,0,4,2,30,6,1,0,7,6,30,6,1,0,7,2,30,4,0,0,4,1,-15,3,1
2,4,15,0,30,4,9,0,13,0,30,6,0,0,6,0,30,6,7,0,13,1,30,3,10,0,13,2,30,5,4,0,9,1,-15,3,1
2,2,19,0,30,2,11,0,13,2,30,8,0,0,8,0,30,4,9,0,13,2,30,3,10,0,13,1,30,9,0,0,9,1,-15,3,1
2,3,19,0,30,2,11,0,13,2,30,8,0,0,8,0,30,4,9,0,13,2,30,3,10,0,13,1,30,9,0,0,9,1,-15,3,1
2,4,19,0,30,2,11,0,13,2,30,8,0,0,8,0,30,4,9,0,13,2,30,3,10,0,13,1,30,9,0,0,9,1,-15,3,1
2,1,27,1,30,4,11,0,15,5,30,1,1,0,2,0,30,5,10,0,15,0,30,7,8,0,15,3,30,6,0,0,6,1,-15,3,1
2,2,27,1,30,4,11,0,15,5,30,1,1,0,2,0,30,5,10,0,15,0,30,7,8,0,15,3,30,6,0,0,6,1,-15,3,1
2,3,27,1,30,4,11,0,15,5,30,1,1,0,2,0,30,5,10,0,15,0,30,7,8,0,15,3,30,6,0,0,6,1,-15,3,1
2,2,29,1,30,5,9,0,14,6,30,11,1,0,12,0,30,3,11,0,14,0,30,0,14,0,14,1,30,9,0,0,9,1,-15,3,1
2,2,39,1,30,5,6,0,11,4,30,6,0,0,6,1,30,11,0,0,11,0,30,2,9,0,11,0,30,3,2,0,5,1,-15,3,1
2,0,1,0,30,7,3,0,10,3,30,2,0,0,2,9,30,5,5,0,10,3,30,7,3,0,10,2,30,6,0,0,6,0,-27,3,0
2,1,4,2,30,5,3,0,8,4,30,3,1,0,4,0,30,2,6,0,8,0,30,4,4,0,8,3,30,4,0,0,4,0,-27,3,0
2,2,4,2,30,5,3,0,8,4,30,3,1,0,4,0,30,2,6,0,8,0,30,4,4,0,8,3,30,4,0,0,4,0,-27,3,0
2,1,13,3,30,5,2,0,7,0,30,4,0,0,4,1,30,7,0,0,7,6,30,7,0,0,7,4,30,4,0,0,4,1,-15,3,1
2,4,19,1,30,4,9,0,13,2,30,8,0,0,8,0,30,5,8,0,13,0,30,3,10,0,13,4,30,6,3,0,9,1,-15,3,1
2,4,25,1,30,10,4,0,14,3,30,6,0,0,6,0,30,7,7,0,14,1,30,5,9,0,14,4,30,4,2,0,6,1,-15,3,1
2,0,27,1,30,4,11,0,15,3,30,1,1,0,2,0,30,6,9,0,15,5,30,5,10,0,15,3,30,6,0,0,6,1,-15,3,1
2,2,27,0,30,4,11,0,15,3,30,1,1,0,2,0,30,6,9,0,15,5,30,5,10,0,15,3,30,6,0,0,6,1,-15,3,1
2,3,27,0,30,4,11,0,15,3,30,1,1,0,2,0,30,6,9,0,15,5,30,5,10,0,15,3,30,6,0,0,6,1,-15,3,1
2,2,29,0,30,5,9,0,14,6,30,11,1,0,12,0,30,4,10,0,14,0,30,0,14,0,14,3,30,9,0,0,9,1,-15,3,1
2,3,35,0,30,11,2,0,13,5,30,2,0,0,2,1,30,2,11,0,13,2,30,5,8,0,13,10,30,8,0,0,8,1,-15,3,1
2,2,6,0,30,6,3,0,9,4,30,2,0,0,2,0,30,2,7,0,9,0,30,6,3,0,9,6,30,5,0,0,5,0,-27,3,0
2,3,6,0,30,6,3,0,9,4,30,2,0,0,2,0,30,2,7,0,9,0,30,6,3,0,9,6,30,5,0,0,5,0,-27,3,0
2,4,6,0,30,6,3,0,9,4,30,2,0,0,2,0,30,2,7,0,9,0,30,6,3,0,9,6,30,5,0,0,5,0,-27,3,0
2,1,17,3,30,8,6,0,14,3,30,6,0,0,6,0,30,5,9,0,14,5,30,6,8,0,14,7,30,4,0,0,4,1,-15,3,1
2,2,19,0,30,4,9,0,13,0,30,7,1,0,8,0,30,7,6,0,13,5,30,5,8,0,13,1,30,9,0,0,9,1,-15,3,1
2,4,19,0,30,4,9,0,13,0,30,7,1,0,8,0,30,7,6,0,13,5,30,5,8,0,13,0,30,9,0,0,9,1,-15,3,1
2,4,22,2,30,8,0,0,8,3,30,2,0,0,2,0,30,4,4,0,8,1,30,3,5,0,8,0,30,2,2,0,4,1,-15,3,1
2,3,25,1,30,7,7,0,14,3,30,6,0,0,6,0,30,9,5,0,14,1,30,7,7,0,14,5,30,6,0,0,6,1,-15,3,1
2,1,27,1,30,4,11,0,15,0,30,2,0,0,2,0,30,6,9,0,15,4,30,5,10,0,15,5,30,6,0,0,6,1,-15,3,1
2,4,39,1,30,4,7,0,11,6,30,6,0,0,6,0,30,4,7,0,11,0,30,2,9,0,11,2,30,4,1,0,5,1,-15,3,1
2,0,4,3,30,5,3,0,8,5,30,3,1,0,4,0,30,2,6,0,8,1,30,7,1,0,8,3,30,3,1,0,4,0,-27,3,0
2,1,4,3,30,5,3,0,8,5,30,3,1,0,4,0,30,2,6,0,8,1,30,7,1,0,8,3,30,3,1,0,4,0,-27,3,0
2,3,4,3,30,5,3,0,8,5,30,3,1,0,4,0,30,2,6,0,8,1,30,7,1,0,8,3,30,3,1,0,4,0,-27,3,0
2,4,4,3,30,5,3,0,8,5,30,3,1,0,4,0,30,2,6,0,8,1,30,7,1,0,8,3,30,3,1,0,4,0,-27,3,0
2,4,5,0,30,3,2,0,5,3,30,4,0,0,4,0,30,0,5,0,5,0,30,1,4,0,5,0,30,2,0,0,2,0,-27,3,0
2,3,6,0,30,5,4,0,9,4,30,2,0,0,2,0,30,3,6,0,9,0,30,5,4,0,9,0,30,4,1,0,5,0,-27,3,0
2,2,13,2,30,5,2,0,7,0,30,4,0,0,4,3,30,5,2,0,7,4,30,6,1,0,7,3,30,4,0,0,4,1,-15,3,1
2,4,13,2,30,5,2,0,7,0,30,4,0,0,4,3,30,5,2,0,7,4,30,6,1,0,7,3,30,4,0,0,4,1,-15,3,1
2,2,25,1,30,9,5,0,14,5,30,6,0,0,6,0,30,3,11,0,14,2,30,11,3,0,14,9,30,6,0,0,6,1,-15,3,1
2,3,31,4,30,5,7,0,12,4,30,8,0,0,8,4,30,9,3,0,12,0,30,5,7,0,12,0,30,2,4,0,6,1,-15,3,1
2,4,32,0,30,6,3,0,9,4,30,2,0,0,2,0,30,9,0,0,9,1,30,3,6,0,9,3,30,2,0,0,2,1,-15,3,1
2,0,4,3,30,8,0,0,8,5,30,4,0,0,4,1,30,2,6,0,8,3,30,8,0,0,8,1,30,4,0,0,4,0,-27,3,0
2,1,4,3,30,8,0,0,8,5,30,4,0,0,4,1,30,2,6,0,8,3,30,8,0,0,8,1,30,4,0,0,4,0,-27,3,0
2,4,13,3,30,5,2,0,7,0,30,4,0,0,4,3,30,7,0,0,7,10,30,7,0,0,7,4,30,4,0,0,4,1,-15,3,1
2,3,17,3,30,8,6,0,14,2,30,6,0,0,6,0,30,6,8,0,14,1,30,6,8,0,14,3,30,4,0,0,4,1,-15,3,1
2,3,19,0,30,4,9,0,13,2,30,5,3,0,8,0,30,5,8,0,13,3,30,4,9,0,13,1,30,8,1,0,9,1,-15,3,1
2,4,19,0,30,4,9,0,13,2,30,5,3,0,8,0,30,5,8,0,13,3,30,4,9,0,13,1,30,8,1,0,9,1,-15,3,1
2,4,23,0,30,4,9,0,13,4,30,6,0,0,6,7,30,11,2,0,13,0,30,5,8,0,13,3,30,6,0,0,6,1,-15,3,1
2,2,25,1,30,7,7,0,14,4,30,6,0,0,6,0,30,6,8,0,14,1,30,7,7,0,14,4,30,5,1,0,6,1,-15,3,1
2,4,25,1,30,7,7,0,14,4,30,6,0,0,6,0,30,6,8,0,14,1,30,7,7,0,14,4,30,5,1,0,6,1,-15,3,1
2,0,27,1,30,5,10,0,15,4,30,2,0,0,2,0,30,2,13,0,15,2,30,8,7,0,15,5,30,6,0,0,6,1,-15,3,1
2,1,27,1,30,5,10,0,15,4,30,2,0,0,2,0,30,2,13,0,15,2,30,8,7,0,15,5,30,6,0,0,6,1,-15,3,1
2,2,27,1,30,5,10,0,15,4,30,2,0,0,2,0,30,2,13,0,15,2,30,8,7,0,15,5,30,6,0,0,6,1,-15,3,1
2,3,27,1,30,5,10,0,15,4,30,2,0,0,2,0,30,2,13,0,15,2,30,8,7,0,15,5,30,6,0,0,6,1,-15,3,1
2,4,27,1,30,5,10,0,15,4,30,2,0,0,2,0,30,2,13,0,15,2,30,8,7,0,15,5,30,6,0,0,6,1,-15,3,1
2,0,4,2,30,7,1,0,8,5,30,4,0,0,4,1,30,1,7,0,8,0,30,6,2,0,8,3,30,4,0,0,4,0,-27,3,0
2,1,17,3,30,9,5,0,14,2,30,6,0,0,6,0,30,6,8,0,14,2,30,5,9,0,14,4,30,4,0,0,4,1,-15,3,1
2,2,17,3,30,9,5,0,14,2,30,6,0,0,6,0,30,6,8,0,14,2,30,5,9,0,14,4,30,4,0,0,4,1,-15,3,1
2,4,17,3,30,9,5,0,14,2,30,6,0,0,6,0,30,6,8,0,14,2,30,5,9,0,14,4,30,4,0,0,4,1,-15,3,1
2,2,19,0,30,3,10,0,13,2,30,7,1,0,8,0,30,6,7,0,13,0,30,4,9,0,13,1,30,9,0,0,9,1,-15,3,1
2,4,19,0,30,3,10,0,13,2,30,7,1,0,8,0,30,6,7,0,13,0,30,4,9,0,13,1,30,9,0,0,9,1,-15,3,1
2,4,23,1,30,3,10,0,13,2,30,6,0,0,6,6,30,13,0,0,13,0,30,5,8,0,13,3,30,6,0,0,6,1,-15,3,1
2,4,25,1,30,9,5,0,14,3,30,6,0,0,6,0,30,9,5,0,14,1,30,5,9,0,14,0,30,5,1,0,6,1,-15,3,1
2,2,27,1,30,4,11,0,15,4,30,1,1,0,2,0,30,5,10,0,15,3,30,9,6,0,15,6,30,6,0,0,6,1,-15,3,1
2,3,27,1,30,4,11,0,15,4,30,1,1,0,2,0,30,5,10,0,15,3,30,9,6,0,15,6,30,6,0,0,6,1,-15,3,1
2,2,1,0,30,7,3,0,10,4,30,2,0,0,2,1,30,4,6,0,10,3,30,7,3,0,10,5,30,6,0,0,6,0,-27,3,0
2,3,4,2,30,7,1,0,8,5,30,4,0,0,4,0,30,1,7,0,8,0,30,4,4,0,8,5,30,4,0,0,4,0,-27,3,0
2,4,4,2,30,7,1,0,8,5,30,4,0,0,4,0,30,1,7,0,8,0,30,4,4,0,8,5,30,4,0,0,4,0,-27,3,0
2,4,8,1,30,7,0,0,7,2,30,2,0,0,2,0,30,3,4,0,7,3,30,3,4,0,7,1,30,3,0,0,3,0,-27,3,0
2,2,13,2,30,5,2,0,7,0,30,4,0,0,4,1,30,5,2,0,7,6,30,6,1,0,7,4,30,4,0,0,4,1,-15,3,1
2,3,13,2,30,5,2,0,7,0,30,4,0,0,4,1,30,5,2,0,7,6,30,6,1,0,7,4,30,4,0,0,4,1,-15,3,1
2,3,19,0,30,5,8,0,13,2,30,4,4,0,8,0,30,6,7,0,13,1,30,5,8,0,13,3,30,7,2,0,9,1,-15,3,1
2,4,19,0,30,5,8,0,13,2,30,4,4,0,8,0,30,6,7,0,13,1,30,5,8,0,13,3,30,7,2,0,9,1,-15,3,1
2,0,27,1,30,5,10,0,15,1,30,1,1,0,2,0,30,6,9,0,15,2,30,6,9,0,15,3,30,6,0,0,6,1,-15,3,1
2,2,27,1,30,5,10,0,15,0,30,1,1,0,2,0,30,6,9,0,15,2,30,6,9,0,15,3,30,6,0,0,6,1,-15,3,1
2,1,29,0,30,5,9,0,14,5,30,12,0,0,12,0,30,3,11,0,14,0,30,0,14,0,14,2,30,9,0,0,9,1,-15,3,1
2,3,8,2,30,7,0,0,7,4,30,2,0,0,2,6,30,2,5,0,7,0,30,6,1,0,7,0,30,3,0,0,3,0,-27,3,0
2,4,8,2,30,7,0,0,7,4,30,2,0,0,2,6,30,2,5,0,7,0,30,6,1,0,7,0,30,3,0,0,3,0,-27,3,0
2,2,19,1,30,5,8,0,13,2,30,6,2,0,8,0,30,6,7,0,13,9,30,4,9,0,13,2,30,8,1,0,9,1,-15,3,1
2,4,23,2,30,5,8,0,13,1,30,6,0,0,6,3,30,12,1,0,13,1,30,5,8,0,13,2,30,6,0,0,6,1,-15,3,1
2,1,27,1,30,3,12,0,15,3,30,2,0,0,2,0,30,4,11,0,15,2,30,5,10,0,15,2,30,6,0,0,6,1,-15,3,1
2,2,27,1,30,3,12,0,15,3,30,2,0,0,2,0,30,4,11,0,15,2,30,5,10,0,15,2,30,6,0,0,6,1,-15,3,1
2,3,27,1,30,3,12,0,15,3,30,2,0,0,2,0,30,4,11,0,15,2,30,5,10,0,15,2,30,6,0,0,6,1,-15,3,1
2,4,31,7,30,5,7,0,12,4,30,8,0,0,8,0,30,11,1,0,12,0,30,3,9,0,12,0,30,4,2,0,6,1,-15,3,1
2,3,4,2,30,5,3,0,8,4,30,4,0,0,4,0,30,5,3,0,8,1,30,8,0,0,8,1,30,3,1,0,4,0,-27,3,0
2,2,13,2,30,6,1,0,7,1,30,4,0,0,4,1,30,5,2,0,7,10,30,7,0,0,7,5,30,4,0,0,4,1,-15,3,1
2,4,13,2,30,6,1,0,7,1,30,4,0,0,4,1,30,5,2,0,7,10,30,7,0,0,7,5,30,4,0,0,4,1,-15,3,1
2,3,17,5,30,9,5,0,14,3,30,6,0,0,6,0,30,6,8,0,14,1,30,6,8,0,14,1,30,4,0,0,4,1,-15,3,1
2,1,19,0,30,4,9,0,13,2,30,5,3,0,8,0,30,6,7,0,13,0,30,3,10,0,13,0,30,9,0,0,9,1,-15,3,1
2,4,19,0,30,4,9,0,13,2,30,5,3,0,8,0,30,6,7,0,13,0,30,3,10,0,13,0,30,9,0,0,9,1,-15,3,1
2,1,21,1,30,6,4,0,10,3,30,6,0,0,6,1,30,5,5,0,10,2,30,5,5,0,10,3,30,4,0,0,4,1,-15,3,1
2,4,23,1,30,4,9,0,13,3,30,6,0,0,6,3,30,11,2,0,13,0,30,8,5,0,13,2,30,6,0,0,6,1,-15,3,1
2,2,25,1,30,8,6,0,14,4,30,6,0,0,6,0,30,5,9,0,14,1,30,5,9,0,14,3,30,5,1,0,6,1,-15,3,1
2,4,25,1,30,8,6,0,14,4,30,6,0,0,6,0,30,5,9,0,14,1,30,5,9,0,14,3,30,5,1,0,6,1,-15,3,1
2,0,26,0,30,9,0,0,9,5,30,4,0,0,4,2,30,0,9,0,9,0,30,2,7,0,9,5,30,3,0,0,3,1,-15,3,1
2,3,27,1,30,4,11,0,15,4,30,2,0,0,2,0,30,6,9,0,15,1,30,5,10,0,15,0,30,4,2,0,6,1,-15,3,1
2,3,32,0,30,3,6,0,9,5,30,2,0,0,2,4,30,4,5,0,9,1,30,3,6,0,9,6,30,2,0,0,2,1,-15,3,1
2,4,32,0,30,3,6,0,9,5,30,2,0,0,2,4,30,4,5,0,9,1,30,3,6,0,9,6,30,2,0,0,2,1,-15,3,1
2,4,8,3,30,7,0,0,7,4,30,2,0,0,2,3,30,4,3,0,7,0,30,4,3,0,7,3,30,3,0,0,3,0,-27,3,0
2,2,13,4,30,6,1,0,7,0,30,4,0,0,4,2,30,5,2,0,7,9,30,4,3,0,7,4,30,4,0,0,4,1,-15,3,1
2,1,19,0,30,2,11,0,13,2,30,7,1,0,8,0,30,8,5,0,13,4,30,3,10,0,13,3,30,8,1,0,9,1,-15,3,1
2,3,19,0,30,2,11,0,13,2,30,7,1,0,8,0,30,8,5,0,13,4,30,3,10,0,13,3,30,8,1,0,9,1,-15,3,1
2,4,23,0,30,6,7,0,13,2,30,6,0,0,6,5,30,13,0,0,13,0,30,4,9,0,13,1,30,5,1,0,6,1,-15,3,1
2,1,25,1,30,10,4,0,14,2,30,6,0,0,6,0,30,8,6,0,14,1,30,5,9,0,14,4,30,5,1,0,6,1,-15,3,1
2,2,25,1,30,10,4,0,14,2,30,6,0,0,6,0,30,8,6,0,14,1,30,5,9,0,14,4,30,5,1,0,6,1,-15,3,1
2,3,31,3,30,5,7,0,12,6,30,8,0,0,8,3,30,8,4,0,12,0,30,9,3,0,12,0,30,6,0,0,6,1,-15,3,1
2,3,35,0,30,8,5,0,13,1,30,2,0,0,2,1,30,10,3,0,13,6,30,1,12,0,13,5,30,8,0,0,8,1,-15,3,1
2,1,41,0,30,11,1,0,12,6,30,3,5,0,8,0,30,4,8,0,12,2,30,5,7,0,12,3,30,4,3,0,7,1,-15,3,1
2,0,5,0,30,2,3,0,5,3,30,0,4,0,4,0,30,0,5,0,5,0,30,1,4,0,5,3,30,1,1,0,2,0,-27,3,0
2,2,5,0,30,2,3,0,5,3,30,0,4,0,4,0,30,0,5,0,5,0,30,1,4,0,5,2,30,1,1,0,2,0,-27,3,0
2,2,13,1,30,3,4,0,7,0,30,4,0,0,4,2,30,6,1,0,7,16,30,6,1,0,7,5,30,4,0,0,4,1,-15,3,1
2,2,17,4,30,11,3,0,14,4,30,6,0,0,6,0,30,4,10,0,14,0,30,7,7,0,14,3,30,4,0,0,4,1,-15,3,1
2,4,23,2,30,5,8,0,13,0,30,6,0,0,6,0,30,13,0,0,13,0,30,5,8,0,13,2,30,6,0,0,6,1,-15,3,1
2,4,25,1,30,4,10,0,14,4,30,6,0,0,6,0,30,8,6,0,14,2,30,10,4,0,14,3,30,6,0,0,6,1,-15,3,1
2,0,27,1,30,7,8,0,15,5,30,2,0,0,2,0,30,3,12,0,15,0,30,4,11,0,15,1,30,5,1,0,6,1,-15,3,1
2,4,29,0,30,5,9,0,14,6,30,12,0,0,12,0,30,5,9,0,14,0,30,1,13,0,14,1,30,9,0,0,9,1,-15,3,1
2,2,39,0,30,4,7,0,11,7,30,6,0,0,6,0,30,6,5,0,11,1,30,8,3,0,11,6,30,5,0,0,5,1,-15,3,1
2,0,41,0,30,7,5,0,12,8,30,8,0,0,8,0,30,3,9,0,12,0,30,3,9,0,12,3,30,7,0,0,7,1,-15,3,1
2,3,41,0,30,7,5,0,12,8,30,8,0,0,8,0,30,3,9,0,12,0,30,3,9,0,12,3,30,7,0,0,7,1,-15,3,1
2,0,5,0,30,3,2,0,5,3,30,1,3,0,4,0,30,0,5,0,5,0,30,1,4,0,5,0,30,1,1,0,2,0,-27,3,0
2,3,6,0,30,6,3,0,9,4,30,2,0,0,2,0,30,2,7,0,9,0,30,4,5,0,9,2,30,4,1,0,5,0,-27,3,0
2,4,8,0,30,7,0,0,7,4,30,2,0,0,2,0,30,2,5,0,7,3,30,7,0,0,7,3,30,3,0,0,3,0,-27,3,0
2,3,13,2,30,6,1,0,7,1,30,4,0,0,4,3,30,7,0,0,7,5,30,5,2,0,7,4,30,4,0,0,4,1,-15,3,1
2,4,13,2,30,6,1,0,7,1,30,4,0,0,4,3,30,7,0,0,7,5,30,5,2,0,7,4,30,4,0,0,4,1,-15,3,1
2,1,19,1,30,5,8,0,13,2,30,4,4,0,8,0,30,6,7,0,13,0,30,4,9,0,13,1,30,9,0,0,9,1,-15,3,1
2,4,19,0,30,5,8,0,13,2,30,4,4,0,8,0,30,6,7,0,13,0,30,4,9,0,13,1,30,9,0,0,9,1,-15,3,1
2,4,23,1,30,5,8,0,13,3,30,6,0,0,6,5,30,10,3,0,13,0,30,6,7,0,13,1,30,6,0,0,6,1,-15,3,1
2,2,25,1,30,8,6,0,14,5,30,6,0,0,6,0,30,4,10,0,14,1,30,8,6,0,14,5,30,6,0,0,6,1,-15,3,1
2,4,25,1,30,8,6,0,14,5,30,6,0,0,6,0,30,4,10,0,14,1,30,8,6,0,14,5,30,6,0,0,6,1,-15,3,1
2,0,27,1,30,6,9,0,15,4,30,1,1,0,2,0,30,6,9,0,15,6,30,4,11,0,15,2,30,6,0,0,6,1,-15,3,1
2,2,27,1,30,6,9,0,15,4,30,1,1,0,2,0,30,6,9,0,15,6,30,4,11,0,15,2,30,6,0,0,6,1,-15,3,1
2,2,29,0,30,8,6,0,14,5,30,11,1,0,12,0,30,3,11,0,14,0,30,0,14,0,14,0,30,8,1,0,9,1,-15,3,1
2,3,29,0,30,8,6,0,14,5,30,11,1,0,12,0,30,3,11,0,14,0,30,0,14,0,14,0,30,8,1,0,9,1,-15,3,1
2,2,35,0,30,8,5,0,13,3,30,1,1,0,2,1,30,10,3,0,13,2,30,2,11,0,13,5,30,8,0,0,8,1,-15,3,1
2,3,35,0,30,8,5,0,13,3,30,1,1,0,2,1,30,10,3,0,13,2,30,2,11,0,13,5,30,8,0,0,8,1,-15,3,1
2,4,8,2,30,7,0,0,7,3,30,2,0,0,2,0,30,7,0,0,7,0,30,5,2,0,7,1,30,3,0,0,3,0,-27,3,0
2,1,9,0,30,2,2,0,4,2,30,1,1,0,2,0,30,2,2,0,4,0,30,1,3,0,4,0,30,1,0,0,1,0,-27,3,0
2,3,11,0,30,3,9,0,12,1,30,4,0,0,4,0,30,6,6,0,12,6,30,5,7,0,12,0,30,4,0,0,4,1,-15,3,1
2,2,13,3,30,5,2,0,7,0,30,4,0,0,4,2,30,7,0,0,7,7,30,7,0,0,7,5,30,4,0,0,4,1,-15,3,1
2,4,13,3,30,5,2,0,7,0,30,4,0,0,4,2,30,7,0,0,7,7,30,7,0,0,7,5,30,4,0,0,4,1,-15,3,1
2,3,23,1,30,6,7,0,13,3,30,6,0,0,6,4,30,9,4,0,13,0,30,5,8,0,13,0,30,6,0,0,6,1,-15,3,1
2,2,27,3,30,5,10,0,15,5,30,1,1,0,2,0,30,5,10,0,15,4,30,4,11,0,15,0,30,6,0,0,6,1,-15,3,1
2,3,27,3,30,5,10,0,15,5,30,1,1,0,2,0,30,5,10,0,15,4,30,4,11,0,15,0,30,6,0,0,6,1,-15,3,1
2,2,31,3,30,5,7,0,12,4,30,8,0,0,8,5,30,12,0,0,12,0,30,3,9,0,12,0,30,3,3,0,6,1,-15,3,1
2,2,35,0,30,8,5,0,13,6,30,2,0,0,2,1,30,2,11,0,13,2,30,1,12,0,13,0,30,8,0,0,8,1,-15,3,1
2,3,35,0,30,8,5,0,13,6,30,2,0,0,2,1,30,2,11,0,13,2,30,1,12,0,13,0,30,8,0,0,8,1,-15,3,1
2,2,6,0,30,8,1,0,9,3,30,2,0,0,2,0,30,2,7,0,9,0,30,4,5,0,9,0,30,0,5,0,5,0,-27,3,0
2,4,6,0,30,8,1,0,9,3,30,2,0,0,2,0,30,2,7,0,9,0,30,4,5,0,9,0,30,0,5,0,5,0,-27,3,0
2,3,8,1,30,7,0,0,7,5,30,2,0,0,2,7,30,2,5,0,7,1,30,7,0,0,7,1,30,3,0,0,3,0,-27,3,0
2,3,19,0,30,3,10,0,13,2,30,8,0,0,8,0,30,7,6,0,13,5,30,5,8,0,13,2,30,8,1,0,9,1,-15,3,1
2,2,27,1,30,7,8,0,15,0,30,2,0,0,2,1,30,10,5,0,15,2,30,6,9,0,15,1,30,4,2,0,6,1,-15,3,1
2,3,27,1,30,7,8,0,15,0,30,2,0,0,2,1,30,10,5,0,15,2,30,6,9,0,15,1,30,4,2,0,6,1,-15,3,1
2,0,41,0,30,9,3,0,12,6,30,6,2,0,8,0,30,4,8,0,12,0,30,3,9,0,12,5,30,5,2,0,7,1,-15,3,1
2,1,41,0,30,9,3,0,12,6,30,6,2,0,8,0,30,4,8,0,12,0,30,3,9,0,12,5,30,5,2,0,7,1,-15,3,1
2,2,41,0,30,9,3,0,12,6,30,6,2,0,8,0,30,4,8,0,12,0,30,3,9,0,12,5,30,5,2,0,7,1,-15,3,1
2,4,41,0,30,9,3,0,12,6,30,6,2,0,8,0,30,4,8,0,12,0,30,3,9,0,12,5,30,5,2,0,7,1,-15,3,1
2,1,4,2,30,7,1,0,8,5,30,4,0,0,4,0,30,1,7,0,8,0,30,5,3,0,8,2,30,3,1,0,4,0,-27,3,0
2,2,4,2,30,7,1,0,8,5,30,4,0,0,4,0,30,1,7,0,8,0,30,5,3,0,8,2,30,3,1,0,4,0,-27,3,0
2,3,4,2,30,7,1,0,8,5,30,4,0,0,4,0,30,1,7,0,8,0,30,5,3,0,8,2,30,3,1,0,4,0,-27,3,0
2,0,5,0,30,2,3,0,5,3,30,1,3,0,4,3,30,1,4,0,5,0,30,1,4,0,5,0,30,2,0,0,2,0,-27,3,0
2,1,5,0,30,2,3,0,5,3,30,1,3,0,4,3,30,1,4,0,5,0,30,1,4,0,5,0,30,2,0,0,2,0,-27,3,0
2,4,7,0,30,4,5,0,9,2,30,4,0,0,4,2,30,6,3,0,9,8,30,3,6,0,9,1,30,5,1,0,6,0,-27,3,0
2,2,13,2,30,5,2,0,7,0,30,4,0,0,4,2,30,5,2,0,7,12,30,6,1,0,7,4,30,4,0,0,4,1,-15,3,1
2,0,14,0,30,5,4,0,9,2,30,5,1,0,6,0,30,6,3,0,9,8,30,9,0,0,9,4,30,4,0,0,4,1,-15,3,1
2,1,14,0,30,5,4,0,9,2,30,5,1,0,6,0,30,6,3,0,9,8,30,9,0,0,9,4,30,4,0,0,4,1,-15,3,1
2,4,17,4,30,9,5,0,14,2,30,6,0,0,6,0,30,7,7,0,14,0,30,7,7,0,14,0,30,4,0,0,4,1,-15,3,1
2,1,19,1,30,5,8,0,13,2,30,7,1,0,8,0,30,6,7,0,13,3,30,4,9,0,13,0,30,9,0,0,9,1,-15,3,1
2,3,19,1,30,5,8,0,13,2,30,7,1,0,8,0,30,6,7,0,13,3,30,4,9,0,13,0,30,9,0,0,9,1,-15,3,1
2,4,19,1,30,5,8,0,13,2,30,7,1,0,8,0,30,6,7,0,13,3,30,4,9,0,13,0,30,9,0,0,9,1,-15,3,1
2,2,25,1,30,3,11,0,14,2,30,6,0,0,6,0,30,10,4,0,14,1,30,4,10,0,14,3,30,6,0,0,6,1,-15,3,1
2,4,35,0,30,9,4,0,13,2,30,2,0,0,2,1,30,6,7,0,13,1,30,2,11,0,13,2,30,8,0,0,8,1,-15,3,1
2,0,38,4,30,8,2,0,10,8,30,4,2,0,6,0,30,1,9,0,10,0,30,2,8,0,10,1,30,6,0,0,6,1,-15,3,1
2,2,38,4,30,8,2,0,10,8,30,4,2,0,6,0,30,1,9,0,10,0,30,2,8,0,10,1,30,6,0,0,6,1,-15,3,1
2,3,38,4,30,8,2,0,10,8,30,4,2,0,6,0,30,1,9,0,10,0,30,2,8,0,10,1,30,6,0,0,6,1,-15,3,1
2,4,39,2,30,2,9,0,11,7,30,6,0,0,6,0,30,4,7,0,11,0,30,2,9,0,11,2,30,5,0,0,5,1,-15,3,1
2,4,41,0,30,6,6,0,12,7,30,8,0,0,8,0,30,6,6,0,12,0,30,3,9,0,12,3,30,7,0,0,7,1,-15,3,1
2,0,4,2,30,7,1,0,8,5,30,4,0,0,4,2,30,1,7,0,8,1,30,8,0,0,8,1,30,3,1,0,4,0,-27,3,0
2,1,4,2,30,7,1,0,8,5,30,4,0,0,4,2,30,1,7,0,8,1,30,8,0,0,8,1,30,3,1,0,4,0,-27,3,0
2,2,4,2,30,7,1,0,8,5,30,4,0,0,4,2,30,1,7,0,8,1,30,8,0,0,8,1,30,3,1,0,4,0,-27,3,0
2,1,13,2,30,7,0,0,7,1,30,4,0,0,4,2,30,6,1,0,7,5,30,6,1,0,7,4,30,4,0,0,4,1,-15,3,1
2,2,13,2,30,7,0,0,7,1,30,4,0,0,4,2,30,6,1,0,7,5,30,6,1,0,7,4,30,4,0,0,4,1,-15,3,1
2,2,19,0,30,3,10,0,13,1,30,5,3,0,8,0,30,8,5,0,13,8,30,5,8,0,13,2,30,8,1,0,9,1,-15,3,1
2,2,21,2,30,7,3,0,10,4,30,6,0,0,6,1,30,3,7,0,10,4,30,5,5,0,10,1,30,4,0,0,4,1,-15,3,1
2,3,23,3,30,5,8,0,13,3,30,6,0,0,6,8,30,11,2,0,13,0,30,4,9,0,13,3,30,6,0,0,6,1,-15,3,1
2,2,29,1,30,8,6,0,14,6,30,9,3,0,12,0,30,3,11,0,14,0,30,1,13,0,14,3,30,9,0,0,9,1,-15,3,1
2,3,35,0,30,7,6,0,13,5,30,2,0,0,2,1,30,2,11,0,13,5,30,2,11,0,13,11,30,8,0,0,8,1,-15,3,1
2,3,2,0,30,7,3,0,10,3,30,1,3,0,4,0,30,2,8,0,10,0,30,5,5,0,10,1,30,8,0,0,8,0,-27,3,0
2,4,2,0,30,7,3,0,10,3,30,1,3,0,4,0,30,2,8,0,10,0,30,5,5,0,10,1,30,8,0,0,8,0,-27,3,0
2,0,17,6,30,8,6,0,14,4,30,6,0,0,6,0,30,5,9,0,14,1,30,7,7,0,14,1,30,4,0,0,4,1,-15,3,1
2,3,19,1,30,7,6,0,13,1,30,7,1,0,8,0,30,7,6,0,13,0,30,4,9,0,13,1,30,7,2,0,9,1,-15,3,1
2,2,23,1,30,2,11,0,13,2,30,6,0,0,6,0,30,11,2,0,13,5,30,9,4,0,13,5,30,6,0,0,6,1,-15,3,1
2,4,27,1,30,10,5,0,15,2,30,2,0,0,2,0,30,5,10,0,15,0,30,3,12,0,15,1,30,5,1,0,6,1,-15,3,1
2,0,31,1,30,6,6,0,12,5,30,8,0,0,8,3,30,11,1,0,12,0,30,3,9,0,12,4,30,5,1,0,6,1,-15,3,1
2,0,43,0,30,9,5,0,14,8,30,6,0,0,6,0,30,4,10,0,14,5,30,7,7,0,14,6,30,5,0,0,5,1,-15,3,1
2,4,9,0,30,2,2,0,4,2,30,2,0,0,2,0,30,4,0,0,4,4,30,1,3,0,4,0,30,1,0,0,1,0,-27,3,0
2,2,11,1,30,4,8,0,12,2,30,4,0,0,4,0,30,5,7,0,12,1,30,7,5,0,12,0,30,4,0,0,4,1,-15,3,1
2,3,13,6,30,7,0,0,7,0,30,4,0,0,4,2,30,6,1,0,7,4,30,6,1,0,7,5,30,4,0,0,4,1,-15,3,1
2,4,13,6,30,7,0,0,7,0,30,4,0,0,4,2,30,6,1,0,7,4,30,6,1,0,7,5,30,4,0,0,4,1,-15,3,1
2,3,23,4,30,6,7,0,13,4,30,6,0,0,6,7,30,9,4,0,13,0,30,4,9,0,13,0,30,5,1,0,6,1,-15,3,1
2,1,27,1,30,9,6,0,15,1,30,2,0,0,2,0,30,5,10,0,15,2,30,5,10,0,15,2,30,6,0,0,6,1,-15,3,1
2,0,29,0,30,7,7,0,14,4,30,7,5,0,12,0,30,3,11,0,14,0,30,7,7,0,14,1,30,9,0,0,9,1,-15,3,1
2,1,29,0,30,7,7,0,14,4,30,7,5,0,12,0,30,3,11,0,14,0,30,7,7,0,14,1,30,9,0,0,9,1,-15,3,1
2,2,29,0,30,7,7,0,14,4,30,7,5,0,12,0,30,3,11,0,14,0,30,7,7,0,14,1,30,9,0,0,9,1,-15,3,1
2,0,5,0,30,2,3,0,5,3,30,3,1,0,4,0,30,0,5,0,5,0,30,2,3,0,5,0,30,1,1,0,2,0,-27,3,0
2,1,5,0,30,2,3,0,5,3,30,3,1,0,4,0,30,0,5,0,5,0,30,2,3,0,5,0,30,1,1,0,2,0,-27,3,0
2,4,5,0,30,2,3,0,5,3,30,3,1,0,4,0,30,0,5,0,5,0,30,2,3,0,5,0,30,1,1,0,2,0,-27,3,0
2,2,17,3,30,8,6,0,14,2,30,6,0,0,6,0,30,7,7,0,14,2,30,6,8,0,14,3,30,4,0,0,4,1,-15,3,1
2,3,17,3,30,8,6,0,14,2,30,6,0,0,6,0,30,7,7,0,14,2,30,6,8,0,14,3,30,4,0,0,4,1,-15,3,1
2,4,17,3,30,8,6,0,14,2,30,6,0,0,6,0,30,7,7,0,14,2,30,6,8,0,14,3,30,4,0,0,4,1,-15,3,1
2,2,19,0,30,4,9,0,13,0,30,6,2,0,8,0,30,7,6,0,13,3,30,4,9,0,13,0,30,8,1,0,9,1,-15,3,1
2,3,19,0,30,4,9,0,13,0,30,6,2,0,8,0,30,7,6,0,13,3,30,4,9,0,13,0,30,8,1,0,9,1,-15,3,1
2,4,22,1,30,7,1,0,8,2,30,2,0,0,2,3,30,5,3,0,8,1,30,5,3,0,8,2,30,1,3,0,4,1,-15,3,1
2,0,25,1,30,5,9,0,14,5,30,6,0,0,6,0,30,7,7,0,14,1,30,4,10,0,14,5,30,6,0,0,6,1,-15,3,1
2,3,25,1,30,5,9,0,14,5,30,6,0,0,6,0,30,7,7,0,14,1,30,4,10,0,14,5,30,6,0,0,6,1,-15,3,1
2,4,27,0,30,4,11,0,15,4,30,1,1,0,2,0,30,3,12,0,15,1,30,7,8,0,15,5,30,6,0,0,6,1,-15,3,1
2,2,29,0,30,6,8,0,14,5,30,11,1,0,12,0,30,6,8,0,14,0,30,1,13,0,14,1,30,9,0,0,9,1,-15,3,1
2,4,38,0,30,1,9,0,10,6,30,6,0,0,6,0,30,3,7,0,10,2,30,5,5,0,10,6,30,4,2,0,6,1,-15,3,1
2,0,39,0,30,3,8,0,11,6,30,4,2,0,6,0,30,7,4,0,11,0,30,4,7,0,11,3,30,5,0,0,5,1,-15,3,1
2,2,39,0,30,3,8,0,11,6,30,4,2,0,6,0,30,7,4,0,11,0,30,4,7,0,11,3,30,5,0,0,5,1,-15,3,1
2,3,5,0,30,1,4,0,5,3,30,3,1,0,4,0,30,0,5,0,5,0,30,1,4,0,5,0,30,0,2,0,2,0,-27,3,0
2,1,13,3,30,7,0,0,7,0,30,4,0,0,4,1,30,6,1,0,7,6,30,7,0,0,7,8,30,4,0,0,4,1,-15,3,1
2,3,17,3,30,8,6,0,14,3,30,6,0,0,6,0,30,5,9,0,14,1,30,6,8,0,14,5,30,4,0,0,4,1,-15,3,1
2,0,19,0,30,2,11,0,13,2,30,6,2,0,8,0,30,6,7,0,13,4,30,6,7,0,13,0,30,9,0,0,9,1,-15,3,1
2,1,25,1,30,3,11,0,14,4,30,6,0,0,6,0,30,9,5,0,14,2,30,7,7,0,14,1,30,6,0,0,6,1,-15,3,1
2,3,25,1,30,3,11,0,14,4,30,6,0,0,6,0,30,9,5,0,14,2,30,7,7,0,14,1,30,6,0,0,6,1,-15,3,1
2,4,29,0,30,7,7,0,14,5,30,12,0,0,12,0,30,7,7,0,14,0,30,1,13,0,14,0,30,7,2,0,9,1,-15,3,1
2,2,32,0,30,6,3,0,9,5,30,2,0,0,2,4,30,6,3,0,9,1,30,3,6,0,9,3,30,2,0,0,2,1,-15,3,1
2,3,32,0,30,6,3,0,9,5,30,2,0,0,2,4,30,6,3,0,9,1,30,3,6,0,9,3,30,2,0,0,2,1,-15,3,1
2,3,35,0,30,7,6,0,13,3,30,2,0,0,2,1,30,9,4,0,13,4,30,1,12,0,13,6,30,8,0,0,8,1,-15,3,1
2,4,1,0,30,7,3,0,10,4,30,2,0,0,2,1,30,4,6,0,10,0,30,6,4,0,10,3,30,6,0,0,6,0,-27,3,0
2,2,13,0,30,7,0,0,7,0,30,4,0,0,4,2,30,6,1,0,7,5,30,7,0,0,7,6,30,4,0,0,4,1,-15,3,1
2,3,13,0,30,7,0,0,7,0,30,4,0,0,4,2,30,6,1,0,7,5,30,7,0,0,7,6,30,4,0,0,4,1,-15,3,1
2,4,19,0,30,2,11,0,13,2,30,6,2,0,8,0,30,5,8,0,13,3,30,4,9,0,13,0,30,9,0,0,9,1,-15,3,1
2,4,25,1,30,10,4,0,14,4,30,6,0,0,6,0,30,4,10,0,14,1,30,5,9,0,14,5,30,5,1,0,6,1,-15,3,1
2,0,27,1,30,3,12,0,15,5,30,1,1,0,2,0,30,5,10,0,15,0,30,3,12,0,15,5,30,6,0,0,6,1,-15,3,1
2,1,27,1,30,3,12,0,15,5,30,1,1,0,2,0,30,5,10,0,15,0,30,3,12,0,15,5,30,6,0,0,6,1,-15,3,1
2,3,27,1,30,3,12,0,15,5,30,1,1,0,2,0,30,5,10,0,15,0,30,3,12,0,15,5,30,6,0,0,6,1,-15,3,1
2,2,29,0,30,5,9,0,14,5,30,10,2,0,12,0,30,4,10,0,14,0,30,2,12,0,14,3,30,9,0,0,9,1,-15,3,1
2,3,32,0,30,6,3,0,9,4,30,2,0,0,2,2,30,9,0,0,9,1,30,2,7,0,9,2,30,2,0,0,2,1,-15,3,1
2,4,32,0,30,6,3,0,9,4,30,2,0,0,2,2,30,9,0,0,9,1,30,2,7,0,9,2,30,2,0,0,2,1,-15,3,1
2,3,36,0,30,1,8,0,9,5,30,2,0,0,2,6,30,5,4,0,9,1,30,4,5,0,9,8,30,3,0,0,3,1,-15,3,1
2,2,4,2,30,5,3,0,8,5,30,3,1,0,4,0,30,1,7,0,8,2,30,8,0,0,8,2,30,3,1,0,4,0,-27,3,0
2,3,4,2,30,5,3,0,8,5,30,3,1,0,4,0,30,1,7,0,8,2,30,8,0,0,8,2,30,3,1,0,4,0,-27,3,0
2,2,17,2,30,13,1,0,14,3,30,6,0,0,6,0,30,4,10,0,14,1,30,8,6,0,14,6,30,4,0,0,4,1,-15,3,1
2,0,19,1,30,2,11,0,13,3,30,7,1,0,8,0,30,4,9,0,13,8,30,7,6,0,13,1,30,9,0,0,9,1,-15,3,1
2,1,19,1,30,2,11,0,13,3,30,7,1,0,8,0,30,4,9,0,13,8,30,7,6,0,13,1,30,9,0,0,9,1,-15,3,1
2,4,19,1,30,2,11,0,13,3,30,7,1,0,8,0,30,4,9,0,13,8,30,7,6,0,13,0,30,9,0,0,9,1,-15,3,1
2,4,22,1,30,7,1,0,8,2,30,2,0,0,2,0,30,5,3,0,8,1,30,3,5,0,8,1,30,2,2,0,4,1,-15,3,1
2,3,25,1,30,6,8,0,14,4,30,6,0,0,6,0,30,7,7,0,14,1,30,7,7,0,14,5,30,6,0,0,6,1,-15,3,1
2,4,29,0,30,9,5,0,14,6,30,7,5,0,12,0,30,2,12,0,14,0,30,1,13,0,14,4,30,9,0,0,9,1,-15,3,1
2,2,8,1,30,7,0,0,7,4,30,2,0,0,2,3,30,2,5,0,7,1,30,7,0,0,7,6,30,3,0,0,3,0,-27,3,0
2,3,8,1,30,7,0,0,7,4,30,2,0,0,2,3,30,2,5,0,7,1,30,7,0,0,7,6,30,3,0,0,3,0,-27,3,0
2,2,13,2,30,3,0,0,3,0,30,2,0,0,2,0,30,3,0,0,3,6,30,3,0,0,3,3,30,2,0,0,2,1,-15,3,1
2,4,13,2,30,3,0,0,3,0,30,2,0,0,2,0,30,3,0,0,3,6,30,3,0,0,3,3,30,2,0,0,2,1,-15,3,1
2,4,15,1,30,6,7,0,13,0,30,6,0,0,6,0,30,5,8,0,13,1,30,4,9,0,13,0,30,5,4,0,9,1,-15,3,1
2,2,17,4,30,9,5,0,14,3,30,6,0,0,6,0,30,4,10,0,14,1,30,5,9,0,14,4,30,4,0,0,4,1,-15,3,1
2,3,17,4,30,9,5,0,14,3,30,6,0,0,6,0,30,4,10,0,14,1,30,5,9,0,14,4,30,4,0,0,4,1,-15,3,1
2,4,17,4,30,9,5,0,14,3,30,6,0,0,6,0,30,4,10,0,14,1,30,5,9,0,14,4,30,4,0,0,4,1,-15,3,1
2,2,19,0,30,4,9,0,13,1,30,8,0,0,8,0,30,4,9,0,13,0,30,5,8,0,13,1,30,6,3,0,9,1,-15,3,1
2,4,25,0,30,7,7,0,14,4,30,6,0,0,6,0,30,8,6,0,14,1,30,5,9,0,14,4,30,5,1,0,6,1,-15,3,1
2,1,27,1,30,4,11,0,15,2,30,1,1,0,2,0,30,8,7,0,15,2,30,6,9,0,15,4,30,6,0,0,6,1,-15,3,1
2,3,27,1,30,4,11,0,15,2,30,1,1,0,2,0,30,8,7,0,15,2,30,6,9,0,15,4,30,6,0,0,6,1,-15,3,1
2,4,27,1,30,4,11,0,15,2,30,1,1,0,2,0,30,8,7,0,15,2,30,6,9,0,15,4,30,6,0,0,6,1,-15,3,1
2,0,29,0,30,5,9,0,14,6,30,11,1,0,12,0,30,5,9,0,14,0,30,1,13,0,14,6,30,9,0,0,9,1,-15,3,1
2,2,33,2,30,3,8,0,11,4,30,4,0,0,4,0,30,10,1,0,11,4,30,3,8,0,11,7,30,4,0,0,4,1,-15,3,1
2,2,35,0,30,7,6,0,13,6,30,2,0,0,2,1,30,2,11,0,13,2,30,3,10,0,13,7,30,8,0,0,8,1,-15,3,1
2,3,4,2,30,5,3,0,8,5,30,2,2,0,4,0,30,1,7,0,8,0,30,8,0,0,8,2,30,4,0,0,4,0,-27,3,0
2,0,5,0,30,2,3,0,5,3,30,3,1,0,4,0,30,0,5,0,5,3,30,1,4,0,5,0,30,1,1,0,2,0,-27,3,0
2,2,5,0,30,2,3,0,5,3,30,3,1,0,4,0,30,0,5,0,5,3,30,1,4,0,5,0,30,1,1,0,2,0,-27,3,0
2,4,8,2,30,7,0,0,7,4,30,2,0,0,2,3,30,3,4,0,7,1,30,7,0,0,7,0,30,3,0,0,3,0,-27,3,0
2,4,13,1,30,3,0,0,3,0,30,2,0,0,2,1,30,3,0,0,3,8,30,2,1,0,3,5,30,2,0,0,2,1,-15,3,1
2,1,13,1,30,6,1,0,7,0,30,4,0,0,4,4,30,7,0,0,7,9,30,6,1,0,7,5,30,4,0,0,4,1,-15,3,1
2,4,15,0,30,4,9,0,13,1,30,5,1,0,6,0,30,3,10,0,13,1,30,4,9,0,13,3,30,9,0,0,9,1,-15,3,1
2,1,17,2,30,10,4,0,14,4,30,6,0,0,6,0,30,3,11,0,14,3,30,5,9,0,14,1,30,4,0,0,4,1,-15,3,1
2,4,17,2,30,10,4,0,14,4,30,6,0,0,6,0,30,3,11,0,14,3,30,5,9,0,14,1,30,4,0,0,4,1,-15,3,1
2,4,19,0,30,4,9,0,13,2,30,6,2,0,8,0,30,7,6,0,13,2,30,7,6,0,13,2,30,8,1,0,9,1,-15,3,1
2,4,22,2,30,8,0,0,8,1,30,2,0,0,2,0,30,4,4,0,8,3,30,3,5,0,8,2,30,1,3,0,4,1,-15,3,1
2,1,25,4,30,4,10,0,14,1,30,6,0,0,6,0,30,12,2,0,14,1,30,4,10,0,14,3,30,5,1,0,6,1,-15,3,1
2,1,27,1,30,4,11,0,15,3,30,2,0,0,2,0,30,2,13,0,15,2,30,7,8,0,15,3,30,6,0,0,6,1,-15,3,1
2,2,27,1,30,4,11,0,15,3,30,2,0,0,2,0,30,2,13,0,15,2,30,7,8,0,15,3,30,6,0,0,6,1,-15,3,1
2,3,31,3,30,5,7,0,12,4,30,8,0,0,8,0,30,9,3,0,12,4,30,3,9,0,12,0,30,4,2,0,6,1,-15,3,1
2,2,33,0,30,3,8,0,11,4,30,4,0,0,4,2,30,11,0,0,11,4,30,5,6,0,11,5,30,4,0,0,4,1,-15,3,1
2,3,33,0,30,3,8,0,11,4,30,4,0,0,4,2,30,11,0,0,11,4,30,5,6,0,11,5,30,4,0,0,4,1,-15,3,1
2,2,6,0,30,7,2,0,9,4,30,2,0,0,2,0,30,2,7,0,9,0,30,4,5,0,9,2,30,3,2,0,5,0,-27,3,0
2,3,6,0,30,7,2,0,9,4,30,2,0,0,2,0,30,2,7,0,9,0,30,4,5,0,9,2,30,3,2,0,5,0,-27,3,0
2,2,13,4,30,3,0,0,3,0,30,2,0,0,2,0,30,2,1,0,3,7,30,3,0,0,3,4,30,2,0,0,2,1,-15,3,1
2,1,13,3,30,7,0,0,7,0,30,4,0,0,4,2,30,5,2,0,7,12,30,7,0,0,7,4,30,4,0,0,4,1,-15,3,1
2,2,13,3,30,7,0,0,7,0,30,4,0,0,4,2,30,5,2,0,7,12,30,7,0,0,7,4,30,4,0,0,4,1,-15,3,1
2,4,13,3,30,7,0,0,7,0,30,4,0,0,4,2,30,5,2,0,7,12,30,7,0,0,7,4,30,4,0,0,4,1,-15,3,1
2,3,19,0,30,4,9,0,13,2,30,7,1,0,8,0,30,7,6,0,13,4,30,5,8,0,13,0,30,8,1,0,9,1,-15,3,1
2,3,23,1,30,6,7,0,13,1,30,6,0,0,6,6,30,11,2,0,13,0,30,5,8,0,13,1,30,6,0,0,6,1,-15,3,1
2,4,25,1,30,7,7,0,14,4,30,6,0,0,6,0,30,7,7,0,14,1,30,5,9,0,14,0,30,6,0,0,6,1,-15,3,1
2,4,27,0,30,4,11,0,15,0,30,2,0,0,2,0,30,11,4,0,15,0,30,4,11,0,15,1,30,5,1,0,6,1,-15,3,1
2,0,29,0,30,5,9,0,14,6,30,12,0,0,12,0,30,3,11,0,14,0,30,1,13,0,14,5,30,9,0,0,9,1,-15,3,1
2,1,29,0,30,5,9,0,14,6,30,12,0,0,12,0,30,3,11,0,14,0,30,1,13,0,14,5,30,9,0,0,9,1,-15,3,1
2,0,5,0,30,1,4,0,5,3,30,1,3,0,4,0,30,0,5,0,5,0,30,3,2,0,5,2,30,2,0,0,2,0,-27,3,0
2,2,5,0,30,1,4,0,5,3,30,1,3,0,4,0,30,0,5,0,5,0,30,3,2,0,5,2,30,2,0,0,2,0,-27,3,0
2,4,5,0,30,1,4,0,5,3,30,1,3,0,4,0,30,0,5,0,5,0,30,3,2,0,5,2,30,2,0,0,2,0,-27,3,0
2,1,13,1,30,6,1,0,7,0,30,4,0,0,4,2,30,6,1,0,7,6,30,6,1,0,7,4,30,4,0,0,4,1,-15,3,1
2,2,13,1,30,6,1,0,7,0,30,4,0,0,4,2,30,6,1,0,7,6,30,6,1,0,7,4,30,4,0,0,4,1,-15,3,1
2,3,13,1,30,6,1,0,7,0,30,4,0,0,4,2,30,6,1,0,7,6,30,6,1,0,7,4,30,4,0,0,4,1,-15,3,1
2,4,13,1,30,6,1,0,7,0,30,4,0,0,4,2,30,6,1,0,7,6,30,6,1,0,7,4,30,4,0,0,4,1,-15,3,1
2,3,22,2,30,8,0,0,8,3,30,2,0,0,2,0,30,3,5,0,8,1,30,3,5,0,8,0,30,3,1,0,4,1,-15,3,1
2,2,25,4,30,5,9,0,14,4,30,6,0,0,6,0,30,9,5,0,14,1,30,4,10,0,14,3,30,5,1,0,6,1,-15,3,1
2,2,39,0,30,2,9,0,11,5,30,6,0,0,6,0,30,4,7,0,11,0,30,2,9,0,11,6,30,5,0,0,5,1,-15,3,1
2,4,2,4,30,10,0,0,10,4,30,4,0,0,4,0,30,2,8,0,10,0,30,2,8,0,10,4,30,8,0,0,8,0,-27,3,0
2,1,4,2,30,3,5,0,8,5,30,4,0,0,4,0,30,1,7,0,8,0,30,7,1,0,8,2,30,2,2,0,4,0,-27,3,0
2,1,13,4,30,6,1,0,7,0,30,4,0,0,4,2,30,6,1,0,7,4,30,4,3,0,7,5,30,4,0,0,4,1,-15,3,1
2,3,13,4,30,6,1,0,7,0,30,4,0,0,4,2,30,6,1,0,7,4,30,4,3,0,7,0,30,4,0,0,4,1,-15,3,1
2,4,13,4,30,6,1,0,7,0,30,4,0,0,4,2,30,6,1,0,7,4,30,4,3,0,7,0,30,4,0,0,4,1,-15,3,1
2,3,19,0,30,5,8,0,13,2,30,3,5,0,8,0,30,4,9,0,13,4,30,3,10,0,13,3,30,9,0,0,9,1,-15,3,1
2,4,19,0,30,5,8,0,13,2,30,3,5,0,8,0,30,4,9,0,13,4,30,3,10,0,13,3,30,9,0,0,9,1,-15,3,1
2,4,25,1,30,8,6,0,14,2,30,6,0,0,6,1,30,8,6,0,14,0,30,5,9,0,14,4,30,5,1,0,6,1,-15,3,1
2,0,27,1,30,4,11,0,15,4,30,1,1,0,2,0,30,8,7,0,15,2,30,4,11,0,15,2,30,6,0,0,6,1,-15,3,1
2,1,27,1,30,4,11,0,15,4,30,1,1,0,2,0,30,8,7,0,15,2,30,4,11,0,15,2,30,6,0,0,6,1,-15,3,1
2,2,27,1,30,4,11,0,15,4,30,1,1,0,2,0,30,8,7,0,15,2,30,4,11,0,15,2,30,6,0,0,6,1,-15,3,1
2,3,27,1,30,4,11,0,15,4,30,1,1,0,2,0,30,8,7,0,15,2,30,4,11,0,15,2,30,6,0,0,6,1,-15,3,1
2,4,27,1,30,4,11,0,15,4,30,1,1,0,2,0,30,8,7,0,15,2,30,4,11,0,15,2,30,6,0,0,6,1,-15,3,1
2,0,37,0,30,5,6,0,11,8,30,8,0,0,8,0,30,3,8,0,11,4,30,6,5,0,11,8,30,6,0,0,6,1,-15,3,1
2,1,5,0,30,1,4,0,5,3,30,2,2,0,4,0,30,0,5,0,5,0,30,1,4,0,5,3,30,2,0,0,2,0,-27,3,0
2,1,13,3,30,6,1,0,7,0,30,4,0,0,4,3,30,7,0,0,7,5,30,7,0,0,7,5,30,4,0,0,4,1,-15,3,1
2,0,26,1,30,9,0,0,9,5,30,4,0,0,4,2,30,0,9,0,9,0,30,4,5,0,9,4,30,2,1,0,3,1,-15,3,1
2,2,27,1,30,5,10,0,15,2,30,1,1,0,2,0,30,6,9,0,15,0,30,4,11,0,15,2,30,5,1,0,6,1,-15,3,1
2,3,27,1,30,5,10,0,15,2,30,1,1,0,2,0,30,6,9,0,15,0,30,4,11,0,15,2,30,5,1,0,6,1,-15,3,1
2,2,38,0,30,2,8,0,10,7,30,6,0,0,6,2,30,1,9,0,10,2,30,2,8,0,10,6,30,6,0,0,6,1,-15,3,1
2,3,38,0,30,2,8,0,10,7,30,6,0,0,6,2,30,1,9,0,10,2,30,2,8,0,10,6,30,6,0,0,6,1,-15,3,1
2,2,4,2,30,7,1,0,8,3,30,4,0,0,4,4,30,1,7,0,8,4,30,0,8,0,8,2,30,4,0,0,4,0,-27,3,0
2,4,4,2,30,7,1,0,8,3,30,4,0,0,4,4,30,1,7,0,8,4,30,0,8,0,8,2,30,4,0,0,4,0,-27,3,0
2,3,9,1,30,9,2,0,11,3,30,6,0,0,6,0,30,7,4,0,11,1,30,3,8,0,11,4,30,4,0,0,4,0,-27,3,0
2,3,17,3,30,9,5,0,14,4,30,6,0,0,6,0,30,4,10,0,14,5,30,5,9,0,14,2,30,4,0,0,4,1,-15,3,1
2,4,17,3,30,9,5,0,14,4,30,6,0,0,6,0,30,4,10,0,14,5,30,5,9,0,14,2,30,4,0,0,4,1,-15,3,1
2,3,19,0,30,3,10,0,13,0,30,8,0,0,8,0,30,7,6,0,13,2,30,7,6,0,13,1,30,6,3,0,9,1,-15,3,1
2,4,23,2,30,9,4,0,13,2,30,6,0,0,6,0,30,13,0,0,13,0,30,4,9,0,13,3,30,6,0,0,6,1,-15,3,1
2,3,25,0,30,3,11,0,14,2,30,6,0,0,6,0,30,7,7,0,14,1,30,7,7,0,14,3,30,6,0,0,6,1,-15,3,1
2,4,25,0,30,3,11,0,14,2,30,6,0,0,6,0,30,7,7,0,14,1,30,7,7,0,14,3,30,6,0,0,6,1,-15,3,1
2,4,27,1,30,5,10,0,15,4,30,1,1,0,2,0,30,2,13,0,15,4,30,6,9,0,15,5,30,6,0,0,6,1,-15,3,1
2,3,29,0,30,4,10,0,14,5,30,12,0,0,12,0,30,8,6,0,14,0,30,0,14,0,14,0,30,7,2,0,9,1,-15,3,1
2,4,29,0,30,4,10,0,14,5,30,12,0,0,12,0,30,8,6,0,14,0,30,0,14,0,14,0,30,7,2,0,9,1,-15,3,1
2,3,32,0,30,5,4,0,9,4,30,2,0,0,2,1,30,8,1,0,9,1,30,3,6,0,9,2,30,2,0,0,2,1,-15,3,1
2,4,39,0,30,3,8,0,11,6,30,6,0,0,6,0,30,5,6,0,11,2,30,2,9,0,11,5,30,5,0,0,5,1,-15,3,1
2,1,4,2,30,7,1,0,8,5,30,4,0,0,4,3,30,2,6,0,8,0,30,7,1,0,8,1,30,3,1,0,4,0,-27,3,0
2,2,4,2,30,7,1,0,8,5,30,4,0,0,4,3,30,2,6,0,8,0,30,7,1,0,8,1,30,3,1,0,4,0,-27,3,0
2,3,4,2,30,7,1,0,8,5,30,4,0,0,4,3,30,2,6,0,8,0,30,7,1,0,8,1,30,3,1,0,4,0,-27,3,0
2,4,4,2,30,7,1,0,8,5,30,4,0,0,4,3,30,2,6,0,8,0,30,7,1,0,8,1,30,3,1,0,4,0,-27,3,0
2,1,5,0,30,2,3,0,5,2,30,3,1,0,4,0,30,1,4,0,5,0,30,1,4,0,5,1,30,0,2,0,2,0,-27,3,0
2,3,5,0,30,2,3,0,5,2,30,3,1,0,4,0,30,1,4,0,5,0,30,1,4,0,5,1,30,0,2,0,2,0,-27,3,0
2,4,5,0,30,2,3,0,5,2,30,3,1,0,4,0,30,1,4,0,5,0,30,1,4,0,5,1,30,0,2,0,2,0,-27,3,0
2,4,13,1,30,6,1,0,7,0,30,4,0,0,4,2,30,7,0,0,7,14,30,6,1,0,7,0,30,4,0,0,4,1,-15,3,1
2,1,19,0,30,4,9,0,13,1,30,5,3,0,8,0,30,4,9,0,13,7,30,4,9,0,13,2,30,9,0,0,9,1,-15,3,1
2,4,19,0,30,4,9,0,13,1,30,5,3,0,8,0,30,4,9,0,13,7,30,4,9,0,13,2,30,9,0,0,9,1,-15,3,1
2,2,23,1,30,5,8,0,13,1,30,6,0,0,6,6,30,12,1,0,13,0,30,4,9,0,13,2,30,6,0,0,6,1,-15,3,1
2,3,23,1,30,5,8,0,13,1,30,6,0,0,6,6,30,12,1,0,13,0,30,4,9,0,13,2,30,6,0,0,6,1,-15,3,1
2,2,27,1,30,4,11,0,15,3,30,1,1,0,2,0,30,5,10,0,15,2,30,4,11,0,15,4,30,6,0,0,6,1,-15,3,1
2,3,27,1,30,4,11,0,15,3,30,1,1,0,2,0,30,5,10,0,15,2,30,4,11,0,15,4,30,6,0,0,6,1,-15,3,1
2,4,27,1,30,4,11,0,15,3,30,1,1,0,2,0,30,5,10,0,15,2,30,4,11,0,15,4,30,6,0,0,6,1,-15,3,1
2,0,29,0,30,5,9,0,14,6,30,10,2,0,12,0,30,4,10,0,14,0,30,0,14,0,14,3,30,9,0,0,9,1,-15,3,1
2,2,29,0,30,5,9,0,14,6,30,10,2,0,12,0,30,4,10,0,14,0,30,0,14,0,14,3,30,9,0,0,9,1,-15,3,1
2,3,29,0,30,5,9,0,14,6,30,10,2,0,12,0,30,4,10,0,14,0,30,0,14,0,14,3,30,9,0,0,9,1,-15,3,1
2,2,31,3,30,7,5,0,12,4,30,8,0,0,8,3,30,10,2,0,12,0,30,3,9,0,12,0,30,5,1,0,6,1,-15,3,1
2,3,31,3,30,7,5,0,12,4,30,8,0,0,8,3,30,10,2,0,12,0,30,3,9,0,12,0,30,5,1,0,6,1,-15,3,1
2,4,31,3,30,7,5,0,12,4,30,8,0,0,8,3,30,10,2,0,12,0,30,3,9,0,12,0,30,5,1,0,6,1,-15,3,1
2,0,4,2,30,8,0,0,8,5,30,4,0,0,4,0,30,2,6,0,8,0,30,7,1,0,8,1,30,3,1,0,4,0,-27,3,0
2,2,4,2,30,8,0,0,8,5,30,4,0,0,4,0,30,2,6,0,8,0,30,7,1,0,8,1,30,3,1,0,4,0,-27,3,0
2,3,4,2,30,8,0,0,8,5,30,4,0,0,4,0,30,2,6,0,8,0,30,7,1,0,8,1,30,3,1,0,4,0,-27,3,0
2,4,8,0,30,6,1,0,7,3,30,2,0,0,2,2,30,3,4,0,7,1,30,5,2,0,7,1,30,3,0,0,3,0,-27,3,0
2,2,11,1,30,4,8,0,12,0,30,4,0,0,4,0,30,8,4,0,12,7,30,5,7,0,12,4,30,3,1,0,4,1,-15,3,1
2,2,13,2,30,5,2,0,7,1,30,4,0,0,4,2,30,6,1,0,7,4,30,6,1,0,7,3,30,4,0,0,4,1,-15,3,1
2,4,13,2,30,5,2,0,7,1,30,4,0,0,4,2,30,6,1,0,7,4,30,6,1,0,7,0,30,4,0,0,4,1,-15,3,1
2,0,25,5,30,6,8,0,14,5,30,5,1,0,6,0,30,7,7,0,14,1,30,4,10,0,14,5,30,5,1,0,6,1,-15,3,1
2,2,25,5,30,6,8,0,14,5,30,5,1,0,6,0,30,7,7,0,14,1,30,4,10,0,14,5,30,5,1,0,6,1,-15,3,1
2,3,25,5,30,6,8,0,14,5,30,5,1,0,6,0,30,7,7,0,14,1,30,4,10,0,14,5,30,5,1,0,6,1,-15,3,1
2,4,25,5,30,6,8,0,14,5,30,5,1,0,6,0,30,7,7,0,14,1,30,4,10,0,14,5,30,5,1,0,6,1,-15,3,1
2,0,26,0,30,9,0,0,9,5,30,4,0,0,4,2,30,0,9,0,9,0,30,2,7,0,9,8,30,3,0,0,3,1,-15,3,1
2,1,26,0,30,9,0,0,9,5,30,4,0,0,4,2,30,0,9,0,9,0,30,2,7,0,9,8,30,3,0,0,3,1,-15,3,1
2,0,27,0,30,4,11,0,15,3,30,2,0,0,2,0,30,3,12,0,15,2,30,4,11,0,15,5,30,6,0,0,6,1,-15,3,1
2,2,27,0,30,4,11,0,15,3,30,2,0,0,2,0,30,3,12,0,15,2,30,4,11,0,15,5,30,6,0,0,6,1,-15,3,1
2,4,27,0,30,4,11,0,15,3,30,2,0,0,2,0,30,3,12,0,15,2,30,4,11,0,15,5,30,6,0,0,6,1,-15,3,1
2,3,29,0,30,8,6,0,14,5,30,11,1,0,12,0,30,3,11,0,14,0,30,1,13,0,14,1,30,9,0,0,9,1,-15,3,1
2,4,29,0,30,8,6,0,14,5,30,11,1,0,12,0,30,3,11,0,14,0,30,1,13,0,14,1,30,9,0,0,9,1,-15,3,1
2,4,31,2,30,6,6,0,12,5,30,8,0,0,8,6,30,9,3,0,12,0,30,3,9,0,12,0,30,4,2,0,6,1,-15,3,1
2,4,39,0,30,2,9,0,11,7,30,6,0,0,6,0,30,4,7,0,11,3,30,3,8,0,11,0,30,5,0,0,5,1,-15,3,1
2,1,11,0,30,6,6,0,12,1,30,4,0,0,4,0,30,5,7,0,12,4,30,6,6,0,12,5,30,4,0,0,4,1,-15,3,1
2,2,11,0,30,6,6,0,12,1,30,4,0,0,4,0,30,5,7,0,12,4,30,6,6,0,12,5,30,4,0,0,4,1,-15,3,1
2,1,17,3,30,8,6,0,14,2,30,6,0,0,6,0,30,6,8,0,14,3,30,8,6,0,14,4,30,4,0,0,4,1,-15,3,1
2,2,17,3,30,8,6,0,14,2,30,6,0,0,6,0,30,6,8,0,14,3,30,8,6,0,14,4,30,4,0,0,4,1,-15,3,1
2,4,17,3,30,8,6,0,14,2,30,6,0,0,6,0,30,6,8,0,14,3,30,8,6,0,14,4,30,4,0,0,4,1,-15,3,1
2,3,25,1,30,10,4,0,14,1,30,6,0,0,6,0,30,9,5,0,14,1,30,6,8,0,14,3,30,5,1,0,6,1,-15,3,1
2,2,27,1,30,4,11,0,15,4,30,2,0,0,2,0,30,9,6,0,15,0,30,6,9,0,15,1,30,6,0,0,6,1,-15,3,1
2,2,43,0,30,5,9,0,14,6,30,6,0,0,6,0,30,4,10,0,14,1,30,3,11,0,14,3,30,5,0,0,5,1,-15,3,1
2,4,43,0,30,5,9,0,14,6,30,6,0,0,6,0,30,4,10,0,14,1,30,3,11,0,14,3,30,5,0,0,5,1,-15,3,1
2,2,45,0,30,8,5,0,13,8,30,10,0,0,10,0,30,8,5,0,13,0,30,4,9,0,13,6,30,4,1,0,5,1,-15,3,1
2,3,45,0,30,8,5,0,13,8,30,10,0,0,10,0,30,8,5,0,13,0,30,4,9,0,13,6,30,4,1,0,5,1,-15,3,1
2,4,7,1,30,8,1,0,9,3,30,4,0,0,4,2,30,6,3,0,9,0,30,3,6,0,9,1,30,4,2,0,6,0,-27,3,0
2,4,13,0,30,6,1,0,7,1,30,4,0,0,4,1,30,5,2,0,7,4,30,4,3,0,7,3,30,4,0,0,4,1,-15,3,1
2,4,19,0,30,10,3,0,13,0,30,5,3,0,8,0,30,4,9,0,13,0,30,3,10,0,13,0,30,9,0,0,9,1,-15,3,1
2,4,25,0,30,6,8,0,14,4,30,6,0,0,6,0,30,8,6,0,14,1,30,5,9,0,14,5,30,6,0,0,6,1,-15,3,1
2,1,27,1,30,4,11,0,15,3,30,2,0,0,2,0,30,6,9,0,15,2,30,6,9,0,15,3,30,6,0,0,6,1,-15,3,1
2,2,27,1,30,4,11,0,15,3,30,2,0,0,2,0,30,6,9,0,15,2,30,6,9,0,15,3,30,6,0,0,6,1,-15,3,1
2,0,29,0,30,9,5,0,14,4,30,11,1,0,12,0,30,3,11,0,14,0,30,1,13,0,14,4,30,9,0,0,9,1,-15,3,1
2,3,33,1,30,3,8,0,11,5,30,4,0,0,4,0,30,9,2,0,11,0,30,3,8,0,11,6,30,4,0,0,4,1,-15,3,1
2,3,8,2,30,7,0,0,7,4,30,2,0,0,2,0,30,3,4,0,7,0,30,6,1,0,7,2,30,3,0,0,3,0,-27,3,0
2,1,13,3,30,7,0,0,7,0,30,4,0,0,4,2,30,6,1,0,7,7,30,6,1,0,7,3,30,4,0,0,4,1,-15,3,1
2,2,13,3,30,7,0,0,7,0,30,4,0,0,4,2,30,6,1,0,7,7,30,6,1,0,7,3,30,4,0,0,4,1,-15,3,1
2,4,13,3,30,7,0,0,7,0,30,4,0,0,4,2,30,6,1,0,7,7,30,6,1,0,7,3,30,4,0,0,4,1,-15,3,1
2,1,17,3,30,11,3,0,14,3,30,6,0,0,6,0,30,4,10,0,14,1,30,4,10,0,14,2,30,4,0,0,4,1,-15,3,1
2,3,17,3,30,11,3,0,14,3,30,6,0,0,6,0,30,4,10,0,14,1,30,4,10,0,14,2,30,4,0,0,4,1,-15,3,1
2,4,23,2,30,6,7,0,13,1,30,6,0,0,6,3,30,12,1,0,13,0,30,5,8,0,13,0,30,6,0,0,6,1,-15,3,1
2,2,25,1,30,5,9,0,14,3,30,6,0,0,6,0,30,9,5,0,14,2,30,8,6,0,14,5,30,6,0,0,6,1,-15,3,1
2,3,25,1,30,5,9,0,14,3,30,6,0,0,6,0,30,9,5,0,14,2,30,8,6,0,14,5,30,6,0,0,6,1,-15,3,1
2,3,29,1,30,6,8,0,14,6,30,12,0,0,12,0,30,2,12,0,14,0,30,0,14,0,14,1,30,9,0,0,9,1,-15,3,1
2,4,29,1,30,6,8,0,14,6,30,12,0,0,12,0,30,2,12,0,14,0,30,0,14,0,14,1,30,9,0,0,9,1,-15,3,1
2,4,32,0,30,7,2,0,9,4,30,2,0,0,2,1,30,9,0,0,9,1,30,3,6,0,9,3,30,2,0,0,2,1,-15,3,1
2,2,33,1,30,2,9,0,11,5,30,4,0,0,4,0,30,10,1,0,11,1,30,6,5,0,11,5,30,4,0,0,4,1,-15,3,1
2,3,33,1,30,2,9,0,11,5,30,4,0,0,4,0,30,10,1,0,11,1,30,6,5,0,11,5,30,4,0,0,4,1,-15,3,1
2,4,8,1,30,7,0,0,7,3,30,2,0,0,2,2,30,6,1,0,7,1,30,5,2,0,7,1,30,3,0,0,3,0,-27,3,0
2,1,13,6,30,3,0,0,3,2,30,2,0,0,2,0,30,2,1,0,3,3,30,2,1,0,3,3,30,2,0,0,2,1,-15,3,1
2,3,13,6,30,3,0,0,3,2,30,2,0,0,2,0,30,2,1,0,3,3,30,2,1,0,3,3,30,2,0,0,2,1,-15,3,1
2,4,13,6,30,3,0,0,3,2,30,2,0,0,2,0,30,2,1,0,3,3,30,2,1,0,3,3,30,2,0,0,2,1,-15,3,1
2,1,13,6,30,7,0,0,7,2,30,4,0,0,4,2,30,5,2,0,7,3,30,6,1,0,7,3,30,4,0,0,4,1,-15,3,1
2,3,13,6,30,7,0,0,7,2,30,4,0,0,4,2,30,5,2,0,7,3,30,6,1,0,7,3,30,4,0,0,4,1,-15,3,1
2,3,17,2,30,8,6,0,14,0,30,6,0,0,6,0,30,9,5,0,14,6,30,5,9,0,14,8,30,4,0,0,4,1,-15,3,1
2,1,19,0,30,3,10,0,13,1,30,5,3,0,8,0,30,7,6,0,13,9,30,4,9,0,13,3,30,9,0,0,9,1,-15,3,1
2,4,19,0,30,3,10,0,13,1,30,5,3,0,8,0,30,7,6,0,13,9,30,4,9,0,13,3,30,9,0,0,9,1,-15,3,1
2,2,25,1,30,3,11,0,14,4,30,6,0,0,6,0,30,13,1,0,14,1,30,5,9,0,14,5,30,5,1,0,6,1,-15,3,1
2,3,25,1,30,3,11,0,14,4,30,6,0,0,6,0,30,13,1,0,14,1,30,5,9,0,14,5,30,5,1,0,6,1,-15,3,1
2,0,27,1,30,3,12,0,15,2,30,1,1,0,2,0,30,6,9,0,15,0,30,5,10,0,15,4,30,6,0,0,6,1,-15,3,1
2,1,27,1,30,3,12,0,15,2,30,1,1,0,2,0,30,6,9,0,15,0,30,5,10,0,15,4,30,6,0,0,6,1,-15,3,1
2,3,32,0,30,7,2,0,9,4,30,2,0,0,2,2,30,9,0,0,9,1,30,2,7,0,9,2,30,2,0,0,2,1,-15,3,1
2,4,32,0,30,7,2,0,9,4,30,2,0,0,2,2,30,9,0,0,9,1,30,2,7,0,9,2,30,2,0,0,2,1,-15,3,1
2,0,38,0,30,5,5,0,10,7,30,6,0,0,6,0,30,1,9,0,10,0,30,3,7,0,10,7,30,6,0,0,6,1,-15,3,1
2,3,4,2,30,7,1,0,8,4,30,4,0,0,4,0,30,3,5,0,8,3,30,4,4,0,8,1,30,4,0,0,4,0,-27,3,0
2,4,4,2,30,7,1,0,8,4,30,4,0,0,4,0,30,3,5,0,8,3,30,4,4,0,8,1,30,4,0,0,4,0,-27,3,0
2,1,13,4,30,7,0,0,7,2,30,4,0,0,4,1,30,5,2,0,7,1,30,7,0,0,7,6,30,4,0,0,4,1,-15,3,1
2,2,13,4,30,7,0,0,7,2,30,4,0,0,4,1,30,5,2,0,7,1,30,7,0,0,7,6,30,4,0,0,4,1,-15,3,1
2,2,19,0,30,4,9,0,13,2,30,5,3,0,8,0,30,6,7,0,13,6,30,4,9,0,13,4,30,8,1,0,9,1,-15,3,1
2,3,19,0,30,4,9,0,13,2,30,5,3,0,8,0,30,6,7,0,13,6,30,4,9,0,13,4,30,8,1,0,9,1,-15,3,1
2,1,21,0,30,6,4,0,10,3,30,5,1,0,6,1,30,3,7,0,10,8,30,5,5,0,10,0,30,4,0,0,4,1,-15,3,1
2,0,26,0,30,9,0,0,9,4,30,3,1,0,4,2,30,0,9,0,9,0,30,2,7,0,9,6,30,3,0,0,3,1,-15,3,1
2,2,26,0,30,9,0,0,9,4,30,3,1,0,4,2,30,0,9,0,9,0,30,2,7,0,9,6,30,3,0,0,3,1,-15,3,1
2,2,27,1,30,5,10,0,15,3,30,2,0,0,2,0,30,5,10,0,15,2,30,3,12,0,15,2,30,4,2,0,6,1,-15,3,1
2,3,27,1,30,5,10,0,15,3,30,2,0,0,2,0,30,5,10,0,15,2,30,3,12,0,15,2,30,4,2,0,6,1,-15,3,1
2,1,32,0,30,6,3,0,9,4,30,2,0,0,2,2,30,9,0,0,9,1,30,2,7,0,9,4,30,2,0,0,2,1,-15,3,1
2,3,32,0,30,6,3,0,9,4,30,2,0,0,2,2,30,9,0,0,9,1,30,2,7,0,9,4,30,2,0,0,2,1,-15,3,1
2,2,35,0,30,7,6,0,13,6,30,2,0,0,2,1,30,2,11,0,13,2,30,6,7,0,13,8,30,8,0,0,8,1,-15,3,1
2,2,43,0,30,6,8,0,14,7,30,6,0,0,6,0,30,4,10,0,14,1,30,3,11,0,14,3,30,5,0,0,5,1,-15,3,1
2,2,47,0,30,3,11,0,14,9,30,4,0,0,4,0,30,3,11,0,14,0,30,2,12,0,14,0,30,6,1,0,7,1,-15,3,1
2,3,47,0,30,3,11,0,14,9,30,4,0,0,4,0,30,3,11,0,14,0,30,2,12,0,14,0,30,6,1,0,7,1,-15,3,1
2,4,47,0,30,3,11,0,14,9,30,4,0,0,4,0,30,3,11,0,14,0,30,2,12,0,14,0,30,6,1,0,7,1,-15,3,1
2,0,4,2,30,6,2,0,8,4,30,2,2,0,4,0,30,2,6,0,8,0,30,6,2,0,8,6,30,3,1,0,4,0,-27,3,0
2,0,17,4,30,11,3,0,14,3,30,6,0,0,6,0,30,5,9,0,14,1,30,8,6,0,14,6,30,4,0,0,4,1,-15,3,1
2,1,17,4,30,11,3,0,14,3,30,6,0,0,6,0,30,5,9,0,14,1,30,8,6,0,14,6,30,4,0,0,4,1,-15,3,1
2,3,17,4,30,11,3,0,14,3,30,6,0,0,6,0,30,5,9,0,14,1,30,8,6,0,14,6,30,4,0,0,4,1,-15,3,1
2,1,27,1,30,4,11,0,15,3,30,2,0,0,2,0,30,2,13,0,15,0,30,3,12,0,15,1,30,4,2,0,6,1,-15,3,1
2,4,27,0,30,4,11,0,15,3,30,2,0,0,2,0,30,2,13,0,15,0,30,3,12,0,15,1,30,4,2,0,6,1,-15,3,1
2,2,29,0,30,7,7,0,14,5,30,10,2,0,12,0,30,6,8,0,14,0,30,1,13,0,14,2,30,9,0,0,9,1,-15,3,1
2,4,7,0,30,4,0,0,4,2,30,2,0,0,2,0,30,2,2,0,4,0,30,1,3,0,4,2,30,1,1,0,2,0,-27,3,0
2,4,17,2,30,8,6,0,14,0,30,6,0,0,6,0,30,6,8,0,14,2,30,5,9,0,14,2,30,4,0,0,4,1,-15,3,1
2,0,27,2,30,4,11,0,15,3,30,1,1,0,2,0,30,2,13,0,15,3,30,4,11,0,15,7,30,6,0,0,6,1,-15,3,1
2,2,27,2,30,4,11,0,15,3,30,1,1,0,2,0,30,2,13,0,15,3,30,4,11,0,15,7,30,6,0,0,6,1,-15,3,1
2,3,27,2,30,4,11,0,15,3,30,1,1,0,2,0,30,2,13,0,15,3,30,4,11,0,15,7,30,6,0,0,6,1,-15,3,1
2,4,31,1,30,8,4,0,12,6,30,8,0,0,8,1,30,6,6,0,12,0,30,6,6,0,12,0,30,5,1,0,6,1,-15,3,1
2,3,33,2,30,7,4,0,11,4,30,4,0,0,4,5,30,11,0,0,11,0,30,3,8,0,11,4,30,4,0,0,4,1,-15,3,1
2,0,41,0,30,8,4,0,12,8,30,8,0,0,8,0,30,3,9,0,12,4,30,4,8,0,12,1,30,4,3,0,7,1,-15,3,1
2,4,41,0,30,8,4,0,12,8,30,8,0,0,8,0,30,3,9,0,12,4,30,4,8,0,12,1,30,4,3,0,7,1,-15,3,1
2,3,3,0,30,0,4,0,4,2,30,4,0,0,4,0,30,2,2,0,4,3,30,0,4,0,4,1,30,2,1,0,3,0,-27,3,0
2,4,3,0,30,0,4,0,4,2,30,4,0,0,4,0,30,2,2,0,4,3,30,0,4,0,4,1,30,2,1,0,3,0,-27,3,0
2,3,8,2,30,7,0,0,7,4,30,2,0,0,2,4,30,3,4,0,7,0,30,6,1,0,7,3,30,3,0,0,3,0,-27,3,0
2,4,8,2,30,7,0,0,7,4,30,2,0,0,2,4,30,3,4,0,7,0,30,6,1,0,7,3,30,3,0,0,3,0,-27,3,0
2,1,13,2,30,7,0,0,7,1,30,4,0,0,4,1,30,5,2,0,7,10,30,4,3,0,7,3,30,4,0,0,4,1,-15,3,1
2,4,13,2,30,7,0,0,7,1,30,4,0,0,4,1,30,5,2,0,7,10,30,4,3,0,7,3,30,4,0,0,4,1,-15,3,1
2,4,17,3,30,9,5,0,14,2,30,6,0,0,6,0,30,6,8,0,14,0,30,7,7,0,14,0,30,4,0,0,4,1,-15,3,1
2,0,21,1,30,5,5,0,10,4,30,6,0,0,6,1,30,3,7,0,10,6,30,5,5,0,10,4,30,4,0,0,4,1,-15,3,1
2,2,21,1,30,5,5,0,10,4,30,6,0,0,6,0,30,3,7,0,10,6,30,5,5,0,10,4,30,4,0,0,4,1,-15,3,1
2,3,21,1,30,5,5,0,10,4,30,6,0,0,6,0,30,3,7,0,10,6,30,5,5,0,10,4,30,4,0,0,4,1,-15,3,1
2,4,21,1,30,5,5,0,10,4,30,6,0,0,6,0,30,3,7,0,10,6,30,5,5,0,10,4,30,4,0,0,4,1,-15,3,1
2,4,22,1,30,6,2,0,8,3,30,2,0,0,2,1,30,4,4,0,8,1,30,6,2,0,8,4,30,4,0,0,4,1,-15,3,1
2,2,25,1,30,7,7,0,14,0,30,6,0,0,6,0,30,13,1,0,14,1,30,5,9,0,14,0,30,6,0,0,6,1,-15,3,1
2,0,27,1,30,3,12,0,15,3,30,2,0,0,2,0,30,6,9,0,15,0,30,5,10,0,15,3,30,6,0,0,6,1,-15,3,1
2,4,1,0,30,7,3,0,10,4,30,2,0,0,2,1,30,5,5,0,10,0,30,6,4,0,10,5,30,6,0,0,6,0,-27,3,0
2,3,6,0,30,8,1,0,9,5,30,2,0,0,2,0,30,2,7,0,9,0,30,5,4,0,9,5,30,5,0,0,5,0,-27,3,0
2,4,6,0,30,8,1,0,9,5,30,2,0,0,2,0,30,2,7,0,9,0,30,5,4,0,9,5,30,5,0,0,5,0,-27,3,0
2,1,17,4,30,10,4,0,14,3,30,6,0,0,6,0,30,6,8,0,14,1,30,5,9,0,14,1,30,4,0,0,4,1,-15,3,1
2,4,17,2,30,10,4,0,14,2,30,6,0,0,6,0,30,6,8,0,14,1,30,5,9,0,14,1,30,4,0,0,4,1,-15,3,1
2,1,23,2,30,6,7,0,13,2,30,6,0,0,6,4,30,13,0,0,13,1,30,6,7,0,13,3,30,6,0,0,6,1,-15,3,1
2,2,23,2,30,6,7,0,13,2,30,6,0,0,6,4,30,13,0,0,13,1,30,6,7,0,13,3,30,6,0,0,6,1,-15,3,1
2,3,23,2,30,6,7,0,13,2,30,6,0,0,6,4,30,13,0,0,13,1,30,6,7,0,13,3,30,6,0,0,6,1,-15,3,1
2,1,27,1,30,4,11,0,15,3,30,2,0,0,2,0,30,6,9,0,15,7,30,5,10,0,15,0,30,5,1,0,6,1,-15,3,1
2,4,27,1,30,4,11,0,15,3,30,2,0,0,2,0,30,6,9,0,15,7,30,5,10,0,15,0,30,5,1,0,6,1,-15,3,1
2,2,29,0,30,8,6,0,14,6,30,10,2,0,12,0,30,6,8,0,14,0,30,1,13,0,14,0,30,9,0,0,9,1,-15,3,1
2,3,29,0,30,8,6,0,14,6,30,10,2,0,12,0,30,6,8,0,14,0,30,1,13,0,14,0,30,9,0,0,9,1,-15,3,1
2,4,29,0,30,8,6,0,14,6,30,10,2,0,12,0,30,6,8,0,14,0,30,1,13,0,14,0,30,9,0,0,9,1,-15,3,1
2,1,1,0,30,7,3,0,10,4,30,2,0,0,2,1,30,4,6,0,10,7,30,7,3,0,10,5,30,6,0,0,6,0,-27,3,0
2,2,1,0,30,7,3,0,10,4,30,2,0,0,2,1,30,4,6,0,10,7,30,7,3,0,10,5,30,6,0,0,6,0,-27,3,0
2,1,5,0,30,2,3,0,5,2,30,2,2,0,4,0,30,2,3,0,5,0,30,1,4,0,5,0,30,0,2,0,2,0,-27,3,0
2,2,5,0,30,2,3,0,5,2,30,2,2,0,4,0,30,2,3,0,5,0,30,1,4,0,5,0,30,0,2,0,2,0,-27,3,0
2,2,6,0,30,7,2,0,9,4,30,2,0,0,2,0,30,3,6,0,9,0,30,4,5,0,9,1,30,5,0,0,5,0,-27,3,0
2,2,8,1,30,7,0,0,7,2,30,2,0,0,2,0,30,3,4,0,7,2,30,6,1,0,7,4,30,3,0,0,3,0,-27,3,0
2,3,8,1,30,7,0,0,7,2,30,2,0,0,2,0,30,3,4,0,7,2,30,6,1,0,7,4,30,3,0,0,3,0,-27,3,0
2,2,13,3,30,7,0,0,7,0,30,4,0,0,4,6,30,6,1,0,7,5,30,3,4,0,7,3,30,4,0,0,4,1,-15,3,1
2,3,13,3,30,7,0,0,7,0,30,4,0,0,4,6,30,6,1,0,7,5,30,3,4,0,7,3,30,4,0,0,4,1,-15,3,1
2,4,13,3,30,7,0,0,7,0,30,4,0,0,4,6,30,6,1,0,7,5,30,3,4,0,7,3,30,4,0,0,4,1,-15,3,1
2,4,15,0,30,5,8,0,13,0,30,6,0,0,6,0,30,6,7,0,13,1,30,5,8,0,13,2,30,6,3,0,9,1,-15,3,1
2,3,19,0,30,4,9,0,13,0,30,7,1,0,8,0,30,10,3,0,13,6,30,5,8,0,13,1,30,9,0,0,9,1,-15,3,1
2,4,23,2,30,5,8,0,13,2,30,6,0,0,6,4,30,13,0,0,13,1,30,6,7,0,13,1,30,6,0,0,6,1,-15,3,1
2,4,25,1,30,10,4,0,14,5,30,6,0,0,6,0,30,4,10,0,14,1,30,5,9,0,14,5,30,6,0,0,6,1,-15,3,1
2,1,27,1,30,5,10,0,15,3,30,2,0,0,2,1,30,9,6,0,15,0,30,4,11,0,15,0,30,4,2,0,6,1,-15,3,1
2,4,27,1,30,5,10,0,15,3,30,2,0,0,2,1,30,9,6,0,15,0,30,4,11,0,15,0,30,4,2,0,6,1,-15,3,1
2,2,39,0,30,1,10,0,11,7,30,6,0,0,6,0,30,5,6,0,11,1,30,6,5,0,11,8,30,5,0,0,5,1,-15,3,1
2,3,39,0,30,1,10,0,11,7,30,6,0,0,6,0,30,5,6,0,11,1,30,6,5,0,11,8,30,5,0,0,5,1,-15,3,1
2,3,6,0,30,8,1,0,9,3,30,2,0,0,2,0,30,6,3,0,9,0,30,4,5,0,9,1,30,5,0,0,5,0,-27,3,0
2,4,6,0,30,8,1,0,9,3,30,2,0,0,2,0,30,6,3,0,9,0,30,4,5,0,9,1,30,5,0,0,5,0,-27,3,0
2,4,11,3,30,7,5,0,12,1,30,4,0,0,4,0,30,6,6,0,12,0,30,5,7,0,12,1,30,3,1,0,4,1,-15,3,1
2,2,17,0,30,8,6,0,14,2,30,6,0,0,6,0,30,7,7,0,14,5,30,5,9,0,14,3,30,4,0,0,4,1,-15,3,1
2,1,19,0,30,7,6,0,13,1,30,4,4,0,8,0,30,6,7,0,13,1,30,7,6,0,13,1,30,7,2,0,9,1,-15,3,1
2,4,19,0,30,7,6,0,13,1,30,4,4,0,8,0,30,6,7,0,13,1,30,7,6,0,13,1,30,7,2,0,9,1,-15,3,1
2,2,25,0,30,6,8,0,14,3,30,6,0,0,6,0,30,10,4,0,14,1,30,5,9,0,14,3,30,5,1,0,6,1,-15,3,1
2,0,27,1,30,5,10,0,15,2,30,2,0,0,2,1,30,9,6,0,15,0,30,10,5,0,15,2,30,2,4,0,6,1,-15,3,1
2,3,27,1,30,5,10,0,15,2,30,2,0,0,2,1,30,9,6,0,15,0,30,10,5,0,15,2,30,2,4,0,6,1,-15,3,1
2,2,29,1,30,7,7,0,14,5,30,9,3,0,12,0,30,3,11,0,14,0,30,1,13,0,14,4,30,9,0,0,9,1,-15,3,1
2,1,4,2,30,6,2,0,8,5,30,4,0,0,4,0,30,2,6,0,8,0,30,8,0,0,8,0,30,3,1,0,4,0,-27,3,0
2,4,8,1,30,7,0,0,7,4,30,2,0,0,2,4,30,3,4,0,7,0,30,6,1,0,7,1,30,3,0,0,3,0,-27,3,0
2,2,13,3,30,7,0,0,7,0,30,4,0,0,4,3,30,5,2,0,7,9,30,5,2,0,7,3,30,4,0,0,4,1,-15,3,1
2,4,19,0,30,6,7,0,13,1,30,3,5,0,8,0,30,6,7,0,13,2,30,7,6,0,13,1,30,9,0,0,9,1,-15,3,1
2,3,21,3,30,6,4,0,10,4,30,6,0,0,6,1,30,3,7,0,10,2,30,3,7,0,10,1,30,4,0,0,4,1,-15,3,1
2,4,21,3,30,6,4,0,10,4,30,6,0,0,6,1,30,3,7,0,10,2,30,3,7,0,10,1,30,4,0,0,4,1,-15,3,1
2,3,25,0,30,6,8,0,14,0,30,6,0,0,6,0,30,14,0,0,14,1,30,5,9,0,14,4,30,5,1,0,6,1,-15,3,1
2,0,27,1,30,4,11,0,15,3,30,2,0,0,2,0,30,4,11,0,15,0,30,5,10,0,15,6,30,6,0,0,6,1,-15,3,1
2,2,33,3,30,6,5,0,11,5,30,4,0,0,4,5,30,9,2,0,11,0,30,3,8,0,11,5,30,4,0,0,4,1,-15,3,1
2,3,33,3,30,6,5,0,11,5,30,4,0,0,4,5,30,9,2,0,11,0,30,3,8,0,11,5,30,4,0,0,4,1,-15,3,1
2,4,33,3,30,6,5,0,11,5,30,4,0,0,4,5,30,9,2,0,11,0,30,3,8,0,11,5,30,4,0,0,4,1,-15,3,1
2,2,1,0,30,10,0,0,10,5,30,2,0,0,2,1,30,4,6,0,10,4,30,10,0,0,10,6,30,6,0,0,6,0,-27,3,0
2,4,1,0,30,10,0,0,10,5,30,2,0,0,2,1,30,4,6,0,10,4,30,10,0,0,10,6,30,6,0,0,6,0,-27,3,0
2,4,3,0,30,0,4,0,4,2,30,4,0,0,4,1,30,2,2,0,4,4,30,2,2,0,4,0,30,1,2,0,3,0,-27,3,0
2,0,5,0,30,1,4,0,5,3,30,0,4,0,4,0,30,0,5,0,5,0,30,1,4,0,5,1,30,0,2,0,2,0,-27,3,0
2,3,5,0,30,1,4,0,5,3,30,0,4,0,4,0,30,0,5,0,5,0,30,1,4,0,5,1,30,0,2,0,2,0,-27,3,0
2,4,5,0,30,1,4,0,5,3,30,0,4,0,4,0,30,0,5,0,5,0,30,1,4,0,5,1,30,0,2,0,2,0,-27,3,0
2,2,6,1,30,6,3,0,9,4,30,2,0,0,2,0,30,2,7,0,9,0,30,4,5,0,9,3,30,5,0,0,5,0,-27,3,0
2,3,6,1,30,6,3,0,9,4,30,2,0,0,2,0,30,2,7,0,9,0,30,4,5,0,9,3,30,5,0,0,5,0,-27,3,0
2,1,11,1,30,6,6,0,12,2,30,4,0,0,4,0,30,4,8,0,12,3,30,7,5,0,12,5,30,4,0,0,4,1,-15,3,1
2,4,15,0,30,4,9,0,13,0,30,6,0,0,6,0,30,5,8,0,13,1,30,4,9,0,13,1,30,7,2,0,9,1,-15,3,1
2,3,17,6,30,9,5,0,14,3,30,6,0,0,6,0,30,7,7,0,14,1,30,6,8,0,14,0,30,4,0,0,4,1,-15,3,1
2,3,21,1,30,6,4,0,10,4,30,6,0,0,6,1,30,3,7,0,10,2,30,5,5,0,10,6,30,4,0,0,4,1,-15,3,1
2,4,21,1,30,6,4,0,10,4,30,6,0,0,6,1,30,3,7,0,10,2,30,5,5,0,10,6,30,4,0,0,4,1,-15,3,1
2,4,22,1,30,6,2,0,8,3,30,2,0,0,2,0,30,4,4,0,8,0,30,6,2,0,8,5,30,4,0,0,4,1,-15,3,1
2,4,23,2,30,5,8,0,13,2,30,6,0,0,6,6,30,12,1,0,13,0,30,5,8,0,13,0,30,6,0,0,6,1,-15,3,1
2,2,25,3,30,14,0,0,14,0,30,6,0,0,6,0,30,7,7,0,14,1,30,5,9,0,14,3,30,5,1,0,6,1,-15,3,1
2,0,27,1,30,7,8,0,15,3,30,2,0,0,2,0,30,4,11,0,15,0,30,5,10,0,15,3,30,6,0,0,6,1,-15,3,1
2,1,27,1,30,7,8,0,15,3,30,2,0,0,2,0,30,4,11,0,15,0,30,5,10,0,15,3,30,6,0,0,6,1,-15,3,1
2,3,31,2,30,8,4,0,12,4,30,8,0,0,8,3,30,9,3,0,12,0,30,4,8,0,12,1,30,5,1,0,6,1,-15,3,1
2,3,17,4,30,11,3,0,14,3,30,6,0,0,6,0,30,4,10,0,14,2,30,7,7,0,14,0,30,2,2,0,4,1,-15,3,1
2,0,19,1,30,4,9,0,13,3,30,8,0,0,8,4,30,4,9,0,13,2,30,3,10,0,13,2,30,7,2,0,9,1,-15,3,1
2,2,19,1,30,4,9,0,13,3,30,8,0,0,8,4,30,4,9,0,13,2,30,3,10,0,13,1,30,7,2,0,9,1,-15,3,1
2,2,23,2,30,5,8,0,13,3,30,6,0,0,6,4,30,13,0,0,13,0,30,6,7,0,13,2,30,5,1,0,6,1,-15,3,1
2,3,23,2,30,5,8,0,13,3,30,6,0,0,6,4,30,13,0,0,13,0,30,6,7,0,13,2,30,5,1,0,6,1,-15,3,1
2,2,25,0,30,5,9,0,14,4,30,6,0,0,6,0,30,5,9,0,14,1,30,7,7,0,14,6,30,6,0,0,6,1,-15,3,1
2,4,25,0,30,5,9,0,14,4,30,6,0,0,6,0,30,5,9,0,14,1,30,7,7,0,14,0,30,6,0,0,6,1,-15,3,1
2,2,29,0,30,5,9,0,14,5,30,12,0,0,12,0,30,7,7,0,14,1,30,2,12,0,14,0,30,7,2,0,9,1,-15,3,1
2,3,29,0,30,5,9,0,14,5,30,12,0,0,12,0,30,7,7,0,14,1,30,2,12,0,14,0,30,7,2,0,9,1,-15,3,1
2,4,32,0,30,6,3,0,9,5,30,2,0,0,2,0,30,7,2,0,9,1,30,3,6,0,9,2,30,2,0,0,2,1,-15,3,1
2,1,5,0,30,0,5,0,5,2,30,2,2,0,4,0,30,2,3,0,5,0,30,1,4,0,5,0,30,0,2,0,2,0,-27,3,0
2,3,6,1,30,8,1,0,9,4,30,2,0,0,2,0,30,3,6,0,9,0,30,4,5,0,9,2,30,5,0,0,5,0,-27,3,0
2,2,11,2,30,4,8,0,12,0,30,4,0,0,4,0,30,8,4,0,12,7,30,5,7,0,12,4,30,4,0,0,4,1,-15,3,1
2,3,15,0,30,4,9,0,13,0,30,6,0,0,6,0,30,4,9,0,13,1,30,6,7,0,13,2,30,6,3,0,9,1,-15,3,1
2,2,17,3,30,10,4,0,14,3,30,6,0,0,6,0,30,5,9,0,14,2,30,6,8,0,14,2,30,4,0,0,4,1,-15,3,1
2,4,19,0,30,4,9,0,13,2,30,6,2,0,8,0,30,5,8,0,13,0,30,4,9,0,13,2,30,8,1,0,9,1,-15,3,1
2,0,27,1,30,6,9,0,15,2,30,2,0,0,2,1,30,7,8,0,15,0,30,7,8,0,15,2,30,6,0,0,6,1,-15,3,1
2,1,27,1,30,6,9,0,15,2,30,2,0,0,2,1,30,7,8,0,15,0,30,7,8,0,15,2,30,6,0,0,6,1,-15,3,1
2,4,27,1,30,6,9,0,15,2,30,2,0,0,2,1,30,7,8,0,15,0,30,7,8,0,15,2,30,6,0,0,6,1,-15,3,1
2,2,31,0,30,5,7,0,12,6,30,8,0,0,8,3,30,7,5,0,12,1,30,9,3,0,12,1,30,6,0,0,6,1,-15,3,1
2,4,31,0,30,5,7,0,12,6,30,8,0,0,8,0,30,7,5,0,12,1,30,9,3,0,12,1,30,6,0,0,6,1,-15,3,1
2,3,2,1,30,7,3,0,10,4,30,4,0,0,4,4,30,2,8,0,10,0,30,6,4,0,10,1,30,4,4,0,8,0,-27,3,0
2,2,19,2,30,3,10,0,13,2,30,6,2,0,8,0,30,6,7,0,13,0,30,4,9,0,13,2,30,8,1,0,9,1,-15,3,1
2,4,23,1,30,7,6,0,13,0,30,6,0,0,6,2,30,13,0,0,13,0,30,6,7,0,13,0,30,6,0,0,6,1,-15,3,1
2,2,25,2,30,4,10,0,14,4,30,6,0,0,6,0,30,6,8,0,14,3,30,4,10,0,14,4,30,6,0,0,6,1,-15,3,1
2,4,25,2,30,4,10,0,14,4,30,6,0,0,6,0,30,6,8,0,14,3,30,4,10,0,14,4,30,6,0,0,6,1,-15,3,1
2,0,27,1,30,4,11,0,15,3,30,2,0,0,2,0,30,3,12,0,15,4,30,4,11,0,15,5,30,6,0,0,6,1,-15,3,1
2,1,27,1,30,4,11,0,15,3,30,2,0,0,2,0,30,3,12,0,15,4,30,4,11,0,15,5,30,6,0,0,6,1,-15,3,1
2,2,27,1,30,4,11,0,15,3,30,2,0,0,2,0,30,3,12,0,15,4,30,4,11,0,15,5,30,6,0,0,6,1,-15,3,1
2,3,27,1,30,4,11,0,15,3,30,2,0,0,2,0,30,3,12,0,15,4,30,4,11,0,15,5,30,6,0,0,6,1,-15,3,1
2,3,29,0,30,5,9,0,14,6,30,11,1,0,12,0,30,4,10,0,14,0,30,3,11,0,14,0,30,9,0,0,9,1,-15,3,1
2,4,29,0,30,5,9,0,14,6,30,11,1,0,12,0,30,4,10,0,14,0,30,3,11,0,14,0,30,9,0,0,9,1,-15,3,1
2,1,4,0,30,7,1,0,8,3,30,4,0,0,4,0,30,1,7,0,8,7,30,1,7,0,8,4,30,4,0,0,4,0,-27,3,0
2,2,4,0,30,7,1,0,8,3,30,4,0,0,4,0,30,1,7,0,8,7,30,1,7,0,8,4,30,4,0,0,4,0,-27,3,0
2,0,5,0,30,0,5,0,5,3,30,1,3,0,4,2,30,1,4,0,5,0,30,4,1,0,5,0,30,2,0,0,2,0,-27,3,0
2,3,5,0,30,0,5,0,5,3,30,1,3,0,4,2,30,1,4,0,5,0,30,4,1,0,5,0,30,2,0,0,2,0,-27,3,0
2,4,5,0,30,0,5,0,5,3,30,1,3,0,4,2,30,1,4,0,5,0,30,4,1,0,5,0,30,2,0,0,2,0,-27,3,0
2,3,11,0,30,1,3,0,4,0,30,0,0,0,0,0,30,3,1,0,4,4,30,2,2,0,4,0,30,1,0,0,1,1,-15,3,1
2,3,13,3,30,7,0,0,7,2,30,4,0,0,4,7,30,6,1,0,7,4,30,6,1,0,7,4,30,4,0,0,4,1,-15,3,1
2,4,13,3,30,7,0,0,7,2,30,4,0,0,4,7,30,6,1,0,7,4,30,6,1,0,7,4,30,4,0,0,4,1,-15,3,1
2,2,17,2,30,10,4,0,14,3,30,6,0,0,6,0,30,5,9,0,14,1,30,5,9,0,14,0,30,4,0,0,4,1,-15,3,1
2,0,19,0,30,3,10,0,13,2,30,7,1,0,8,0,30,7,6,0,13,4,30,7,6,0,13,2,30,8,1,0,9,1,-15,3,1
2,2,19,0,30,3,10,0,13,2,30,7,1,0,8,0,30,7,6,0,13,4,30,7,6,0,13,2,30,8,1,0,9,1,-15,3,1
2,3,19,0,30,3,10,0,13,2,30,7,1,0,8,0,30,7,6,0,13,4,30,7,6,0,13,2,30,8,1,0,9,1,-15,3,1
2,3,22,1,30,7,1,0,8,2,30,2,0,0,2,0,30,6,2,0,8,2,30,2,6,0,8,2,30,4,0,0,4,1,-15,3,1
2,1,25,3,30,5,9,0,14,1,30,6,0,0,6,0,30,11,3,0,14,1,30,7,7,0,14,4,30,5,1,0,6,1,-15,3,1
2,0,27,6,30,10,5,0,15,3,30,1,1,0,2,0,30,7,8,0,15,0,30,3,12,0,15,1,30,3,3,0,6,1,-15,3,1
2,1,27,6,30,10,5,0,15,3,30,1,1,0,2,0,30,7,8,0,15,0,30,3,12,0,15,1,30,3,3,0,6,1,-15,3,1
2,2,27,6,30,10,5,0,15,3,30,1,1,0,2,0,30,7,8,0,15,0,30,3,12,0,15,1,30,3,3,0,6,1,-15,3,1
2,4,27,6,30,10,5,0,15,3,30,1,1,0,2,0,30,7,8,0,15,0,30,3,12,0,15,1,30,3,3,0,6,1,-15,3,1
2,1,31,3,30,4,8,0,12,5,30,8,0,0,8,3,30,9,3,0,12,0,30,7,5,0,12,1,30,6,0,0,6,1,-15,3,1
2,3,31,3,30,4,8,0,12,5,30,8,0,0,8,3,30,9,3,0,12,0,30,7,5,0,12,1,30,6,0,0,6,1,-15,3,1
2,4,31,3,30,4,8,0,12,5,30,8,0,0,8,3,30,9,3,0,12,0,30,7,5,0,12,1,30,6,0,0,6,1,-15,3,1
2,2,35,0,30,7,6,0,13,3,30,2,0,0,2,3,30,7,6,0,13,2,30,3,10,0,13,5,30,8,0,0,8,1,-15,3,1
2,0,38,0,30,6,4,0,10,7,30,6,0,0,6,0,30,1,9,0,10,0,30,2,8,0,10,8,30,6,0,0,6,1,-15,3,1
2,2,38,0,30,6,4,0,10,7,30,6,0,0,6,0,30,1,9,0,10,0,30,2,8,0,10,8,30,6,0,0,6,1,-15,3,1
2,2,11,1,30,3,9,0,12,0,30,4,0,0,4,0,30,7,5,0,12,7,30,5,7,0,12,6,30,4,0,0,4,1,-15,3,1
2,1,13,1,30,5,2,0,7,0,30,4,0,0,4,2,30,6,1,0,7,16,30,7,0,0,7,6,30,4,0,0,4,1,-15,3,1
2,2,13,1,30,5,2,0,7,0,30,4,0,0,4,2,30,6,1,0,7,16,30,7,0,0,7,6,30,4,0,0,4,1,-15,3,1
2,4,13,1,30,5,2,0,7,0,30,4,0,0,4,2,30,6,1,0,7,16,30,7,0,0,7,6,30,4,0,0,4,1,-15,3,1
2,3,19,0,30,3,10,0,13,1,30,8,0,0,8,0,30,10,3,0,13,5,30,4,9,0,13,1,30,8,1,0,9,1,-15,3,1
2,4,19,0,30,3,10,0,13,1,30,8,0,0,8,0,30,10,3,0,13,5,30,4,9,0,13,1,30,8,1,0,9,1,-15,3,1
2,4,23,1,30,6,7,0,13,1,30,6,0,0,6,1,30,13,0,0,13,0,30,6,7,0,13,1,30,6,0,0,6,1,-15,3,1
2,2,29,5,30,4,10,0,14,7,30,8,4,0,12,0,30,4,10,0,14,0,30,10,4,0,14,0,30,7,2,0,9,1,-15,3,1
2,3,32,0,30,5,4,0,9,4,30,2,0,0,2,1,30,7,2,0,9,1,30,2,7,0,9,2,30,2,0,0,2,1,-15,3,1
2,4,8,1,30,7,0,0,7,4,30,2,0,0,2,0,30,4,3,0,7,0,30,5,2,0,7,0,30,3,0,0,3,0,-27,3,0
2,2,13,2,30,7,0,0,7,2,30,4,0,0,4,2,30,6,1,0,7,6,30,6,1,0,7,3,30,4,0,0,4,1,-15,3,1
2,3,15,1,30,4,9,0,13,1,30,6,0,0,6,0,30,3,10,0,13,2,30,7,6,0,13,2,30,8,1,0,9,1,-15,3,1
2,3,17,4,30,10,4,0,14,3,30,6,0,0,6,0,30,6,8,0,14,1,30,6,8,0,14,0,30,4,0,0,4,1,-15,3,1
2,4,17,4,30,10,4,0,14,3,30,6,0,0,6,0,30,6,8,0,14,1,30,6,8,0,14,0,30,4,0,0,4,1,-15,3,1
2,3,23,1,30,5,8,0,13,3,30,6,0,0,6,6,30,13,0,0,13,1,30,5,8,0,13,1,30,5,1,0,6,1,-15,3,1
2,0,27,2,30,3,12,0,15,3,30,2,0,0,2,0,30,10,5,0,15,1,30,4,11,0,15,1,30,4,2,0,6,1,-15,3,1
2,2,27,2,30,3,12,0,15,3,30,2,0,0,2,0,30,10,5,0,15,1,30,4,11,0,15,1,30,4,2,0,6,1,-15,3,1
2,4,27,2,30,3,12,0,15,3,30,2,0,0,2,0,30,10,5,0,15,1,30,4,11,0,15,1,30,4,2,0,6,1,-15,3,1
2,2,35,2,30,11,2,0,13,3,30,2,0,0,2,1,30,9,4,0,13,0,30,1,12,0,13,2,30,8,0,0,8,1,-15,3,1
2,3,35,2,30,11,2,0,13,3,30,2,0,0,2,1,30,9,4,0,13,0,30,1,12,0,13,2,30,8,0,0,8,1,-15,3,1
2,4,1,2,30,7,3,0,10,4,30,2,0,0,2,1,30,4,6,0,10,1,30,5,5,0,10,6,30,6,0,0,6,0,-27,3,0
2,2,13,2,30,7,0,0,7,0,30,4,0,0,4,2,30,6,1,0,7,9,30,7,0,0,7,3,30,4,0,0,4,1,-15,3,1
2,2,25,1,30,8,6,0,14,3,30,6,0,0,6,0,30,12,2,0,14,1,30,5,9,0,14,3,30,5,1,0,6,1,-15,3,1
2,1,27,2,30,4,11,0,15,2,30,1,1,0,2,0,30,6,9,0,15,3,30,5,10,0,15,5,30,6,0,0,6,1,-15,3,1
2,2,27,2,30,4,11,0,15,2,30,1,1,0,2,0,30,6,9,0,15,3,30,5,10,0,15,5,30,6,0,0,6,1,-15,3,1
2,3,27,2,30,4,11,0,15,2,30,1,1,0,2,0,30,6,9,0,15,3,30,5,10,0,15,5,30,6,0,0,6,1,-15,3,1
2,2,29,0,30,3,11,0,14,5,30,10,2,0,12,0,30,3,11,0,14,0,30,2,12,0,14,3,30,9,0,0,9,1,-15,3,1
2,3,29,0,30,3,11,0,14,5,30,10,2,0,12,0,30,3,11,0,14,0,30,2,12,0,14,3,30,9,0,0,9,1,-15,3,1
2,3,1,0,30,7,3,0,10,4,30,2,0,0,2,1,30,4,6,0,10,5,30,8,2,0,10,6,30,6,0,0,6,0,-27,3,0
2,3,4,0,30,8,0,0,8,3,30,4,0,0,4,0,30,4,4,0,8,3,30,2,6,0,8,1,30,4,0,0,4,0,-27,3,0
2,2,5,0,30,0,5,0,5,2,30,3,1,0,4,2,30,1,4,0,5,0,30,1,4,0,5,0,30,0,2,0,2,0,-27,3,0
2,3,7,0,30,4,5,0,9,3,30,4,0,0,4,0,30,4,5,0,9,4,30,2,7,0,9,2,30,4,2,0,6,0,-27,3,0
2,4,8,5,30,7,0,0,7,5,30,2,0,0,2,3,30,4,3,0,7,0,30,4,3,0,7,2,30,3,0,0,3,0,-27,3,0
2,2,13,2,30,3,4,0,7,0,30,4,0,0,4,2,30,5,2,0,7,8,30,7,0,0,7,7,30,4,0,0,4,1,-15,3,1
2,4,15,0,30,3,10,0,13,1,30,5,1,0,6,0,30,5,8,0,13,1,30,8,5,0,13,3,30,9,0,0,9,1,-15,3,1
2,3,19,1,30,5,8,0,13,1,30,8,0,0,8,0,30,7,6,0,13,1,30,4,9,0,13,1,30,7,2,0,9,1,-15,3,1
2,3,23,3,30,7,6,0,13,2,30,6,0,0,6,5,30,13,0,0,13,0,30,5,8,0,13,3,30,6,0,0,6,1,-15,3,1
2,1,25,1,30,4,10,0,14,5,30,6,0,0,6,0,30,4,10,0,14,2,30,8,6,0,14,7,30,6,0,0,6,1,-15,3,1
2,2,25,1,30,4,10,0,14,5,30,6,0,0,6,0,30,4,10,0,14,2,30,8,6,0,14,7,30,6,0,0,6,1,-15,3,1
2,0,27,1,30,5,10,0,15,4,30,1,1,0,2,0,30,3,12,0,15,4,30,4,11,0,15,5,30,6,0,0,6,1,-15,3,1
2,4,27,1,30,5,10,0,15,4,30,1,1,0,2,0,30,3,12,0,15,2,30,4,11,0,15,5,30,6,0,0,6,1,-15,3,1
2,3,31,3,30,8,4,0,12,3,30,8,0,0,8,4,30,12,0,0,12,0,30,3,9,0,12,0,30,2,4,0,6,1,-15,3,1
2,4,31,3,30,8,4,0,12,3,30,8,0,0,8,4,30,12,0,0,12,0,30,3,9,0,12,0,30,2,4,0,6,1,-15,3,1
2,3,39,0,30,5,6,0,11,7,30,6,0,0,6,0,30,5,6,0,11,0,30,6,5,0,11,4,30,5,0,0,5,1,-15,3,1
2,4,39,0,30,5,6,0,11,7,30,6,0,0,6,0,30,5,6,0,11,0,30,6,5,0,11,4,30,5,0,0,5,1,-15,3,1
2,4,7,0,30,2,2,0,4,2,30,2,0,0,2,1,30,3,1,0,4,1,30,4,0,0,4,1,30,1,1,0,2,0,-27,3,0
2,3,8,3,30,7,0,0,7,4,30,2,0,0,2,1,30,3,4,0,7,0,30,4,3,0,7,3,30,3,0,0,3,0,-27,3,0
2,1,13,3,30,5,2,0,7,0,30,4,0,0,4,1,30,5,2,0,7,5,30,7,0,0,7,4,30,4,0,0,4,1,-15,3,1
2,2,13,3,30,5,2,0,7,0,30,4,0,0,4,1,30,5,2,0,7,5,30,7,0,0,7,4,30,4,0,0,4,1,-15,3,1
2,3,13,3,30,5,2,0,7,0,30,4,0,0,4,1,30,5,2,0,7,5,30,7,0,0,7,4,30,4,0,0,4,1,-15,3,1
2,4,17,2,30,7,7,0,14,1,30,6,0,0,6,0,30,7,7,0,14,1,30,5,9,0,14,2,30,4,0,0,4,1,-15,3,1
2,1,19,0,30,4,9,0,13,0,30,8,0,0,8,0,30,6,7,0,13,0,30,4,9,0,13,1,30,7,2,0,9,1,-15,3,1
2,0,21,2,30,6,4,0,10,4,30,6,0,0,6,1,30,3,7,0,10,3,30,6,4,0,10,4,30,4,0,0,4,1,-15,3,1
2,1,21,2,30,6,4,0,10,4,30,6,0,0,6,1,30,3,7,0,10,3,30,6,4,0,10,4,30,4,0,0,4,1,-15,3,1
2,2,21,2,30,6,4,0,10,4,30,6,0,0,6,1,30,3,7,0,10,3,30,6,4,0,10,4,30,4,0,0,4,1,-15,3,1
2,4,23,2,30,5,8,0,13,0,30,6,0,0,6,0,30,12,1,0,13,0,30,5,8,0,13,2,30,6,0,0,6,1,-15,3,1
2,1,27,1,30,5,10,0,15,4,30,2,0,0,2,0,30,9,6,0,15,0,30,5,10,0,15,5,30,6,0,0,6,1,-15,3,1
2,3,27,1,30,5,10,0,15,4,30,2,0,0,2,0,30,9,6,0,15,0,30,5,10,0,15,5,30,6,0,0,6,1,-15,3,1
2,1,29,0,30,5,9,0,14,6,30,11,1,0,12,0,30,1,13,0,14,0,30,2,12,0,14,0,30,9,0,0,9,1,-15,3,1
2,4,29,0,30,5,9,0,14,6,30,11,1,0,12,0,30,1,13,0,14,0,30,2,12,0,14,0,30,9,0,0,9,1,-15,3,1
2,2,6,0,30,7,2,0,9,4,30,2,0,0,2,0,30,2,7,0,9,0,30,4,5,0,9,0,30,5,0,0,5,0,-27,3,0
2,4,13,1,30,5,2,0,7,0,30,4,0,0,4,2,30,6,1,0,7,5,30,5,2,0,7,5,30,4,0,0,4,1,-15,3,1
2,3,15,0,30,5,8,0,13,1,30,6,0,0,6,0,30,3,10,0,13,1,30,7,6,0,13,2,30,8,1,0,9,1,-15,3,1
2,4,15,0,30,5,8,0,13,1,30,6,0,0,6,0,30,3,10,0,13,1,30,7,6,0,13,2,30,8,1,0,9,1,-15,3,1
2,1,17,6,30,11,3,0,14,4,30,6,0,0,6,0,30,3,11,0,14,1,30,6,8,0,14,2,30,4,0,0,4,1,-15,3,1
2,2,17,6,30,11,3,0,14,4,30,6,0,0,6,0,30,3,11,0,14,1,30,6,8,0,14,2,30,4,0,0,4,1,-15,3,1
2,2,19,0,30,6,7,0,13,1,30,3,5,0,8,0,30,4,9,0,13,8,30,6,7,0,13,1,30,8,1,0,9,1,-15,3,1
2,2,23,1,30,6,7,0,13,4,30,6,0,0,6,6,30,9,4,0,13,0,30,5,8,0,13,4,30,6,0,0,6,1,-15,3,1
2,3,23,1,30,6,7,0,13,4,30,6,0,0,6,6,30,9,4,0,13,0,30,5,8,0,13,4,30,6,0,0,6,1,-15,3,1
2,0,25,1,30,3,11,0,14,6,30,6,0,0,6,0,30,6,8,0,14,2,30,10,4,0,14,6,30,6,0,0,6,1,-15,3,1
2,4,25,1,30,3,11,0,14,6,30,6,0,0,6,0,30,6,8,0,14,0,30,10,4,0,14,6,30,6,0,0,6,1,-15,3,1
2,3,27,1,30,5,10,0,15,4,30,2,0,0,2,0,30,3,12,0,15,2,30,4,11,0,15,1,30,5,1,0,6,1,-15,3,1
2,0,38,0,30,1,9,0,10,6,30,6,0,0,6,2,30,3,7,0,10,0,30,4,6,0,10,8,30,6,0,0,6,1,-15,3,1
2,2,38,0,30,1,9,0,10,6,30,6,0,0,6,0,30,3,7,0,10,0,30,4,6,0,10,8,30,6,0,0,6,1,-15,3,1
2,1,5,0,30,0,5,0,5,2,30,2,2,0,4,0,30,1,4,0,5,0,30,1,4,0,5,2,30,2,0,0,2,0,-27,3,0
2,3,8,4,30,7,0,0,7,4,30,2,0,0,2,3,30,5,2,0,7,0,30,6,1,0,7,1,30,3,0,0,3,0,-27,3,0
2,2,9,1,30,8,3,0,11,4,30,6,0,0,6,4,30,4,7,0,11,2,30,3,8,0,11,4,30,4,0,0,4,0,-27,3,0
2,4,9,1,30,8,3,0,11,4,30,6,0,0,6,0,30,4,7,0,11,2,30,3,8,0,11,4,30,4,0,0,4,0,-27,3,0
2,1,13,5,30,7,0,0,7,2,30,4,0,0,4,2,30,6,1,0,7,1,30,6,1,0,7,4,30,4,0,0,4,1,-15,3,1
2,3,17,3,30,9,5,0,14,2,30,6,0,0,6,0,30,7,7,0,14,1,30,6,8,0,14,3,30,4,0,0,4,1,-15,3,1
2,3,19,0,30,4,9,0,13,2,30,4,4,0,8,0,30,7,6,0,13,0,30,5,8,0,13,2,30,8,1,0,9,1,-15,3,1
2,4,21,1,30,7,3,0,10,3,30,4,2,0,6,0,30,3,7,0,10,0,30,4,6,0,10,2,30,4,0,0,4,1,-15,3,1
2,0,26,0,30,6,3,0,9,5,30,4,0,0,4,2,30,0,9,0,9,0,30,2,7,0,9,4,30,2,1,0,3,1,-15,3,1
2,1,26,0,30,6,3,0,9,5,30,4,0,0,4,2,30,0,9,0,9,0,30,2,7,0,9,4,30,2,1,0,3,1,-15,3,1
2,4,27,1,30,8,7,0,15,4,30,2,0,0,2,2,30,4,11,0,15,0,30,4,11,0,15,1,30,4,2,0,6,1,-15,3,1
2,0,29,0,30,7,7,0,14,6,30,11,1,0,12,0,30,5,9,0,14,0,30,1,13,0,14,2,30,9,0,0,9,1,-15,3,1
2,2,29,0,30,7,7,0,14,6,30,11,1,0,12,0,30,5,9,0,14,0,30,1,13,0,14,2,30,9,0,0,9,1,-15,3,1
2,3,29,0,30,7,7,0,14,6,30,11,1,0,12,0,30,5,9,0,14,0,30,1,13,0,14,2,30,9,0,0,9,1,-15,3,1
2,4,29,0,30,7,7,0,14,6,30,11,1,0,12,0,30,5,9,0,14,0,30,1,13,0,14,2,30,9,0,0,9,1,-15,3,1
2,3,7,0,30,0,4,0,4,2,30,2,0,0,2,0,30,1,3,0,4,5,30,3,1,0,4,2,30,1,1,0,2,0,-27,3,0
2,2,9,0,30,3,1,0,4,2,30,2,0,0,2,0,30,0,4,0,4,0,30,1,3,0,4,0,30,1,0,0,1,0,-27,3,0
2,0,17,4,30,8,6,0,14,4,30,6,0,0,6,0,30,5,9,0,14,5,30,5,9,0,14,4,30,4,0,0,4,1,-15,3,1
2,1,19,0,30,6,7,0,13,2,30,3,5,0,8,0,30,4,9,0,13,4,30,4,9,0,13,2,30,8,1,0,9,1,-15,3,1
2,4,19,0,30,6,7,0,13,0,30,3,5,0,8,0,30,4,9,0,13,4,30,4,9,0,13,2,30,8,1,0,9,1,-15,3,1
2,4,32,0,30,4,5,0,9,4,30,2,0,0,2,0,30,8,1,0,9,1,30,3,6,0,9,4,30,2,0,0,2,1,-15,3,1
2,4,39,0,30,4,7,0,11,7,30,6,0,0,6,0,30,7,4,0,11,3,30,6,5,0,11,1,30,5,0,0,5,1,-15,3,1
2,3,47,0,30,0,14,0,14,6,30,4,0,0,4,1,30,14,0,0,14,0,30,2,12,0,14,1,30,7,0,0,7,1,-15,3,1
2,0,4,2,30,7,1,0,8,5,30,4,0,0,4,1,30,1,7,0,8,0,30,6,2,0,8,2,30,4,0,0,4,0,-27,3,0
2,1,4,2,30,7,1,0,8,5,30,4,0,0,4,1,30,1,7,0,8,0,30,6,2,0,8,2,30,4,0,0,4,0,-27,3,0
2,4,4,2,30,7,1,0,8,5,30,4,0,0,4,1,30,1,7,0,8,0,30,6,2,0,8,2,30,4,0,0,4,0,-27,3,0
2,2,13,4,30,7,0,0,7,0,30,4,0,0,4,2,30,6,1,0,7,4,30,5,2,0,7,4,30,4,0,0,4,1,-15,3,1
2,2,17,4,30,7,7,0,14,3,30,6,0,0,6,0,30,4,10,0,14,2,30,6,8,0,14,5,30,4,0,0,4,1,-15,3,1
2,3,27,1,30,6,9,0,15,0,30,2,0,0,2,0,30,4,11,0,15,2,30,4,11,0,15,3,30,6,0,0,6,1,-15,3,1
2,2,38,3,30,3,7,0,10,7,30,6,0,0,6,0,30,1,9,0,10,0,30,2,8,0,10,8,30,6,0,0,6,1,-15,3,1
2,3,39,0,30,0,11,0,11,7,30,6,0,0,6,0,30,4,7,0,11,4,30,4,7,0,11,4,30,5,0,0,5,1,-15,3,1
2,4,39,0,30,0,11,0,11,7,30,6,0,0,6,0,30,4,7,0,11,4,30,4,7,0,11,4,30,5,0,0,5,1,-15,3,1
2,3,6,1,30,9,0,0,9,3,30,2,0,0,2,0,30,5,4,0,9,0,30,3,6,0,9,0,30,5,0,0,5,0,-27,3,0
2,4,8,2,30,7,0,0,7,4,30,2,0,0,2,3,30,3,4,0,7,0,30,5,2,0,7,4,30,3,0,0,3,0,-27,3,0
2,2,9,0,30,2,2,0,4,2,30,2,0,0,2,1,30,4,0,0,4,2,30,4,0,0,4,3,30,1,0,0,1,0,-27,3,0
2,4,9,0,30,2,2,0,4,2,30,2,0,0,2,1,30,4,0,0,4,2,30,4,0,0,4,3,30,1,0,0,1,0,-27,3,0
2,4,11,0,30,5,7,0,12,0,30,4,0,0,4,0,30,9,3,0,12,3,30,4,8,0,12,0,30,4,0,0,4,1,-15,3,1
2,1,13,2,30,7,0,0,7,0,30,4,0,0,4,2,30,6,1,0,7,6,30,5,2,0,7,2,30,4,0,0,4,1,-15,3,1
2,2,13,2,30,7,0,0,7,0,30,4,0,0,4,2,30,6,1,0,7,6,30,5,2,0,7,2,30,4,0,0,4,1,-15,3,1
2,3,13,2,30,7,0,0,7,0,30,4,0,0,4,2,30,6,1,0,7,6,30,5,2,0,7,2,30,4,0,0,4,1,-15,3,1
2,4,13,2,30,7,0,0,7,0,30,4,0,0,4,2,30,6,1,0,7,6,30,5,2,0,7,2,30,4,0,0,4,1,-15,3,1
2,1,17,5,30,12,2,0,14,4,30,6,0,0,6,0,30,3,11,0,14,1,30,5,9,0,14,1,30,4,0,0,4,1,-15,3,1
2,3,19,0,30,3,10,0,13,1,30,7,1,0,8,0,30,11,2,0,13,4,30,4,9,0,13,2,30,8,1,0,9,1,-15,3,1
2,4,19,0,30,3,10,0,13,1,30,7,1,0,8,0,30,11,2,0,13,4,30,4,9,0,13,2,30,8,1,0,9,1,-15,3,1
2,2,31,5,30,8,4,0,12,5,30,8,0,0,8,3,30,8,4,0,12,0,30,3,9,0,12,1,30,6,0,0,6,1,-15,3,1
2,3,31,5,30,8,4,0,12,5,30,8,0,0,8,3,30,8,4,0,12,0,30,3,9,0,12,1,30,6,0,0,6,1,-15,3,1
2,3,38,0,30,2,8,0,10,7,30,4,2,0,6,0,30,1,9,0,10,0,30,4,6,0,10,8,30,6,0,0,6,1,-15,3,1
2,0,4,3,30,7,1,0,8,4,30,4,0,0,4,1,30,1,7,0,8,0,30,3,5,0,8,3,30,4,0,0,4,0,-27,3,0
2,3,4,3,30,7,1,0,8,4,30,4,0,0,4,1,30,1,7,0,8,0,30,3,5,0,8,3,30,4,0,0,4,0,-27,3,0
2,4,13,0,30,4,3,0,7,0,30,4,0,0,4,2,30,5,2,0,7,6,30,5,2,0,7,3,30,4,0,0,4,1,-15,3,1
2,4,25,1,30,4,10,0,14,2,30,6,0,0,6,0,30,8,6,0,14,3,30,4,10,0,14,4,30,5,1,0,6,1,-15,3,1
2,2,27,0,30,4,11,0,15,4,30,1,1,0,2,0,30,6,9,0,15,2,30,6,9,0,15,4,30,6,0,0,6,1,-15,3,1
2,2,29,7,30,5,9,0,14,5,30,12,0,0,12,0,30,4,10,0,14,0,30,2,12,0,14,0,30,7,2,0,9,1,-15,3,1
2,4,29,7,30,5,9,0,14,5,30,12,0,0,12,0,30,4,10,0,14,0,30,2,12,0,14,0,30,7,2,0,9,1,-15,3,1
2,4,30,7,30,5,0,0,5,6,30,2,0,0,2,1,30,2,3,0,5,3,30,1,4,0,5,0,30,2,1,0,3,1,-15,3,1
2,2,39,0,30,3,8,0,11,6,30,6,0,0,6,2,30,8,3,0,11,0,30,2,9,0,11,4,30,5,0,0,5,1,-15,3,1
2,3,39,0,30,3,8,0,11,6,30,6,0,0,6,2,30,8,3,0,11,0,30,2,9,0,11,4,30,5,0,0,5,1,-15,3,1
2,4,39,0,30,3,8,0,11,6,30,6,0,0,6,2,30,8,3,0,11,0,30,2,9,0,11,4,30,5,0,0,5,1,-15,3,1
2,3,3,3,30,2,2,0,4,3,30,4,0,0,4,0,30,0,4,0,4,1,30,2,2,0,4,0,30,1,2,0,3,0,-27,3,0
2,2,4,2,30,8,0,0,8,4,30,4,0,0,4,4,30,1,7,0,8,0,30,4,4,0,8,2,30,2,2,0,4,0,-27,3,0
2,4,4,2,30,8,0,0,8,4,30,4,0,0,4,4,30,1,7,0,8,0,30,4,4,0,8,2,30,2,2,0,4,0,-27,3,0
2,2,17,1,30,7,7,0,14,3,30,6,0,0,6,0,30,7,7,0,14,6,30,5,9,0,14,0,30,4,0,0,4,1,-15,3,1
2,3,17,1,30,7,7,0,14,3,30,6,0,0,6,0,30,7,7,0,14,6,30,5,9,0,14,0,30,4,0,0,4,1,-15,3,1
2,1,27,1,30,5,10,0,15,2,30,1,1,0,2,0,30,4,11,0,15,2,30,3,12,0,15,3,30,6,0,0,6,1,-15,3,1
2,3,27,1,30,5,10,0,15,2,30,1,1,0,2,0,30,4,11,0,15,2,30,3,12,0,15,3,30,6,0,0,6,1,-15,3,1
2,4,27,1,30,5,10,0,15,2,30,1,1,0,2,0,30,4,11,0,15,2,30,3,12,0,15,3,30,6,0,0,6,1,-15,3,1
2,2,1,0,30,8,2,0,10,5,30,2,0,0,2,1,30,3,7,0,10,4,30,10,0,0,10,5,30,6,0,0,6,0,-27,3,0
2,3,1,0,30,8,2,0,10,5,30,2,0,0,2,1,30,3,7,0,10,4,30,10,0,0,10,5,30,6,0,0,6,0,-27,3,0
2,2,4,2,30,6,2,0,8,5,30,4,0,0,4,0,30,1,7,0,8,0,30,4,4,0,8,2,30,3,1,0,4,0,-27,3,0
2,3,4,2,30,6,2,0,8,5,30,4,0,0,4,0,30,1,7,0,8,0,30,4,4,0,8,2,30,3,1,0,4,0,-27,3,0
2,4,8,4,30,7,0,0,7,5,30,2,0,0,2,0,30,3,4,0,7,0,30,5,2,0,7,1,30,3,0,0,3,0,-27,3,0
2,4,13,2,30,6,1,0,7,0,30,4,0,0,4,2,30,6,1,0,7,14,30,6,1,0,7,0,30,4,0,0,4,1,-15,3,1
2,0,17,4,30,11,3,0,14,4,30,6,0,0,6,0,30,4,10,0,14,8,30,6,8,0,14,0,30,4,0,0,4,1,-15,3,1
2,1,17,4,30,11,3,0,14,4,30,6,0,0,6,0,30,4,10,0,14,8,30,6,8,0,14,0,30,4,0,0,4,1,-15,3,1
2,4,17,4,30,11,3,0,14,4,30,6,0,0,6,0,30,4,10,0,14,8,30,6,8,0,14,0,30,4,0,0,4,1,-15,3,1
2,3,19,0,30,5,8,0,13,1,30,5,3,0,8,0,30,7,6,0,13,1,30,4,9,0,13,0,30,7,2,0,9,1,-15,3,1
2,2,21,2,30,8,2,0,10,4,30,6,0,0,6,1,30,3,7,0,10,4,30,5,5,0,10,1,30,4,0,0,4,1,-15,3,1
2,1,26,0,30,7,2,0,9,5,30,4,0,0,4,5,30,4,5,0,9,0,30,1,8,0,9,4,30,3,0,0,3,1,-15,3,1
2,4,27,0,30,9,6,0,15,1,30,2,0,0,2,0,30,8,7,0,15,0,30,4,11,0,15,1,30,2,4,0,6,1,-15,3,1
2,2,33,1,30,5,6,0,11,3,30,4,0,0,4,0,30,10,1,0,11,5,30,4,7,0,11,7,30,4,0,0,4,1,-15,3,1
2,0,35,0,30,7,6,0,13,4,30,0,2,0,2,1,30,6,7,0,13,2,30,2,11,0,13,4,30,8,0,0,8,1,-15,3,1
2,1,39,4,30,7,4,0,11,6,30,6,0,0,6,0,30,8,3,0,11,0,30,1,10,0,11,3,30,4,1,0,5,1,-15,3,1
2,2,39,4,30,7,4,0,11,6,30,6,0,0,6,0,30,8,3,0,11,0,30,1,10,0,11,3,30,4,1,0,5,1,-15,3,1
2,4,39,4,30,7,4,0,11,6,30,6,0,0,6,0,30,8,3,0,11,0,30,1,10,0,11,3,30,4,1,0,5,1,-15,3,1
2,3,41,0,30,7,5,0,12,8,30,8,0,0,8,0,30,3,9,0,12,0,30,3,9,0,12,4,30,7,0,0,7,1,-15,3,1
2,4,5,0,30,1,4,0,5,3,30,4,0,0,4,1,30,0,5,0,5,0,30,2,3,0,5,1,30,2,0,0,2,0,-27,3,0
2,3,17,3,30,9,5,0,14,2,30,6,0,0,6,0,30,8,6,0,14,4,30,6,8,0,14,3,30,4,0,0,4,1,-15,3,1
2,1,19,0,30,5,8,0,13,2,30,5,3,0,8,4,30,4,9,0,13,0,30,4,9,0,13,0,30,8,1,0,9,1,-15,3,1
2,3,19,0,30,5,8,0,13,2,30,5,3,0,8,4,30,4,9,0,13,0,30,4,9,0,13,0,30,8,1,0,9,1,-15,3,1
2,4,19,0,30,5,8,0,13,2,30,5,3,0,8,4,30,4,9,0,13,0,30,4,9,0,13,0,30,8,1,0,9,1,-15,3,1
2,1,25,1,30,5,9,0,14,4,30,6,0,0,6,1,30,10,4,0,14,0,30,9,5,0,14,4,30,5,1,0,6,1,-15,3,1
2,1,27,1,30,3,12,0,15,3,30,2,0,0,2,0,30,2,13,0,15,2,30,5,10,0,15,7,30,6,0,0,6,1,-15,3,1
2,1,29,0,30,4,10,0,14,6,30,12,0,0,12,0,30,3,11,0,14,0,30,2,12,0,14,2,30,9,0,0,9,1,-15,3,1
2,2,29,0,30,4,10,0,14,6,30,12,0,0,12,0,30,3,11,0,14,0,30,2,12,0,14,2,30,9,0,0,9,1,-15,3,1
2,2,13,2,30,6,1,0,7,0,30,4,0,0,4,2,30,6,1,0,7,8,30,7,0,0,7,2,30,4,0,0,4,1,-15,3,1
2,2,17,3,30,9,5,0,14,3,30,6,0,0,6,0,30,6,8,0,14,2,30,7,7,0,14,3,30,4,0,0,4,1,-15,3,1
2,3,17,3,30,9,5,0,14,3,30,6,0,0,6,0,30,6,8,0,14,2,30,7,7,0,14,3,30,4,0,0,4,1,-15,3,1
2,4,19,0,30,4,9,0,13,1,30,8,0,0,8,0,30,9,4,0,13,1,30,4,9,0,13,1,30,7,2,0,9,1,-15,3,1
2,4,23,2,30,9,4,0,13,1,30,6,0,0,6,6,30,12,1,0,13,0,30,6,7,0,13,2,30,5,1,0,6,1,-15,3,1
2,2,25,0,30,6,8,0,14,1,30,6,0,0,6,0,30,9,5,0,14,1,30,5,9,0,14,4,30,5,1,0,6,1,-15,3,1
2,3,25,0,30,6,8,0,14,1,30,6,0,0,6,0,30,9,5,0,14,1,30,5,9,0,14,4,30,5,1,0,6,1,-15,3,1
2,0,27,1,30,7,8,0,15,3,30,1,1,0,2,3,30,9,6,0,15,0,30,6,9,0,15,5,30,3,3,0,6,1,-15,3,1
2,1,27,1,30,7,8,0,15,3,30,1,1,0,2,3,30,9,6,0,15,0,30,6,9,0,15,5,30,3,3,0,6,1,-15,3,1
2,2,27,1,30,7,8,0,15,3,30,1,1,0,2,3,30,9,6,0,15,0,30,6,9,0,15,5,30,3,3,0,6,1,-15,3,1
2,0,31,1,30,2,10,0,12,8,30,8,0,0,8,3,30,4,8,0,12,3,30,8,4,0,12,7,30,6,0,0,6,1,-15,3,1
2,2,31,1,30,2,10,0,12,8,30,8,0,0,8,3,30,4,8,0,12,3,30,8,4,0,12,7,30,6,0,0,6,1,-15,3,1
2,3,35,1,30,8,5,0,13,3,30,2,0,0,2,1,30,11,2,0,13,0,30,1,12,0,13,0,30,7,1,0,8,1,-15,3,1
2,3,39,0,30,6,5,0,11,6,30,6,0,0,6,0,30,8,3,0,11,0,30,2,9,0,11,3,30,5,0,0,5,1,-15,3,1
2,4,5,0,30,2,3,0,5,3,30,1,3,0,4,0,30,0,5,0,5,0,30,1,4,0,5,2,30,2,0,0,2,0,-27,3,0
2,4,13,0,30,6,1,0,7,0,30,4,0,0,4,2,30,5,2,0,7,11,30,7,0,0,7,0,30,4,0,0,4,1,-15,3,1
2,4,15,0,30,4,9,0,13,0,30,5,1,0,6,0,30,10,3,0,13,1,30,5,8,0,13,4,30,5,4,0,9,1,-15,3,1
2,2,19,0,30,3,10,0,13,2,30,3,5,0,8,0,30,7,6,0,13,2,30,5,8,0,13,0,30,9,0,0,9,1,-15,3,1
2,3,23,1,30,7,6,0,13,0,30,6,0,0,6,4,30,12,1,0,13,0,30,6,7,0,13,3,30,6,0,0,6,1,-15,3,1
2,2,25,1,30,5,9,0,14,5,30,6,0,0,6,0,30,5,9,0,14,1,30,9,5,0,14,5,30,6,0,0,6,1,-15,3,1
2,4,35,0,30,7,6,0,13,2,30,2,0,0,2,1,30,13,0,0,13,2,30,1,12,0,13,4,30,8,0,0,8,1,-15,3,1
2,2,11,3,30,6,6,0,12,0,30,4,0,0,4,0,30,9,3,0,12,6,30,3,9,0,12,5,30,4,0,0,4,1,-15,3,1
2,3,11,3,30,6,6,0,12,0,30,4,0,0,4,0,30,9,3,0,12,6,30,3,9,0,12,5,30,4,0,0,4,1,-15,3,1
2,2,13,6,30,7,0,0,7,1,30,4,0,0,4,2,30,6,1,0,7,5,30,1,6,0,7,6,30,4,0,0,4,1,-15,3,1
2,0,27,1,30,5,10,0,15,3,30,2,0,0,2,0,30,11,4,0,15,1,30,6,9,0,15,5,30,6,0,0,6,1,-15,3,1
2,3,27,1,30,5,10,0,15,3,30,2,0,0,2,0,30,11,4,0,15,1,30,6,9,0,15,5,30,6,0,0,6,1,-15,3,1
2,0,31,2,30,9,3,0,12,7,30,8,0,0,8,3,30,4,8,0,12,0,30,7,5,0,12,5,30,6,0,0,6,1,-15,3,1
2,2,31,2,30,9,3,0,12,7,30,8,0,0,8,3,30,4,8,0,12,0,30,7,5,0,12,5,30,6,0,0,6,1,-15,3,1
2,2,38,0,30,2,8,0,10,6,30,6,0,0,6,0,30,5,5,0,10,0,30,4,6,0,10,7,30,6,0,0,6,1,-15,3,1
2,4,8,0,30,6,1,0,7,3,30,2,0,0,2,0,30,3,4,0,7,0,30,4,3,0,7,0,30,3,0,0,3,0,-27,3,0
2,1,13,3,30,5,2,0,7,0,30,4,0,0,4,3,30,7,0,0,7,8,30,7,0,0,7,8,30,4,0,0,4,1,-15,3,1
2,2,13,3,30,5,2,0,7,0,30,4,0,0,4,3,30,7,0,0,7,8,30,7,0,0,7,8,30,4,0,0,4,1,-15,3,1
2,4,17,3,30,9,5,0,14,2,30,6,0,0,6,0,30,6,8,0,14,1,30,4,10,0,14,5,30,3,1,0,4,1,-15,3,1
2,4,23,1,30,8,5,0,13,1,30,6,0,0,6,3,30,13,0,0,13,0,30,6,7,0,13,2,30,6,0,0,6,1,-15,3,1
2,2,27,1,30,5,10,0,15,5,30,2,0,0,2,2,30,4,11,0,15,0,30,5,10,0,15,0,30,4,2,0,6,1,-15,3,1
2,3,27,1,30,5,10,0,15,5,30,2,0,0,2,2,30,4,11,0,15,0,30,5,10,0,15,0,30,4,2,0,6,1,-15,3,1
2,2,29,0,30,7,7,0,14,5,30,10,2,0,12,0,30,6,8,0,14,0,30,1,13,0,14,4,30,9,0,0,9,1,-15,3,1
2,4,3,0,30,0,4,0,4,2,30,4,0,0,4,0,30,0,4,0,4,1,30,2,2,0,4,1,30,2,1,0,3,0,-27,3,0
2,1,4,2,30,8,0,0,8,5,30,4,0,0,4,0,30,1,7,0,8,0,30,6,2,0,8,0,30,3,1,0,4,0,-27,3,0
2,2,4,2,30,8,0,0,8,5,30,4,0,0,4,0,30,1,7,0,8,0,30,6,2,0,8,0,30,3,1,0,4,0,-27,3,0
2,3,4,2,30,8,0,0,8,5,30,4,0,0,4,0,30,1,7,0,8,0,30,6,2,0,8,0,30,3,1,0,4,0,-27,3,0
2,4,4,2,30,8,0,0,8,5,30,4,0,0,4,0,30,1,7,0,8,0,30,6,2,0,8,0,30,3,1,0,4,0,-27,3,0
2,1,9,0,30,2,2,0,4,2,30,2,0,0,2,0,30,2,2,0,4,0,30,1,3,0,4,1,30,1,0,0,1,0,-27,3,0
2,4,23,2,30,7,6,0,13,2,30,6,0,0,6,6,30,10,3,0,13,0,30,6,7,0,13,3,30,6,0,0,6,1,-15,3,1
2,2,29,0,30,8,6,0,14,6,30,10,2,0,12,0,30,2,12,0,14,0,30,1,13,0,14,3,30,9,0,0,9,1,-15,3,1
2,1,31,5,30,4,8,0,12,5,30,8,0,0,8,3,30,10,2,0,12,0,30,7,5,0,12,0,30,5,1,0,6,1,-15,3,1
2,4,5,0,30,1,4,0,5,2,30,2,2,0,4,0,30,3,2,0,5,0,30,1,4,0,5,1,30,0,2,0,2,0,-27,3,0
2,4,6,0,30,7,2,0,9,4,30,2,0,0,2,0,30,3,6,0,9,0,30,4,5,0,9,5,30,5,0,0,5,0,-27,3,0
2,2,13,2,30,6,1,0,7,0,30,4,0,0,4,2,30,5,2,0,7,7,30,5,2,0,7,4,30,4,0,0,4,1,-15,3,1
2,4,13,2,30,6,1,0,7,0,30,4,0,0,4,2,30,5,2,0,7,7,30,5,2,0,7,4,30,4,0,0,4,1,-15,3,1
2,0,17,4,30,9,5,0,14,3,30,6,0,0,6,0,30,5,9,0,14,3,30,8,6,0,14,5,30,4,0,0,4,1,-15,3,1
2,1,17,4,30,9,5,0,14,3,30,6,0,0,6,0,30,5,9,0,14,3,30,8,6,0,14,5,30,4,0,0,4,1,-15,3,1
2,2,17,4,30,9,5,0,14,3,30,6,0,0,6,0,30,5,9,0,14,3,30,8,6,0,14,5,30,4,0,0,4,1,-15,3,1
2,3,17,4,30,9,5,0,14,3,30,6,0,0,6,0,30,5,9,0,14,3,30,8,6,0,14,5,30,4,0,0,4,1,-15,3,1
2,4,17,4,30,9,5,0,14,3,30,6,0,0,6,0,30,5,9,0,14,3,30,8,6,0,14,5,30,4,0,0,4,1,-15,3,1
2,4,19,0,30,4,9,0,13,2,30,8,0,0,8,0,30,4,9,0,13,0,30,4,9,0,13,1,30,8,1,0,9,1,-15,3,1
2,0,27,1,30,4,11,0,15,4,30,1,1,0,2,0,30,6,9,0,15,2,30,8,7,0,15,5,30,6,0,0,6,1,-15,3,1
2,1,27,1,30,4,11,0,15,4,30,1,1,0,2,0,30,6,9,0,15,2,30,8,7,0,15,5,30,6,0,0,6,1,-15,3,1
2,1,33,2,30,4,7,0,11,6,30,4,0,0,4,5,30,7,4,0,11,0,30,3,8,0,11,4,30,4,0,0,4,1,-15,3,1
2,3,33,2,30,4,7,0,11,6,30,4,0,0,4,5,30,7,4,0,11,0,30,3,8,0,11,4,30,4,0,0,4,1,-15,3,1
2,0,38,0,30,3,7,0,10,7,30,6,0,0,6,0,30,1,9,0,10,0,30,4,6,0,10,8,30,6,0,0,6,1,-15,3,1
2,2,38,0,30,3,7,0,10,7,30,6,0,0,6,0,30,1,9,0,10,0,30,4,6,0,10,8,30,6,0,0,6,1,-15,3,1
2,3,38,0,30,3,7,0,10,7,30,6,0,0,6,0,30,1,9,0,10,0,30,4,6,0,10,8,30,6,0,0,6,1,-15,3,1
2,4,11,0,30,5,7,0,12,1,30,4,0,0,4,0,30,6,6,0,12,0,30,7,5,0,12,4,30,4,0,0,4,1,-15,3,1
2,1,27,1,30,7,8,0,15,3,30,2,0,0,2,0,30,3,12,0,15,2,30,5,10,0,15,3,30,6,0,0,6,1,-15,3,1
2,2,27,1,30,7,8,0,15,3,30,2,0,0,2,0,30,3,12,0,15,2,30,5,10,0,15,3,30,6,0,0,6,1,-15,3,1
2,4,27,1,30,7,8,0,15,3,30,2,0,0,2,0,30,3,12,0,15,2,30,5,10,0,15,3,30,6,0,0,6,1,-15,3,1
2,2,29,0,30,4,10,0,14,5,30,7,5,0,12,0,30,3,11,0,14,1,30,8,6,0,14,0,30,8,1,0,9,1,-15,3,1
2,3,29,0,30,4,10,0,14,5,30,7,5,0,12,0,30,3,11,0,14,1,30,8,6,0,14,0,30,8,1,0,9,1,-15,3,1
2,2,33,1,30,4,7,0,11,5,30,4,0,0,4,1,30,9,2,0,11,2,30,3,8,0,11,6,30,4,0,0,4,1,-15,3,1
2,4,35,0,30,9,4,0,13,4,30,2,0,0,2,0,30,6,7,0,13,0,30,1,12,0,13,2,30,8,0,0,8,1,-15,3,1
2,2,17,4,30,9,5,0,14,2,30,6,0,0,6,0,30,6,8,0,14,3,30,5,9,0,14,0,30,4,0,0,4,1,-15,3,1
2,1,19,0,30,3,10,0,13,1,30,5,3,0,8,0,30,6,7,0,13,0,30,5,8,0,13,2,30,8,1,0,9,1,-15,3,1
2,4,19,0,30,3,10,0,13,1,30,5,3,0,8,0,30,6,7,0,13,0,30,5,8,0,13,2,30,8,1,0,9,1,-15,3,1
2,1,29,0,30,5,9,0,14,5,30,12,0,0,12,0,30,8,6,0,14,0,30,1,13,0,14,0,30,9,0,0,9,1,-15,3,1
2,3,35,0,30,7,6,0,13,3,30,2,0,0,2,2,30,13,0,0,13,3,30,2,11,0,13,5,30,8,0,0,8,1,-15,3,1
2,4,35,0,30,7,6,0,13,3,30,2,0,0,2,2,30,13,0,0,13,3,30,2,11,0,13,5,30,8,0,0,8,1,-15,3,1
2,3,25,1,30,5,9,0,14,2,30,6,0,0,6,0,30,13,1,0,14,1,30,5,9,0,14,4,30,6,0,0,6,1,-15,3,1
2,4,39,0,30,4,7,0,11,7,30,6,0,0,6,0,30,4,7,0,11,1,30,3,8,0,11,5,30,5,0,0,5,1,-15,3,1
2,0,5,4,30,1,4,0,5,3,30,0,4,0,4,0,30,1,4,0,5,0,30,1,4,0,5,1,30,2,0,0,2,0,-27,3,0
2,2,5,4,30,1,4,0,5,3,30,0,4,0,4,0,30,1,4,0,5,0,30,1,4,0,5,1,30,2,0,0,2,0,-27,3,0
2,3,5,4,30,1,4,0,5,3,30,0,4,0,4,0,30,1,4,0,5,0,30,1,4,0,5,1,30,2,0,0,2,0,-27,3,0
2,4,6,3,30,9,0,0,9,4,30,2,0,0,2,0,30,2,7,0,9,0,30,4,5,0,9,0,30,3,2,0,5,0,-27,3,0
2,1,13,3,30,7,0,0,7,0,30,4,0,0,4,2,30,6,1,0,7,9,30,6,1,0,7,5,30,4,0,0,4,1,-15,3,1
2,4,13,3,30,7,0,0,7,0,30,4,0,0,4,2,30,6,1,0,7,9,30,6,1,0,7,5,30,4,0,0,4,1,-15,3,1
2,3,19,0,30,2,11,0,13,1,30,7,1,0,8,1,30,13,0,0,13,0,30,4,9,0,13,1,30,8,1,0,9,1,-15,3,1
2,4,25,0,30,6,8,0,14,2,30,6,0,0,6,0,30,9,5,0,14,1,30,4,10,0,14,4,30,5,1,0,6,1,-15,3,1
2,0,27,1,30,4,11,0,15,5,30,1,1,0,2,0,30,2,13,0,15,4,30,4,11,0,15,4,30,6,0,0,6,1,-15,3,1
2,2,27,1,30,4,11,0,15,5,30,1,1,0,2,0,30,2,13,0,15,4,30,4,11,0,15,0,30,6,0,0,6,1,-15,3,1
2,3,27,1,30,4,11,0,15,5,30,1,1,0,2,0,30,2,13,0,15,4,30,4,11,0,15,0,30,6,0,0,6,1,-15,3,1
2,4,27,1,30,4,11,0,15,5,30,1,1,0,2,0,30,2,13,0,15,4,30,4,11,0,15,0,30,6,0,0,6,1,-15,3,1
2,4,13,3,30,5,2,0,7,1,30,4,0,0,4,2,30,6,1,0,7,9,30,6,1,0,7,0,30,4,0,0,4,1,-15,3,1
2,4,15,0,30,4,9,0,13,1,30,6,0,0,6,0,30,3,10,0,13,1,30,5,8,0,13,2,30,5,4,0,9,1,-15,3,1
2,1,19,0,30,3,10,0,13,3,30,7,1,0,8,0,30,4,9,0,13,9,30,3,10,0,13,2,30,9,0,0,9,1,-15,3,1
2,2,19,0,30,3,10,0,13,3,30,7,1,0,8,0,30,4,9,0,13,9,30,3,10,0,13,2,30,9,0,0,9,1,-15,3,1
2,2,23,3,30,7,6,0,13,2,30,6,0,0,6,4,30,13,0,0,13,0,30,6,7,0,13,3,30,5,1,0,6,1,-15,3,1
2,4,23,3,30,7,6,0,13,2,30,6,0,0,6,4,30,13,0,0,13,0,30,6,7,0,13,3,30,5,1,0,6,1,-15,3,1
2,3,25,0,30,5,9,0,14,5,30,6,0,0,6,1,30,5,9,0,14,0,30,7,7,0,14,5,30,5,1,0,6,1,-15,3,1
2,4,25,0,30,5,9,0,14,5,30,6,0,0,6,1,30,5,9,0,14,0,30,7,7,0,14,5,30,5,1,0,6,1,-15,3,1
2,0,27,1,30,5,10,0,15,5,30,2,0,0,2,0,30,5,10,0,15,3,30,5,10,0,15,6,30,6,0,0,6,1,-15,3,1
2,1,29,1,30,8,6,0,14,5,30,8,4,0,12,0,30,3,11,0,14,2,30,5,9,0,14,0,30,9,0,0,9,1,-15,3,1
2,3,29,1,30,8,6,0,14,5,30,8,4,0,12,0,30,3,11,0,14,2,30,5,9,0,14,0,30,9,0,0,9,1,-15,3,1
2,1,31,2,30,8,4,0,12,5,30,8,0,0,8,3,30,8,4,0,12,0,30,3,9,0,12,1,30,4,2,0,6,1,-15,3,1
2,2,31,2,30,8,4,0,12,5,30,8,0,0,8,3,30,8,4,0,12,0,30,3,9,0,12,1,30,4,2,0,6,1,-15,3,1
2,1,33,1,30,2,9,0,11,5,30,4,0,0,4,0,30,9,2,0,11,1,30,4,7,0,11,7,30,4,0,0,4,1,-15,3,1
2,4,35,0,30,5,8,0,13,5,30,2,0,0,2,1,30,4,9,0,13,4,30,3,10,0,13,5,30,8,0,0,8,1,-15,3,1
2,1,5,0,30,5,0,0,5,3,30,1,3,0,4,0,30,1,4,0,5,0,30,3,2,0,5,0,30,0,2,0,2,0,-27,3,0
2,2,5,0,30,5,0,0,5,3,30,1,3,0,4,0,30,1,4,0,5,0,30,3,2,0,5,0,30,0,2,0,2,0,-27,3,0
2,4,5,0,30,5,0,0,5,3,30,1,3,0,4,0,30,1,4,0,5,0,30,3,2,0,5,0,30,0,2,0,2,0,-27,3,0
2,3,8,4,30,7,0,0,7,4,30,2,0,0,2,0,30,2,5,0,7,0,30,4,3,0,7,1,30,3,0,0,3,0,-27,3,0
2,4,15,1,30,5,8,0,13,0,30,6,0,0,6,0,30,6,7,0,13,1,30,3,10,0,13,2,30,3,6,0,9,1,-15,3,1
2,4,19,0,30,3,10,0,13,1,30,8,0,0,8,0,30,10,3,0,13,6,30,4,9,0,13,1,30,6,3,0,9,1,-15,3,1
2,0,27,1,30,4,11,0,15,1,30,1,1,0,2,0,30,6,9,0,15,3,30,6,9,0,15,4,30,6,0,0,6,1,-15,3,1
2,2,4,3,30,7,1,0,8,5,30,4,0,0,4,0,30,1,7,0,8,1,30,6,2,0,8,1,30,3,1,0,4,0,-27,3,0
2,3,8,2,30,7,0,0,7,4,30,2,0,0,2,3,30,3,4,0,7,0,30,6,1,0,7,5,30,3,0,0,3,0,-27,3,0
2,4,13,1,30,5,2,0,7,0,30,4,0,0,4,2,30,6,1,0,7,8,30,7,0,0,7,4,30,4,0,0,4,1,-15,3,1
2,3,15,0,30,4,9,0,13,1,30,6,0,0,6,0,30,3,10,0,13,1,30,4,9,0,13,2,30,8,1,0,9,1,-15,3,1
2,3,17,3,30,10,4,0,14,3,30,6,0,0,6,0,30,6,8,0,14,1,30,4,10,0,14,0,30,4,0,0,4,1,-15,3,1
2,3,19,0,30,3,10,0,13,2,30,8,0,0,8,0,30,4,9,0,13,0,30,5,8,0,13,0,30,8,1,0,9,1,-15,3,1
2,3,23,2,30,6,7,0,13,1,30,6,0,0,6,3,30,13,0,0,13,0,30,5,8,0,13,2,30,6,0,0,6,1,-15,3,1
2,4,23,2,30,6,7,0,13,1,30,6,0,0,6,3,30,13,0,0,13,0,30,5,8,0,13,2,30,6,0,0,6,1,-15,3,1
2,2,25,1,30,5,9,0,14,4,30,6,0,0,6,0,30,9,5,0,14,1,30,5,9,0,14,4,30,6,0,0,6,1,-15,3,1
2,4,25,1,30,5,9,0,14,4,30,6,0,0,6,0,30,9,5,0,14,1,30,5,9,0,14,4,30,6,0,0,6,1,-15,3,1
2,3,27,1,30,3,12,0,15,3,30,1,1,0,2,0,30,7,8,0,15,2,30,5,10,0,15,3,30,6,0,0,6,1,-15,3,1
2,0,31,3,30,6,6,0,12,6,30,8,0,0,8,3,30,8,4,0,12,0,30,9,3,0,12,0,30,6,0,0,6,1,-15,3,1
2,4,31,3,30,6,6,0,12,6,30,8,0,0,8,3,30,8,4,0,12,0,30,9,3,0,12,0,30,6,0,0,6,1,-15,3,1
2,1,4,2,30,6,2,0,8,4,30,2,2,0,4,0,30,3,5,0,8,0,30,8,0,0,8,4,30,3,1,0,4,0,-27,3,0
2,2,4,2,30,6,2,0,8,4,30,2,2,0,4,0,30,3,5,0,8,0,30,8,0,0,8,4,30,3,1,0,4,0,-27,3,0
2,3,4,2,30,6,2,0,8,4,30,2,2,0,4,0,30,3,5,0,8,0,30,8,0,0,8,4,30,3,1,0,4,0,-27,3,0
2,4,4,2,30,6,2,0,8,4,30,2,2,0,4,0,30,3,5,0,8,0,30,8,0,0,8,4,30,3,1,0,4,0,-27,3,0
2,4,7,0,30,3,1,0,4,2,30,2,0,0,2,0,30,2,2,0,4,0,30,1,3,0,4,2,30,1,1,0,2,0,-27,3,0
2,3,8,1,30,7,0,0,7,4,30,2,0,0,2,3,30,3,4,0,7,2,30,7,0,0,7,2,30,3,0,0,3,0,-27,3,0
2,2,13,1,30,5,2,0,7,0,30,4,0,0,4,2,30,6,1,0,7,5,30,6,1,0,7,6,30,4,0,0,4,1,-15,3,1
2,4,13,1,30,5,2,0,7,0,30,4,0,0,4,2,30,6,1,0,7,5,30,6,1,0,7,6,30,4,0,0,4,1,-15,3,1
2,2,17,2,30,11,3,0,14,3,30,6,0,0,6,0,30,4,10,0,14,1,30,5,9,0,14,1,30,3,1,0,4,1,-15,3,1
2,1,23,2,30,5,8,0,13,2,30,6,0,0,6,2,30,11,2,0,13,0,30,5,8,0,13,3,30,6,0,0,6,1,-15,3,1
2,1,27,1,30,4,11,0,15,1,30,1,1,0,2,0,30,8,7,0,15,5,30,5,10,0,15,1,30,6,0,0,6,1,-15,3,1
2,3,5,0,30,2,3,0,5,2,30,2,2,0,4,0,30,3,2,0,5,0,30,1,4,0,5,0,30,0,2,0,2,0,-27,3,0
2,1,15,0,30,4,9,0,13,1,30,6,0,0,6,0,30,3,10,0,13,6,30,7,6,0,13,2,30,9,0,0,9,1,-15,3,1
2,4,17,2,30,10,4,0,14,2,30,6,0,0,6,0,30,7,7,0,14,5,30,5,9,0,14,6,30,4,0,0,4,1,-15,3,1
2,3,23,2,30,8,5,0,13,2,30,6,0,0,6,4,30,10,3,0,13,3,30,6,7,0,13,1,30,6,0,0,6,1,-15,3,1
2,3,25,1,30,9,5,0,14,3,30,6,0,0,6,0,30,5,9,0,14,1,30,5,9,0,14,3,30,5,1,0,6,1,-15,3,1
2,3,27,1,30,4,11,0,15,4,30,2,0,0,2,2,30,7,8,0,15,2,30,4,11,0,15,0,30,4,2,0,6,1,-15,3,1
2,0,29,0,30,8,6,0,14,6,30,8,4,0,12,0,30,5,9,0,14,0,30,1,13,0,14,4,30,9,0,0,9,1,-15,3,1
2,1,29,0,30,8,6,0,14,6,30,8,4,0,12,0,30,5,9,0,14,0,30,1,13,0,14,4,30,9,0,0,9,1,-15,3,1
2,0,4,2,30,6,2,0,8,4,30,2,2,0,4,0,30,2,6,0,8,0,30,5,3,0,8,2,30,4,0,0,4,0,-27,3,0
2,4,4,0,30,6,2,0,8,4,30,2,2,0,4,0,30,2,6,0,8,0,30,5,3,0,8,2,30,4,0,0,4,0,-27,3,0
2,3,17,2,30,8,6,0,14,3,30,6,0,0,6,0,30,3,11,0,14,1,30,8,6,0,14,3,30,4,0,0,4,1,-15,3,1
2,3,19,0,30,5,8,0,13,2,30,6,2,0,8,0,30,7,6,0,13,1,30,3,10,0,13,1,30,9,0,0,9,1,-15,3,1
2,2,25,2,30,8,6,0,14,2,30,6,0,0,6,0,30,11,3,0,14,1,30,4,10,0,14,0,30,5,1,0,6,1,-15,3,1
2,4,25,2,30,8,6,0,14,2,30,6,0,0,6,0,30,11,3,0,14,1,30,4,10,0,14,0,30,5,1,0,6,1,-15,3,1
2,0,26,0,30,7,2,0,9,4,30,3,1,0,4,6,30,0,9,0,9,0,30,2,7,0,9,4,30,2,1,0,3,1,-15,3,1
2,1,26,0,30,7,2,0,9,4,30,3,1,0,4,6,30,0,9,0,9,0,30,2,7,0,9,4,30,2,1,0,3,1,-15,3,1
2,2,26,0,30,7,2,0,9,4,30,3,1,0,4,6,30,0,9,0,9,0,30,2,7,0,9,4,30,2,1,0,3,1,-15,3,1
2,4,26,0,30,7,2,0,9,4,30,3,1,0,4,6,30,0,9,0,9,0,30,2,7,0,9,4,30,2,1,0,3,1,-15,3,1
2,2,27,1,30,4,11,0,15,4,30,2,0,0,2,0,30,7,8,0,15,4,30,4,11,0,15,2,30,6,0,0,6,1,-15,3,1
2,4,27,1,30,4,11,0,15,4,30,2,0,0,2,0,30,7,8,0,15,4,30,4,11,0,15,0,30,6,0,0,6,1,-15,3,1
2,0,29,0,30,7,7,0,14,5,30,12,0,0,12,0,30,3,11,0,14,0,30,1,13,0,14,5,30,9,0,0,9,1,-15,3,1
2,1,29,0,30,7,7,0,14,5,30,12,0,0,12,0,30,3,11,0,14,0,30,1,13,0,14,5,30,9,0,0,9,1,-15,3,1
2,4,29,0,30,7,7,0,14,5,30,12,0,0,12,0,30,3,11,0,14,0,30,1,13,0,14,5,30,9,0,0,9,1,-15,3,1
2,4,31,1,30,8,4,0,12,5,30,8,0,0,8,3,30,8,4,0,12,0,30,7,5,0,12,0,30,4,2,0,6,1,-15,3,1
2,3,35,0,30,10,3,0,13,6,30,2,0,0,2,1,30,2,11,0,13,0,30,3,10,0,13,9,30,8,0,0,8,1,-15,3,1
2,2,39,0,30,3,8,0,11,7,30,6,0,0,6,0,30,5,6,0,11,2,30,4,7,0,11,5,30,5,0,0,5,1,-15,3,1
2,3,39,0,30,3,8,0,11,7,30,6,0,0,6,0,30,5,6,0,11,2,30,4,7,0,11,5,30,5,0,0,5,1,-15,3,1
2,4,39,0,30,3,8,0,11,7,30,6,0,0,6,0,30,5,6,0,11,2,30,4,7,0,11,5,30,5,0,0,5,1,-15,3,1
2,1,4,2,30,7,1,0,8,4,30,3,1,0,4,0,30,2,6,0,8,0,30,4,4,0,8,2,30,4,0,0,4,0,-27,3,0
2,1,5,0,30,2,3,0,5,2,30,3,1,0,4,0,30,1,4,0,5,0,30,1,4,0,5,1,30,1,1,0,2,0,-27,3,0
2,4,5,0,30,2,3,0,5,2,30,3,1,0,4,0,30,1,4,0,5,0,30,1,4,0,5,1,30,1,1,0,2,0,-27,3,0
2,1,13,1,30,6,1,0,7,0,30,4,0,0,4,2,30,6,1,0,7,6,30,7,0,0,7,4,30,4,0,0,4,1,-15,3,1
2,3,13,1,30,6,1,0,7,0,30,4,0,0,4,2,30,6,1,0,7,6,30,7,0,0,7,4,30,4,0,0,4,1,-15,3,1
2,4,22,1,30,8,0,0,8,2,30,2,0,0,2,0,30,5,3,0,8,1,30,3,5,0,8,1,30,2,2,0,4,1,-15,3,1
2,3,23,2,30,5,8,0,13,4,30,6,0,0,6,5,30,11,2,0,13,0,30,6,7,0,13,3,30,6,0,0,6,1,-15,3,1
2,4,23,2,30,5,8,0,13,4,30,6,0,0,6,5,30,11,2,0,13,0,30,6,7,0,13,3,30,6,0,0,6,1,-15,3,1
2,2,27,1,30,4,11,0,15,3,30,2,0,0,2,0,30,9,6,0,15,4,30,4,11,0,15,2,30,6,0,0,6,1,-15,3,1
2,3,27,1,30,4,11,0,15,3,30,2,0,0,2,0,30,9,6,0,15,4,30,4,11,0,15,2,30,6,0,0,6,1,-15,3,1
2,4,27,1,30,4,11,0,15,3,30,2,0,0,2,0,30,9,6,0,15,4,30,4,11,0,15,2,30,6,0,0,6,1,-15,3,1
2,3,23,1,30,5,8,0,13,2,30,6,0,0,6,3,30,10,3,0,13,0,30,5,8,0,13,1,30,5,1,0,6,1,-15,3,1
2,0,27,1,30,4,11,0,15,2,30,2,0,0,2,0,30,6,9,0,15,1,30,7,8,0,15,2,30,6,0,0,6,1,-15,3,1
2,0,29,0,30,6,8,0,14,5,30,12,0,0,12,0,30,6,8,0,14,0,30,1,13,0,14,2,30,9,0,0,9,1,-15,3,1
2,1,29,0,30,6,8,0,14,5,30,12,0,0,12,0,30,6,8,0,14,0,30,1,13,0,14,2,30,9,0,0,9,1,-15,3,1
2,3,29,0,30,6,8,0,14,5,30,12,0,0,12,0,30,6,8,0,14,0,30,1,13,0,14,2,30,9,0,0,9,1,-15,3,1
2,3,47,0,30,0,14,0,14,5,30,4,0,0,4,0,30,4,10,0,14,1,30,3,11,0,14,6,30,7,0,0,7,1,-15,3,1
2,4,47,0,30,0,14,0,14,5,30,4,0,0,4,0,30,4,10,0,14,1,30,3,11,0,14,6,30,7,0,0,7,1,-15,3,1
2,3,8,5,30,7,0,0,7,5,30,2,0,0,2,4,30,2,5,0,7,1,30,5,2,0,7,4,30,3,0,0,3,0,-27,3,0
2,4,8,5,30,7,0,0,7,5,30,2,0,0,2,4,30,2,5,0,7,1,30,5,2,0,7,4,30,3,0,0,3,0,-27,3,0
2,3,13,1,30,7,0,0,7,0,30,4,0,0,4,2,30,6,1,0,7,4,30,5,2,0,7,2,30,4,0,0,4,1,-15,3,1
2,4,13,1,30,7,0,0,7,0,30,4,0,0,4,2,30,6,1,0,7,4,30,5,2,0,7,2,30,4,0,0,4,1,-15,3,1
2,4,17,4,30,11,3,0,14,2,30,6,0,0,6,0,30,2,12,0,14,1,30,4,10,0,14,2,30,4,0,0,4,1,-15,3,1
2,1,19,0,30,8,5,0,13,1,30,7,1,0,8,3,30,8,5,0,13,0,30,3,10,0,13,1,30,6,3,0,9,1,-15,3,1
2,2,19,0,30,8,5,0,13,1,30,7,1,0,8,3,30,8,5,0,13,0,30,3,10,0,13,1,30,6,3,0,9,1,-15,3,1
2,3,19,0,30,8,5,0,13,1,30,7,1,0,8,3,30,8,5,0,13,0,30,3,10,0,13,1,30,6,3,0,9,1,-15,3,1
2,4,19,0,30,8,5,0,13,1,30,7,1,0,8,3,30,8,5,0,13,0,30,3,10,0,13,1,30,6,3,0,9,1,-15,3,1
2,4,21,0,30,6,4,0,10,3,30,5,1,0,6,1,30,3,7,0,10,4,30,4,6,0,10,3,30,4,0,0,4,1,-15,3,1
2,2,29,2,30,8,6,0,14,6,30,9,3,0,12,0,30,3,11,0,14,0,30,1,13,0,14,0,30,7,2,0,9,1,-15,3,1
2,3,29,2,30,8,6,0,14,6,30,9,3,0,12,0,30,3,11,0,14,0,30,1,13,0,14,0,30,7,2,0,9,1,-15,3,1
2,4,32,0,30,5,4,0,9,4,30,2,0,0,2,0,30,7,2,0,9,6,30,3,6,0,9,1,30,2,0,0,2,1,-15,3,1
2,2,5,0,30,2,3,0,5,2,30,3,1,0,4,0,30,0,5,0,5,0,30,1,4,0,5,4,30,0,2,0,2,0,-27,3,0
2,4,5,0,30,2,3,0,5,2,30,3,1,0,4,0,30,0,5,0,5,0,30,1,4,0,5,4,30,0,2,0,2,0,-27,3,0
2,4,11,1,30,7,5,0,12,0,30,4,0,0,4,0,30,9,3,0,12,7,30,4,8,0,12,5,30,4,0,0,4,1,-15,3,1
2,1,13,1,30,7,0,0,7,0,30,4,0,0,4,2,30,6,1,0,7,5,30,6,1,0,7,4,30,4,0,0,4,1,-15,3,1
2,3,13,1,30,7,0,0,7,0,30,4,0,0,4,2,30,6,1,0,7,5,30,6,1,0,7,4,30,4,0,0,4,1,-15,3,1
2,4,23,1,30,10,3,0,13,2,30,6,0,0,6,1,30,9,4,0,13,0,30,6,7,0,13,5,30,6,0,0,6,1,-15,3,1
2,0,27,2,30,5,10,0,15,5,30,1,1,0,2,2,30,5,10,0,15,0,30,4,11,0,15,3,30,4,2,0,6,1,-15,3,1
2,1,29,0,30,5,9,0,14,5,30,12,0,0,12,0,30,8,6,0,14,0,30,7,7,0,14,0,30,7,2,0,9,1,-15,3,1
2,0,37,1,30,9,2,0,11,6,30,6,2,0,8,0,30,3,8,0,11,4,30,3,8,0,11,8,30,6,0,0,6,1,-15,3,1
2,4,3,5,30,1,3,0,4,3,30,4,0,0,4,0,30,2,2,0,4,0,30,3,1,0,4,0,30,1,2,0,3,0,-27,3,0
2,0,4,3,30,8,0,0,8,4,30,4,0,0,4,0,30,4,4,0,8,0,30,4,4,0,8,2,30,4,0,0,4,0,-27,3,0
2,3,4,3,30,8,0,0,8,4,30,4,0,0,4,0,30,4,4,0,8,0,30,4,4,0,8,0,30,4,0,0,4,0,-27,3,0
2,4,13,6,30,3,0,0,3,2,30,2,0,0,2,0,30,2,1,0,3,4,30,2,1,0,3,2,30,2,0,0,2,1,-15,3,1
2,3,13,7,30,7,0,0,7,2,30,4,0,0,4,5,30,5,2,0,7,0,30,6,1,0,7,4,30,4,0,0,4,1,-15,3,1
2,2,17,1,30,9,5,0,14,2,30,6,0,0,6,0,30,5,9,0,14,4,30,6,8,0,14,7,30,4,0,0,4,1,-15,3,1
2,3,17,1,30,9,5,0,14,2,30,6,0,0,6,0,30,5,9,0,14,4,30,6,8,0,14,7,30,4,0,0,4,1,-15,3,1
2,2,25,3,30,7,7,0,14,4,30,6,0,0,6,0,30,8,6,0,14,1,30,6,8,0,14,4,30,5,1,0,6,1,-15,3,1
2,4,25,3,30,7,7,0,14,4,30,6,0,0,6,0,30,8,6,0,14,1,30,6,8,0,14,0,30,5,1,0,6,1,-15,3,1
2,0,27,2,30,5,10,0,15,2,30,2,0,0,2,0,30,10,5,0,15,3,30,5,10,0,15,0,30,5,1,0,6,1,-15,3,1
2,3,29,0,30,6,8,0,14,6,30,12,0,0,12,0,30,3,11,0,14,0,30,1,13,0,14,4,30,9,0,0,9,1,-15,3,1
2,4,29,0,30,6,8,0,14,6,30,12,0,0,12,0,30,3,11,0,14,0,30,1,13,0,14,4,30,9,0,0,9,1,-15,3,1
2,0,35,0,30,7,6,0,13,6,30,2,0,0,2,1,30,2,11,0,13,1,30,9,4,0,13,10,30,8,0,0,8,1,-15,3,1
2,1,11,1,30,5,7,0,12,2,30,4,0,0,4,0,30,6,6,0,12,7,30,8,4,0,12,4,30,4,0,0,4,1,-15,3,1
2,4,13,1,30,5,2,0,7,0,30,4,0,0,4,3,30,7,0,0,7,11,30,6,1,0,7,5,30,4,0,0,4,1,-15,3,1
2,2,17,4,30,10,4,0,14,3,30,6,0,0,6,0,30,4,10,0,14,1,30,2,12,0,14,2,30,4,0,0,4,1,-15,3,1
2,3,23,1,30,12,1,0,13,1,30,6,0,0,6,0,30,12,1,0,13,0,30,5,8,0,13,2,30,6,0,0,6,1,-15,3,1
2,4,25,1,30,4,10,0,14,5,30,6,0,0,6,0,30,8,6,0,14,1,30,5,9,0,14,2,30,6,0,0,6,1,-15,3,1
2,4,31,0,30,6,6,0,12,3,30,8,0,0,8,3,30,12,0,0,12,0,30,3,9,0,12,1,30,4,2,0,6,1,-15,3,1
2,4,39,0,30,3,8,0,11,7,30,6,0,0,6,0,30,4,7,0,11,1,30,3,8,0,11,6,30,5,0,0,5,1,-15,3,1
2,4,2,0,30,7,3,0,10,2,30,1,3,0,4,0,30,3,7,0,10,0,30,4,6,0,10,1,30,2,6,0,8,0,-27,3,0
2,3,5,0,30,2,3,0,5,3,30,3,1,0,4,0,30,0,5,0,5,0,30,5,0,0,5,0,30,0,2,0,2,0,-27,3,0
2,4,5,0,30,2,3,0,5,3,30,3,1,0,4,0,30,0,5,0,5,0,30,5,0,0,5,0,30,0,2,0,2,0,-27,3,0
2,3,13,4,30,7,0,0,7,0,30,4,0,0,4,2,30,5,2,0,7,5,30,6,1,0,7,5,30,4,0,0,4,1,-15,3,1
2,4,13,4,30,7,0,0,7,0,30,4,0,0,4,2,30,5,2,0,7,5,30,6,1,0,7,5,30,4,0,0,4,1,-15,3,1
2,2,25,1,30,9,5,0,14,4,30,6,0,0,6,0,30,8,6,0,14,1,30,4,10,0,14,3,30,5,1,0,6,1,-15,3,1
2,3,25,1,30,9,5,0,14,4,30,6,0,0,6,0,30,8,6,0,14,1,30,4,10,0,14,3,30,5,1,0,6,1,-15,3,1
2,4,25,1,30,9,5,0,14,4,30,6,0,0,6,0,30,8,6,0,14,1,30,4,10,0,14,3,30,5,1,0,6,1,-15,3,1
2,2,27,1,30,4,11,0,15,4,30,2,0,0,2,0,30,6,9,0,15,1,30,5,10,0,15,2,30,6,0,0,6,1,-15,3,1
2,2,29,1,30,8,6,0,14,6,30,10,2,0,12,0,30,3,11,0,14,0,30,1,13,0,14,2,30,9,0,0,9,1,-15,3,1
2,3,37,1,30,7,4,0,11,7,30,8,0,0,8,0,30,5,6,0,11,0,30,3,8,0,11,2,30,6,0,0,6,1,-15,3,1
2,4,37,1,30,7,4,0,11,7,30,8,0,0,8,0,30,5,6,0,11,0,30,3,8,0,11,2,30,6,0,0,6,1,-15,3,1
2,3,6,0,30,8,1,0,9,4,30,2,0,0,2,0,30,2,7,0,9,0,30,4,5,0,9,1,30,5,0,0,5,0,-27,3,0
2,0,13,2,30,6,1,0,7,1,30,4,0,0,4,2,30,6,1,0,7,11,30,5,2,0,7,2,30,4,0,0,4,1,-15,3,1
2,1,13,2,30,6,1,0,7,1,30,4,0,0,4,2,30,6,1,0,7,11,30,5,2,0,7,2,30,4,0,0,4,1,-15,3,1
2,2,13,2,30,6,1,0,7,1,30,4,0,0,4,2,30,6,1,0,7,11,30,5,2,0,7,2,30,4,0,0,4,1,-15,3,1
2,4,13,2,30,6,1,0,7,1,30,4,0,0,4,2,30,6,1,0,7,11,30,5,2,0,7,2,30,4,0,0,4,1,-15,3,1
2,1,17,4,30,11,3,0,14,3,30,6,0,0,6,0,30,3,11,0,14,0,30,6,8,0,14,0,30,3,1,0,4,1,-15,3,1
2,1,19,0,30,3,10,0,13,2,30,8,0,0,8,0,30,7,6,0,13,0,30,5,8,0,13,1,30,8,1,0,9,1,-15,3,1
2,3,19,0,30,3,10,0,13,2,30,8,0,0,8,0,30,7,6,0,13,0,30,5,8,0,13,1,30,8,1,0,9,1,-15,3,1
2,4,23,2,30,8,5,0,13,1,30,6,0,0,6,4,30,13,0,0,13,0,30,6,7,0,13,2,30,6,0,0,6,1,-15,3,1
2,2,27,0,30,3,12,0,15,4,30,2,0,0,2,0,30,1,14,0,15,1,30,4,11,0,15,5,30,6,0,0,6,1,-15,3,1
2,4,27,0,30,3,12,0,15,4,30,2,0,0,2,0,30,1,14,0,15,1,30,4,11,0,15,5,30,6,0,0,6,1,-15,3,1
2,3,29,0,30,5,9,0,14,5,30,11,1,0,12,0,30,7,7,0,14,0,30,2,12,0,14,0,30,9,0,0,9,1,-15,3,1
2,3,33,1,30,2,9,0,11,3,30,4,0,0,4,0,30,11,0,0,11,5,30,4,7,0,11,7,30,4,0,0,4,1,-15,3,1
2,3,39,0,30,3,8,0,11,7,30,6,0,0,6,0,30,5,6,0,11,3,30,3,8,0,11,3,30,5,0,0,5,1,-15,3,1
2,2,4,3,30,8,0,0,8,3,30,4,0,0,4,0,30,4,4,0,8,0,30,4,4,0,8,1,30,3,1,0,4,0,-27,3,0
2,3,8,5,30,7,0,0,7,4,30,2,0,0,2,7,30,5,2,0,7,0,30,2,5,0,7,2,30,3,0,0,3,0,-27,3,0
2,4,8,5,30,7,0,0,7,4,30,2,0,0,2,7,30,5,2,0,7,0,30,2,5,0,7,2,30,3,0,0,3,0,-27,3,0
2,3,17,3,30,8,6,0,14,3,30,6,0,0,6,0,30,7,7,0,14,3,30,7,7,0,14,5,30,4,0,0,4,1,-15,3,1
2,3,19,0,30,4,9,0,13,0,30,3,5,0,8,0,30,4,9,0,13,6,30,6,7,0,13,4,30,9,0,0,9,1,-15,3,1
2,2,21,3,30,6,4,0,10,3,30,6,0,0,6,1,30,5,5,0,10,4,30,3,7,0,10,4,30,4,0,0,4,1,-15,3,1
2,3,21,3,30,6,4,0,10,3,30,6,0,0,6,1,30,5,5,0,10,4,30,3,7,0,10,4,30,4,0,0,4,1,-15,3,1
2,3,25,0,30,8,6,0,14,4,30,6,0,0,6,0,30,8,6,0,14,1,30,5,9,0,14,4,30,5,1,0,6,1,-15,3,1
2,0,27,1,30,4,11,0,15,3,30,1,1,0,2,0,30,7,8,0,15,2,30,6,9,0,15,4,30,6,0,0,6,1,-15,3,1
2,1,27,1,30,4,11,0,15,3,30,1,1,0,2,0,30,7,8,0,15,2,30,6,9,0,15,4,30,6,0,0,6,1,-15,3,1
2,3,27,1,30,4,11,0,15,3,30,1,1,0,2,0,30,7,8,0,15,2,30,6,9,0,15,4,30,6,0,0,6,1,-15,3,1
2,1,29,0,30,7,7,0,14,4,30,11,1,0,12,0,30,5,9,0,14,0,30,0,14,0,14,5,30,9,0,0,9,1,-15,3,1
2,3,39,0,30,4,7,0,11,7,30,6,0,0,6,0,30,6,5,0,11,2,30,4,7,0,11,2,30,5,0,0,5,1,-15,3,1
2,4,39,0,30,4,7,0,11,7,30,6,0,0,6,0,30,6,5,0,11,2,30,4,7,0,11,2,30,5,0,0,5,1,-15,3,1
2,3,43,0,30,6,8,0,14,8,30,6,0,0,6,0,30,4,10,0,14,1,30,1,13,0,14,4,30,5,0,0,5,1,-15,3,1
2,0,4,3,30,7,1,0,8,4,30,2,2,0,4,0,30,3,5,0,8,0,30,5,3,0,8,2,30,4,0,0,4,0,-27,3,0
2,1,4,3,30,7,1,0,8,4,30,2,2,0,4,0,30,3,5,0,8,0,30,5,3,0,8,2,30,4,0,0,4,0,-27,3,0
2,2,4,3,30,7,1,0,8,4,30,2,2,0,4,0,30,3,5,0,8,0,30,5,3,0,8,2,30,4,0,0,4,0,-27,3,0
2,3,4,3,30,7,1,0,8,4,30,2,2,0,4,0,30,3,5,0,8,0,30,5,3,0,8,2,30,4,0,0,4,0,-27,3,0
2,2,6,0,30,7,2,0,9,4,30,2,0,0,2,0,30,2,7,0,9,0,30,4,5,0,9,1,30,5,0,0,5,0,-27,3,0
2,2,13,3,30,7,0,0,7,0,30,4,0,0,4,2,30,7,0,0,7,3,30,6,1,0,7,5,30,4,0,0,4,1,-15,3,1
2,3,13,3,30,7,0,0,7,0,30,4,0,0,4,2,30,7,0,0,7,3,30,6,1,0,7,5,30,4,0,0,4,1,-15,3,1
2,0,19,0,30,2,11,0,13,2,30,4,4,0,8,0,30,7,6,0,13,8,30,6,7,0,13,2,30,8,1,0,9,1,-15,3,1
2,1,19,0,30,2,11,0,13,2,30,4,4,0,8,0,30,7,6,0,13,8,30,6,7,0,13,2,30,8,1,0,9,1,-15,3,1
2,2,19,0,30,2,11,0,13,2,30,4,4,0,8,0,30,7,6,0,13,8,30,6,7,0,13,2,30,8,1,0,9,1,-15,3,1
2,4,25,1,30,8,6,0,14,2,30,6,0,0,6,1,30,8,6,0,14,1,30,7,7,0,14,5,30,6,0,0,6,1,-15,3,1
2,3,27,1,30,4,11,0,15,2,30,1,1,0,2,0,30,5,10,0,15,0,30,3,12,0,15,0,30,6,0,0,6,1,-15,3,1
2,4,27,1,30,4,11,0,15,2,30,1,1,0,2,0,30,5,10,0,15,0,30,3,12,0,15,0,30,6,0,0,6,1,-15,3,1
2,4,29,0,30,3,11,0,14,5,30,7,5,0,12,0,30,9,5,0,14,0,30,0,14,0,14,0,30,9,0,0,9,1,-15,3,1
2,0,31,1,30,4,8,0,12,8,30,8,0,0,8,3,30,4,8,0,12,0,30,11,1,0,12,7,30,6,0,0,6,1,-15,3,1
2,2,31,1,30,4,8,0,12,8,30,8,0,0,8,3,30,4,8,0,12,0,30,11,1,0,12,7,30,6,0,0,6,1,-15,3,1
2,2,35,0,30,9,4,0,13,4,30,2,0,0,2,2,30,6,7,0,13,4,30,1,12,0,13,6,30,8,0,0,8,1,-15,3,1
2,4,35,0,30,9,4,0,13,4,30,2,0,0,2,2,30,6,7,0,13,1,30,1,12,0,13,6,30,8,0,0,8,1,-15,3,1
2,4,3,0,30,0,4,0,4,2,30,4,0,0,4,0,30,0,4,0,4,7,30,2,2,0,4,0,30,2,1,0,3,0,-27,3,0
2,2,8,1,30,7,0,0,7,5,30,2,0,0,2,0,30,2,5,0,7,1,30,7,0,0,7,4,30,3,0,0,3,0,-27,3,0
2,2,17,4,30,9,5,0,14,3,30,6,0,0,6,0,30,4,10,0,14,5,30,6,8,0,14,6,30,4,0,0,4,1,-15,3,1
2,3,17,4,30,9,5,0,14,3,30,6,0,0,6,0,30,4,10,0,14,5,30,6,8,0,14,6,30,4,0,0,4,1,-15,3,1
2,4,19,0,30,4,9,0,13,2,30,4,4,0,8,0,30,4,9,0,13,5,30,4,9,0,13,3,30,9,0,0,9,1,-15,3,1
2,2,23,1,30,5,8,0,13,3,30,6,0,0,6,3,30,12,1,0,13,1,30,5,8,0,13,3,30,6,0,0,6,1,-15,3,1
2,4,23,1,30,5,8,0,13,3,30,6,0,0,6,3,30,12,1,0,13,1,30,5,8,0,13,3,30,6,0,0,6,1,-15,3,1
2,2,39,0,30,2,9,0,11,6,30,6,0,0,6,0,30,4,7,0,11,0,30,4,7,0,11,4,30,5,0,0,5,1,-15,3,1
2,0,4,3,30,8,0,0,8,4,30,1,3,0,4,0,30,1,7,0,8,0,30,4,4,0,8,2,30,4,0,0,4,0,-27,3,0
2,1,4,3,30,8,0,0,8,4,30,1,3,0,4,0,30,1,7,0,8,0,30,4,4,0,8,2,30,4,0,0,4,0,-27,3,0
2,3,4,3,30,8,0,0,8,4,30,1,3,0,4,0,30,1,7,0,8,0,30,4,4,0,8,2,30,4,0,0,4,0,-27,3,0
2,2,6,0,30,7,2,0,9,4,30,2,0,0,2,0,30,2,7,0,9,0,30,3,6,0,9,1,30,5,0,0,5,0,-27,3,0
2,2,13,2,30,3,0,0,3,0,30,2,0,0,2,0,30,3,0,0,3,7,30,3,0,0,3,4,30,2,0,0,2,1,-15,3,1
2,1,13,3,30,7,0,0,7,0,30,4,0,0,4,1,30,6,1,0,7,7,30,7,0,0,7,4,30,4,0,0,4,1,-15,3,1
2,2,13,3,30,7,0,0,7,0,30,4,0,0,4,1,30,6,1,0,7,7,30,7,0,0,7,4,30,4,0,0,4,1,-15,3,1
2,1,17,5,30,10,4,0,14,4,30,6,0,0,6,0,30,4,10,0,14,3,30,7,7,0,14,1,30,4,0,0,4,1,-15,3,1
2,4,17,5,30,10,4,0,14,4,30,6,0,0,6,0,30,4,10,0,14,3,30,7,7,0,14,1,30,4,0,0,4,1,-15,3,1
2,2,23,1,30,7,6,0,13,0,30,6,0,0,6,5,30,12,1,0,13,0,30,4,9,0,13,2,30,6,0,0,6,1,-15,3,1
2,3,25,0,30,11,3,0,14,4,30,6,0,0,6,0,30,3,11,0,14,1,30,4,10,0,14,5,30,6,0,0,6,1,-15,3,1
2,3,27,1,30,3,12,0,15,3,30,2,0,0,2,0,30,3,12,0,15,0,30,9,6,0,15,7,30,6,0,0,6,1,-15,3,1
2,2,29,1,30,6,8,0,14,6,30,12,0,0,12,0,30,7,7,0,14,1,30,2,12,0,14,0,30,9,0,0,9,1,-15,3,1
2,4,39,0,30,5,6,0,11,6,30,6,0,0,6,0,30,4,7,0,11,0,30,2,9,0,11,1,30,5,0,0,5,1,-15,3,1
2,4,45,0,30,3,10,0,13,9,30,10,0,0,10,0,30,2,11,0,13,0,30,4,9,0,13,5,30,5,0,0,5,1,-15,3,1
2,4,5,0,30,2,3,0,5,3,30,2,2,0,4,0,30,0,5,0,5,0,30,1,4,0,5,3,30,2,0,0,2,0,-27,3,0
2,2,21,4,30,7,3,0,10,4,30,6,0,0,6,1,30,3,7,0,10,2,30,4,6,0,10,2,30,4,0,0,4,1,-15,3,1
2,4,21,4,30,7,3,0,10,4,30,6,0,0,6,1,30,3,7,0,10,2,30,4,6,0,10,0,30,4,0,0,4,1,-15,3,1
2,3,27,1,30,4,11,0,15,4,30,2,0,0,2,0,30,3,12,0,15,3,30,9,6,0,15,6,30,6,0,0,6,1,-15,3,1
2,4,29,1,30,5,9,0,14,6,30,9,3,0,12,0,30,3,11,0,14,0,30,2,12,0,14,3,30,9,0,0,9,1,-15,3,1
2,2,35,0,30,6,7,0,13,4,30,2,0,0,2,1,30,2,11,0,13,3,30,4,9,0,13,6,30,8,0,0,8,1,-15,3,1
2,3,35,0,30,6,7,0,13,4,30,2,0,0,2,1,30,2,11,0,13,3,30,4,9,0,13,6,30,8,0,0,8,1,-15,3,1
2,4,38,0,30,4,6,0,10,7,30,6,0,0,6,0,30,1,9,0,10,0,30,2,8,0,10,0,30,6,0,0,6,1,-15,3,1
2,4,3,0,30,1,3,0,4,2,30,4,0,0,4,2,30,1,3,0,4,0,30,0,4,0,4,0,30,1,2,0,3,0,-27,3,0
2,0,5,0,30,2,3,0,5,3,30,3,1,0,4,0,30,0,5,0,5,0,30,1,4,0,5,1,30,0,2,0,2,0,-27,3,0
2,2,5,0,30,2,3,0,5,3,30,3,1,0,4,0,30,0,5,0,5,0,30,1,4,0,5,1,30,0,2,0,2,0,-27,3,0
2,4,5,0,30,2,3,0,5,3,30,3,1,0,4,0,30,0,5,0,5,0,30,1,4,0,5,1,30,0,2,0,2,0,-27,3,0
2,4,13,1,30,3,0,0,3,0,30,2,0,0,2,0,30,3,0,0,3,6,30,3,0,0,3,3,30,2,0,0,2,1,-15,3,1
2,3,13,1,30,5,2,0,7,1,30,4,0,0,4,5,30,6,1,0,7,6,30,7,0,0,7,3,30,4,0,0,4,1,-15,3,1
2,4,13,1,30,5,2,0,7,1,30,4,0,0,4,5,30,6,1,0,7,6,30,7,0,0,7,3,30,4,0,0,4,1,-15,3,1
2,0,17,2,30,10,4,0,14,4,30,6,0,0,6,0,30,4,10,0,14,5,30,6,8,0,14,4,30,4,0,0,4,1,-15,3,1
2,1,17,2,30,10,4,0,14,4,30,6,0,0,6,0,30,4,10,0,14,5,30,6,8,0,14,4,30,4,0,0,4,1,-15,3,1
2,2,17,2,30,10,4,0,14,4,30,6,0,0,6,0,30,4,10,0,14,5,30,6,8,0,14,4,30,4,0,0,4,1,-15,3,1
2,4,17,2,30,10,4,0,14,4,30,6,0,0,6,0,30,4,10,0,14,5,30,6,8,0,14,4,30,4,0,0,4,1,-15,3,1
2,3,19,0,30,2,11,0,13,2,30,7,1,0,8,0,30,5,8,0,13,5,30,4,9,0,13,1,30,8,1,0,9,1,-15,3,1
2,4,19,0,30,2,11,0,13,2,30,7,1,0,8,0,30,5,8,0,13,5,30,4,9,0,13,1,30,8,1,0,9,1,-15,3,1
2,2,23,1,30,6,7,0,13,2,30,6,0,0,6,4,30,11,2,0,13,1,30,6,7,0,13,2,30,6,0,0,6,1,-15,3,1
2,3,23,1,30,6,7,0,13,2,30,6,0,0,6,4,30,11,2,0,13,1,30,6,7,0,13,2,30,6,0,0,6,1,-15,3,1
2,2,25,1,30,8,6,0,14,4,30,6,0,0,6,0,30,4,10,0,14,1,30,5,9,0,14,7,30,5,1,0,6,1,-15,3,1
2,2,29,0,30,8,6,0,14,4,30,12,0,0,12,0,30,5,9,0,14,0,30,1,13,0,14,0,30,5,4,0,9,1,-15,3,1
2,3,29,0,30,8,6,0,14,4,30,12,0,0,12,0,30,5,9,0,14,0,30,1,13,0,14,0,30,5,4,0,9,1,-15,3,1
2,2,11,1,30,5,7,0,12,0,30,4,0,0,4,0,30,6,6,0,12,1,30,4,8,0,12,2,30,4,0,0,4,1,-15,3,1
2,2,13,3,30,6,1,0,7,0,30,4,0,0,4,1,30,6,1,0,7,17,30,3,4,0,7,4,30,4,0,0,4,1,-15,3,1
2,2,17,5,30,10,4,0,14,2,30,6,0,0,6,0,30,7,7,0,14,3,30,7,7,0,14,2,30,4,0,0,4,1,-15,3,1
2,2,21,2,30,7,3,0,10,4,30,5,1,0,6,1,30,3,7,0,10,0,30,5,5,0,10,3,30,4,0,0,4,1,-15,3,1
2,4,21,2,30,7,3,0,10,4,30,5,1,0,6,0,30,3,7,0,10,0,30,5,5,0,10,3,30,4,0,0,4,1,-15,3,1
2,4,22,2,30,7,1,0,8,3,30,2,0,0,2,0,30,4,4,0,8,0,30,4,4,0,8,0,30,4,0,0,4,1,-15,3,1
2,2,23,5,30,5,8,0,13,2,30,6,0,0,6,3,30,13,0,0,13,0,30,7,6,0,13,1,30,6,0,0,6,1,-15,3,1
2,4,25,0,30,8,6,0,14,4,30,6,0,0,6,0,30,7,7,0,14,2,30,8,6,0,14,6,30,6,0,0,6,1,-15,3,1
2,1,27,2,30,4,11,0,15,3,30,1,1,0,2,0,30,5,10,0,15,2,30,3,12,0,15,2,30,6,0,0,6,1,-15,3,1
2,3,27,2,30,4,11,0,15,3,30,1,1,0,2,0,30,5,10,0,15,2,30,3,12,0,15,2,30,6,0,0,6,1,-15,3,1
2,4,27,2,30,4,11,0,15,3,30,1,1,0,2,0,30,5,10,0,15,2,30,3,12,0,15,2,30,6,0,0,6,1,-15,3,1
2,2,31,1,30,5,7,0,12,4,30,8,0,0,8,4,30,11,1,0,12,0,30,3,9,0,12,2,30,3,3,0,6,1,-15,3,1
2,4,8,1,30,7,0,0,7,3,30,2,0,0,2,3,30,5,2,0,7,1,30,7,0,0,7,1,30,3,0,0,3,0,-27,3,0
2,0,13,4,30,7,0,0,7,2,30,4,0,0,4,5,30,6,1,0,7,1,30,7,0,0,7,2,30,4,0,0,4,1,-15,3,1
2,2,13,4,30,7,0,0,7,2,30,4,0,0,4,5,30,6,1,0,7,1,30,7,0,0,7,2,30,4,0,0,4,1,-15,3,1
2,3,19,0,30,4,9,0,13,2,30,7,1,0,8,0,30,5,8,0,13,3,30,5,8,0,13,2,30,8,1,0,9,1,-15,3,1
2,1,23,1,30,6,7,0,13,1,30,6,0,0,6,8,30,13,0,0,13,0,30,7,6,0,13,3,30,6,0,0,6,1,-15,3,1
2,0,27,1,30,6,9,0,15,5,30,2,0,0,2,2,30,2,13,0,15,0,30,4,11,0,15,4,30,5,1,0,6,1,-15,3,1
2,2,27,1,30,6,9,0,15,5,30,2,0,0,2,2,30,2,13,0,15,0,30,4,11,0,15,4,30,5,1,0,6,1,-15,3,1
2,3,27,1,30,6,9,0,15,5,30,2,0,0,2,2,30,2,13,0,15,0,30,4,11,0,15,4,30,5,1,0,6,1,-15,3,1
2,4,27,1,30,6,9,0,15,5,30,2,0,0,2,2,30,2,13,0,15,0,30,4,11,0,15,4,30,5,1,0,6,1,-15,3,1
2,4,29,0,30,4,10,0,14,5,30,12,0,0,12,0,30,6,8,0,14,0,30,1,13,0,14,0,30,9,0,0,9,1,-15,3,1
2,2,31,1,30,5,7,0,12,4,30,8,0,0,8,3,30,12,0,0,12,0,30,3,9,0,12,2,30,4,2,0,6,1,-15,3,1
2,3,31,1,30,5,7,0,12,4,30,8,0,0,8,3,30,12,0,0,12,0,30,3,9,0,12,2,30,4,2,0,6,1,-15,3,1
2,2,47,0,30,0,14,0,14,6,30,4,0,0,4,3,30,4,10,0,14,0,30,2,12,0,14,9,30,7,0,0,7,1,-15,3,1
2,3,17,4,30,9,5,0,14,3,30,6,0,0,6,0,30,5,9,0,14,1,30,6,8,0,14,5,30,4,0,0,4,1,-15,3,1
2,4,17,4,30,9,5,0,14,3,30,6,0,0,6,0,30,5,9,0,14,1,30,6,8,0,14,5,30,4,0,0,4,1,-15,3,1
2,0,19,0,30,2,11,0,13,2,30,5,3,0,8,0,30,5,8,0,13,4,30,5,8,0,13,1,30,9,0,0,9,1,-15,3,1
2,0,26,0,30,4,5,0,9,4,30,4,0,0,4,3,30,2,7,0,9,5,30,5,4,0,9,4,30,1,2,0,3,1,-15,3,1
2,2,26,0,30,4,5,0,9,4,30,4,0,0,4,0,30,2,7,0,9,5,30,5,4,0,9,4,30,1,2,0,3,1,-15,3,1
2,2,27,1,30,4,11,0,15,5,30,2,0,0,2,0,30,3,12,0,15,4,30,4,11,0,15,6,30,6,0,0,6,1,-15,3,1
2,3,27,1,30,4,11,0,15,5,30,2,0,0,2,0,30,3,12,0,15,4,30,4,11,0,15,6,30,6,0,0,6,1,-15,3,1
2,1,29,0,30,5,9,0,14,3,30,10,2,0,12,0,30,7,7,0,14,0,30,2,12,0,14,0,30,9,0,0,9,1,-15,3,1
2,3,31,2,30,7,5,0,12,4,30,8,0,0,8,3,30,8,4,0,12,0,30,3,9,0,12,1,30,4,2,0,6,1,-15,3,1
2,3,3,0,30,0,4,0,4,2,30,4,0,0,4,0,30,0,4,0,4,2,30,1,3,0,4,3,30,3,0,0,3,0,-27,3,0
2,3,7,7,30,5,4,0,9,4,30,4,0,0,4,0,30,5,4,0,9,0,30,2,7,0,9,1,30,5,1,0,6,0,-27,3,0
2,4,8,6,30,7,0,0,7,4,30,2,0,0,2,3,30,5,2,0,7,0,30,4,3,0,7,0,30,3,0,0,3,0,-27,3,0
2,3,11,0,30,3,1,0,4,1,30,0,0,0,0,0,30,0,4,0,4,2,30,4,0,0,4,2,30,1,0,0,1,1,-15,3,1
2,1,13,4,30,6,1,0,7,0,30,4,0,0,4,5,30,7,0,0,7,5,30,4,3,0,7,2,30,4,0,0,4,1,-15,3,1
2,2,13,4,30,6,1,0,7,0,30,4,0,0,4,5,30,7,0,0,7,5,30,4,3,0,7,2,30,4,0,0,4,1,-15,3,1
2,3,13,4,30,6,1,0,7,0,30,4,0,0,4,5,30,7,0,0,7,5,30,4,3,0,7,2,30,4,0,0,4,1,-15,3,1
2,4,17,3,30,6,8,0,14,3,30,6,0,0,6,0,30,7,7,0,14,1,30,6,8,0,14,6,30,4,0,0,4,1,-15,3,1
2,0,19,1,30,3,10,0,13,2,30,6,2,0,8,0,30,7,6,0,13,3,30,5,8,0,13,0,30,8,1,0,9,1,-15,3,1
2,3,19,1,30,3,10,0,13,2,30,6,2,0,8,0,30,7,6,0,13,3,30,5,8,0,13,0,30,8,1,0,9,1,-15,3,1
2,4,19,1,30,3,10,0,13,2,30,6,2,0,8,0,30,7,6,0,13,3,30,5,8,0,13,0,30,8,1,0,9,1,-15,3,1
2,1,21,3,30,7,3,0,10,4,30,6,0,0,6,1,30,3,7,0,10,4,30,5,5,0,10,1,30,4,0,0,4,1,-15,3,1
2,4,23,1,30,6,7,0,13,3,30,6,0,0,6,3,30,11,2,0,13,1,30,6,7,0,13,6,30,6,0,0,6,1,-15,3,1
2,0,27,1,30,4,11,0,15,3,30,1,1,0,2,0,30,8,7,0,15,1,30,4,11,0,15,2,30,6,0,0,6,1,-15,3,1
2,1,27,1,30,4,11,0,15,3,30,1,1,0,2,0,30,8,7,0,15,1,30,4,11,0,15,2,30,6,0,0,6,1,-15,3,1
2,4,27,1,30,4,11,0,15,3,30,1,1,0,2,0,30,8,7,0,15,1,30,4,11,0,15,2,30,6,0,0,6,1,-15,3,1
2,0,29,0,30,6,8,0,14,6,30,8,4,0,12,0,30,4,10,0,14,0,30,5,9,0,14,3,30,9,0,0,9,1,-15,3,1
2,0,4,2,30,7,1,0,8,5,30,4,0,0,4,1,30,1,7,0,8,0,30,5,3,0,8,1,30,3,1,0,4,0,-27,3,0
2,2,4,2,30,7,1,0,8,5,30,4,0,0,4,0,30,1,7,0,8,0,30,5,3,0,8,1,30,3,1,0,4,0,-27,3,0
2,1,5,1,30,4,1,0,5,3,30,3,1,0,4,0,30,0,5,0,5,0,30,1,4,0,5,0,30,0,2,0,2,0,-27,3,0
2,4,6,0,30,6,3,0,9,4,30,2,0,0,2,0,30,2,7,0,9,0,30,4,5,0,9,0,30,4,1,0,5,0,-27,3,0
2,4,8,1,30,7,0,0,7,4,30,2,0,0,2,3,30,4,3,0,7,1,30,7,0,0,7,0,30,3,0,0,3,0,-27,3,0
2,3,13,3,30,7,0,0,7,2,30,4,0,0,4,1,30,5,2,0,7,1,30,6,1,0,7,3,30,4,0,0,4,1,-15,3,1
2,4,15,0,30,4,9,0,13,0,30,6,0,0,6,1,30,5,8,0,13,1,30,3,10,0,13,2,30,6,3,0,9,1,-15,3,1
2,3,19,0,30,8,5,0,13,2,30,5,3,0,8,5,30,4,9,0,13,0,30,6,7,0,13,0,30,7,2,0,9,1,-15,3,1
2,2,23,1,30,4,9,0,13,2,30,6,0,0,6,5,30,11,2,0,13,0,30,5,8,0,13,3,30,6,0,0,6,1,-15,3,1
2,4,39,0,30,5,6,0,11,6,30,6,0,0,6,0,30,7,4,0,11,2,30,3,8,0,11,4,30,5,0,0,5,1,-15,3,1
2,2,1,0,30,7,3,0,10,4,30,2,0,0,2,1,30,4,6,0,10,7,30,5,5,0,10,6,30,6,0,0,6,0,-27,3,0
2,4,1,0,30,7,3,0,10,4,30,2,0,0,2,1,30,4,6,0,10,7,30,5,5,0,10,6,30,6,0,0,6,0,-27,3,0
2,1,4,1,30,7,1,0,8,5,30,4,0,0,4,0,30,1,7,0,8,0,30,4,4,0,8,7,30,4,0,0,4,0,-27,3,0
2,3,4,1,30,7,1,0,8,5,30,4,0,0,4,0,30,1,7,0,8,0,30,4,4,0,8,7,30,4,0,0,4,0,-27,3,0
2,2,5,0,30,1,4,0,5,2,30,4,0,0,4,0,30,0,5,0,5,0,30,1,4,0,5,3,30,2,0,0,2,0,-27,3,0
2,3,5,0,30,1,4,0,5,2,30,4,0,0,4,0,30,0,5,0,5,0,30,1,4,0,5,3,30,2,0,0,2,0,-27,3,0
2,1,11,2,30,4,8,0,12,0,30,4,0,0,4,0,30,8,4,0,12,6,30,5,7,0,12,5,30,4,0,0,4,1,-15,3,1
2,2,11,2,30,4,8,0,12,0,30,4,0,0,4,0,30,8,4,0,12,6,30,5,7,0,12,5,30,4,0,0,4,1,-15,3,1
2,4,13,1,30,6,1,0,7,0,30,4,0,0,4,2,30,7,0,0,7,4,30,5,2,0,7,3,30,4,0,0,4,1,-15,3,1
2,4,17,0,30,9,5,0,14,2,30,6,0,0,6,0,30,6,8,0,14,2,30,6,8,0,14,6,30,4,0,0,4,1,-15,3,1
2,4,23,2,30,8,5,0,13,3,30,6,0,0,6,6,30,10,3,0,13,0,30,6,7,0,13,0,30,6,0,0,6,1,-15,3,1
2,2,25,1,30,7,7,0,14,4,30,6,0,0,6,0,30,7,7,0,14,1,30,5,9,0,14,4,30,5,1,0,6,1,-15,3,1
2,4,25,1,30,7,7,0,14,4,30,6,0,0,6,0,30,7,7,0,14,1,30,5,9,0,14,4,30,5,1,0,6,1,-15,3,1
2,0,27,5,30,7,8,0,15,3,30,2,0,0,2,0,30,6,9,0,15,0,30,4,11,0,15,1,30,4,2,0,6,1,-15,3,1
2,2,27,0,30,7,8,0,15,3,30,2,0,0,2,0,30,6,9,0,15,0,30,4,11,0,15,1,30,4,2,0,6,1,-15,3,1
2,4,27,0,30,7,8,0,15,3,30,2,0,0,2,0,30,6,9,0,15,0,30,4,11,0,15,1,30,4,2,0,6,1,-15,3,1
2,3,29,0,30,8,6,0,14,5,30,11,1,0,12,0,30,4,10,0,14,0,30,1,13,0,14,0,30,9,0,0,9,1,-15,3,1
2,4,29,0,30,8,6,0,14,5,30,11,1,0,12,0,30,4,10,0,14,0,30,1,13,0,14,0,30,9,0,0,9,1,-15,3,1
2,4,35,0,30,6,7,0,13,2,30,2,0,0,2,1,30,6,7,0,13,1,30,3,10,0,13,1,30,8,0,0,8,1,-15,3,1
2,3,39,0,30,5,6,0,11,7,30,6,0,0,6,0,30,4,7,0,11,0,30,4,7,0,11,4,30,5,0,0,5,1,-15,3,1
2,4,39,0,30,5,6,0,11,7,30,6,0,0,6,0,30,4,7,0,11,0,30,4,7,0,11,4,30,5,0,0,5,1,-15,3,1
2,4,9,0,30,1,3,0,4,2,30,2,0,0,2,0,30,0,4,0,4,3,30,1,3,0,4,0,30,1,0,0,1,0,-27,3,0
2,1,19,0,30,2,11,0,13,2,30,8,0,0,8,0,30,7,6,0,13,7,30,4,9,0,13,2,30,9,0,0,9,1,-15,3,1
2,2,19,0,30,2,11,0,13,2,30,8,0,0,8,0,30,7,6,0,13,7,30,4,9,0,13,2,30,9,0,0,9,1,-15,3,1
2,4,25,1,30,7,7,0,14,1,30,6,0,0,6,0,30,9,5,0,14,1,30,6,8,0,14,4,30,6,0,0,6,1,-15,3,1
2,3,27,0,30,5,10,0,15,3,30,2,0,0,2,0,30,6,9,0,15,2,30,6,9,0,15,4,30,6,0,0,6,1,-15,3,1
2,4,27,0,30,5,10,0,15,3,30,2,0,0,2,0,30,6,9,0,15,2,30,6,9,0,15,4,30,6,0,0,6,1,-15,3,1
2,0,31,2,30,5,7,0,12,7,30,8,0,0,8,3,30,5,7,0,12,0,30,9,3,0,12,2,30,6,0,0,6,1,-15,3,1
2,2,31,2,30,5,7,0,12,7,30,8,0,0,8,3,30,5,7,0,12,0,30,9,3,0,12,2,30,6,0,0,6,1,-15,3,1
2,4,31,2,30,5,7,0,12,7,30,8,0,0,8,3,30,5,7,0,12,0,30,9,3,0,12,2,30,6,0,0,6,1,-15,3,1
2,1,33,5,30,5,6,0,11,6,30,4,0,0,4,5,30,9,2,0,11,0,30,5,6,0,11,4,30,4,0,0,4,1,-15,3,1
2,2,33,5,30,5,6,0,11,6,30,4,0,0,4,5,30,9,2,0,11,0,30,5,6,0,11,4,30,4,0,0,4,1,-15,3,1
2,3,35,0,30,6,7,0,13,6,30,2,0,0,2,2,30,2,11,0,13,4,30,1,12,0,13,3,30,8,0,0,8,1,-15,3,1
2,1,13,4,30,6,1,0,7,0,30,4,0,0,4,2,30,6,1,0,7,6,30,7,0,0,7,3,30,4,0,0,4,1,-15,3,1
2,3,13,4,30,6,1,0,7,0,30,4,0,0,4,2,30,6,1,0,7,6,30,7,0,0,7,3,30,4,0,0,4,1,-15,3,1
2,4,13,4,30,6,1,0,7,0,30,4,0,0,4,2,30,6,1,0,7,6,30,7,0,0,7,3,30,4,0,0,4,1,-15,3,1
2,3,17,4,30,8,6,0,14,3,30,6,0,0,6,0,30,6,8,0,14,1,30,8,6,0,14,5,30,4,0,0,4,1,-15,3,1
2,4,17,4,30,8,6,0,14,3,30,6,0,0,6,0,30,6,8,0,14,1,30,8,6,0,14,5,30,4,0,0,4,1,-15,3,1
2,2,19,2,30,4,9,0,13,2,30,7,1,0,8,0,30,7,6,0,13,3,30,3,10,0,13,0,30,8,1,0,9,1,-15,3,1
2,4,19,2,30,4,9,0,13,2,30,7,1,0,8,0,30,7,6,0,13,3,30,3,10,0,13,0,30,8,1,0,9,1,-15,3,1
2,2,23,3,30,4,9,0,13,2,30,6,0,0,6,6,30,13,0,0,13,0,30,5,8,0,13,4,30,6,0,0,6,1,-15,3,1
2,3,23,3,30,4,9,0,13,2,30,6,0,0,6,6,30,13,0,0,13,0,30,5,8,0,13,4,30,6,0,0,6,1,-15,3,1
2,4,23,3,30,4,9,0,13,2,30,6,0,0,6,6,30,13,0,0,13,0,30,5,8,0,13,4,30,6,0,0,6,1,-15,3,1
2,0,25,1,30,7,7,0,14,4,30,6,0,0,6,0,30,5,9,0,14,3,30,7,7,0,14,6,30,6,0,0,6,1,-15,3,1
2,4,27,1,30,8,7,0,15,5,30,2,0,0,2,0,30,2,13,0,15,2,30,4,11,0,15,2,30,6,0,0,6,1,-15,3,1
2,3,33,2,30,3,8,0,11,5,30,4,0,0,4,0,30,9,2,0,11,0,30,3,8,0,11,6,30,4,0,0,4,1,-15,3,1
2,1,5,1,30,3,2,0,5,3,30,2,2,0,4,0,30,0,5,0,5,0,30,1,4,0,5,0,30,0,2,0,2,0,-27,3,0
2,3,5,1,30,3,2,0,5,3,30,2,2,0,4,0,30,0,5,0,5,0,30,1,4,0,5,0,30,0,2,0,2,0,-27,3,0
2,0,6,1,30,6,3,0,9,4,30,2,0,0,2,1,30,2,7,0,9,0,30,5,4,0,9,1,30,4,1,0,5,0,-27,3,0
2,1,6,1,30,6,3,0,9,4,30,2,0,0,2,1,30,2,7,0,9,0,30,5,4,0,9,1,30,4,1,0,5,0,-27,3,0
2,4,19,0,30,3,10,0,13,2,30,6,2,0,8,0,30,10,3,0,13,0,30,3,10,0,13,1,30,8,1,0,9,1,-15,3,1
2,0,21,2,30,7,3,0,10,4,30,6,0,0,6,1,30,3,7,0,10,5,30,5,5,0,10,3,30,4,0,0,4,1,-15,3,1
2,3,21,2,30,7,3,0,10,4,30,6,0,0,6,1,30,3,7,0,10,5,30,5,5,0,10,3,30,4,0,0,4,1,-15,3,1
2,4,21,2,30,7,3,0,10,4,30,6,0,0,6,1,30,3,7,0,10,5,30,5,5,0,10,3,30,4,0,0,4,1,-15,3,1
2,0,25,1,30,4,10,0,14,5,30,6,0,0,6,0,30,6,8,0,14,1,30,6,8,0,14,5,30,5,1,0,6,1,-15,3,1
2,2,25,1,30,4,10,0,14,5,30,6,0,0,6,0,30,6,8,0,14,1,30,6,8,0,14,5,30,5,1,0,6,1,-15,3,1
2,4,25,1,30,4,10,0,14,5,30,6,0,0,6,0,30,6,8,0,14,1,30,6,8,0,14,5,30,5,1,0,6,1,-15,3,1
2,0,27,1,30,7,8,0,15,5,30,2,0,0,2,1,30,2,13,0,15,1,30,10,5,0,15,3,30,4,2,0,6,1,-15,3,1
2,4,29,2,30,11,3,0,14,4,30,11,1,0,12,0,30,4,10,0,14,0,30,1,13,0,14,0,30,6,3,0,9,1,-15,3,1
2,2,31,1,30,4,8,0,12,4,30,8,0,0,8,4,30,12,0,0,12,0,30,3,9,0,12,2,30,2,4,0,6,1,-15,3,1
2,4,31,0,30,4,8,0,12,4,30,8,0,0,8,4,30,12,0,0,12,0,30,3,9,0,12,2,30,2,4,0,6,1,-15,3,1
2,3,47,0,30,0,14,0,14,6,30,4,0,0,4,0,30,3,11,0,14,0,30,2,12,0,14,4,30,7,0,0,7,1,-15,3,1
2,2,11,2,30,5,7,0,12,2,30,4,0,0,4,3,30,2,10,0,12,0,30,3,9,0,12,3,30,4,0,0,4,1,-15,3,1
2,4,17,5,30,11,3,0,14,2,30,6,0,0,6,0,30,5,9,0,14,1,30,5,9,0,14,0,30,3,1,0,4,1,-15,3,1
2,4,19,0,30,8,5,0,13,2,30,8,0,0,8,0,30,5,8,0,13,4,30,4,9,0,13,0,30,5,4,0,9,1,-15,3,1
2,1,27,1,30,3,12,0,15,5,30,1,1,0,2,0,30,6,9,0,15,1,30,4,11,0,15,3,30,6,0,0,6,1,-15,3,1
2,3,27,1,30,3,12,0,15,5,30,1,1,0,2,0,30,6,9,0,15,1,30,4,11,0,15,0,30,6,0,0,6,1,-15,3,1
2,4,27,1,30,3,12,0,15,5,30,1,1,0,2,0,30,6,9,0,15,1,30,4,11,0,15,0,30,6,0,0,6,1,-15,3,1
2,1,31,1,30,9,3,0,12,4,30,8,0,0,8,3,30,10,2,0,12,0,30,4,8,0,12,0,30,6,0,0,6,1,-15,3,1
2,2,31,1,30,9,3,0,12,4,30,8,0,0,8,3,30,10,2,0,12,0,30,4,8,0,12,0,30,6,0,0,6,1,-15,3,1
2,2,43,0,30,5,9,0,14,8,30,6,0,0,6,0,30,4,10,0,14,1,30,2,12,0,14,9,30,5,0,0,5,1,-15,3,1
2,3,4,2,30,8,0,0,8,4,30,4,0,0,4,0,30,5,3,0,8,0,30,3,5,0,8,3,30,4,0,0,4,0,-27,3,0
2,3,5,0,30,1,4,0,5,3,30,3,1,0,4,0,30,0,5,0,5,0,30,1,4,0,5,1,30,2,0,0,2,0,-27,3,0
2,3,8,1,30,7,0,0,7,4,30,2,0,0,2,6,30,4,3,0,7,1,30,7,0,0,7,1,30,3,0,0,3,0,-27,3,0
2,4,11,1,30,4,8,0,12,0,30,4,0,0,4,0,30,7,5,0,12,5,30,6,6,0,12,5,30,4,0,0,4,1,-15,3,1
2,2,19,0,30,5,8,0,13,2,30,8,0,0,8,0,30,4,9,0,13,3,30,3,10,0,13,1,30,9,0,0,9,1,-15,3,1
2,4,19,0,30,5,8,0,13,2,30,8,0,0,8,0,30,4,9,0,13,3,30,3,10,0,13,1,30,9,0,0,9,1,-15,3,1
2,4,25,1,30,6,8,0,14,4,30,6,0,0,6,0,30,3,11,0,14,0,30,8,6,0,14,5,30,6,0,0,6,1,-15,3,1
2,3,27,1,30,6,9,0,15,0,30,2,0,0,2,0,30,11,4,0,15,0,30,4,11,0,15,0,30,3,3,0,6,1,-15,3,1
2,4,27,1,30,6,9,0,15,0,30,2,0,0,2,0,30,11,4,0,15,0,30,4,11,0,15,0,30,3,3,0,6,1,-15,3,1
2,4,39,0,30,3,8,0,11,7,30,6,0,0,6,0,30,7,4,0,11,3,30,5,6,0,11,3,30,5,0,0,5,1,-15,3,1
2,0,4,2,30,7,1,0,8,4,30,2,2,0,4,1,30,1,7,0,8,0,30,7,1,0,8,5,30,4,0,0,4,0,-27,3,0
2,2,4,2,30,7,1,0,8,4,30,2,2,0,4,1,30,1,7,0,8,0,30,7,1,0,8,5,30,4,0,0,4,0,-27,3,0
2,2,19,0,30,4,9,0,13,1,30,7,1,0,8,0,30,10,3,0,13,4,30,4,9,0,13,1,30,7,2,0,9,1,-15,3,1
2,2,21,1,30,7,3,0,10,3,30,4,2,0,6,0,30,3,7,0,10,7,30,4,6,0,10,5,30,4,0,0,4,1,-15,3,1
2,2,25,0,30,7,7,0,14,3,30,6,0,0,6,0,30,6,8,0,14,1,30,7,7,0,14,4,30,5,1,0,6,1,-15,3,1
2,4,25,0,30,7,7,0,14,3,30,6,0,0,6,0,30,6,8,0,14,1,30,7,7,0,14,4,30,5,1,0,6,1,-15,3,1
2,3,27,1,30,5,10,0,15,3,30,2,0,0,2,0,30,3,12,0,15,0,30,6,9,0,15,5,30,6,0,0,6,1,-15,3,1
2,4,27,1,30,5,10,0,15,3,30,2,0,0,2,0,30,3,12,0,15,0,30,6,9,0,15,5,30,6,0,0,6,1,-15,3,1
2,4,31,1,30,4,8,0,12,5,30,8,0,0,8,3,30,9,3,0,12,0,30,7,5,0,12,1,30,6,0,0,6,1,-15,3,1
2,4,6,0,30,5,4,0,9,3,30,2,0,0,2,0,30,3,6,0,9,0,30,3,6,0,9,1,30,5,0,0,5,0,-27,3,0
2,3,13,3,30,6,1,0,7,1,30,4,0,0,4,2,30,5,2,0,7,2,30,7,0,0,7,4,30,4,0,0,4,1,-15,3,1
2,3,19,1,30,4,9,0,13,1,30,4,4,0,8,0,30,9,4,0,13,5,30,7,6,0,13,0,30,9,0,0,9,1,-15,3,1
2,4,19,1,30,4,9,0,13,1,30,4,4,0,8,0,30,9,4,0,13,5,30,7,6,0,13,0,30,9,0,0,9,1,-15,3,1
2,2,25,0,30,9,5,0,14,3,30,6,0,0,6,0,30,11,3,0,14,1,30,7,7,0,14,1,30,4,2,0,6,1,-15,3,1
2,3,25,0,30,9,5,0,14,3,30,6,0,0,6,0,30,11,3,0,14,1,30,7,7,0,14,1,30,4,2,0,6,1,-15,3,1
2,0,26,0,30,6,3,0,9,4,30,4,0,0,4,4,30,2,7,0,9,0,30,2,7,0,9,4,30,3,0,0,3,1,-15,3,1
2,3,27,1,30,4,11,0,15,4,30,2,0,0,2,1,30,6,9,0,15,0,30,4,11,0,15,0,30,4,2,0,6,1,-15,3,1
2,1,29,0,30,5,9,0,14,5,30,11,1,0,12,0,30,7,7,0,14,0,30,1,13,0,14,3,30,9,0,0,9,1,-15,3,1
2,3,29,0,30,5,9,0,14,5,30,11,1,0,12,0,30,7,7,0,14,0,30,1,13,0,14,3,30,9,0,0,9,1,-15,3,1
2,2,37,0,30,8,3,0,11,8,30,8,0,0,8,0,30,2,9,0,11,5,30,6,5,0,11,9,30,6,0,0,6,1,-15,3,1
2,3,37,0,30,8,3,0,11,8,30,8,0,0,8,0,30,2,9,0,11,5,30,6,5,0,11,9,30,6,0,0,6,1,-15,3,1
2,1,39,1,30,3,8,0,11,6,30,6,0,0,6,0,30,7,4,0,11,0,30,4,7,0,11,2,30,5,0,0,5,1,-15,3,1
2,4,39,1,30,3,8,0,11,6,30,6,0,0,6,0,30,7,4,0,11,0,30,4,7,0,11,2,30,5,0,0,5,1,-15,3,1
2,2,11,0,30,4,8,0,12,0,30,4,0,0,4,0,30,7,5,0,12,7,30,6,6,0,12,6,30,4,0,0,4,1,-15,3,1
2,4,11,0,30,4,8,0,12,0,30,4,0,0,4,0,30,7,5,0,12,7,30,6,6,0,12,6,30,4,0,0,4,1,-15,3,1
2,2,17,4,30,10,4,0,14,3,30,6,0,0,6,0,30,5,9,0,14,1,30,7,7,0,14,5,30,4,0,0,4,1,-15,3,1
2,4,17,4,30,10,4,0,14,3,30,6,0,0,6,0,30,5,9,0,14,1,30,7,7,0,14,5,30,4,0,0,4,1,-15,3,1
2,3,19,0,30,5,8,0,13,1,30,7,1,0,8,0,30,7,6,0,13,3,30,4,9,0,13,2,30,7,2,0,9,1,-15,3,1
2,3,23,2,30,6,7,0,13,3,30,6,0,0,6,2,30,12,1,0,13,0,30,5,8,0,13,5,30,6,0,0,6,1,-15,3,1
2,4,23,2,30,6,7,0,13,3,30,6,0,0,6,2,30,12,1,0,13,0,30,5,8,0,13,5,30,6,0,0,6,1,-15,3,1
2,0,25,1,30,4,10,0,14,6,30,6,0,0,6,0,30,4,10,0,14,3,30,9,5,0,14,8,30,6,0,0,6,1,-15,3,1
2,2,31,3,30,9,3,0,12,3,30,8,0,0,8,3,30,12,0,0,12,0,30,3,9,0,12,0,30,2,4,0,6,1,-15,3,1
2,3,37,0,30,7,4,0,11,6,30,8,0,0,8,0,30,6,5,0,11,2,30,5,6,0,11,3,30,6,0,0,6,1,-15,3,1
2,2,8,2,30,7,0,0,7,4,30,2,0,0,2,6,30,5,2,0,7,2,30,7,0,0,7,0,30,2,1,0,3,0,-27,3,0
2,3,15,0,30,4,9,0,13,1,30,5,1,0,6,0,30,4,9,0,13,1,30,8,5,0,13,2,30,9,0,0,9,1,-15,3,1
2,3,17,3,30,8,6,0,14,4,30,6,0,0,6,0,30,5,9,0,14,0,30,10,4,0,14,5,30,4,0,0,4,1,-15,3,1
2,4,17,3,30,8,6,0,14,4,30,6,0,0,6,0,30,5,9,0,14,0,30,10,4,0,14,5,30,4,0,0,4,1,-15,3,1
2,3,23,1,30,3,10,0,13,4,30,6,0,0,6,2,30,11,2,0,13,1,30,5,8,0,13,5,30,6,0,0,6,1,-15,3,1
2,4,23,1,30,3,10,0,13,4,30,6,0,0,6,2,30,11,2,0,13,1,30,5,8,0,13,5,30,6,0,0,6,1,-15,3,1
2,0,25,1,30,5,9,0,14,5,30,6,0,0,6,0,30,3,11,0,14,1,30,7,7,0,14,8,30,6,0,0,6,1,-15,3,1
2,0,5,0,30,2,3,0,5,3,30,0,4,0,4,0,30,1,4,0,5,0,30,1,4,0,5,1,30,1,1,0,2,0,-27,3,0
2,4,7,0,30,4,5,0,9,3,30,4,0,0,4,0,30,4,5,0,9,6,30,2,7,0,9,1,30,4,2,0,6,0,-27,3,0
2,3,8,2,30,7,0,0,7,5,30,2,0,0,2,3,30,3,4,0,7,3,30,7,0,0,7,1,30,3,0,0,3,0,-27,3,0
2,0,19,0,30,3,10,0,13,3,30,5,3,0,8,0,30,4,9,0,13,8,30,6,7,0,13,2,30,9,0,0,9,1,-15,3,1
2,1,19,0,30,3,10,0,13,3,30,5,3,0,8,0,30,4,9,0,13,8,30,6,7,0,13,2,30,9,0,0,9,1,-15,3,1
2,2,19,0,30,3,10,0,13,3,30,5,3,0,8,0,30,4,9,0,13,8,30,6,7,0,13,2,30,9,0,0,9,1,-15,3,1
2,4,19,0,30,3,10,0,13,3,30,5,3,0,8,0,30,4,9,0,13,8,30,6,7,0,13,2,30,9,0,0,9,1,-15,3,1
2,3,25,1,30,8,6,0,14,3,30,6,0,0,6,0,30,6,8,0,14,4,30,5,9,0,14,5,30,5,1,0,6,1,-15,3,1
2,4,25,1,30,8,6,0,14,3,30,6,0,0,6,0,30,6,8,0,14,4,30,5,9,0,14,5,30,5,1,0,6,1,-15,3,1
2,0,27,1,30,5,10,0,15,3,30,2,0,0,2,0,30,6,9,0,15,2,30,6,9,0,15,4,30,6,0,0,6,1,-15,3,1
2,2,27,1,30,5,10,0,15,3,30,2,0,0,2,0,30,6,9,0,15,2,30,6,9,0,15,4,30,6,0,0,6,1,-15,3,1
2,3,27,1,30,5,10,0,15,3,30,2,0,0,2,0,30,6,9,0,15,2,30,6,9,0,15,4,30,6,0,0,6,1,-15,3,1
2,0,29,0,30,6,8,0,14,5,30,12,0,0,12,0,30,5,9,0,14,0,30,1,13,0,14,4,30,9,0,0,9,1,-15,3,1
2,1,29,0,30,6,8,0,14,5,30,12,0,0,12,0,30,5,9,0,14,0,30,1,13,0,14,4,30,9,0,0,9,1,-15,3,1
2,4,29,0,30,6,8,0,14,5,30,12,0,0,12,0,30,5,9,0,14,0,30,1,13,0,14,4,30,9,0,0,9,1,-15,3,1
2,1,33,1,30,2,9,0,11,5,30,4,0,0,4,1,30,10,1,0,11,0,30,5,6,0,11,8,30,4,0,0,4,1,-15,3,1
2,3,33,1,30,2,9,0,11,5,30,4,0,0,4,1,30,10,1,0,11,0,30,5,6,0,11,8,30,4,0,0,4,1,-15,3,1
2,2,35,0,30,6,7,0,13,5,30,2,0,0,2,1,30,2,11,0,13,3,30,4,9,0,13,6,30,8,0,0,8,1,-15,3,1
2,1,5,0,30,0,5,0,5,3,30,2,2,0,4,1,30,0,5,0,5,0,30,2,3,0,5,0,30,0,2,0,2,0,-27,3,0
2,3,5,0,30,0,5,0,5,3,30,2,2,0,4,1,30,0,5,0,5,0,30,2,3,0,5,0,30,0,2,0,2,0,-27,3,0
2,1,6,0,30,8,1,0,9,3,30,2,0,0,2,0,30,4,5,0,9,0,30,4,5,0,9,0,30,3,2,0,5,0,-27,3,0
2,2,11,1,30,4,0,0,4,1,30,0,0,0,0,0,30,1,3,0,4,2,30,2,2,0,4,2,30,1,0,0,1,1,-15,3,1
2,4,11,1,30,4,0,0,4,1,30,0,0,0,0,0,30,1,3,0,4,2,30,2,2,0,4,2,30,1,0,0,1,1,-15,3,1
2,3,11,0,30,10,2,0,12,1,30,4,0,0,4,0,30,6,6,0,12,3,30,5,7,0,12,4,30,4,0,0,4,1,-15,3,1
2,4,11,0,30,10,2,0,12,1,30,4,0,0,4,0,30,6,6,0,12,3,30,5,7,0,12,4,30,4,0,0,4,1,-15,3,1
2,4,17,1,30,10,4,0,14,2,30,6,0,0,6,0,30,6,8,0,14,1,30,5,9,0,14,0,30,4,0,0,4,1,-15,3,1
2,1,1,0,30,7,3,0,10,4,30,2,0,0,2,0,30,4,6,0,10,8,30,10,0,0,10,6,30,6,0,0,6,0,-27,3,0
2,4,1,0,30,7,3,0,10,4,30,2,0,0,2,0,30,4,6,0,10,8,30,10,0,0,10,6,30,6,0,0,6,0,-27,3,0
2,0,4,2,30,8,0,0,8,5,30,4,0,0,4,0,30,1,7,0,8,3,30,8,0,0,8,2,30,3,1,0,4,0,-27,3,0
2,1,4,2,30,8,0,0,8,5,30,4,0,0,4,0,30,1,7,0,8,3,30,8,0,0,8,2,30,3,1,0,4,0,-27,3,0
2,2,17,1,30,8,6,0,14,2,30,6,0,0,6,0,30,6,8,0,14,0,30,5,9,0,14,5,30,4,0,0,4,1,-15,3,1
2,0,19,0,30,3,10,0,13,2,30,6,2,0,8,0,30,4,9,0,13,4,30,5,8,0,13,3,30,9,0,0,9,1,-15,3,1
2,1,19,0,30,3,10,0,13,2,30,6,2,0,8,0,30,4,9,0,13,4,30,5,8,0,13,3,30,9,0,0,9,1,-15,3,1
2,3,19,0,30,3,10,0,13,2,30,6,2,0,8,0,30,4,9,0,13,4,30,5,8,0,13,3,30,9,0,0,9,1,-15,3,1
2,1,21,3,30,7,3,0,10,4,30,6,0,0,6,1,30,3,7,0,10,3,30,4,6,0,10,1,30,4,0,0,4,1,-15,3,1
2,4,21,3,30,7,3,0,10,4,30,6,0,0,6,1,30,3,7,0,10,3,30,4,6,0,10,1,30,4,0,0,4,1,-15,3,1
2,4,23,1,30,5,8,0,13,1,30,6,0,0,6,5,30,11,2,0,13,0,30,7,6,0,13,2,30,5,1,0,6,1,-15,3,1
2,1,25,1,30,6,8,0,14,0,30,6,0,0,6,0,30,12,2,0,14,1,30,5,9,0,14,3,30,5,1,0,6,1,-15,3,1
2,3,25,1,30,6,8,0,14,0,30,6,0,0,6,0,30,12,2,0,14,1,30,5,9,0,14,3,30,5,1,0,6,1,-15,3,1
2,1,27,1,30,4,11,0,15,2,30,1,1,0,2,0,30,3,12,0,15,0,30,9,6,0,15,6,30,6,0,0,6,1,-15,3,1
2,2,27,1,30,4,11,0,15,2,30,1,1,0,2,0,30,3,12,0,15,0,30,9,6,0,15,6,30,6,0,0,6,1,-15,3,1
2,3,27,1,30,4,11,0,15,2,30,1,1,0,2,0,30,3,12,0,15,0,30,9,6,0,15,6,30,6,0,0,6,1,-15,3,1
2,0,29,0,30,8,6,0,14,6,30,9,3,0,12,0,30,2,12,0,14,0,30,1,13,0,14,3,30,9,0,0,9,1,-15,3,1
2,4,35,0,30,5,8,0,13,5,30,2,0,0,2,1,30,4,9,0,13,2,30,5,8,0,13,6,30,8,0,0,8,1,-15,3,1
2,4,7,1,30,5,4,0,9,2,30,4,0,0,4,1,30,6,3,0,9,4,30,2,7,0,9,1,30,3,3,0,6,0,-27,3,0
2,1,19,0,30,4,9,0,13,2,30,4,4,0,8,0,30,7,6,0,13,5,30,4,9,0,13,4,30,9,0,0,9,1,-15,3,1
2,3,23,2,30,6,7,0,13,0,30,6,0,0,6,3,30,12,1,0,13,2,30,4,9,0,13,2,30,6,0,0,6,1,-15,3,1
2,3,27,0,30,3,12,0,15,3,30,2,0,0,2,0,30,6,9,0,15,0,30,6,9,0,15,3,30,6,0,0,6,1,-15,3,1
2,1,31,1,30,2,10,0,12,6,30,8,0,0,8,0,30,5,7,0,12,2,30,9,3,0,12,6,30,6,0,0,6,1,-15,3,1
2,3,31,1,30,2,10,0,12,6,30,8,0,0,8,0,30,5,7,0,12,2,30,9,3,0,12,6,30,6,0,0,6,1,-15,3,1
2,4,31,1,30,2,10,0,12,6,30,8,0,0,8,0,30,5,7,0,12,2,30,9,3,0,12,6,30,6,0,0,6,1,-15,3,1
2,0,4,2,30,6,2,0,8,4,30,2,2,0,4,1,30,1,7,0,8,0,30,6,2,0,8,3,30,3,1,0,4,0,-27,3,0
2,2,4,2,30,6,2,0,8,4,30,2,2,0,4,1,30,1,7,0,8,0,30,6,2,0,8,3,30,3,1,0,4,0,-27,3,0
2,3,4,2,30,6,2,0,8,4,30,2,2,0,4,1,30,1,7,0,8,0,30,6,2,0,8,3,30,3,1,0,4,0,-27,3,0
2,3,25,2,30,9,5,0,14,4,30,6,0,0,6,0,30,8,6,0,14,0,30,6,8,0,14,5,30,5,1,0,6,1,-15,3,1
2,4,25,2,30,9,5,0,14,4,30,6,0,0,6,0,30,8,6,0,14,0,30,6,8,0,14,5,30,5,1,0,6,1,-15,3,1
2,1,27,1,30,4,11,0,15,3,30,2,0,0,2,0,30,5,10,0,15,0,30,4,11,0,15,3,30,6,0,0,6,1,-15,3,1
2,4,27,1,30,4,11,0,15,3,30,2,0,0,2,0,30,5,10,0,15,0,30,4,11,0,15,3,30,6,0,0,6,1,-15,3,1
2,3,29,0,30,7,7,0,14,6,30,10,2,0,12,0,30,3,11,0,14,0,30,1,13,0,14,2,30,9,0,0,9,1,-15,3,1
2,4,31,1,30,8,4,0,12,4,30,8,0,0,8,6,30,9,3,0,12,0,30,3,9,0,12,0,30,4,2,0,6,1,-15,3,1
2,2,19,1,30,5,8,0,13,2,30,3,5,0,8,0,30,6,7,0,13,5,30,5,8,0,13,1,30,9,0,0,9,1,-15,3,1
2,4,19,1,30,5,8,0,13,2,30,3,5,0,8,0,30,6,7,0,13,5,30,5,8,0,13,1,30,9,0,0,9,1,-15,3,1
2,1,26,0,30,7,2,0,9,4,30,4,0,0,4,4,30,2,7,0,9,0,30,1,8,0,9,5,30,3,0,0,3,1,-15,3,1
2,0,27,1,30,3,12,0,15,5,30,1,1,0,2,0,30,3,12,0,15,3,30,7,8,0,15,6,30,6,0,0,6,1,-15,3,1
2,2,30,3,30,3,2,0,5,3,30,2,0,0,2,1,30,2,3,0,5,9,30,1,4,0,5,2,30,3,0,0,3,1,-15,3,1
2,4,30,3,30,3,2,0,5,3,30,2,0,0,2,1,30,2,3,0,5,9,30,1,4,0,5,2,30,3,0,0,3,1,-15,3,1
2,1,33,1,30,5,6,0,11,4,30,4,0,0,4,0,30,10,1,0,11,3,30,4,7,0,11,7,30,4,0,0,4,1,-15,3,1
2,2,33,1,30,5,6,0,11,4,30,4,0,0,4,0,30,10,1,0,11,3,30,4,7,0,11,7,30,4,0,0,4,1,-15,3,1
2,3,33,1,30,5,6,0,11,4,30,4,0,0,4,0,30,10,1,0,11,3,30,4,7,0,11,7,30,4,0,0,4,1,-15,3,1
2,1,17,4,30,9,5,0,14,3,30,6,0,0,6,0,30,6,8,0,14,1,30,7,7,0,14,4,30,4,0,0,4,1,-15,3,1
2,3,19,0,30,3,10,0,13,2,30,6,2,0,8,0,30,4,9,0,13,0,30,5,8,0,13,1,30,8,1,0,9,1,-15,3,1
2,1,25,1,30,8,6,0,14,2,30,5,1,0,6,0,30,7,7,0,14,1,30,4,10,0,14,4,30,5,1,0,6,1,-15,3,1
2,4,25,1,30,8,6,0,14,2,30,5,1,0,6,0,30,7,7,0,14,1,30,4,10,0,14,4,30,5,1,0,6,1,-15,3,1
2,4,27,0,30,4,11,0,15,3,30,2,0,0,2,0,30,6,9,0,15,5,30,5,10,0,15,4,30,6,0,0,6,1,-15,3,1
2,1,29,0,30,7,7,0,14,4,30,11,1,0,12,0,30,4,10,0,14,0,30,1,13,0,14,3,30,9,0,0,9,1,-15,3,1
2,3,29,0,30,7,7,0,14,4,30,11,1,0,12,0,30,4,10,0,14,0,30,1,13,0,14,3,30,9,0,0,9,1,-15,3,1
2,4,29,0,30,7,7,0,14,4,30,11,1,0,12,0,30,4,10,0,14,0,30,1,13,0,14,3,30,9,0,0,9,1,-15,3,1
2,3,5,0,30,1,4,0,5,2,30,4,0,0,4,0,30,0,5,0,5,0,30,1,4,0,5,4,30,0,2,0,2,0,-27,3,0
2,3,17,2,30,10,4,0,14,2,30,6,0,0,6,0,30,8,6,0,14,0,30,9,5,0,14,6,30,4,0,0,4,1,-15,3,1
2,2,19,0,30,3,10,0,13,2,30,3,5,0,8,0,30,4,9,0,13,8,30,6,7,0,13,1,30,9,0,0,9,1,-15,3,1
2,3,25,1,30,6,8,0,14,5,30,6,0,0,6,0,30,6,8,0,14,1,30,5,9,0,14,4,30,5,1,0,6,1,-15,3,1
2,4,27,1,30,9,6,0,15,4,30,2,0,0,2,0,30,5,10,0,15,2,30,5,10,0,15,3,30,6,0,0,6,1,-15,3,1
2,3,13,0,30,5,2,0,7,1,30,4,0,0,4,2,30,6,1,0,7,4,30,7,0,0,7,2,30,4,0,0,4,1,-15,3,1
2,3,15,1,30,4,9,0,13,0,30,6,0,0,6,0,30,3,10,0,13,1,30,4,9,0,13,2,30,7,2,0,9,1,-15,3,1
2,2,17,3,30,8,6,0,14,3,30,6,0,0,6,0,30,5,9,0,14,3,30,5,9,0,14,4,30,4,0,0,4,1,-15,3,1
2,4,17,3,30,8,6,0,14,3,30,6,0,0,6,0,30,5,9,0,14,0,30,5,9,0,14,4,30,4,0,0,4,1,-15,3,1
2,2,19,0,30,2,11,0,13,2,30,4,4,0,8,0,30,9,4,0,13,9,30,6,7,0,13,3,30,8,1,0,9,1,-15,3,1
2,4,25,1,30,12,2,0,14,3,30,6,0,0,6,0,30,6,8,0,14,1,30,5,9,0,14,3,30,4,2,0,6,1,-15,3,1
2,1,27,2,30,10,5,0,15,2,30,2,0,0,2,0,30,7,8,0,15,1,30,3,12,0,15,1,30,4,2,0,6,1,-15,3,1
2,2,27,2,30,10,5,0,15,2,30,2,0,0,2,0,30,7,8,0,15,1,30,3,12,0,15,1,30,4,2,0,6,1,-15,3,1
2,2,31,0,30,7,5,0,12,5,30,8,0,0,8,3,30,5,7,0,12,0,30,3,9,0,12,2,30,2,4,0,6,1,-15,3,1
2,4,5,0,30,2,3,0,5,3,30,1,3,0,4,0,30,1,4,0,5,3,30,1,4,0,5,1,30,1,1,0,2,0,-27,3,0
2,2,13,1,30,5,2,0,7,1,30,4,0,0,4,3,30,7,0,0,7,6,30,6,1,0,7,0,30,4,0,0,4,1,-15,3,1
2,0,17,5,30,10,4,0,14,3,30,6,0,0,6,0,30,4,10,0,14,1,30,6,8,0,14,3,30,4,0,0,4,1,-15,3,1
2,3,17,5,30,10,4,0,14,3,30,6,0,0,6,0,30,4,10,0,14,1,30,6,8,0,14,3,30,4,0,0,4,1,-15,3,1
2,4,17,5,30,10,4,0,14,3,30,6,0,0,6,0,30,4,10,0,14,1,30,6,8,0,14,3,30,4,0,0,4,1,-15,3,1
2,3,19,0,30,5,8,0,13,2,30,3,5,0,8,0,30,4,9,0,13,3,30,4,9,0,13,1,30,8,1,0,9,1,-15,3,1
2,1,25,1,30,7,7,0,14,4,30,5,1,0,6,0,30,6,8,0,14,1,30,4,10,0,14,6,30,5,1,0,6,1,-15,3,1
2,2,25,1,30,7,7,0,14,4,30,5,1,0,6,0,30,6,8,0,14,1,30,4,10,0,14,6,30,5,1,0,6,1,-15,3,1
2,4,25,1,30,7,7,0,14,4,30,5,1,0,6,0,30,6,8,0,14,1,30,4,10,0,14,6,30,5,1,0,6,1,-15,3,1
2,1,27,0,30,4,11,0,15,3,30,2,0,0,2,0,30,3,12,0,15,2,30,4,11,0,15,5,30,6,0,0,6,1,-15,3,1
2,4,29,0,30,7,7,0,14,6,30,10,2,0,12,0,30,5,9,0,14,0,30,1,13,0,14,2,30,9,0,0,9,1,-15,3,1
2,3,33,1,30,2,9,0,11,5,30,4,0,0,4,1,30,11,0,0,11,1,30,4,7,0,11,4,30,4,0,0,4,1,-15,3,1
2,0,4,2,30,7,1,0,8,5,30,4,0,0,4,3,30,2,6,0,8,0,30,4,4,0,8,3,30,4,0,0,4,0,-27,3,0
2,4,4,2,30,7,1,0,8,5,30,4,0,0,4,0,30,2,6,0,8,0,30,4,4,0,8,3,30,4,0,0,4,0,-27,3,0
2,0,6,1,30,7,2,0,9,4,30,2,0,0,2,0,30,2,7,0,9,0,30,5,4,0,9,0,30,3,2,0,5,0,-27,3,0
2,2,13,1,30,6,1,0,7,0,30,4,0,0,4,2,30,5,2,0,7,9,30,5,2,0,7,3,30,4,0,0,4,1,-15,3,1
2,4,13,1,30,6,1,0,7,0,30,4,0,0,4,2,30,5,2,0,7,9,30,5,2,0,7,3,30,4,0,0,4,1,-15,3,1
2,4,15,0,30,4,9,0,13,0,30,6,0,0,6,0,30,7,6,0,13,1,30,8,5,0,13,3,30,4,5,0,9,1,-15,3,1
2,1,19,0,30,5,8,0,13,2,30,5,3,0,8,0,30,6,7,0,13,3,30,3,10,0,13,2,30,9,0,0,9,1,-15,3,1
2,4,19,0,30,5,8,0,13,0,30,5,3,0,8,0,30,6,7,0,13,3,30,3,10,0,13,2,30,9,0,0,9,1,-15,3,1
2,3,21,2,30,7,3,0,10,4,30,6,0,0,6,1,30,3,7,0,10,3,30,5,5,0,10,1,30,4,0,0,4,1,-15,3,1
2,4,21,2,30,7,3,0,10,4,30,6,0,0,6,1,30,3,7,0,10,3,30,5,5,0,10,1,30,4,0,0,4,1,-15,3,1
2,3,25,1,30,5,9,0,14,3,30,6,0,0,6,0,30,8,6,0,14,2,30,6,8,0,14,3,30,5,1,0,6,1,-15,3,1
2,4,25,1,30,5,9,0,14,3,30,6,0,0,6,0,30,8,6,0,14,2,30,6,8,0,14,3,30,5,1,0,6,1,-15,3,1
2,2,27,1,30,5,10,0,15,3,30,2,0,0,2,0,30,6,9,0,15,2,30,6,9,0,15,2,30,6,0,0,6,1,-15,3,1
2,3,27,1,30,5,10,0,15,3,30,2,0,0,2,0,30,6,9,0,15,2,30,6,9,0,15,2,30,6,0,0,6,1,-15,3,1
2,4,27,1,30,5,10,0,15,3,30,2,0,0,2,0,30,6,9,0,15,2,30,6,9,0,15,2,30,6,0,0,6,1,-15,3,1
2,3,29,0,30,6,8,0,14,5,30,12,0,0,12,0,30,3,11,0,14,0,30,1,13,0,14,3,30,9,0,0,9,1,-15,3,1
2,4,31,1,30,6,6,0,12,5,30,8,0,0,8,3,30,8,4,0,12,3,30,8,4,0,12,0,30,4,2,0,6,1,-15,3,1
2,2,47,0,30,0,14,0,14,6,30,4,0,0,4,0,30,8,6,0,14,0,30,2,12,0,14,5,30,7,0,0,7,1,-15,3,1
2,3,47,0,30,0,14,0,14,6,30,4,0,0,4,0,30,8,6,0,14,0,30,2,12,0,14,5,30,7,0,0,7,1,-15,3,1
2,4,47,0,30,0,14,0,14,6,30,4,0,0,4,0,30,8,6,0,14,0,30,2,12,0,14,5,30,7,0,0,7,1,-15,3,1
2,0,4,2,30,7,1,0,8,5,30,4,0,0,4,1,30,2,6,0,8,1,30,8,0,0,8,2,30,4,0,0,4,0,-27,3,0
2,1,5,5,30,2,3,0,5,3,30,0,4,0,4,0,30,0,5,0,5,0,30,1,4,0,5,0,30,0,2,0,2,0,-27,3,0
2,2,13,2,30,6,1,0,7,1,30,4,0,0,4,2,30,5,2,0,7,2,30,7,0,0,7,4,30,4,0,0,4,1,-15,3,1
2,2,19,0,30,3,10,0,13,1,30,5,3,0,8,0,30,8,5,0,13,7,30,3,10,0,13,2,30,8,1,0,9,1,-15,3,1
2,3,22,2,30,5,3,0,8,2,30,2,0,0,2,0,30,4,4,0,8,0,30,5,3,0,8,5,30,4,0,0,4,1,-15,3,1
2,4,23,2,30,9,4,0,13,2,30,6,0,0,6,0,30,7,6,0,13,0,30,4,9,0,13,3,30,6,0,0,6,1,-15,3,1
2,1,27,1,30,8,7,0,15,2,30,2,0,0,2,0,30,7,8,0,15,0,30,3,12,0,15,2,30,5,1,0,6,1,-15,3,1
2,3,27,1,30,8,7,0,15,2,30,2,0,0,2,0,30,7,8,0,15,0,30,3,12,0,15,2,30,5,1,0,6,1,-15,3,1
2,4,27,1,30,8,7,0,15,2,30,2,0,0,2,0,30,7,8,0,15,0,30,3,12,0,15,2,30,5,1,0,6,1,-15,3,1
2,2,31,1,30,6,6,0,12,7,30,8,0,0,8,3,30,4,8,0,12,0,30,8,4,0,12,0,30,6,0,0,6,1,-15,3,1
2,3,31,1,30,6,6,0,12,7,30,8,0,0,8,3,30,4,8,0,12,0,30,8,4,0,12,0,30,6,0,0,6,1,-15,3,1
2,1,35,0,30,8,5,0,13,2,30,2,0,0,2,1,30,6,7,0,13,2,30,2,11,0,13,4,30,8,0,0,8,1,-15,3,1
2,1,41,0,30,7,5,0,12,6,30,8,0,0,8,0,30,8,4,0,12,0,30,3,9,0,12,5,30,7,0,0,7,1,-15,3,1
2,3,41,0,30,7,5,0,12,6,30,8,0,0,8,0,30,8,4,0,12,0,30,3,9,0,12,5,30,7,0,0,7,1,-15,3,1
2,4,3,0,30,0,4,0,4,2,30,4,0,0,4,0,30,0,4,0,4,8,30,2,2,0,4,0,30,2,1,0,3,0,-27,3,0
2,3,4,3,30,7,1,0,8,3,30,4,0,0,4,0,30,5,3,0,8,2,30,4,4,0,8,1,30,2,2,0,4,0,-27,3,0
2,1,17,4,30,9,5,0,14,4,30,6,0,0,6,0,30,4,10,0,14,1,30,9,5,0,14,2,30,4,0,0,4,1,-15,3,1
2,2,17,4,30,9,5,0,14,4,30,6,0,0,6,0,30,4,10,0,14,1,30,9,5,0,14,2,30,4,0,0,4,1,-15,3,1
2,3,17,4,30,9,5,0,14,4,30,6,0,0,6,0,30,4,10,0,14,1,30,9,5,0,14,2,30,4,0,0,4,1,-15,3,1
2,4,19,0,30,4,9,0,13,2,30,8,0,0,8,4,30,7,6,0,13,0,30,4,9,0,13,1,30,7,2,0,9,1,-15,3,1
2,3,25,1,30,1,13,0,14,6,30,6,0,0,6,0,30,6,8,0,14,1,30,4,10,0,14,6,30,6,0,0,6,1,-15,3,1
2,0,27,1,30,4,11,0,15,3,30,1,1,0,2,0,30,8,7,0,15,0,30,10,5,0,15,1,30,4,2,0,6,1,-15,3,1
2,1,27,1,30,4,11,0,15,3,30,1,1,0,2,0,30,8,7,0,15,0,30,10,5,0,15,1,30,4,2,0,6,1,-15,3,1
2,2,27,1,30,4,11,0,15,3,30,1,1,0,2,0,30,8,7,0,15,0,30,10,5,0,15,1,30,4,2,0,6,1,-15,3,1
2,3,27,1,30,4,11,0,15,3,30,1,1,0,2,0,30,8,7,0,15,0,30,10,5,0,15,1,30,4,2,0,6,1,-15,3,1
2,2,29,1,30,8,6,0,14,5,30,8,4,0,12,0,30,7,7,0,14,0,30,0,14,0,14,1,30,9,0,0,9,1,-15,3,1
2,3,29,1,30,8,6,0,14,5,30,8,4,0,12,0,30,7,7,0,14,0,30,0,14,0,14,1,30,9,0,0,9,1,-15,3,1
2,3,31,0,30,5,7,0,12,4,30,8,0,0,8,3,30,8,4,0,12,0,30,5,7,0,12,1,30,3,3,0,6,1,-15,3,1
2,3,35,0,30,8,5,0,13,6,30,2,0,0,2,0,30,2,11,0,13,4,30,4,9,0,13,10,30,8,0,0,8,1,-15,3,1
2,2,17,4,30,8,6,0,14,3,30,6,0,0,6,0,30,7,7,0,14,3,30,7,7,0,14,5,30,4,0,0,4,1,-15,3,1
2,4,22,2,30,6,2,0,8,3,30,2,0,0,2,2,30,4,4,0,8,1,30,4,4,0,8,3,30,2,2,0,4,1,-15,3,1
2,0,25,0,30,6,8,0,14,4,30,6,0,0,6,0,30,7,7,0,14,1,30,6,8,0,14,6,30,6,0,0,6,1,-15,3,1
2,1,27,3,30,8,7,0,15,3,30,2,0,0,2,0,30,3,12,0,15,0,30,4,11,0,15,1,30,3,3,0,6,1,-15,3,1
2,1,31,3,30,6,6,0,12,5,30,8,0,0,8,3,30,8,4,0,12,0,30,3,9,0,12,1,30,5,1,0,6,1,-15,3,1
2,4,31,3,30,6,6,0,12,5,30,8,0,0,8,3,30,8,4,0,12,0,30,3,9,0,12,1,30,5,1,0,6,1,-15,3,1
2,2,35,0,30,13,0,0,13,5,30,2,0,0,2,1,30,3,10,0,13,4,30,1,12,0,13,7,30,8,0,0,8,1,-15,3,1
2,3,35,0,30,13,0,0,13,5,30,2,0,0,2,1,30,3,10,0,13,4,30,1,12,0,13,7,30,8,0,0,8,1,-15,3,1
2,1,5,0,30,1,4,0,5,2,30,3,1,0,4,1,30,2,3,0,5,0,30,1,4,0,5,0,30,0,2,0,2,0,-27,3,0
2,2,5,0,30,1,4,0,5,2,30,3,1,0,4,1,30,2,3,0,5,0,30,1,4,0,5,0,30,0,2,0,2,0,-27,3,0
2,3,5,0,30,1,4,0,5,2,30,3,1,0,4,1,30,2,3,0,5,0,30,1,4,0,5,0,30,0,2,0,2,0,-27,3,0
2,4,15,0,30,4,9,0,13,0,30,6,0,0,6,0,30,4,9,0,13,1,30,6,7,0,13,2,30,4,5,0,9,1,-15,3,1
2,2,17,0,30,10,4,0,14,3,30,6,0,0,6,0,30,4,10,0,14,1,30,6,8,0,14,1,30,4,0,0,4,1,-15,3,1
2,3,17,0,30,10,4,0,14,3,30,6,0,0,6,0,30,4,10,0,14,1,30,6,8,0,14,1,30,4,0,0,4,1,-15,3,1
2,2,21,4,30,9,1,0,10,4,30,6,0,0,6,1,30,3,7,0,10,3,30,5,5,0,10,2,30,4,0,0,4,1,-15,3,1
2,4,21,4,30,9,1,0,10,4,30,6,0,0,6,1,30,3,7,0,10,3,30,5,5,0,10,2,30,4,0,0,4,1,-15,3,1
2,1,27,1,30,7,8,0,15,2,30,2,0,0,2,0,30,11,4,0,15,0,30,4,11,0,15,0,30,3,3,0,6,1,-15,3,1
2,4,27,1,30,7,8,0,15,0,30,2,0,0,2,0,30,11,4,0,15,0,30,4,11,0,15,0,30,3,3,0,6,1,-15,3,1
2,0,31,1,30,5,7,0,12,7,30,8,0,0,8,3,30,4,8,0,12,0,30,6,6,0,12,3,30,6,0,0,6,1,-15,3,1
2,2,31,1,30,5,7,0,12,7,30,8,0,0,8,3,30,4,8,0,12,0,30,6,6,0,12,3,30,6,0,0,6,1,-15,3,1
2,3,31,1,30,5,7,0,12,7,30,8,0,0,8,3,30,4,8,0,12,0,30,6,6,0,12,3,30,6,0,0,6,1,-15,3,1
2,2,35,0,30,5,8,0,13,2,30,2,0,0,2,2,30,11,2,0,13,9,30,0,13,0,13,5,30,8,0,0,8,1,-15,3,1
2,4,35,0,30,5,8,0,13,2,30,2,0,0,2,2,30,11,2,0,13,9,30,0,13,0,13,5,30,8,0,0,8,1,-15,3,1
2,3,39,0,30,4,7,0,11,7,30,6,0,0,6,0,30,4,7,0,11,0,30,4,7,0,11,7,30,5,0,0,5,1,-15,3,1
2,4,47,0,30,0,14,0,14,8,30,4,0,0,4,0,30,8,6,0,14,1,30,3,11,0,14,0,30,7,0,0,7,1,-15,3,1
2,4,11,2,30,7,5,0,12,0,30,4,0,0,4,0,30,8,4,0,12,0,30,6,6,0,12,4,30,4,0,0,4,1,-15,3,1
2,2,19,0,30,5,8,0,13,2,30,6,2,0,8,0,30,5,8,0,13,4,30,6,7,0,13,0,30,8,1,0,9,1,-15,3,1
2,3,19,0,30,5,8,0,13,2,30,6,2,0,8,0,30,5,8,0,13,4,30,6,7,0,13,0,30,8,1,0,9,1,-15,3,1
2,1,25,2,30,7,7,0,14,2,30,6,0,0,6,0,30,11,3,0,14,1,30,5,9,0,14,4,30,4,2,0,6,1,-15,3,1
2,4,25,0,30,7,7,0,14,2,30,6,0,0,6,0,30,11,3,0,14,1,30,5,9,0,14,4,30,4,2,0,6,1,-15,3,1
2,2,27,1,30,4,11,0,15,4,30,2,0,0,2,0,30,5,10,0,15,0,30,4,11,0,15,2,30,6,0,0,6,1,-15,3,1
2,3,29,2,30,6,8,0,14,7,30,12,0,0,12,0,30,4,10,0,14,0,30,1,13,0,14,2,30,9,0,0,9,1,-15,3,1
2,4,29,2,30,6,8,0,14,7,30,12,0,0,12,0,30,4,10,0,14,0,30,1,13,0,14,2,30,9,0,0,9,1,-15,3,1
2,3,35,2,30,13,0,0,13,6,30,2,0,0,2,1,30,2,11,0,13,0,30,1,12,0,13,9,30,8,0,0,8,1,-15,3,1
2,0,47,0,30,3,11,0,14,6,30,4,0,0,4,0,30,4,10,0,14,0,30,7,7,0,14,10,30,7,0,0,7,1,-15,3,1
2,3,4,2,30,8,0,0,8,5,30,4,0,0,4,0,30,2,6,0,8,1,30,7,1,0,8,2,30,3,1,0,4,0,-27,3,0
2,4,4,2,30,8,0,0,8,5,30,4,0,0,4,0,30,2,6,0,8,1,30,7,1,0,8,2,30,3,1,0,4,0,-27,3,0
2,4,8,1,30,7,0,0,7,4,30,2,0,0,2,2,30,3,4,0,7,0,30,2,5,0,7,1,30,3,0,0,3,0,-27,3,0
2,4,13,1,30,6,1,0,7,0,30,4,0,0,4,0,30,6,1,0,7,8,30,6,1,0,7,4,30,4,0,0,4,1,-15,3,1
2,2,17,4,30,11,3,0,14,3,30,6,0,0,6,0,30,4,10,0,14,0,30,5,9,0,14,1,30,3,1,0,4,1,-15,3,1
2,3,17,4,30,11,3,0,14,3,30,6,0,0,6,0,30,4,10,0,14,0,30,5,9,0,14,1,30,3,1,0,4,1,-15,3,1
2,3,21,0,30,6,4,0,10,3,30,4,2,0,6,0,30,4,6,0,10,4,30,5,5,0,10,3,30,4,0,0,4,1,-15,3,1
2,3,25,1,30,8,6,0,14,3,30,6,0,0,6,0,30,6,8,0,14,1,30,9,5,0,14,5,30,5,1,0,6,1,-15,3,1
2,0,27,1,30,4,11,0,15,4,30,0,2,0,2,0,30,5,10,0,15,1,30,7,8,0,15,4,30,6,0,0,6,1,-15,3,1
2,2,29,0,30,8,6,0,14,6,30,11,1,0,12,0,30,3,11,0,14,0,30,3,11,0,14,0,30,7,2,0,9,1,-15,3,1
2,3,29,0,30,8,6,0,14,6,30,11,1,0,12,0,30,3,11,0,14,0,30,3,11,0,14,0,30,7,2,0,9,1,-15,3,1
2,4,29,0,30,8,6,0,14,6,30,11,1,0,12,0,30,3,11,0,14,0,30,3,11,0,14,0,30,7,2,0,9,1,-15,3,1
2,4,31,5,30,8,4,0,12,6,30,8,0,0,8,5,30,6,6,0,12,0,30,3,9,0,12,0,30,3,3,0,6,1,-15,3,1
2,1,5,0,30,2,3,0,5,2,30,3,1,0,4,1,30,2,3,0,5,0,30,3,2,0,5,0,30,0,2,0,2,0,-27,3,0
2,4,11,0,30,4,8,0,12,0,30,4,0,0,4,0,30,7,5,0,12,6,30,4,8,0,12,5,30,4,0,0,4,1,-15,3,1
2,3,15,0,30,5,8,0,13,0,30,5,1,0,6,0,30,3,10,0,13,1,30,2,11,0,13,2,30,6,3,0,9,1,-15,3,1
2,4,15,0,30,5,8,0,13,0,30,5,1,0,6,0,30,3,10,0,13,1,30,2,11,0,13,2,30,6,3,0,9,1,-15,3,1
2,2,17,2,30,9,5,0,14,3,30,6,0,0,6,0,30,5,9,0,14,3,30,7,7,0,14,5,30,4,0,0,4,1,-15,3,1
2,3,17,2,30,9,5,0,14,3,30,6,0,0,6,0,30,5,9,0,14,3,30,7,7,0,14,5,30,4,0,0,4,1,-15,3,1
2,3,22,2,30,8,0,0,8,3,30,2,0,0,2,0,30,5,3,0,8,1,30,4,4,0,8,2,30,2,2,0,4,1,-15,3,1
2,4,22,2,30,8,0,0,8,3,30,2,0,0,2,0,30,5,3,0,8,1,30,4,4,0,8,2,30,2,2,0,4,1,-15,3,1
2,4,23,2,30,7,6,0,13,3,30,6,0,0,6,0,30,9,4,0,13,0,30,6,7,0,13,2,30,6,0,0,6,1,-15,3,1
2,4,25,1,30,7,7,0,14,2,30,6,0,0,6,0,30,6,8,0,14,1,30,7,7,0,14,1,30,5,1,0,6,1,-15,3,1
2,2,27,1,30,4,11,0,15,2,30,2,0,0,2,0,30,7,8,0,15,0,30,9,6,0,15,0,30,3,3,0,6,1,-15,3,1
2,4,27,1,30,4,11,0,15,2,30,2,0,0,2,0,30,7,8,0,15,0,30,9,6,0,15,0,30,3,3,0,6,1,-15,3,1
2,3,29,1,30,8,6,0,14,6,30,9,3,0,12,0,30,3,11,0,14,0,30,1,13,0,14,2,30,9,0,0,9,1,-15,3,1
2,4,29,1,30,8,6,0,14,6,30,9,3,0,12,0,30,3,11,0,14,0,30,1,13,0,14,2,30,9,0,0,9,1,-15,3,1
2,1,31,1,30,2,10,0,12,5,30,8,0,0,8,9,30,11,1,0,12,0,30,3,9,0,12,1,30,5,1,0,6,1,-15,3,1
2,3,31,1,30,2,10,0,12,5,30,8,0,0,8,9,30,11,1,0,12,0,30,3,9,0,12,1,30,5,1,0,6,1,-15,3,1
2,4,3,0,30,3,1,0,4,2,30,4,0,0,4,0,30,1,3,0,4,0,30,0,4,0,4,0,30,1,2,0,3,0,-27,3,0
2,1,11,6,30,5,7,0,12,1,30,4,0,0,4,2,30,9,3,0,12,4,30,6,6,0,12,4,30,4,0,0,4,1,-15,3,1
2,4,11,6,30,5,7,0,12,1,30,4,0,0,4,2,30,9,3,0,12,4,30,6,6,0,12,1,30,4,0,0,4,1,-15,3,1
2,2,13,1,30,5,2,0,7,0,30,4,0,0,4,1,30,6,1,0,7,5,30,6,1,0,7,6,30,4,0,0,4,1,-15,3,1
2,4,13,1,30,5,2,0,7,0,30,4,0,0,4,1,30,6,1,0,7,5,30,6,1,0,7,6,30,4,0,0,4,1,-15,3,1
2,3,23,2,30,6,7,0,13,4,30,6,0,0,6,7,30,11,2,0,13,0,30,4,9,0,13,4,30,6,0,0,6,1,-15,3,1
2,2,25,1,30,8,6,0,14,5,30,6,0,0,6,0,30,6,8,0,14,1,30,7,7,0,14,3,30,5,1,0,6,1,-15,3,1
2,3,25,1,30,8,6,0,14,5,30,6,0,0,6,0,30,6,8,0,14,1,30,7,7,0,14,3,30,5,1,0,6,1,-15,3,1
2,4,25,1,30,8,6,0,14,5,30,6,0,0,6,0,30,6,8,0,14,1,30,7,7,0,14,3,30,5,1,0,6,1,-15,3,1
2,1,29,1,30,6,8,0,14,6,30,11,1,0,12,0,30,2,12,0,14,0,30,1,13,0,14,4,30,9,0,0,9,1,-15,3,1
2,3,29,1,30,6,8,0,14,6,30,11,1,0,12,0,30,2,12,0,14,0,30,1,13,0,14,4,30,9,0,0,9,1,-15,3,1
2,4,29,1,30,6,8,0,14,6,30,11,1,0,12,0,30,2,12,0,14,0,30,1,13,0,14,4,30,9,0,0,9,1,-15,3,1
2,4,32,0,30,8,1,0,9,4,30,2,0,0,2,3,30,7,2,0,9,1,30,2,7,0,9,2,30,1,1,0,2,1,-15,3,1
2,3,45,0,30,6,7,0,13,9,30,10,0,0,10,0,30,5,8,0,13,0,30,8,5,0,13,9,30,5,0,0,5,1,-15,3,1
2,0,4,2,30,6,2,0,8,4,30,3,1,0,4,2,30,3,5,0,8,0,30,8,0,0,8,2,30,3,1,0,4,0,-27,3,0
2,4,7,0,30,2,2,0,4,2,30,2,0,0,2,2,30,2,2,0,4,0,30,0,4,0,4,1,30,1,1,0,2,0,-27,3,0
2,3,8,1,30,7,0,0,7,3,30,2,0,0,2,0,30,3,4,0,7,0,30,4,3,0,7,4,30,3,0,0,3,0,-27,3,0
2,2,17,2,30,9,5,0,14,2,30,6,0,0,6,0,30,8,6,0,14,5,30,5,9,0,14,5,30,4,0,0,4,1,-15,3,1
2,0,19,0,30,2,11,0,13,2,30,4,4,0,8,0,30,5,8,0,13,6,30,5,8,0,13,3,30,9,0,0,9,1,-15,3,1
2,2,19,0,30,2,11,0,13,2,30,4,4,0,8,0,30,5,8,0,13,6,30,5,8,0,13,3,30,9,0,0,9,1,-15,3,1
2,4,19,0,30,2,11,0,13,2,30,4,4,0,8,0,30,5,8,0,13,6,30,5,8,0,13,3,30,9,0,0,9,1,-15,3,1
2,2,23,2,30,7,6,0,13,3,30,6,0,0,6,6,30,12,1,0,13,0,30,5,8,0,13,2,30,5,1,0,6,1,-15,3,1
2,4,23,2,30,7,6,0,13,3,30,6,0,0,6,6,30,12,1,0,13,0,30,5,8,0,13,2,30,5,1,0,6,1,-15,3,1
2,4,25,0,30,9,5,0,14,5,30,6,0,0,6,0,30,5,9,0,14,1,30,5,9,0,14,4,30,5,1,0,6,1,-15,3,1
2,4,27,2,30,5,10,0,15,2,30,2,0,0,2,0,30,5,10,0,15,0,30,7,8,0,15,1,30,3,3,0,6,1,-15,3,1
2,2,31,1,30,3,9,0,12,5,30,8,0,0,8,3,30,11,1,0,12,0,30,3,9,0,12,3,30,5,1,0,6,1,-15,3,1
2,3,35,4,30,11,2,0,13,5,30,2,0,0,2,3,30,2,11,0,13,0,30,1,12,0,13,2,30,8,0,0,8,1,-15,3,1
2,3,47,0,30,1,13,0,14,5,30,4,0,0,4,0,30,4,10,0,14,0,30,2,12,0,14,7,30,7,0,0,7,1,-15,3,1
2,3,8,2,30,7,0,0,7,5,30,2,0,0,2,0,30,1,6,0,7,1,30,7,0,0,7,1,30,3,0,0,3,0,-27,3,0
2,1,13,1,30,5,2,0,7,0,30,4,0,0,4,1,30,6,1,0,7,8,30,6,1,0,7,4,30,4,0,0,4,1,-15,3,1
2,1,17,6,30,10,4,0,14,3,30,6,0,0,6,0,30,5,9,0,14,1,30,4,10,0,14,3,30,4,0,0,4,1,-15,3,1
2,3,17,6,30,10,4,0,14,3,30,6,0,0,6,0,30,5,9,0,14,1,30,4,10,0,14,3,30,4,0,0,4,1,-15,3,1
2,3,19,0,30,4,9,0,13,2,30,7,1,0,8,0,30,4,9,0,13,0,30,4,9,0,13,2,30,8,1,0,9,1,-15,3,1
2,2,21,1,30,6,4,0,10,3,30,4,2,0,6,0,30,3,7,0,10,2,30,4,6,0,10,1,30,4,0,0,4,1,-15,3,1
2,4,23,1,30,8,5,0,13,3,30,6,0,0,6,5,30,9,4,0,13,0,30,5,8,0,13,5,30,6,0,0,6,1,-15,3,1
2,2,25,1,30,7,7,0,14,5,30,6,0,0,6,0,30,7,7,0,14,1,30,5,9,0,14,4,30,5,1,0,6,1,-15,3,1
2,1,27,1,30,4,11,0,15,4,30,1,1,0,2,0,30,4,11,0,15,3,30,5,10,0,15,5,30,6,0,0,6,1,-15,3,1
2,4,27,1,30,4,11,0,15,4,30,1,1,0,2,0,30,4,11,0,15,3,30,5,10,0,15,5,30,6,0,0,6,1,-15,3,1
2,1,29,0,30,4,10,0,14,4,30,11,1,0,12,0,30,4,10,0,14,0,30,1,13,0,14,0,30,6,3,0,9,1,-15,3,1
2,2,29,0,30,4,10,0,14,4,30,11,1,0,12,0,30,4,10,0,14,0,30,1,13,0,14,0,30,6,3,0,9,1,-15,3,1
2,4,29,0,30,4,10,0,14,4,30,11,1,0,12,0,30,4,10,0,14,0,30,1,13,0,14,0,30,6,3,0,9,1,-15,3,1
2,1,4,3,30,7,1,0,8,4,30,4,0,0,4,1,30,5,3,0,8,0,30,5,3,0,8,1,30,4,0,0,4,0,-27,3,0
2,2,4,3,30,7,1,0,8,4,30,4,0,0,4,1,30,5,3,0,8,0,30,5,3,0,8,1,30,4,0,0,4,0,-27,3,0
2,4,4,3,30,7,1,0,8,4,30,4,0,0,4,1,30,5,3,0,8,0,30,5,3,0,8,1,30,4,0,0,4,0,-27,3,0
2,3,11,4,30,6,6,0,12,2,30,4,0,0,4,0,30,4,8,0,12,0,30,4,8,0,12,4,30,4,0,0,4,1,-15,3,1
2,2,13,1,30,6,1,0,7,0,30,4,0,0,4,2,30,6,1,0,7,6,30,5,2,0,7,4,30,4,0,0,4,1,-15,3,1
2,1,17,4,30,8,6,0,14,4,30,6,0,0,6,0,30,7,7,0,14,7,30,9,5,0,14,0,30,4,0,0,4,1,-15,3,1
2,4,22,1,30,6,2,0,8,2,30,2,0,0,2,0,30,5,3,0,8,1,30,1,7,0,8,2,30,2,2,0,4,1,-15,3,1
2,0,27,1,30,4,11,0,15,3,30,1,1,0,2,0,30,3,12,0,15,0,30,4,11,0,15,5,30,6,0,0,6,1,-15,3,1
2,1,27,1,30,4,11,0,15,3,30,1,1,0,2,0,30,3,12,0,15,0,30,4,11,0,15,5,30,6,0,0,6,1,-15,3,1
2,3,39,0,30,7,4,0,11,7,30,6,0,0,6,0,30,4,7,0,11,0,30,2,9,0,11,2,30,5,0,0,5,1,-15,3,1
2,4,39,0,30,7,4,0,11,7,30,6,0,0,6,0,30,4,7,0,11,0,30,2,9,0,11,2,30,5,0,0,5,1,-15,3,1
2,2,4,2,30,8,0,0,8,5,30,4,0,0,4,1,30,2,6,0,8,2,30,8,0,0,8,1,30,3,1,0,4,0,-27,3,0
2,4,8,0,30,6,1,0,7,4,30,2,0,0,2,0,30,3,4,0,7,0,30,4,3,0,7,4,30,3,0,0,3,0,-27,3,0
2,2,13,1,30,6,1,0,7,0,30,4,0,0,4,2,30,5,2,0,7,13,30,7,0,0,7,0,30,4,0,0,4,1,-15,3,1
2,2,25,0,30,7,7,0,14,2,30,6,0,0,6,0,30,11,3,0,14,1,30,4,10,0,14,4,30,5,1,0,6,1,-15,3,1
2,2,35,0,30,9,4,0,13,5,30,2,0,0,2,1,30,2,11,0,13,3,30,2,11,0,13,9,30,8,0,0,8,1,-15,3,1
2,2,1,0,30,7,3,0,10,4,30,2,0,0,2,1,30,4,6,0,10,9,30,9,1,0,10,3,30,6,0,0,6,0,-27,3,0
2,3,8,1,30,7,0,0,7,4,30,2,0,0,2,0,30,4,3,0,7,0,30,7,0,0,7,2,30,3,0,0,3,0,-27,3,0
2,4,8,1,30,7,0,0,7,4,30,2,0,0,2,0,30,4,3,0,7,0,30,7,0,0,7,2,30,3,0,0,3,0,-27,3,0
2,4,15,0,30,4,9,0,13,1,30,6,0,0,6,0,30,3,10,0,13,1,30,8,5,0,13,2,30,9,0,0,9,1,-15,3,1
2,4,17,3,30,11,3,0,14,2,30,6,0,0,6,0,30,6,8,0,14,0,30,5,9,0,14,3,30,4,0,0,4,1,-15,3,1
2,4,19,0,30,3,10,0,13,2,30,8,0,0,8,0,30,6,7,0,13,5,30,5,8,0,13,2,30,6,3,0,9,1,-15,3,1
2,1,23,1,30,7,6,0,13,2,30,6,0,0,6,5,30,13,0,0,13,0,30,5,8,0,13,2,30,5,1,0,6,1,-15,3,1
2,3,23,1,30,7,6,0,13,2,30,6,0,0,6,5,30,13,0,0,13,0,30,5,8,0,13,2,30,5,1,0,6,1,-15,3,1
2,2,31,5,30,7,5,0,12,5,30,8,0,0,8,3,30,7,5,0,12,0,30,3,9,0,12,1,30,3,3,0,6,1,-15,3,1
2,3,31,5,30,7,5,0,12,5,30,8,0,0,8,3,30,7,5,0,12,0,30,3,9,0,12,1,30,3,3,0,6,1,-15,3,1
2,0,47,0,30,2,12,0,14,4,30,4,0,0,4,2,30,12,2,0,14,4,30,4,10,0,14,7,30,7,0,0,7,1,-15,3,1
2,3,8,2,30,7,0,0,7,4,30,2,0,0,2,0,30,5,2,0,7,0,30,3,4,0,7,2,30,3,0,0,3,0,-27,3,0
2,1,13,2,30,7,0,0,7,0,30,4,0,0,4,2,30,6,1,0,7,15,30,5,2,0,7,2,30,4,0,0,4,1,-15,3,1
2,4,13,2,30,7,0,0,7,0,30,4,0,0,4,2,30,6,1,0,7,15,30,5,2,0,7,2,30,4,0,0,4,1,-15,3,1
2,2,17,4,30,11,3,0,14,3,30,6,0,0,6,0,30,4,10,0,14,1,30,6,8,0,14,4,30,4,0,0,4,1,-15,3,1
2,3,17,4,30,11,3,0,14,3,30,6,0,0,6,0,30,4,10,0,14,1,30,6,8,0,14,4,30,4,0,0,4,1,-15,3,1
2,4,17,4,30,11,3,0,14,3,30,6,0,0,6,0,30,4,10,0,14,1,30,6,8,0,14,4,30,4,0,0,4,1,-15,3,1
2,3,23,1,30,6,7,0,13,1,30,5,1,0,6,8,30,13,0,0,13,0,30,4,9,0,13,4,30,6,0,0,6,1,-15,3,1
2,4,23,1,30,6,7,0,13,1,30,5,1,0,6,8,30,13,0,0,13,0,30,4,9,0,13,4,30,6,0,0,6,1,-15,3,1
2,1,25,1,30,3,11,0,14,2,30,6,0,0,6,0,30,12,2,0,14,1,30,5,9,0,14,4,30,6,0,0,6,1,-15,3,1
2,2,25,1,30,3,11,0,14,2,30,6,0,0,6,0,30,12,2,0,14,1,30,5,9,0,14,4,30,6,0,0,6,1,-15,3,1
2,1,27,1,30,4,11,0,15,2,30,2,0,0,2,0,30,3,12,0,15,2,30,6,9,0,15,7,30,6,0,0,6,1,-15,3,1
2,2,27,1,30,4,11,0,15,2,30,2,0,0,2,0,30,3,12,0,15,2,30,6,9,0,15,7,30,6,0,0,6,1,-15,3,1
2,3,37,0,30,5,6,0,11,4,30,7,1,0,8,3,30,10,1,0,11,4,30,3,8,0,11,4,30,6,0,0,6,1,-15,3,1
2,3,43,0,30,7,7,0,14,8,30,6,0,0,6,0,30,4,10,0,14,1,30,1,13,0,14,4,30,5,0,0,5,1,-15,3,1
2,4,8,3,30,7,0,0,7,4,30,2,0,0,2,5,30,6,1,0,7,1,30,7,0,0,7,0,30,3,0,0,3,0,-27,3,0
2,4,13,2,30,5,2,0,7,0,30,4,0,0,4,3,30,7,0,0,7,8,30,7,0,0,7,2,30,4,0,0,4,1,-15,3,1
2,1,19,1,30,6,7,0,13,2,30,5,3,0,8,0,30,6,7,0,13,8,30,3,10,0,13,0,30,8,1,0,9,1,-15,3,1
2,0,25,0,30,5,9,0,14,5,30,6,0,0,6,0,30,3,11,0,14,4,30,10,4,0,14,4,30,6,0,0,6,1,-15,3,1
2,2,25,0,30,5,9,0,14,5,30,6,0,0,6,0,30,3,11,0,14,4,30,10,4,0,14,4,30,6,0,0,6,1,-15,3,1
2,3,27,1,30,11,4,0,15,5,30,2,0,0,2,2,30,2,13,0,15,0,30,3,12,0,15,1,30,6,0,0,6,1,-15,3,1
2,3,33,1,30,2,9,0,11,4,30,4,0,0,4,0,30,9,2,0,11,4,30,4,7,0,11,8,30,4,0,0,4,1,-15,3,1
2,2,38,0,30,2,8,0,10,8,30,6,0,0,6,0,30,1,9,0,10,7,30,2,8,0,10,1,30,6,0,0,6,1,-15,3,1
2,4,39,0,30,4,7,0,11,6,30,6,0,0,6,0,30,7,4,0,11,1,30,5,6,0,11,3,30,5,0,0,5,1,-15,3,1
2,2,6,0,30,7,2,0,9,4,30,2,0,0,2,0,30,3,6,0,9,0,30,4,5,0,9,2,30,5,0,0,5,0,-27,3,0
2,4,6,0,30,7,2,0,9,4,30,2,0,0,2,0,30,3,6,0,9,0,30,4,5,0,9,2,30,5,0,0,5,0,-27,3,0
2,2,13,1,30,7,0,0,7,0,30,4,0,0,4,2,30,6,1,0,7,6,30,5,2,0,7,1,30,4,0,0,4,1,-15,3,1
2,4,17,0,30,11,3,0,14,1,30,6,0,0,6,0,30,6,8,0,14,0,30,5,9,0,14,2,30,4,0,0,4,1,-15,3,1
2,4,23,2,30,6,7,0,13,0,30,6,0,0,6,4,30,13,0,0,13,0,30,5,8,0,13,2,30,6,0,0,6,1,-15,3,1
2,1,27,1,30,3,12,0,15,4,30,1,1,0,2,0,30,9,6,0,15,0,30,2,13,0,15,2,30,6,0,0,6,1,-15,3,1
2,3,27,1,30,3,12,0,15,4,30,1,1,0,2,0,30,9,6,0,15,0,30,2,13,0,15,2,30,6,0,0,6,1,-15,3,1
2,1,39,0,30,4,7,0,11,5,30,6,0,0,6,0,30,6,5,0,11,0,30,2,9,0,11,3,30,5,0,0,5,1,-15,3,1
2,2,39,0,30,4,7,0,11,5,30,6,0,0,6,0,30,6,5,0,11,0,30,2,9,0,11,3,30,5,0,0,5,1,-15,3,1
2,3,39,0,30,4,7,0,11,5,30,6,0,0,6,0,30,6,5,0,11,0,30,2,9,0,11,3,30,5,0,0,5,1,-15,3,1
2,1,4,0,30,6,2,0,8,4,30,4,0,0,4,1,30,2,6,0,8,0,30,8,0,0,8,5,30,4,0,0,4,0,-27,3,0
2,0,5,0,30,3,2,0,5,3,30,2,2,0,4,0,30,0,5,0,5,0,30,1,4,0,5,1,30,2,0,0,2,0,-27,3,0
2,1,5,0,30,3,2,0,5,3,30,2,2,0,4,0,30,0,5,0,5,0,30,1,4,0,5,1,30,2,0,0,2,0,-27,3,0
2,1,13,1,30,7,0,0,7,0,30,4,0,0,4,2,30,7,0,0,7,7,30,6,1,0,7,4,30,4,0,0,4,1,-15,3,1
2,4,19,0,30,4,9,0,13,2,30,6,2,0,8,0,30,6,7,0,13,4,30,6,7,0,13,0,30,7,2,0,9,1,-15,3,1
2,3,25,2,30,5,9,0,14,3,30,6,0,0,6,0,30,7,7,0,14,3,30,5,9,0,14,2,30,5,1,0,6,1,-15,3,1
2,4,25,2,30,5,9,0,14,3,30,6,0,0,6,0,30,7,7,0,14,3,30,5,9,0,14,2,30,5,1,0,6,1,-15,3,1
2,0,27,4,30,4,11,0,15,3,30,2,0,0,2,0,30,9,6,0,15,2,30,4,11,0,15,1,30,4,2,0,6,1,-15,3,1
2,2,5,0,30,2,3,0,5,3,30,1,3,0,4,3,30,1,4,0,5,0,30,1,4,0,5,0,30,0,2,0,2,0,-27,3,0
2,1,13,1,30,6,1,0,7,0,30,4,0,0,4,2,30,6,1,0,7,12,30,5,2,0,7,2,30,4,0,0,4,1,-15,3,1
2,2,13,1,30,6,1,0,7,0,30,4,0,0,4,2,30,6,1,0,7,12,30,5,2,0,7,2,30,4,0,0,4,1,-15,3,1
2,4,13,1,30,6,1,0,7,0,30,4,0,0,4,2,30,6,1,0,7,12,30,5,2,0,7,2,30,4,0,0,4,1,-15,3,1
2,3,17,7,30,9,5,0,14,3,30,6,0,0,6,0,30,5,9,0,14,0,30,3,11,0,14,5,30,4,0,0,4,1,-15,3,1
2,4,17,7,30,9,5,0,14,3,30,6,0,0,6,0,30,5,9,0,14,0,30,3,11,0,14,5,30,4,0,0,4,1,-15,3,1
2,4,21,2,30,5,5,0,10,3,30,6,0,0,6,1,30,5,5,0,10,1,30,3,7,0,10,0,30,4,0,0,4,1,-15,3,1
2,4,23,2,30,6,7,0,13,3,30,6,0,0,6,4,30,9,4,0,13,0,30,6,7,0,13,1,30,6,0,0,6,1,-15,3,1
2,0,25,2,30,3,11,0,14,4,30,6,0,0,6,0,30,6,8,0,14,3,30,9,5,0,14,4,30,6,0,0,6,1,-15,3,1
2,4,25,2,30,3,11,0,14,4,30,6,0,0,6,0,30,6,8,0,14,3,30,9,5,0,14,4,30,6,0,0,6,1,-15,3,1
2,2,27,1,30,4,11,0,15,3,30,2,0,0,2,0,30,3,12,0,15,0,30,3,12,0,15,5,30,5,1,0,6,1,-15,3,1
2,3,27,1,30,4,11,0,15,3,30,2,0,0,2,0,30,3,12,0,15,0,30,3,12,0,15,5,30,5,1,0,6,1,-15,3,1
2,3,31,0,30,5,7,0,12,4,30,8,0,0,8,5,30,10,2,0,12,0,30,4,8,0,12,0,30,4,2,0,6,1,-15,3,1
2,4,31,0,30,5,7,0,12,4,30,8,0,0,8,5,30,10,2,0,12,0,30,4,8,0,12,0,30,4,2,0,6,1,-15,3,1
2,3,45,0,30,9,4,0,13,11,30,10,0,0,10,0,30,0,13,0,13,0,30,5,8,0,13,8,30,5,0,0,5,1,-15,3,1
2,0,5,4,30,1,4,0,5,3,30,2,2,0,4,0,30,1,4,0,5,0,30,1,4,0,5,0,30,0,2,0,2,0,-27,3,0
2,2,5,4,30,1,4,0,5,3,30,2,2,0,4,0,30,1,4,0,5,0,30,1,4,0,5,0,30,0,2,0,2,0,-27,3,0
2,4,5,4,30,1,4,0,5,3,30,2,2,0,4,0,30,1,4,0,5,0,30,1,4,0,5,0,30,0,2,0,2,0,-27,3,0
2,4,21,2,30,6,4,0,10,2,30,6,0,0,6,0,30,7,3,0,10,1,30,4,6,0,10,1,30,4,0,0,4,1,-15,3,1
2,4,23,1,30,4,9,0,13,5,30,6,0,0,6,8,30,10,3,0,13,0,30,5,8,0,13,3,30,6,0,0,6,1,-15,3,1
2,3,25,1,30,2,12,0,14,5,30,6,0,0,6,0,30,7,7,0,14,1,30,8,6,0,14,3,30,6,0,0,6,1,-15,3,1
2,4,25,1,30,2,12,0,14,5,30,6,0,0,6,0,30,7,7,0,14,1,30,8,6,0,14,3,30,6,0,0,6,1,-15,3,1
2,0,27,1,30,5,10,0,15,5,30,1,1,0,2,0,30,3,12,0,15,1,30,5,10,0,15,3,30,6,0,0,6,1,-15,3,1
2,4,27,1,30,5,10,0,15,5,30,1,1,0,2,0,30,3,12,0,15,0,30,5,10,0,15,3,30,6,0,0,6,1,-15,3,1
2,2,29,0,30,5,9,0,14,6,30,12,0,0,12,0,30,4,10,0,14,0,30,0,14,0,14,2,30,9,0,0,9,1,-15,3,1
2,0,31,1,30,4,8,0,12,5,30,8,0,0,8,12,30,7,5,0,12,0,30,4,8,0,12,0,30,2,4,0,6,1,-15,3,1
2,3,35,3,30,13,0,0,13,4,30,2,0,0,2,1,30,2,11,0,13,0,30,3,10,0,13,1,30,8,0,0,8,1,-15,3,1
2,3,39,0,30,1,10,0,11,6,30,6,0,0,6,0,30,6,5,0,11,0,30,4,7,0,11,4,30,5,0,0,5,1,-15,3,1
2,4,39,0,30,1,10,0,11,6,30,6,0,0,6,0,30,6,5,0,11,0,30,4,7,0,11,4,30,5,0,0,5,1,-15,3,1
2,4,8,1,30,7,0,0,7,4,30,2,0,0,2,2,30,3,4,0,7,1,30,7,0,0,7,2,30,3,0,0,3,0,-27,3,0
2,4,11,2,30,4,8,0,12,1,30,4,0,0,4,0,30,5,7,0,12,2,30,4,8,0,12,2,30,4,0,0,4,1,-15,3,1
2,2,13,2,30,7,0,0,7,0,30,4,0,0,4,2,30,7,0,0,7,9,30,5,2,0,7,6,30,4,0,0,4,1,-15,3,1
2,4,15,0,30,3,10,0,13,1,30,6,0,0,6,0,30,3,10,0,13,1,30,6,7,0,13,2,30,4,5,0,9,1,-15,3,1
2,2,17,3,30,10,4,0,14,4,30,6,0,0,6,0,30,4,10,0,14,4,30,6,8,0,14,3,30,4,0,0,4,1,-15,3,1
2,4,17,3,30,10,4,0,14,4,30,6,0,0,6,0,30,4,10,0,14,4,30,6,8,0,14,3,30,4,0,0,4,1,-15,3,1
2,4,25,2,30,6,8,0,14,0,30,6,0,0,6,0,30,14,0,0,14,1,30,5,9,0,14,4,30,5,1,0,6,1,-15,3,1
2,1,27,1,30,4,11,0,15,4,30,2,0,0,2,0,30,5,10,0,15,0,30,5,10,0,15,5,30,6,0,0,6,1,-15,3,1
2,3,27,1,30,4,11,0,15,4,30,2,0,0,2,0,30,5,10,0,15,0,30,5,10,0,15,5,30,6,0,0,6,1,-15,3,1
2,1,33,3,30,5,6,0,11,4,30,4,0,0,4,4,30,10,1,0,11,5,30,4,7,0,11,4,30,4,0,0,4,1,-15,3,1
2,0,6,0,30,8,1,0,9,4,30,2,0,0,2,0,30,2,7,0,9,0,30,3,6,0,9,1,30,5,0,0,5,0,-27,3,0
2,1,6,0,30,8,1,0,9,4,30,2,0,0,2,0,30,2,7,0,9,0,30,3,6,0,9,1,30,5,0,0,5,0,-27,3,0
2,3,6,0,30,8,1,0,9,4,30,2,0,0,2,0,30,2,7,0,9,0,30,3,6,0,9,1,30,5,0,0,5,0,-27,3,0
2,4,6,0,30,8,1,0,9,4,30,2,0,0,2,0,30,2,7,0,9,0,30,3,6,0,9,1,30,5,0,0,5,0,-27,3,0
2,4,8,1,30,7,0,0,7,4,30,2,0,0,2,0,30,4,3,0,7,1,30,7,0,0,7,4,30,3,0,0,3,0,-27,3,0
2,2,11,3,30,6,6,0,12,1,30,4,0,0,4,0,30,6,6,0,12,2,30,6,6,0,12,4,30,4,0,0,4,1,-15,3,1
2,3,11,3,30,6,6,0,12,1,30,4,0,0,4,0,30,6,6,0,12,2,30,6,6,0,12,4,30,4,0,0,4,1,-15,3,1
2,4,13,2,30,7,0,0,7,0,30,4,0,0,4,2,30,6,1,0,7,8,30,6,1,0,7,2,30,4,0,0,4,1,-15,3,1
2,3,19,0,30,4,9,0,13,2,30,7,1,0,8,0,30,4,9,0,13,4,30,7,6,0,13,1,30,8,1,0,9,1,-15,3,1
2,4,19,0,30,4,9,0,13,2,30,7,1,0,8,0,30,4,9,0,13,4,30,7,6,0,13,1,30,8,1,0,9,1,-15,3,1
2,3,23,2,30,5,8,0,13,3,30,6,0,0,6,9,30,12,1,0,13,0,30,5,8,0,13,1,30,6,0,0,6,1,-15,3,1
2,3,25,1,30,9,5,0,14,3,30,6,0,0,6,0,30,8,6,0,14,1,30,5,9,0,14,4,30,5,1,0,6,1,-15,3,1
2,4,25,1,30,9,5,0,14,3,30,6,0,0,6,0,30,8,6,0,14,1,30,5,9,0,14,4,30,5,1,0,6,1,-15,3,1
2,4,27,3,30,4,11,0,15,3,30,2,0,0,2,0,30,10,5,0,15,0,30,4,11,0,15,1,30,4,2,0,6,1,-15,3,1
2,3,29,0,30,4,10,0,14,6,30,12,0,0,12,0,30,5,9,0,14,0,30,1,13,0,14,0,30,9,0,0,9,1,-15,3,1
2,4,29,0,30,4,10,0,14,6,30,12,0,0,12,0,30,5,9,0,14,0,30,1,13,0,14,0,30,9,0,0,9,1,-15,3,1
2,4,31,8,30,4,8,0,12,4,30,8,0,0,8,3,30,12,0,0,12,0,30,3,9,0,12,0,30,1,5,0,6,1,-15,3,1
2,0,5,0,30,3,2,0,5,3,30,1,3,0,4,0,30,0,5,0,5,1,30,1,4,0,5,2,30,2,0,0,2,0,-27,3,0
2,1,5,0,30,3,2,0,5,3,30,1,3,0,4,0,30,0,5,0,5,1,30,1,4,0,5,2,30,2,0,0,2,0,-27,3,0
2,2,5,0,30,3,2,0,5,3,30,1,3,0,4,0,30,0,5,0,5,1,30,1,4,0,5,2,30,2,0,0,2,0,-27,3,0
2,3,5,0,30,3,2,0,5,3,30,1,3,0,4,0,30,0,5,0,5,1,30,1,4,0,5,2,30,2,0,0,2,0,-27,3,0
2,2,6,0,30,6,3,0,9,4,30,2,0,0,2,0,30,3,6,0,9,0,30,4,5,0,9,3,30,5,0,0,5,0,-27,3,0
2,2,17,4,30,11,3,0,14,2,30,6,0,0,6,0,30,7,7,0,14,0,30,5,9,0,14,5,30,4,0,0,4,1,-15,3,1
2,1,21,2,30,7,3,0,10,3,30,5,1,0,6,1,30,3,7,0,10,5,30,4,6,0,10,3,30,4,0,0,4,1,-15,3,1
2,3,21,2,30,7,3,0,10,3,30,5,1,0,6,0,30,3,7,0,10,5,30,4,6,0,10,3,30,4,0,0,4,1,-15,3,1
2,4,23,1,30,7,6,0,13,4,30,6,0,0,6,9,30,9,4,0,13,0,30,3,10,0,13,0,30,6,0,0,6,1,-15,3,1
2,2,25,0,30,6,8,0,14,5,30,6,0,0,6,0,30,8,6,0,14,2,30,8,6,0,14,4,30,6,0,0,6,1,-15,3,1
2,4,25,0,30,6,8,0,14,5,30,6,0,0,6,0,30,8,6,0,14,2,30,8,6,0,14,4,30,6,0,0,6,1,-15,3,1
2,0,27,2,30,4,11,0,15,3,30,2,0,0,2,0,30,4,11,0,15,2,30,3,12,0,15,1,30,4,2,0,6,1,-15,3,1
2,2,35,1,30,8,5,0,13,4,30,2,0,0,2,1,30,8,5,0,13,0,30,1,12,0,13,1,30,8,0,0,8,1,-15,3,1
2,3,35,1,30,8,5,0,13,4,30,2,0,0,2,1,30,8,5,0,13,0,30,1,12,0,13,1,30,8,0,0,8,1,-15,3,1
2,1,19,0,30,3,10,0,13,2,30,7,1,0,8,0,30,6,7,0,13,0,30,8,5,0,13,1,30,9,0,0,9,1,-15,3,1
2,3,19,0,30,3,10,0,13,2,30,7,1,0,8,0,30,6,7,0,13,0,30,8,5,0,13,1,30,9,0,0,9,1,-15,3,1
2,2,21,3,30,6,4,0,10,4,30,6,0,0,6,1,30,3,7,0,10,3,30,3,7,0,10,5,30,3,1,0,4,1,-15,3,1
2,4,21,3,30,6,4,0,10,4,30,6,0,0,6,1,30,3,7,0,10,3,30,3,7,0,10,5,30,3,1,0,4,1,-15,3,1
2,4,25,0,30,6,8,0,14,4,30,6,0,0,6,0,30,7,7,0,14,3,30,5,9,0,14,5,30,5,1,0,6,1,-15,3,1
2,0,27,1,30,4,11,0,15,4,30,2,0,0,2,0,30,3,12,0,15,3,30,5,10,0,15,5,30,6,0,0,6,1,-15,3,1
2,1,27,1,30,4,11,0,15,4,30,2,0,0,2,0,30,3,12,0,15,3,30,5,10,0,15,5,30,6,0,0,6,1,-15,3,1
2,4,27,1,30,4,11,0,15,4,30,2,0,0,2,0,30,3,12,0,15,3,30,5,10,0,15,5,30,6,0,0,6,1,-15,3,1
2,0,29,0,30,5,9,0,14,6,30,11,1,0,12,0,30,4,10,0,14,0,30,3,11,0,14,2,30,9,0,0,9,1,-15,3,1
2,4,43,0,30,7,7,0,14,7,30,6,0,0,6,0,30,4,10,0,14,5,30,6,8,0,14,3,30,5,0,0,5,1,-15,3,1
2,3,47,0,30,2,12,0,14,7,30,4,0,0,4,0,30,3,11,0,14,0,30,2,12,0,14,4,30,7,0,0,7,1,-15,3,1
2,4,47,0,30,2,12,0,14,7,30,4,0,0,4,0,30,3,11,0,14,0,30,2,12,0,14,4,30,7,0,0,7,1,-15,3,1
2,4,3,0,30,1,3,0,4,2,30,4,0,0,4,0,30,0,4,0,4,0,30,3,1,0,4,1,30,2,1,0,3,0,-27,3,0
2,4,8,1,30,7,0,0,7,4,30,2,0,0,2,0,30,5,2,0,7,1,30,7,0,0,7,0,30,3,0,0,3,0,-27,3,0
2,2,17,2,30,10,4,0,14,2,30,6,0,0,6,0,30,6,8,0,14,3,30,6,8,0,14,5,30,4,0,0,4,1,-15,3,1
2,3,17,2,30,10,4,0,14,2,30,6,0,0,6,0,30,6,8,0,14,3,30,6,8,0,14,5,30,4,0,0,4,1,-15,3,1
2,4,17,2,30,10,4,0,14,2,30,6,0,0,6,0,30,6,8,0,14,3,30,6,8,0,14,5,30,4,0,0,4,1,-15,3,1
2,3,29,0,30,4,10,0,14,5,30,10,2,0,12,0,30,8,6,0,14,0,30,0,14,0,14,3,30,9,0,0,9,1,-15,3,1
2,4,29,0,30,4,10,0,14,5,30,10,2,0,12,0,30,8,6,0,14,0,30,0,14,0,14,3,30,9,0,0,9,1,-15,3,1
2,1,31,8,30,8,4,0,12,6,30,8,0,0,8,3,30,4,8,0,12,0,30,3,9,0,12,1,30,5,1,0,6,1,-15,3,1
2,2,31,8,30,8,4,0,12,6,30,8,0,0,8,3,30,4,8,0,12,0,30,3,9,0,12,1,30,5,1,0,6,1,-15,3,1
2,4,31,8,30,8,4,0,12,6,30,8,0,0,8,3,30,4,8,0,12,0,30,3,9,0,12,1,30,5,1,0,6,1,-15,3,1
2,4,32,2,30,9,0,0,9,5,30,2,0,0,2,0,30,7,2,0,9,0,30,2,7,0,9,2,30,2,0,0,2,1,-15,3,1
2,4,1,0,30,5,5,0,10,4,30,2,0,0,2,1,30,4,6,0,10,3,30,7,3,0,10,6,30,6,0,0,6,0,-27,3,0
2,0,4,2,30,5,3,0,8,5,30,4,0,0,4,1,30,1,7,0,8,1,30,7,1,0,8,3,30,4,0,0,4,0,-27,3,0
2,1,4,2,30,5,3,0,8,5,30,4,0,0,4,1,30,1,7,0,8,1,30,7,1,0,8,3,30,4,0,0,4,0,-27,3,0
2,4,4,2,30,5,3,0,8,5,30,4,0,0,4,1,30,1,7,0,8,1,30,7,1,0,8,3,30,4,0,0,4,0,-27,3,0
2,1,17,2,30,8,6,0,14,3,30,6,0,0,6,0,30,5,9,0,14,2,30,7,7,0,14,6,30,4,0,0,4,1,-15,3,1
2,2,17,2,30,8,6,0,14,3,30,6,0,0,6,0,30,5,9,0,14,2,30,7,7,0,14,6,30,4,0,0,4,1,-15,3,1
2,3,17,2,30,8,6,0,14,3,30,6,0,0,6,0,30,5,9,0,14,2,30,7,7,0,14,6,30,4,0,0,4,1,-15,3,1
2,1,19,0,30,4,9,0,13,2,30,3,5,0,8,0,30,7,6,0,13,5,30,6,7,0,13,5,30,9,0,0,9,1,-15,3,1
2,0,21,2,30,7,3,0,10,3,30,6,0,0,6,1,30,4,6,0,10,2,30,4,6,0,10,4,30,4,0,0,4,1,-15,3,1
2,1,21,2,30,7,3,0,10,3,30,6,0,0,6,1,30,4,6,0,10,2,30,4,6,0,10,4,30,4,0,0,4,1,-15,3,1
2,2,21,2,30,7,3,0,10,3,30,6,0,0,6,1,30,4,6,0,10,2,30,4,6,0,10,4,30,4,0,0,4,1,-15,3,1
2,3,23,3,30,5,8,0,13,3,30,6,0,0,6,3,30,11,2,0,13,0,30,5,8,0,13,2,30,6,0,0,6,1,-15,3,1
2,4,25,1,30,6,8,0,14,4,30,6,0,0,6,0,30,3,11,0,14,1,30,6,8,0,14,5,30,6,0,0,6,1,-15,3,1
2,0,27,2,30,7,8,0,15,4,30,2,0,0,2,0,30,5,10,0,15,3,30,4,11,0,15,2,30,6,0,0,6,1,-15,3,1
2,3,29,0,30,6,8,0,14,6,30,12,0,0,12,2,30,4,10,0,14,0,30,1,13,0,14,0,30,7,2,0,9,1,-15,3,1
2,3,5,0,30,3,2,0,5,3,30,0,4,0,4,0,30,0,5,0,5,0,30,1,4,0,5,0,30,1,1,0,2,0,-27,3,0
2,1,9,0,30,2,2,0,4,2,30,2,0,0,2,0,30,1,3,0,4,0,30,1,3,0,4,1,30,1,0,0,1,0,-27,3,0
2,3,15,0,30,4,9,0,13,1,30,6,0,0,6,0,30,3,10,0,13,2,30,3,10,0,13,3,30,9,0,0,9,1,-15,3,1
2,1,17,3,30,9,5,0,14,2,30,6,0,0,6,0,30,5,9,0,14,5,30,7,7,0,14,3,30,4,0,0,4,1,-15,3,1
2,3,19,1,30,6,7,0,13,0,30,6,2,0,8,0,30,6,7,0,13,0,30,4,9,0,13,1,30,8,1,0,9,1,-15,3,1
2,2,24,6,30,5,1,0,6,4,30,4,0,0,4,0,30,1,5,0,6,0,30,1,5,0,6,2,30,4,0,0,4,1,-15,3,1
2,4,24,6,30,5,1,0,6,4,30,4,0,0,4,0,30,1,5,0,6,0,30,1,5,0,6,2,30,4,0,0,4,1,-15,3,1
2,0,25,5,30,5,9,0,14,5,30,6,0,0,6,0,30,8,6,0,14,4,30,6,8,0,14,2,30,6,0,0,6,1,-15,3,1
2,3,25,5,30,5,9,0,14,5,30,6,0,0,6,0,30,8,6,0,14,4,30,6,8,0,14,2,30,6,0,0,6,1,-15,3,1
2,4,8,2,30,7,0,0,7,3,30,2,0,0,2,0,30,3,4,0,7,0,30,0,7,0,7,3,30,3,0,0,3,0,-27,3,0
2,4,25,2,30,7,7,0,14,3,30,6,0,0,6,0,30,6,8,0,14,1,30,5,9,0,14,1,30,4,2,0,6,1,-15,3,1
2,2,27,0,30,6,9,0,15,2,30,2,0,0,2,0,30,6,9,0,15,0,30,4,11,0,15,1,30,6,0,0,6,1,-15,3,1
2,2,31,2,30,6,6,0,12,4,30,8,0,0,8,5,30,10,2,0,12,2,30,5,7,0,12,0,30,4,2,0,6,1,-15,3,1
2,3,31,2,30,6,6,0,12,4,30,8,0,0,8,5,30,10,2,0,12,2,30,5,7,0,12,0,30,4,2,0,6,1,-15,3,1
2,4,31,2,30,6,6,0,12,4,30,8,0,0,8,5,30,10,2,0,12,2,30,5,7,0,12,0,30,4,2,0,6,1,-15,3,1
2,3,3,0,30,0,4,0,4,2,30,4,0,0,4,1,30,2,2,0,4,1,30,2,2,0,4,0,30,3,0,0,3,0,-27,3,0
2,4,3,0,30,0,4,0,4,2,30,4,0,0,4,1,30,2,2,0,4,1,30,2,2,0,4,0,30,3,0,0,3,0,-27,3,0
2,0,4,2,30,7,1,0,8,5,30,4,0,0,4,0,30,1,7,0,8,0,30,3,5,0,8,3,30,4,0,0,4,0,-27,3,0
2,1,4,2,30,7,1,0,8,5,30,4,0,0,4,0,30,1,7,0,8,0,30,3,5,0,8,3,30,4,0,0,4,0,-27,3,0
2,1,17,3,30,10,4,0,14,3,30,6,0,0,6,0,30,5,9,0,14,5,30,4,10,0,14,5,30,4,0,0,4,1,-15,3,1
2,2,17,3,30,10,4,0,14,3,30,6,0,0,6,0,30,5,9,0,14,5,30,4,10,0,14,5,30,4,0,0,4,1,-15,3,1
2,3,17,3,30,10,4,0,14,3,30,6,0,0,6,0,30,5,9,0,14,5,30,4,10,0,14,5,30,4,0,0,4,1,-15,3,1
2,4,17,3,30,10,4,0,14,3,30,6,0,0,6,0,30,5,9,0,14,5,30,4,10,0,14,5,30,4,0,0,4,1,-15,3,1
2,3,21,2,30,7,3,0,10,4,30,6,0,0,6,1,30,3,7,0,10,2,30,5,5,0,10,2,30,4,0,0,4,1,-15,3,1
2,4,21,2,30,7,3,0,10,4,30,6,0,0,6,1,30,3,7,0,10,2,30,5,5,0,10,2,30,4,0,0,4,1,-15,3,1
2,3,23,1,30,4,9,0,13,4,30,6,0,0,6,8,30,10,3,0,13,0,30,6,7,0,13,1,30,6,0,0,6,1,-15,3,1
2,1,26,0,30,7,2,0,9,5,30,4,0,0,4,3,30,2,7,0,9,0,30,3,6,0,9,6,30,3,0,0,3,1,-15,3,1
2,0,27,1,30,9,6,0,15,3,30,1,1,0,2,0,30,6,9,0,15,2,30,3,12,0,15,3,30,6,0,0,6,1,-15,3,1
2,3,27,1,30,9,6,0,15,3,30,1,1,0,2,0,30,6,9,0,15,2,30,3,12,0,15,3,30,6,0,0,6,1,-15,3,1
2,1,4,3,30,4,4,0,8,5,30,3,1,0,4,0,30,2,6,0,8,0,30,8,0,0,8,2,30,4,0,0,4,0,-27,3,0
2,3,4,3,30,4,4,0,8,5,30,3,1,0,4,0,30,2,6,0,8,0,30,8,0,0,8,2,30,4,0,0,4,0,-27,3,0
2,4,6,0,30,4,5,0,9,3,30,2,0,0,2,0,30,3,6,0,9,0,30,4,5,0,9,1,30,5,0,0,5,0,-27,3,0
2,3,7,0,30,3,1,0,4,2,30,2,0,0,2,0,30,3,1,0,4,0,30,1,3,0,4,0,30,2,0,0,2,0,-27,3,0
2,4,8,2,30,7,0,0,7,4,30,2,0,0,2,5,30,4,3,0,7,0,30,5,2,0,7,2,30,3,0,0,3,0,-27,3,0
2,2,11,2,30,4,8,0,12,0,30,4,0,0,4,0,30,9,3,0,12,6,30,3,9,0,12,0,30,4,0,0,4,1,-15,3,1
2,3,17,3,30,11,3,0,14,3,30,6,0,0,6,0,30,4,10,0,14,1,30,5,9,0,14,4,30,4,0,0,4,1,-15,3,1
2,4,17,3,30,11,3,0,14,3,30,6,0,0,6,0,30,4,10,0,14,1,30,5,9,0,14,4,30,4,0,0,4,1,-15,3,1
2,3,23,1,30,7,6,0,13,2,30,6,0,0,6,5,30,12,1,0,13,0,30,10,3,0,13,1,30,6,0,0,6,1,-15,3,1
2,1,25,2,30,9,5,0,14,4,30,6,0,0,6,0,30,3,11,0,14,1,30,6,8,0,14,5,30,6,0,0,6,1,-15,3,1
2,2,25,2,30,9,5,0,14,4,30,6,0,0,6,0,30,3,11,0,14,1,30,6,8,0,14,5,30,6,0,0,6,1,-15,3,1
2,1,27,1,30,6,9,0,15,4,30,2,0,0,2,0,30,3,12,0,15,0,30,5,10,0,15,1,30,6,0,0,6,1,-15,3,1
2,4,27,1,30,6,9,0,15,4,30,2,0,0,2,0,30,3,12,0,15,0,30,5,10,0,15,1,30,6,0,0,6,1,-15,3,1
2,3,33,1,30,2,9,0,11,5,30,4,0,0,4,0,30,6,5,0,11,2,30,3,8,0,11,7,30,4,0,0,4,1,-15,3,1
2,3,39,0,30,4,7,0,11,7,30,6,0,0,6,0,30,4,7,0,11,2,30,5,6,0,11,3,30,5,0,0,5,1,-15,3,1
2,0,5,0,30,2,3,0,5,3,30,3,1,0,4,0,30,0,5,0,5,0,30,1,4,0,5,3,30,2,0,0,2,0,-27,3,0
2,3,5,0,30,2,3,0,5,3,30,3,1,0,4,0,30,0,5,0,5,0,30,1,4,0,5,3,30,2,0,0,2,0,-27,3,0
2,4,8,1,30,7,0,0,7,4,30,2,0,0,2,7,30,4,3,0,7,1,30,7,0,0,7,2,30,3,0,0,3,0,-27,3,0
2,3,9,0,30,7,4,0,11,1,30,5,1,0,6,1,30,10,1,0,11,5,30,3,8,0,11,5,30,4,0,0,4,0,-27,3,0
2,2,11,0,30,1,3,0,4,0,30,0,0,0,0,0,30,0,4,0,4,5,30,3,1,0,4,3,30,1,0,0,1,1,-15,3,1
2,4,19,0,30,3,10,0,13,3,30,5,3,0,8,0,30,4,9,0,13,9,30,4,9,0,13,2,30,8,1,0,9,1,-15,3,1
2,1,23,1,30,5,8,0,13,1,30,6,0,0,6,5,30,10,3,0,13,0,30,6,7,0,13,3,30,6,0,0,6,1,-15,3,1
2,2,23,1,30,5,8,0,13,1,30,6,0,0,6,5,30,10,3,0,13,0,30,6,7,0,13,3,30,6,0,0,6,1,-15,3,1
2,1,29,0,30,6,8,0,14,6,30,8,4,0,12,0,30,3,11,0,14,0,30,4,10,0,14,5,30,9,0,0,9,1,-15,3,1
2,2,31,3,30,7,5,0,12,8,30,8,0,0,8,3,30,4,8,0,12,4,30,9,3,0,12,0,30,5,1,0,6,1,-15,3,1
2,3,31,3,30,7,5,0,12,8,30,8,0,0,8,3,30,4,8,0,12,4,30,9,3,0,12,0,30,5,1,0,6,1,-15,3,1
2,4,33,2,30,6,5,0,11,4,30,4,0,0,4,5,30,9,2,0,11,0,30,3,8,0,11,3,30,4,0,0,4,1,-15,3,1
2,2,13,0,30,7,0,0,7,0,30,4,0,0,4,2,30,5,2,0,7,14,30,5,2,0,7,3,30,4,0,0,4,1,-15,3,1
2,4,13,0,30,7,0,0,7,0,30,4,0,0,4,2,30,5,2,0,7,14,30,5,2,0,7,3,30,4,0,0,4,1,-15,3,1
2,1,17,5,30,11,3,0,14,3,30,6,0,0,6,0,30,6,8,0,14,2,30,6,8,0,14,2,30,4,0,0,4,1,-15,3,1
2,2,17,5,30,11,3,0,14,3,30,6,0,0,6,0,30,6,8,0,14,2,30,6,8,0,14,2,30,4,0,0,4,1,-15,3,1
2,0,19,0,30,7,6,0,13,2,30,8,0,0,8,6,30,5,8,0,13,0,30,3,10,0,13,0,30,6,3,0,9,1,-15,3,1
2,3,19,0,30,7,6,0,13,2,30,8,0,0,8,6,30,5,8,0,13,0,30,3,10,0,13,0,30,6,3,0,9,1,-15,3,1
2,3,25,1,30,3,11,0,14,4,30,6,0,0,6,0,30,7,7,0,14,3,30,12,2,0,14,7,30,6,0,0,6,1,-15,3,1
2,1,27,1,30,6,9,0,15,3,30,2,0,0,2,0,30,1,14,0,15,1,30,4,11,0,15,5,30,6,0,0,6,1,-15,3,1
2,2,27,1,30,6,9,0,15,3,30,2,0,0,2,0,30,1,14,0,15,1,30,4,11,0,15,5,30,6,0,0,6,1,-15,3,1
2,2,29,0,30,5,9,0,14,5,30,12,0,0,12,0,30,3,11,0,14,0,30,1,13,0,14,0,30,6,3,0,9,1,-15,3,1
2,3,29,0,30,5,9,0,14,5,30,12,0,0,12,0,30,3,11,0,14,0,30,1,13,0,14,0,30,6,3,0,9,1,-15,3,1
2,1,41,0,30,7,5,0,12,5,30,8,0,0,8,0,30,6,6,0,12,1,30,4,8,0,12,4,30,1,6,0,7,1,-15,3,1
2,4,41,0,30,7,5,0,12,5,30,8,0,0,8,0,30,6,6,0,12,0,30,4,8,0,12,4,30,1,6,0,7,1,-15,3,1
2,4,1,0,30,7,3,0,10,4,30,2,0,0,2,1,30,4,6,0,10,3,30,7,3,0,10,5,30,6,0,0,6,0,-27,3,0
2,4,3,0,30,1,3,0,4,3,30,4,0,0,4,0,30,0,4,0,4,7,30,3,1,0,4,0,30,1,2,0,3,0,-27,3,0
2,0,5,2,30,1,4,0,5,3,30,1,3,0,4,0,30,0,5,0,5,0,30,1,4,0,5,0,30,0,2,0,2,0,-27,3,0
2,2,5,1,30,1,4,0,5,3,30,1,3,0,4,0,30,0,5,0,5,0,30,1,4,0,5,0,30,0,2,0,2,0,-27,3,0
2,4,5,1,30,1,4,0,5,3,30,1,3,0,4,0,30,0,5,0,5,0,30,1,4,0,5,0,30,0,2,0,2,0,-27,3,0
2,0,6,2,30,6,3,0,9,4,30,2,0,0,2,0,30,4,5,0,9,0,30,5,4,0,9,0,30,4,1,0,5,0,-27,3,0
2,1,6,2,30,6,3,0,9,4,30,2,0,0,2,0,30,4,5,0,9,0,30,5,4,0,9,0,30,4,1,0,5,0,-27,3,0
2,2,6,2,30,6,3,0,9,4,30,2,0,0,2,0,30,4,5,0,9,0,30,5,4,0,9,0,30,4,1,0,5,0,-27,3,0
2,3,6,2,30,6,3,0,9,4,30,2,0,0,2,0,30,4,5,0,9,0,30,5,4,0,9,0,30,4,1,0,5,0,-27,3,0
2,4,7,2,30,4,5,0,9,3,30,4,0,0,4,0,30,6,3,0,9,8,30,3,6,0,9,2,30,4,2,0,6,0,-27,3,0
2,3,15,1,30,4,9,0,13,1,30,6,0,0,6,0,30,3,10,0,13,1,30,2,11,0,13,2,30,8,1,0,9,1,-15,3,1
2,1,17,2,30,11,3,0,14,3,30,6,0,0,6,0,30,4,10,0,14,1,30,5,9,0,14,2,30,4,0,0,4,1,-15,3,1
2,4,17,2,30,11,3,0,14,3,30,6,0,0,6,0,30,4,10,0,14,1,30,5,9,0,14,2,30,4,0,0,4,1,-15,3,1
2,3,23,9,30,9,4,0,13,4,30,6,0,0,6,0,30,7,6,0,13,0,30,5,8,0,13,1,30,6,0,0,6,1,-15,3,1
2,3,27,4,30,6,9,0,15,0,30,2,0,0,2,0,30,8,7,0,15,0,30,5,10,0,15,1,30,4,2,0,6,1,-15,3,1
2,3,47,0,30,0,14,0,14,5,30,4,0,0,4,0,30,4,10,0,14,0,30,4,10,0,14,8,30,7,0,0,7,1,-15,3,1
2,2,4,5,30,8,0,0,8,4,30,4,0,0,4,0,30,3,5,0,8,0,30,4,4,0,8,1,30,3,1,0,4,0,-27,3,0
2,3,4,5,30,8,0,0,8,4,30,4,0,0,4,0,30,3,5,0,8,0,30,4,4,0,8,1,30,3,1,0,4,0,-27,3,0
2,4,7,1,30,3,6,0,9,1,30,3,1,0,4,0,30,9,0,0,9,8,30,2,7,0,9,1,30,3,3,0,6,0,-27,3,0
2,1,13,2,30,7,0,0,7,0,30,4,0,0,4,2,30,6,1,0,7,11,30,4,3,0,7,2,30,4,0,0,4,1,-15,3,1
2,2,13,2,30,7,0,0,7,0,30,4,0,0,4,2,30,6,1,0,7,11,30,4,3,0,7,2,30,4,0,0,4,1,-15,3,1
2,4,13,2,30,7,0,0,7,0,30,4,0,0,4,2,30,6,1,0,7,11,30,4,3,0,7,2,30,4,0,0,4,1,-15,3,1
2,2,19,1,30,9,4,0,13,2,30,4,4,0,8,0,30,4,9,0,13,3,30,4,9,0,13,2,30,9,0,0,9,1,-15,3,1
2,4,19,1,30,9,4,0,13,2,30,4,4,0,8,0,30,4,9,0,13,3,30,4,9,0,13,2,30,9,0,0,9,1,-15,3,1
2,2,21,2,30,6,4,0,10,4,30,6,0,0,6,1,30,3,7,0,10,3,30,4,6,0,10,2,30,4,0,0,4,1,-15,3,1
2,3,21,2,30,6,4,0,10,4,30,6,0,0,6,1,30,3,7,0,10,3,30,4,6,0,10,2,30,4,0,0,4,1,-15,3,1
2,4,21,2,30,6,4,0,10,4,30,6,0,0,6,1,30,3,7,0,10,3,30,4,6,0,10,2,30,4,0,0,4,1,-15,3,1
2,3,23,1,30,5,8,0,13,1,30,6,0,0,6,4,30,13,0,0,13,2,30,6,7,0,13,2,30,5,1,0,6,1,-15,3,1
2,4,23,1,30,5,8,0,13,1,30,6,0,0,6,4,30,13,0,0,13,2,30,6,7,0,13,2,30,5,1,0,6,1,-15,3,1
2,1,27,1,30,4,11,0,15,3,30,2,0,0,2,0,30,12,3,0,15,0,30,2,13,0,15,2,30,6,0,0,6,1,-15,3,1
2,2,27,1,30,4,11,0,15,3,30,2,0,0,2,0,30,12,3,0,15,0,30,2,13,0,15,2,30,6,0,0,6,1,-15,3,1
2,3,27,1,30,4,11,0,15,3,30,2,0,0,2,0,30,12,3,0,15,0,30,2,13,0,15,2,30,6,0,0,6,1,-15,3,1
2,1,31,2,30,6,6,0,12,6,30,8,0,0,8,3,30,8,4,0,12,0,30,9,3,0,12,1,30,6,0,0,6,1,-15,3,1
2,2,31,2,30,6,6,0,12,6,30,8,0,0,8,3,30,8,4,0,12,0,30,9,3,0,12,1,30,6,0,0,6,1,-15,3,1
2,3,31,2,30,6,6,0,12,6,30,8,0,0,8,3,30,8,4,0,12,0,30,9,3,0,12,1,30,6,0,0,6,1,-15,3,1
2,4,32,0,30,5,4,0,9,5,30,2,0,0,2,0,30,7,2,0,9,1,30,2,7,0,9,0,30,2,0,0,2,1,-15,3,1
2,4,7,0,30,4,0,0,4,2,30,2,0,0,2,0,30,1,3,0,4,0,30,1,3,0,4,2,30,1,1,0,2,0,-27,3,0
2,4,19,0,30,4,9,0,13,2,30,5,3,0,8,0,30,4,9,0,13,7,30,5,8,0,13,3,30,8,1,0,9,1,-15,3,1
2,3,27,1,30,7,8,0,15,1,30,2,0,0,2,0,30,12,3,0,15,0,30,8,7,0,15,1,30,1,5,0,6,1,-15,3,1
2,2,29,1,30,7,7,0,14,7,30,10,2,0,12,0,30,2,12,0,14,0,30,1,13,0,14,4,30,9,0,0,9,1,-15,3,1
2,3,29,1,30,7,7,0,14,7,30,10,2,0,12,0,30,2,12,0,14,0,30,1,13,0,14,4,30,9,0,0,9,1,-15,3,1
2,4,29,1,30,7,7,0,14,7,30,10,2,0,12,0,30,2,12,0,14,0,30,1,13,0,14,4,30,9,0,0,9,1,-15,3,1
2,3,38,0,30,1,9,0,10,6,30,6,0,0,6,0,30,5,5,0,10,0,30,5,5,0,10,7,30,6,0,0,6,1,-15,3,1
2,4,39,0,30,1,10,0,11,5,30,6,0,0,6,0,30,7,4,0,11,2,30,2,9,0,11,6,30,5,0,0,5,1,-15,3,1
2,0,4,2,30,7,1,0,8,4,30,2,2,0,4,0,30,1,7,0,8,2,30,8,0,0,8,7,30,3,1,0,4,0,-27,3,0
2,1,13,7,30,6,1,0,7,3,30,4,0,0,4,4,30,6,1,0,7,4,30,6,1,0,7,4,30,4,0,0,4,1,-15,3,1
2,3,15,0,30,7,6,0,13,0,30,6,0,0,6,0,30,6,7,0,13,1,30,3,10,0,13,3,30,9,0,0,9,1,-15,3,1
2,2,19,0,30,3,10,0,13,2,30,8,0,0,8,0,30,6,7,0,13,0,30,5,8,0,13,1,30,8,1,0,9,1,-15,3,1
2,4,19,0,30,3,10,0,13,2,30,8,0,0,8,0,30,6,7,0,13,0,30,5,8,0,13,1,30,8,1,0,9,1,-15,3,1
2,2,25,1,30,7,7,0,14,4,30,6,0,0,6,0,30,6,8,0,14,1,30,5,9,0,14,2,30,4,2,0,6,1,-15,3,1
2,3,25,1,30,7,7,0,14,4,30,6,0,0,6,0,30,6,8,0,14,1,30,5,9,0,14,2,30,4,2,0,6,1,-15,3,1
2,4,25,1,30,7,7,0,14,4,30,6,0,0,6,0,30,6,8,0,14,1,30,5,9,0,14,2,30,4,2,0,6,1,-15,3,1
2,2,27,2,30,7,8,0,15,0,30,2,0,0,2,0,30,12,3,0,15,0,30,3,12,0,15,1,30,3,3,0,6,1,-15,3,1
2,4,27,2,30,7,8,0,15,0,30,2,0,0,2,0,30,12,3,0,15,0,30,3,12,0,15,1,30,3,3,0,6,1,-15,3,1
2,0,31,1,30,5,7,0,12,7,30,8,0,0,8,3,30,4,8,0,12,0,30,9,3,0,12,6,30,5,1,0,6,1,-15,3,1
2,4,31,1,30,5,7,0,12,7,30,8,0,0,8,3,30,4,8,0,12,0,30,9,3,0,12,6,30,5,1,0,6,1,-15,3,1
2,1,4,2,30,5,3,0,8,4,30,3,1,0,4,0,30,1,7,0,8,1,30,5,3,0,8,3,30,4,0,0,4,0,-27,3,0
2,3,4,1,30,5,3,0,8,4,30,3,1,0,4,0,30,1,7,0,8,1,30,5,3,0,8,3,30,4,0,0,4,0,-27,3,0
2,4,6,0,30,6,3,0,9,4,30,2,0,0,2,0,30,3,6,0,9,0,30,4,5,0,9,1,30,5,0,0,5,0,-27,3,0
2,3,15,0,30,5,8,0,13,1,30,5,1,0,6,0,30,4,9,0,13,0,30,5,8,0,13,3,30,9,0,0,9,1,-15,3,1
2,4,15,0,30,5,8,0,13,1,30,5,1,0,6,0,30,4,9,0,13,0,30,5,8,0,13,3,30,9,0,0,9,1,-15,3,1
2,4,19,1,30,3,10,0,13,2,30,7,1,0,8,0,30,4,9,0,13,1,30,9,4,0,13,1,30,9,0,0,9,1,-15,3,1
2,2,21,2,30,7,3,0,10,4,30,6,0,0,6,1,30,3,7,0,10,1,30,5,5,0,10,2,30,4,0,0,4,1,-15,3,1
2,3,21,2,30,7,3,0,10,4,30,6,0,0,6,1,30,3,7,0,10,1,30,5,5,0,10,2,30,4,0,0,4,1,-15,3,1
2,4,23,1,30,6,7,0,13,2,30,6,0,0,6,4,30,13,0,0,13,0,30,7,6,0,13,2,30,6,0,0,6,1,-15,3,1
2,4,25,1,30,5,9,0,14,5,30,6,0,0,6,0,30,6,8,0,14,1,30,6,8,0,14,4,30,5,1,0,6,1,-15,3,1
2,0,27,1,30,5,10,0,15,3,30,1,1,0,2,0,30,8,7,0,15,0,30,3,12,0,15,3,30,6,0,0,6,1,-15,3,1
2,2,27,1,30,5,10,0,15,3,30,1,1,0,2,0,30,8,7,0,15,0,30,3,12,0,15,3,30,6,0,0,6,1,-15,3,1
2,2,29,0,30,5,9,0,14,6,30,11,1,0,12,0,30,3,11,0,14,0,30,0,14,0,14,4,30,9,0,0,9,1,-15,3,1
2,3,29,0,30,5,9,0,14,6,30,11,1,0,12,0,30,3,11,0,14,0,30,0,14,0,14,4,30,9,0,0,9,1,-15,3,1
2,4,39,0,30,1,10,0,11,7,30,6,0,0,6,0,30,4,7,0,11,3,30,3,8,0,11,4,30,5,0,0,5,1,-15,3,1
2,1,4,2,30,8,0,0,8,5,30,4,0,0,4,0,30,2,6,0,8,0,30,8,0,0,8,3,30,4,0,0,4,0,-27,3,0
2,3,5,0,30,2,3,0,5,3,30,4,0,0,4,0,30,0,5,0,5,0,30,3,2,0,5,0,30,1,1,0,2,0,-27,3,0
2,4,15,2,30,5,8,0,13,0,30,6,0,0,6,0,30,5,8,0,13,1,30,4,9,0,13,5,30,4,5,0,9,1,-15,3,1
2,1,17,5,30,7,7,0,14,4,30,6,0,0,6,0,30,4,10,0,14,2,30,7,7,0,14,8,30,4,0,0,4,1,-15,3,1
2,3,17,5,30,7,7,0,14,4,30,6,0,0,6,0,30,4,10,0,14,2,30,7,7,0,14,8,30,4,0,0,4,1,-15,3,1
2,3,23,1,30,2,11,0,13,3,30,6,0,0,6,5,30,13,0,0,13,0,30,7,6,0,13,1,30,6,0,0,6,1,-15,3,1
2,3,27,1,30,9,6,0,15,3,30,2,0,0,2,0,30,8,7,0,15,0,30,6,9,0,15,1,30,6,0,0,6,1,-15,3,1
2,1,5,0,30,2,3,0,5,2,30,4,0,0,4,1,30,0,5,0,5,0,30,1,4,0,5,0,30,0,2,0,2,0,-27,3,0
2,2,8,1,30,7,0,0,7,5,30,2,0,0,2,4,30,1,6,0,7,2,30,7,0,0,7,3,30,3,0,0,3,0,-27,3,0
2,4,8,1,30,7,0,0,7,5,30,2,0,0,2,4,30,1,6,0,7,2,30,7,0,0,7,3,30,3,0,0,3,0,-27,3,0
2,1,13,2,30,6,1,0,7,0,30,4,0,0,4,1,30,6,1,0,7,7,30,6,1,0,7,2,30,4,0,0,4,1,-15,3,1
2,2,13,2,30,6,1,0,7,0,30,4,0,0,4,1,30,6,1,0,7,7,30,6,1,0,7,2,30,4,0,0,4,1,-15,3,1
2,1,17,2,30,10,4,0,14,3,30,6,0,0,6,0,30,5,9,0,14,5,30,4,10,0,14,1,30,4,0,0,4,1,-15,3,1
2,2,17,2,30,10,4,0,14,3,30,6,0,0,6,0,30,5,9,0,14,5,30,4,10,0,14,1,30,4,0,0,4,1,-15,3,1
2,3,23,2,30,5,8,0,13,1,30,6,0,0,6,3,30,11,2,0,13,0,30,5,8,0,13,1,30,6,0,0,6,1,-15,3,1
2,3,25,1,30,6,8,0,14,5,30,6,0,0,6,0,30,6,8,0,14,1,30,5,9,0,14,4,30,6,0,0,6,1,-15,3,1
2,0,29,0,30,6,8,0,14,5,30,12,0,0,12,0,30,6,8,0,14,0,30,0,14,0,14,1,30,9,0,0,9,1,-15,3,1
2,1,31,2,30,8,4,0,12,5,30,8,0,0,8,6,30,7,5,0,12,0,30,3,9,0,12,2,30,3,3,0,6,1,-15,3,1
2,3,35,2,30,6,7,0,13,3,30,2,0,0,2,1,30,12,1,0,13,3,30,2,11,0,13,3,30,7,1,0,8,1,-15,3,1
2,0,4,2,30,5,3,0,8,4,30,2,2,0,4,2,30,1,7,0,8,2,30,8,0,0,8,4,30,3,1,0,4,0,-27,3,0
2,2,4,2,30,5,3,0,8,4,30,2,2,0,4,2,30,1,7,0,8,2,30,8,0,0,8,4,30,3,1,0,4,0,-27,3,0
2,4,8,1,30,7,0,0,7,4,30,2,0,0,2,0,30,4,3,0,7,0,30,5,2,0,7,1,30,3,0,0,3,0,-27,3,0
2,4,11,0,30,4,8,0,12,0,30,4,0,0,4,0,30,7,5,0,12,3,30,3,9,0,12,3,30,4,0,0,4,1,-15,3,1
2,2,13,2,30,3,0,0,3,1,30,2,0,0,2,1,30,3,0,0,3,6,30,3,0,0,3,3,30,2,0,0,2,1,-15,3,1
2,3,13,2,30,3,0,0,3,1,30,2,0,0,2,1,30,3,0,0,3,6,30,3,0,0,3,3,30,2,0,0,2,1,-15,3,1
2,1,13,1,30,6,1,0,7,0,30,4,0,0,4,2,30,7,0,0,7,12,30,7,0,0,7,3,30,4,0,0,4,1,-15,3,1
2,3,17,2,30,9,5,0,14,2,30,6,0,0,6,0,30,7,7,0,14,1,30,6,8,0,14,2,30,4,0,0,4,1,-15,3,1
2,1,19,0,30,3,10,0,13,2,30,6,2,0,8,0,30,6,7,0,13,4,30,5,8,0,13,0,30,9,0,0,9,1,-15,3,1
2,2,19,0,30,3,10,0,13,2,30,6,2,0,8,0,30,6,7,0,13,4,30,5,8,0,13,0,30,9,0,0,9,1,-15,3,1
2,3,21,3,30,7,3,0,10,4,30,6,0,0,6,1,30,3,7,0,10,3,30,5,5,0,10,0,30,3,1,0,4,1,-15,3,1
2,3,27,3,30,4,11,0,15,3,30,1,1,0,2,0,30,6,9,0,15,2,30,4,11,0,15,1,30,4,2,0,6,1,-15,3,1
2,4,31,3,30,7,5,0,12,3,30,8,0,0,8,4,30,11,1,0,12,0,30,3,9,0,12,0,30,2,4,0,6,1,-15,3,1
2,1,13,1,30,7,0,0,7,0,30,4,0,0,4,2,30,6,1,0,7,12,30,5,2,0,7,5,30,4,0,0,4,1,-15,3,1
2,1,17,5,30,10,4,0,14,3,30,6,0,0,6,0,30,3,11,0,14,1,30,6,8,0,14,1,30,4,0,0,4,1,-15,3,1
2,3,17,5,30,10,4,0,14,3,30,6,0,0,6,0,30,3,11,0,14,1,30,6,8,0,14,1,30,4,0,0,4,1,-15,3,1
2,3,27,1,30,7,8,0,15,2,30,1,1,0,2,0,30,12,3,0,15,0,30,3,12,0,15,2,30,6,0,0,6,1,-15,3,1
2,4,32,0,30,6,3,0,9,4,30,2,0,0,2,0,30,7,2,0,9,1,30,2,7,0,9,6,30,2,0,0,2,1,-15,3,1
2,3,39,0,30,4,7,0,11,6,30,6,0,0,6,0,30,4,7,0,11,1,30,3,8,0,11,6,30,5,0,0,5,1,-15,3,1
2,2,1,0,30,7,3,0,10,4,30,2,0,0,2,1,30,5,5,0,10,4,30,9,1,0,10,6,30,6,0,0,6,0,-27,3,0
2,3,4,5,30,8,0,0,8,5,30,4,0,0,4,0,30,1,7,0,8,0,30,4,4,0,8,1,30,4,0,0,4,0,-27,3,0
2,1,5,0,30,5,0,0,5,3,30,3,1,0,4,0,30,0,5,0,5,0,30,1,4,0,5,0,30,1,1,0,2,0,-27,3,0
2,2,5,0,30,5,0,0,5,3,30,3,1,0,4,0,30,0,5,0,5,0,30,1,4,0,5,0,30,1,1,0,2,0,-27,3,0
2,1,13,3,30,7,0,0,7,0,30,4,0,0,4,2,30,5,2,0,7,8,30,5,2,0,7,2,30,4,0,0,4,1,-15,3,1
2,4,13,3,30,7,0,0,7,0,30,4,0,0,4,2,30,5,2,0,7,8,30,5,2,0,7,2,30,4,0,0,4,1,-15,3,1
2,3,17,4,30,9,5,0,14,3,30,6,0,0,6,0,30,5,9,0,14,2,30,6,8,0,14,2,30,4,0,0,4,1,-15,3,1
2,3,19,0,30,3,10,0,13,2,30,8,0,0,8,4,30,6,7,0,13,1,30,6,7,0,13,0,30,6,3,0,9,1,-15,3,1
2,4,19,0,30,3,10,0,13,2,30,8,0,0,8,4,30,6,7,0,13,1,30,6,7,0,13,0,30,6,3,0,9,1,-15,3,1
2,2,23,1,30,4,9,0,13,3,30,6,0,0,6,5,30,13,0,0,13,2,30,7,6,0,13,3,30,6,0,0,6,1,-15,3,1
2,4,23,1,30,4,9,0,13,3,30,6,0,0,6,5,30,13,0,0,13,2,30,7,6,0,13,3,30,6,0,0,6,1,-15,3,1
2,3,27,1,30,8,7,0,15,2,30,1,1,0,2,0,30,6,9,0,15,0,30,6,9,0,15,1,30,4,2,0,6,1,-15,3,1
2,4,27,1,30,8,7,0,15,2,30,1,1,0,2,0,30,6,9,0,15,0,30,6,9,0,15,1,30,4,2,0,6,1,-15,3,1
2,3,31,3,30,6,6,0,12,4,30,8,0,0,8,4,30,9,3,0,12,0,30,5,7,0,12,1,30,4,2,0,6,1,-15,3,1
2,0,39,2,30,3,8,0,11,7,30,6,0,0,6,0,30,7,4,0,11,6,30,3,8,0,11,0,30,5,0,0,5,1,-15,3,1
2,2,39,2,30,3,8,0,11,7,30,6,0,0,6,0,30,7,4,0,11,6,30,3,8,0,11,0,30,5,0,0,5,1,-15,3,1
2,2,4,2,30,8,0,0,8,3,30,4,0,0,4,0,30,3,5,0,8,0,30,2,6,0,8,1,30,4,0,0,4,0,-27,3,0
2,4,8,0,30,7,0,0,7,4,30,2,0,0,2,1,30,4,3,0,7,1,30,7,0,0,7,1,30,3,0,0,3,0,-27,3,0
2,1,17,4,30,9,5,0,14,4,30,6,0,0,6,0,30,2,12,0,14,2,30,7,7,0,14,0,30,4,0,0,4,1,-15,3,1
2,1,19,0,30,8,5,0,13,1,30,7,1,0,8,1,30,7,6,0,13,1,30,3,10,0,13,2,30,7,2,0,9,1,-15,3,1
2,2,23,4,30,4,9,0,13,3,30,6,0,0,6,0,30,13,0,0,13,0,30,6,7,0,13,3,30,6,0,0,6,1,-15,3,1
2,4,23,4,30,4,9,0,13,3,30,6,0,0,6,0,30,13,0,0,13,0,30,6,7,0,13,3,30,6,0,0,6,1,-15,3,1
2,4,25,1,30,5,9,0,14,5,30,6,0,0,6,0,30,3,11,0,14,0,30,10,4,0,14,6,30,6,0,0,6,1,-15,3,1
2,1,27,1,30,5,10,0,15,4,30,2,0,0,2,0,30,3,12,0,15,6,30,4,11,0,15,2,30,6,0,0,6,1,-15,3,1
2,1,29,1,30,5,9,0,14,5,30,12,0,0,12,0,30,6,8,0,14,0,30,1,13,0,14,0,30,7,2,0,9,1,-15,3,1
2,2,35,0,30,7,6,0,13,3,30,2,0,0,2,2,30,8,5,0,13,6,30,3,10,0,13,5,30,8,0,0,8,1,-15,3,1
2,1,4,2,30,5,3,0,8,4,30,4,0,0,4,1,30,2,6,0,8,0,30,5,3,0,8,1,30,3,1,0,4,0,-27,3,0
2,1,5,0,30,3,2,0,5,3,30,2,2,0,4,0,30,1,4,0,5,0,30,1,4,0,5,0,30,0,2,0,2,0,-27,3,0
2,2,5,0,30,3,2,0,5,3,30,2,2,0,4,0,30,1,4,0,5,0,30,1,4,0,5,0,30,0,2,0,2,0,-27,3,0
2,3,5,0,30,3,2,0,5,3,30,2,2,0,4,0,30,1,4,0,5,0,30,1,4,0,5,0,30,0,2,0,2,0,-27,3,0
2,4,5,0,30,3,2,0,5,3,30,2,2,0,4,0,30,1,4,0,5,0,30,1,4,0,5,0,30,0,2,0,2,0,-27,3,0
2,2,13,2,30,7,0,0,7,2,30,4,0,0,4,2,30,5,2,0,7,8,30,7,0,0,7,4,30,4,0,0,4,1,-15,3,1
2,4,15,0,30,4,9,0,13,1,30,6,0,0,6,0,30,3,10,0,13,1,30,7,6,0,13,2,30,9,0,0,9,1,-15,3,1
2,1,17,3,30,11,3,0,14,2,30,6,0,0,6,0,30,8,6,0,14,2,30,5,9,0,14,1,30,4,0,0,4,1,-15,3,1
2,2,17,3,30,11,3,0,14,2,30,6,0,0,6,0,30,8,6,0,14,2,30,5,9,0,14,1,30,4,0,0,4,1,-15,3,1
2,3,17,3,30,11,3,0,14,2,30,6,0,0,6,0,30,8,6,0,14,2,30,5,9,0,14,1,30,4,0,0,4,1,-15,3,1
2,4,17,3,30,11,3,0,14,2,30,6,0,0,6,0,30,8,6,0,14,2,30,5,9,0,14,1,30,4,0,0,4,1,-15,3,1
2,0,21,1,30,6,4,0,10,4,30,6,0,0,6,1,30,3,7,0,10,3,30,6,4,0,10,4,30,4,0,0,4,1,-15,3,1
2,2,21,1,30,6,4,0,10,4,30,6,0,0,6,1,30,3,7,0,10,3,30,6,4,0,10,4,30,4,0,0,4,1,-15,3,1
2,4,21,1,30,6,4,0,10,4,30,6,0,0,6,1,30,3,7,0,10,3,30,6,4,0,10,4,30,4,0,0,4,1,-15,3,1
2,0,27,1,30,5,10,0,15,2,30,2,0,0,2,0,30,10,5,0,15,3,30,5,10,0,15,2,30,6,0,0,6,1,-15,3,1
2,4,27,1,30,5,10,0,15,2,30,2,0,0,2,0,30,10,5,0,15,0,30,5,10,0,15,2,30,6,0,0,6,1,-15,3,1
2,2,31,1,30,8,4,0,12,7,30,8,0,0,8,3,30,4,8,0,12,2,30,7,5,0,12,3,30,6,0,0,6,1,-15,3,1
2,4,31,1,30,8,4,0,12,7,30,8,0,0,8,3,30,4,8,0,12,2,30,7,5,0,12,3,30,6,0,0,6,1,-15,3,1
2,2,45,0,30,3,10,0,13,8,30,10,0,0,10,0,30,2,11,0,13,0,30,4,9,0,13,6,30,5,0,0,5,1,-15,3,1
2,4,5,0,30,2,3,0,5,3,30,1,3,0,4,0,30,0,5,0,5,0,30,3,2,0,5,0,30,1,1,0,2,0,-27,3,0
2,3,8,3,30,7,0,0,7,3,30,2,0,0,2,0,30,3,4,0,7,0,30,4,3,0,7,1,30,3,0,0,3,0,-27,3,0
2,2,19,0,30,2,11,0,13,1,30,4,4,0,8,0,30,11,2,0,13,4,30,4,9,0,13,1,30,8,1,0,9,1,-15,3,1
2,3,19,0,30,2,11,0,13,1,30,4,4,0,8,0,30,11,2,0,13,4,30,4,9,0,13,1,30,8,1,0,9,1,-15,3,1
2,2,25,0,30,12,2,0,14,2,30,6,0,0,6,0,30,9,5,0,14,1,30,5,9,0,14,5,30,5,1,0,6,1,-15,3,1
2,0,27,1,30,7,8,0,15,3,30,2,0,0,2,0,30,5,10,0,15,1,30,7,8,0,15,2,30,6,0,0,6,1,-15,3,1
2,0,29,0,30,7,7,0,14,3,30,12,0,0,12,0,30,5,9,0,14,0,30,1,13,0,14,0,30,6,3,0,9,1,-15,3,1
2,4,29,0,30,7,7,0,14,3,30,12,0,0,12,0,30,5,9,0,14,0,30,1,13,0,14,0,30,6,3,0,9,1,-15,3,1
2,2,6,2,30,7,2,0,9,4,30,2,0,0,2,0,30,3,6,0,9,0,30,4,5,0,9,0,30,4,1,0,5,0,-27,3,0
2,4,6,2,30,7,2,0,9,4,30,2,0,0,2,0,30,3,6,0,9,0,30,4,5,0,9,0,30,4,1,0,5,0,-27,3,0
2,1,13,3,30,7,0,0,7,0,30,4,0,0,4,3,30,7,0,0,7,5,30,6,1,0,7,3,30,4,0,0,4,1,-15,3,1
2,3,13,0,30,7,0,0,7,0,30,4,0,0,4,3,30,7,0,0,7,5,30,6,1,0,7,3,30,4,0,0,4,1,-15,3,1
2,1,17,4,30,9,5,0,14,3,30,6,0,0,6,0,30,3,11,0,14,4,30,7,7,0,14,5,30,4,0,0,4,1,-15,3,1
2,2,17,4,30,9,5,0,14,3,30,6,0,0,6,0,30,3,11,0,14,4,30,7,7,0,14,5,30,4,0,0,4,1,-15,3,1
2,2,19,0,30,6,7,0,13,2,30,8,0,0,8,0,30,4,9,0,13,4,30,4,9,0,13,0,30,8,1,0,9,1,-15,3,1
2,3,23,3,30,6,7,0,13,3,30,6,0,0,6,4,30,12,1,0,13,1,30,5,8,0,13,0,30,5,1,0,6,1,-15,3,1
2,0,27,1,30,7,8,0,15,4,30,2,0,0,2,2,30,6,9,0,15,0,30,8,7,0,15,1,30,5,1,0,6,1,-15,3,1
2,1,27,1,30,7,8,0,15,4,30,2,0,0,2,2,30,6,9,0,15,0,30,8,7,0,15,1,30,5,1,0,6,1,-15,3,1
2,3,27,1,30,7,8,0,15,4,30,2,0,0,2,2,30,6,9,0,15,0,30,8,7,0,15,1,30,5,1,0,6,1,-15,3,1
2,1,29,1,30,8,6,0,14,6,30,11,1,0,12,0,30,5,9,0,14,0,30,1,13,0,14,0,30,8,1,0,9,1,-15,3,1
2,4,29,1,30,8,6,0,14,6,30,11,1,0,12,0,30,5,9,0,14,0,30,1,13,0,14,0,30,8,1,0,9,1,-15,3,1
2,4,32,0,30,7,2,0,9,5,30,2,0,0,2,0,30,6,3,0,9,3,30,4,5,0,9,3,30,2,0,0,2,1,-15,3,1
2,3,13,1,30,7,0,0,7,0,30,4,0,0,4,2,30,6,1,0,7,5,30,6,1,0,7,3,30,4,0,0,4,1,-15,3,1
2,4,13,1,30,7,0,0,7,0,30,4,0,0,4,2,30,6,1,0,7,5,30,6,1,0,7,3,30,4,0,0,4,1,-15,3,1
2,2,17,4,30,10,4,0,14,3,30,6,0,0,6,0,30,6,8,0,14,2,30,5,9,0,14,4,30,4,0,0,4,1,-15,3,1
2,0,19,0,30,3,10,0,13,3,30,3,5,0,8,5,30,4,9,0,13,4,30,4,9,0,13,1,30,8,1,0,9,1,-15,3,1
2,4,19,0,30,3,10,0,13,1,30,3,5,0,8,5,30,4,9,0,13,4,30,4,9,0,13,1,30,8,1,0,9,1,-15,3,1
2,3,22,3,30,7,1,0,8,3,30,2,0,0,2,0,30,4,4,0,8,0,30,5,3,0,8,1,30,2,2,0,4,1,-15,3,1
2,4,22,3,30,7,1,0,8,3,30,2,0,0,2,0,30,4,4,0,8,0,30,5,3,0,8,1,30,2,2,0,4,1,-15,3,1
2,3,25,2,30,5,9,0,14,0,30,6,0,0,6,0,30,11,3,0,14,1,30,5,9,0,14,2,30,5,1,0,6,1,-15,3,1
2,2,35,0,30,7,6,0,13,5,30,2,0,0,2,1,30,2,11,0,13,4,30,2,11,0,13,11,30,8,0,0,8,1,-15,3,1
2,0,37,1,30,7,4,0,11,7,30,8,0,0,8,0,30,6,5,0,11,0,30,5,6,0,11,7,30,6,0,0,6,1,-15,3,1
2,3,39,0,30,9,2,0,11,5,30,6,0,0,6,0,30,6,5,0,11,0,30,2,9,0,11,6,30,2,3,0,5,1,-15,3,1
2,3,8,2,30,7,0,0,7,4,30,2,0,0,2,0,30,4,3,0,7,0,30,5,2,0,7,0,30,3,0,0,3,0,-27,3,0
2,2,13,1,30,3,0,0,3,1,30,2,0,0,2,0,30,3,0,0,3,8,30,2,1,0,3,3,30,2,0,0,2,1,-15,3,1
2,2,13,2,30,7,0,0,7,0,30,4,0,0,4,2,30,6,1,0,7,5,30,6,1,0,7,3,30,4,0,0,4,1,-15,3,1
2,3,17,2,30,9,5,0,14,4,30,6,0,0,6,0,30,4,10,0,14,6,30,8,6,0,14,5,30,4,0,0,4,1,-15,3,1
2,4,21,1,30,6,4,0,10,3,30,6,0,0,6,1,30,4,6,0,10,2,30,4,6,0,10,3,30,4,0,0,4,1,-15,3,1
2,0,27,1,30,7,8,0,15,5,30,2,0,0,2,0,30,4,11,0,15,0,30,8,7,0,15,1,30,6,0,0,6,1,-15,3,1
2,1,27,1,30,7,8,0,15,5,30,2,0,0,2,0,30,4,11,0,15,0,30,8,7,0,15,1,30,6,0,0,6,1,-15,3,1
2,2,27,1,30,7,8,0,15,5,30,2,0,0,2,0,30,4,11,0,15,0,30,8,7,0,15,1,30,6,0,0,6,1,-15,3,1
2,3,27,1,30,7,8,0,15,5,30,2,0,0,2,0,30,4,11,0,15,0,30,8,7,0,15,1,30,6,0,0,6,1,-15,3,1
2,3,31,6,30,5,7,0,12,4,30,8,0,0,8,3,30,11,1,0,12,0,30,3,9,0,12,0,30,3,3,0,6,1,-15,3,1
2,3,35,1,30,11,2,0,13,4,30,2,0,0,2,0,30,7,6,0,13,0,30,3,10,0,13,7,30,8,0,0,8,1,-15,3,1
2,3,5,0,30,2,3,0,5,3,30,1,3,0,4,0,30,3,2,0,5,0,30,2,3,0,5,0,30,0,2,0,2,0,-27,3,0
2,0,13,6,30,7,0,0,7,2,30,4,0,0,4,2,30,6,1,0,7,3,30,4,3,0,7,5,30,4,0,0,4,1,-15,3,1
2,1,17,1,30,9,5,0,14,2,30,6,0,0,6,0,30,7,7,0,14,4,30,6,8,0,14,4,30,4,0,0,4,1,-15,3,1
2,2,17,1,30,9,5,0,14,2,30,6,0,0,6,0,30,7,7,0,14,4,30,6,8,0,14,4,30,4,0,0,4,1,-15,3,1
2,2,19,0,30,3,10,0,13,2,30,6,2,0,8,0,30,7,6,0,13,4,30,4,9,0,13,0,30,8,1,0,9,1,-15,3,1
2,3,23,2,30,5,8,0,13,3,30,6,0,0,6,3,30,12,1,0,13,2,30,6,7,0,13,5,30,6,0,0,6,1,-15,3,1
2,4,23,2,30,5,8,0,13,3,30,6,0,0,6,3,30,12,1,0,13,2,30,6,7,0,13,5,30,6,0,0,6,1,-15,3,1
2,1,27,3,30,5,10,0,15,1,30,2,0,0,2,0,30,10,5,0,15,3,30,5,10,0,15,0,30,5,1,0,6,1,-15,3,1
2,3,27,3,30,5,10,0,15,0,30,2,0,0,2,0,30,10,5,0,15,3,30,5,10,0,15,0,30,5,1,0,6,1,-15,3,1
2,2,29,0,30,5,9,0,14,6,30,12,0,0,12,0,30,5,9,0,14,0,30,1,13,0,14,4,30,9,0,0,9,1,-15,3,1
2,4,29,0,30,5,9,0,14,6,30,12,0,0,12,0,30,5,9,0,14,0,30,1,13,0,14,4,30,9,0,0,9,1,-15,3,1
2,0,37,1,30,5,6,0,11,4,30,5,3,0,8,3,30,11,0,0,11,6,30,3,8,0,11,5,30,6,0,0,6,1,-15,3,1
2,2,38,5,30,3,7,0,10,7,30,6,0,0,6,0,30,4,6,0,10,0,30,0,10,0,10,3,30,5,1,0,6,1,-15,3,1
2,4,38,5,30,3,7,0,10,7,30,6,0,0,6,0,30,4,6,0,10,0,30,0,10,0,10,0,30,5,1,0,6,1,-15,3,1
2,3,11,1,30,4,8,0,12,1,30,4,0,0,4,0,30,6,6,0,12,6,30,6,6,0,12,3,30,4,0,0,4,1,-15,3,1
2,4,13,3,30,6,1,0,7,1,30,4,0,0,4,2,30,6,1,0,7,2,30,6,1,0,7,6,30,4,0,0,4,1,-15,3,1
2,3,19,0,30,2,11,0,13,2,30,7,1,0,8,0,30,5,8,0,13,1,30,4,9,0,13,1,30,9,0,0,9,1,-15,3,1
2,1,25,1,30,4,10,0,14,4,30,6,0,0,6,0,30,7,7,0,14,1,30,4,10,0,14,5,30,6,0,0,6,1,-15,3,1
2,2,25,1,30,4,10,0,14,4,30,6,0,0,6,0,30,7,7,0,14,1,30,4,10,0,14,5,30,6,0,0,6,1,-15,3,1
2,0,27,2,30,5,10,0,15,4,30,1,1,0,2,0,30,2,13,0,15,4,30,6,9,0,15,4,30,6,0,0,6,1,-15,3,1
2,3,31,1,30,9,3,0,12,4,30,8,0,0,8,3,30,8,4,0,12,0,30,3,9,0,12,1,30,2,4,0,6,1,-15,3,1
2,4,31,1,30,9,3,0,12,4,30,8,0,0,8,3,30,8,4,0,12,0,30,3,9,0,12,1,30,2,4,0,6,1,-15,3,1
2,3,45,0,30,3,10,0,13,8,30,10,0,0,10,0,30,2,11,0,13,0,30,4,9,0,13,8,30,5,0,0,5,1,-15,3,1
2,3,5,0,30,2,3,0,5,2,30,2,2,0,4,0,30,2,3,0,5,0,30,1,4,0,5,2,30,0,2,0,2,0,-27,3,0
2,4,8,2,30,7,0,0,7,4,30,2,0,0,2,3,30,5,2,0,7,0,30,6,1,0,7,2,30,3,0,0,3,0,-27,3,0
2,2,17,3,30,10,4,0,14,3,30,6,0,0,6,0,30,4,10,0,14,5,30,3,11,0,14,4,30,4,0,0,4,1,-15,3,1
2,0,19,0,30,3,10,0,13,2,30,4,4,0,8,0,30,4,9,0,13,3,30,6,7,0,13,2,30,8,1,0,9,1,-15,3,1
2,4,23,1,30,5,8,0,13,3,30,6,0,0,6,6,30,8,5,0,13,0,30,7,6,0,13,0,30,4,2,0,6,1,-15,3,1
2,1,25,2,30,10,4,0,14,3,30,6,0,0,6,0,30,6,8,0,14,1,30,5,9,0,14,4,30,5,1,0,6,1,-15,3,1
2,2,25,2,30,10,4,0,14,3,30,6,0,0,6,0,30,6,8,0,14,1,30,5,9,0,14,4,30,5,1,0,6,1,-15,3,1
2,2,27,1,30,4,11,0,15,2,30,2,0,0,2,0,30,6,9,0,15,0,30,6,9,0,15,1,30,6,0,0,6,1,-15,3,1
2,4,27,1,30,4,11,0,15,2,30,2,0,0,2,0,30,6,9,0,15,0,30,6,9,0,15,1,30,6,0,0,6,1,-15,3,1
2,4,29,0,30,7,7,0,14,6,30,8,4,0,12,0,30,4,10,0,14,0,30,6,8,0,14,0,30,9,0,0,9,1,-15,3,1
2,2,32,1,30,9,0,0,9,5,30,2,0,0,2,2,30,7,2,0,9,1,30,2,7,0,9,1,30,2,0,0,2,1,-15,3,1
2,2,33,1,30,6,5,0,11,4,30,4,0,0,4,0,30,7,4,0,11,2,30,3,8,0,11,6,30,4,0,0,4,1,-15,3,1
2,3,37,1,30,6,5,0,11,4,30,5,3,0,8,0,30,11,0,0,11,2,30,2,9,0,11,3,30,6,0,0,6,1,-15,3,1
2,4,37,1,30,6,5,0,11,4,30,5,3,0,8,0,30,11,0,0,11,2,30,2,9,0,11,3,30,6,0,0,6,1,-15,3,1
2,3,5,1,30,3,2,0,5,3,30,4,0,0,4,0,30,0,5,0,5,0,30,1,4,0,5,0,30,0,2,0,2,0,-27,3,0
2,1,13,2,30,6,1,0,7,0,30,4,0,0,4,3,30,7,0,0,7,3,30,7,0,0,7,4,30,4,0,0,4,1,-15,3,1
2,4,17,4,30,7,7,0,14,3,30,6,0,0,6,0,30,6,8,0,14,3,30,7,7,0,14,0,30,4,0,0,4,1,-15,3,1
2,3,19,1,30,4,9,0,13,1,30,7,1,0,8,0,30,8,5,0,13,0,30,7,6,0,13,1,30,6,3,0,9,1,-15,3,1
2,1,21,5,30,8,2,0,10,3,30,5,1,0,6,1,30,6,4,0,10,0,30,4,6,0,10,0,30,3,1,0,4,1,-15,3,1
2,4,21,5,30,8,2,0,10,3,30,5,1,0,6,1,30,6,4,0,10,0,30,4,6,0,10,0,30,3,1,0,4,1,-15,3,1
2,4,23,1,30,5,8,0,13,3,30,6,0,0,6,3,30,12,1,0,13,0,30,3,10,0,13,4,30,6,0,0,6,1,-15,3,1
2,3,25,0,30,5,9,0,14,3,30,6,0,0,6,0,30,7,7,0,14,3,30,9,5,0,14,4,30,6,0,0,6,1,-15,3,1
2,3,27,1,30,5,10,0,15,3,30,2,0,0,2,0,30,5,10,0,15,4,30,6,9,0,15,3,30,6,0,0,6,1,-15,3,1
2,3,29,0,30,6,8,0,14,6,30,12,0,0,12,0,30,4,10,0,14,0,30,1,13,0,14,1,30,9,0,0,9,1,-15,3,1
2,3,39,0,30,5,6,0,11,6,30,6,0,0,6,0,30,8,3,0,11,0,30,2,9,0,11,5,30,5,0,0,5,1,-15,3,1
2,0,4,2,30,7,1,0,8,4,30,4,0,0,4,1,30,2,6,0,8,0,30,5,3,0,8,1,30,4,0,0,4,0,-27,3,0
2,1,13,1,30,6,1,0,7,0,30,4,0,0,4,2,30,7,0,0,7,7,30,6,1,0,7,5,30,4,0,0,4,1,-15,3,1
2,4,13,1,30,6,1,0,7,0,30,4,0,0,4,2,30,7,0,0,7,7,30,6,1,0,7,5,30,4,0,0,4,1,-15,3,1
2,1,19,0,30,3,10,0,13,2,30,4,4,0,8,0,30,6,7,0,13,8,30,6,7,0,13,2,30,9,0,0,9,1,-15,3,1
2,2,19,0,30,3,10,0,13,2,30,4,4,0,8,0,30,6,7,0,13,8,30,6,7,0,13,2,30,9,0,0,9,1,-15,3,1
2,4,19,0,30,3,10,0,13,2,30,4,4,0,8,0,30,6,7,0,13,8,30,6,7,0,13,2,30,9,0,0,9,1,-15,3,1
2,1,25,1,30,8,6,0,14,3,30,6,0,0,6,1,30,5,9,0,14,1,30,5,9,0,14,4,30,5,1,0,6,1,-15,3,1
2,2,25,1,30,8,6,0,14,3,30,6,0,0,6,1,30,5,9,0,14,1,30,5,9,0,14,4,30,5,1,0,6,1,-15,3,1
2,3,25,1,30,8,6,0,14,3,30,6,0,0,6,1,30,5,9,0,14,1,30,5,9,0,14,4,30,5,1,0,6,1,-15,3,1
2,2,31,5,30,7,5,0,12,6,30,8,0,0,8,3,30,7,5,0,12,0,30,7,5,0,12,1,30,6,0,0,6,1,-15,3,1
2,3,31,5,30,7,5,0,12,6,30,8,0,0,8,3,30,7,5,0,12,0,30,7,5,0,12,1,30,6,0,0,6,1,-15,3,1
2,3,39,0,30,2,9,0,11,6,30,6,0,0,6,0,30,6,5,0,11,1,30,3,8,0,11,5,30,5,0,0,5,1,-15,3,1
2,4,39,0,30,2,9,0,11,6,30,6,0,0,6,0,30,6,5,0,11,1,30,3,8,0,11,5,30,5,0,0,5,1,-15,3,1
2,0,4,2,30,8,0,0,8,5,30,4,0,0,4,1,30,2,6,0,8,1,30,8,0,0,8,2,30,3,1,0,4,0,-27,3,0
2,3,4,2,30,8,0,0,8,5,30,4,0,0,4,1,30,2,6,0,8,1,30,8,0,0,8,2,30,3,1,0,4,0,-27,3,0
2,3,8,2,30,7,0,0,7,3,30,2,0,0,2,6,30,3,4,0,7,2,30,7,0,0,7,0,30,3,0,0,3,0,-27,3,0
2,1,13,2,30,7,0,0,7,0,30,4,0,0,4,2,30,6,1,0,7,8,30,6,1,0,7,5,30,4,0,0,4,1,-15,3,1
2,2,17,4,30,10,4,0,14,3,30,6,0,0,6,0,30,7,7,0,14,3,30,5,9,0,14,2,30,4,0,0,4,1,-15,3,1
2,3,17,4,30,10,4,0,14,3,30,6,0,0,6,0,30,7,7,0,14,3,30,5,9,0,14,2,30,4,0,0,4,1,-15,3,1
2,3,19,3,30,2,11,0,13,3,30,8,0,0,8,0,30,4,9,0,13,0,30,4,9,0,13,2,30,7,2,0,9,1,-15,3,1
2,1,27,1,30,10,5,0,15,4,30,2,0,0,2,2,30,7,8,0,15,2,30,4,11,0,15,1,30,5,1,0,6,1,-15,3,1
2,3,29,0,30,6,8,0,14,4,30,10,2,0,12,0,30,3,11,0,14,0,30,1,13,0,14,3,30,9,0,0,9,1,-15,3,1
2,0,31,2,30,5,7,0,12,7,30,8,0,0,8,3,30,4,8,0,12,0,30,7,5,0,12,4,30,6,0,0,6,1,-15,3,1
2,4,31,2,30,5,7,0,12,7,30,8,0,0,8,3,30,4,8,0,12,0,30,7,5,0,12,4,30,6,0,0,6,1,-15,3,1
2,4,39,1,30,6,5,0,11,7,30,6,0,0,6,0,30,3,8,0,11,0,30,2,9,0,11,2,30,5,0,0,5,1,-15,3,1
2,2,5,0,30,1,4,0,5,2,30,2,2,0,4,0,30,1,4,0,5,0,30,1,4,0,5,1,30,0,2,0,2,0,-27,3,0
2,3,5,0,30,1,4,0,5,2,30,2,2,0,4,0,30,1,4,0,5,0,30,1,4,0,5,1,30,0,2,0,2,0,-27,3,0
2,4,5,0,30,1,4,0,5,2,30,2,2,0,4,0,30,1,4,0,5,0,30,1,4,0,5,1,30,0,2,0,2,0,-27,3,0
2,1,13,2,30,7,0,0,7,0,30,4,0,0,4,2,30,5,2,0,7,7,30,5,2,0,7,4,30,4,0,0,4,1,-15,3,1
2,4,13,2,30,7,0,0,7,0,30,4,0,0,4,2,30,5,2,0,7,7,30,5,2,0,7,4,30,4,0,0,4,1,-15,3,1
2,1,19,1,30,4,9,0,13,2,30,7,1,0,8,0,30,6,7,0,13,8,30,5,8,0,13,0,30,7,2,0,9,1,-15,3,1
2,4,19,1,30,4,9,0,13,2,30,7,1,0,8,0,30,6,7,0,13,8,30,5,8,0,13,0,30,7,2,0,9,1,-15,3,1
2,3,23,2,30,5,8,0,13,2,30,6,0,0,6,8,30,13,0,0,13,0,30,6,7,0,13,3,30,6,0,0,6,1,-15,3,1
2,4,23,2,30,5,8,0,13,2,30,6,0,0,6,8,30,13,0,0,13,0,30,6,7,0,13,3,30,6,0,0,6,1,-15,3,1
2,4,25,1,30,6,8,0,14,5,30,6,0,0,6,0,30,6,8,0,14,1,30,5,9,0,14,1,30,5,1,0,6,1,-15,3,1
2,0,26,0,30,7,2,0,9,5,30,4,0,0,4,2,30,0,9,0,9,0,30,2,7,0,9,5,30,3,0,0,3,1,-15,3,1
2,3,26,0,30,7,2,0,9,5,30,4,0,0,4,2,30,0,9,0,9,0,30,2,7,0,9,5,30,3,0,0,3,1,-15,3,1
2,4,26,0,30,7,2,0,9,5,30,4,0,0,4,2,30,0,9,0,9,0,30,2,7,0,9,5,30,3,0,0,3,1,-15,3,1
2,0,27,1,30,4,11,0,15,3,30,2,0,0,2,0,30,3,12,0,15,3,30,6,9,0,15,1,30,6,0,0,6,1,-15,3,1
2,1,27,1,30,4,11,0,15,3,30,2,0,0,2,0,30,3,12,0,15,3,30,6,9,0,15,1,30,6,0,0,6,1,-15,3,1
2,2,27,1,30,4,11,0,15,3,30,2,0,0,2,0,30,3,12,0,15,3,30,6,9,0,15,1,30,6,0,0,6,1,-15,3,1
2,3,27,1,30,4,11,0,15,3,30,2,0,0,2,0,30,3,12,0,15,3,30,6,9,0,15,1,30,6,0,0,6,1,-15,3,1
2,0,29,0,30,6,8,0,14,6,30,8,4,0,12,0,30,3,11,0,14,0,30,1,13,0,14,3,30,9,0,0,9,1,-15,3,1
2,3,32,0,30,6,3,0,9,2,30,2,0,0,2,1,30,9,0,0,9,5,30,2,7,0,9,3,30,2,0,0,2,1,-15,3,1
2,4,32,0,30,6,3,0,9,2,30,2,0,0,2,1,30,9,0,0,9,5,30,2,7,0,9,3,30,2,0,0,2,1,-15,3,1
2,2,38,0,30,3,7,0,10,7,30,6,0,0,6,0,30,1,9,0,10,0,30,3,7,0,10,7,30,6,0,0,6,1,-15,3,1
2,2,15,0,30,0,4,0,4,0,30,6,0,0,6,0,30,2,2,0,4,13,30,4,0,0,4,0,30,4,0,0,4,1,-15,3,1
2,0,17,4,30,10,4,0,14,3,30,6,0,0,6,0,30,4,10,0,14,5,30,7,7,0,14,5,30,4,0,0,4,1,-15,3,1
2,1,17,4,30,10,4,0,14,3,30,6,0,0,6,0,30,4,10,0,14,5,30,7,7,0,14,5,30,4,0,0,4,1,-15,3,1
2,4,17,0,30,10,4,0,14,3,30,6,0,0,6,0,30,4,10,0,14,5,30,7,7,0,14,5,30,4,0,0,4,1,-15,3,1
2,3,21,2,30,9,1,0,10,3,30,6,0,0,6,1,30,5,5,0,10,3,30,4,6,0,10,3,30,4,0,0,4,1,-15,3,1
2,4,23,1,30,5,8,0,13,2,30,6,0,0,6,2,30,10,3,0,13,0,30,6,7,0,13,4,30,6,0,0,6,1,-15,3,1
2,2,27,1,30,3,12,0,15,5,30,2,0,0,2,0,30,2,13,0,15,3,30,3,12,0,15,5,30,6,0,0,6,1,-15,3,1
2,3,27,1,30,3,12,0,15,5,30,2,0,0,2,0,30,2,13,0,15,3,30,3,12,0,15,5,30,6,0,0,6,1,-15,3,1
2,4,27,1,30,3,12,0,15,5,30,2,0,0,2,0,30,2,13,0,15,3,30,3,12,0,15,5,30,6,0,0,6,1,-15,3,1
2,2,29,0,30,6,8,0,14,6,30,11,1,0,12,0,30,4,10,0,14,0,30,2,12,0,14,1,30,9,0,0,9,1,-15,3,1
2,3,29,0,30,6,8,0,14,6,30,11,1,0,12,0,30,4,10,0,14,0,30,2,12,0,14,1,30,9,0,0,9,1,-15,3,1
2,3,33,0,30,3,8,0,11,4,30,4,0,0,4,0,30,11,0,0,11,0,30,4,7,0,11,6,30,4,0,0,4,1,-15,3,1
2,2,47,0,30,1,13,0,14,6,30,4,0,0,4,0,30,3,11,0,14,2,30,2,12,0,14,8,30,7,0,0,7,1,-15,3,1
2,3,47,0,30,1,13,0,14,6,30,4,0,0,4,0,30,3,11,0,14,2,30,2,12,0,14,8,30,7,0,0,7,1,-15,3,1
2,3,6,0,30,9,0,0,9,4,30,2,0,0,2,0,30,2,7,0,9,0,30,4,5,0,9,1,30,5,0,0,5,0,-27,3,0
2,1,13,3,30,7,0,0,7,1,30,4,0,0,4,2,30,6,1,0,7,4,30,6,1,0,7,7,30,4,0,0,4,1,-15,3,1
2,2,13,3,30,7,0,0,7,1,30,4,0,0,4,2,30,6,1,0,7,4,30,6,1,0,7,7,30,4,0,0,4,1,-15,3,1
2,4,19,0,30,5,8,0,13,2,30,7,1,0,8,4,30,5,8,0,13,4,30,5,8,0,13,0,30,5,4,0,9,1,-15,3,1
2,3,22,1,30,5,3,0,8,3,30,2,0,0,2,1,30,4,4,0,8,1,30,1,7,0,8,2,30,3,1,0,4,1,-15,3,1
2,4,22,1,30,5,3,0,8,3,30,2,0,0,2,1,30,4,4,0,8,1,30,1,7,0,8,2,30,3,1,0,4,1,-15,3,1
2,3,23,1,30,4,9,0,13,4,30,6,0,0,6,7,30,10,3,0,13,0,30,4,9,0,13,3,30,6,0,0,6,1,-15,3,1
2,1,27,1,30,5,10,0,15,2,30,1,1,0,2,0,30,9,6,0,15,0,30,9,6,0,15,5,30,6,0,0,6,1,-15,3,1
2,2,27,1,30,5,10,0,15,2,30,1,1,0,2,0,30,9,6,0,15,0,30,9,6,0,15,5,30,6,0,0,6,1,-15,3,1
2,4,27,1,30,5,10,0,15,2,30,1,1,0,2,0,30,9,6,0,15,0,30,9,6,0,15,5,30,6,0,0,6,1,-15,3,1
2,2,33,2,30,5,6,0,11,4,30,4,0,0,4,4,30,10,1,0,11,0,30,3,8,0,11,5,30,4,0,0,4,1,-15,3,1
2,3,33,2,30,5,6,0,11,4,30,4,0,0,4,4,30,10,1,0,11,0,30,3,8,0,11,5,30,4,0,0,4,1,-15,3,1
2,4,33,2,30,5,6,0,11,4,30,4,0,0,4,4,30,10,1,0,11,0,30,3,8,0,11,5,30,4,0,0,4,1,-15,3,1
2,0,5,4,30,2,3,0,5,3,30,3,1,0,4,0,30,0,5,0,5,0,30,1,4,0,5,0,30,0,2,0,2,0,-27,3,0
2,0,19,0,30,3,10,0,13,2,30,4,4,0,8,0,30,5,8,0,13,4,30,6,7,0,13,1,30,9,0,0,9,1,-15,3,1
2,4,19,0,30,3,10,0,13,2,30,4,4,0,8,0,30,5,8,0,13,4,30,6,7,0,13,1,30,9,0,0,9,1,-15,3,1
2,3,25,3,30,11,3,0,14,4,30,6,0,0,6,0,30,7,7,0,14,1,30,5,9,0,14,5,30,5,1,0,6,1,-15,3,1
2,3,4,2,30,7,1,0,8,4,30,4,0,0,4,5,30,3,5,0,8,0,30,4,4,0,8,1,30,3,1,0,4,0,-27,3,0
2,2,13,2,30,5,2,0,7,0,30,4,0,0,4,1,30,5,2,0,7,10,30,5,2,0,7,7,30,4,0,0,4,1,-15,3,1
2,4,15,1,30,3,10,0,13,1,30,6,0,0,6,0,30,4,9,0,13,1,30,4,9,0,13,3,30,9,0,0,9,1,-15,3,1
2,3,19,0,30,3,10,0,13,2,30,8,0,0,8,0,30,4,9,0,13,4,30,8,5,0,13,0,30,7,2,0,9,1,-15,3,1
2,4,19,0,30,3,10,0,13,2,30,8,0,0,8,0,30,4,9,0,13,4,30,8,5,0,13,0,30,7,2,0,9,1,-15,3,1
2,4,23,2,30,8,5,0,13,2,30,6,0,0,6,4,30,12,1,0,13,0,30,5,8,0,13,2,30,6,0,0,6,1,-15,3,1
2,3,27,1,30,5,10,0,15,2,30,2,0,0,2,0,30,3,12,0,15,0,30,4,11,0,15,4,30,6,0,0,6,1,-15,3,1
2,3,4,0,30,7,1,0,8,4,30,4,0,0,4,0,30,2,6,0,8,0,30,4,4,0,8,3,30,4,0,0,4,0,-27,3,0
2,4,8,2,30,7,0,0,7,3,30,2,0,0,2,0,30,1,6,0,7,0,30,5,2,0,7,6,30,3,0,0,3,0,-27,3,0
2,1,13,4,30,7,0,0,7,0,30,4,0,0,4,2,30,5,2,0,7,9,30,6,1,0,7,3,30,4,0,0,4,1,-15,3,1
2,1,17,3,30,9,5,0,14,2,30,6,0,0,6,2,30,8,6,0,14,1,30,6,8,0,14,7,30,4,0,0,4,1,-15,3,1
2,3,17,3,30,9,5,0,14,2,30,6,0,0,6,2,30,8,6,0,14,1,30,6,8,0,14,7,30,4,0,0,4,1,-15,3,1
2,1,19,0,30,3,10,0,13,2,30,6,2,0,8,0,30,5,8,0,13,3,30,6,7,0,13,2,30,9,0,0,9,1,-15,3,1
2,2,23,1,30,8,5,0,13,3,30,6,0,0,6,5,30,12,1,0,13,0,30,4,9,0,13,4,30,6,0,0,6,1,-15,3,1
2,3,25,1,30,7,7,0,14,4,30,6,0,0,6,0,30,6,8,0,14,1,30,9,5,0,14,4,30,6,0,0,6,1,-15,3,1
2,4,25,1,30,7,7,0,14,4,30,6,0,0,6,0,30,6,8,0,14,1,30,9,5,0,14,4,30,6,0,0,6,1,-15,3,1
2,0,27,1,30,6,9,0,15,2,30,2,0,0,2,0,30,4,11,0,15,2,30,3,12,0,15,3,30,6,0,0,6,1,-15,3,1
2,1,27,1,30,6,9,0,15,2,30,2,0,0,2,0,30,4,11,0,15,2,30,3,12,0,15,3,30,6,0,0,6,1,-15,3,1
2,3,27,0,30,6,9,0,15,2,30,2,0,0,2,0,30,4,11,0,15,2,30,3,12,0,15,3,30,6,0,0,6,1,-15,3,1
2,4,29,0,30,10,4,0,14,4,30,10,2,0,12,0,30,4,10,0,14,0,30,1,13,0,14,0,30,7,2,0,9,1,-15,3,1
2,4,7,1,30,5,4,0,9,2,30,4,0,0,4,0,30,6,3,0,9,4,30,3,6,0,9,1,30,4,2,0,6,0,-27,3,0
2,4,8,2,30,7,0,0,7,5,30,2,0,0,2,0,30,1,6,0,7,1,30,7,0,0,7,2,30,3,0,0,3,0,-27,3,0
2,1,19,0,30,6,7,0,13,2,30,3,5,0,8,2,30,5,8,0,13,6,30,7,6,0,13,2,30,8,1,0,9,1,-15,3,1
2,0,29,0,30,5,9,0,14,6,30,11,1,0,12,0,30,3,11,0,14,0,30,1,13,0,14,4,30,9,0,0,9,1,-15,3,1
2,2,29,0,30,5,9,0,14,6,30,11,1,0,12,0,30,3,11,0,14,0,30,1,13,0,14,4,30,9,0,0,9,1,-15,3,1
2,3,29,0,30,5,9,0,14,6,30,11,1,0,12,0,30,3,11,0,14,0,30,1,13,0,14,4,30,9,0,0,9,1,-15,3,1
2,3,33,3,30,5,6,0,11,4,30,4,0,0,4,3,30,11,0,0,11,0,30,3,8,0,11,5,30,4,0,0,4,1,-15,3,1
2,3,35,0,30,6,7,0,13,4,30,2,0,0,2,1,30,2,11,0,13,1,30,4,9,0,13,4,30,8,0,0,8,1,-15,3,1
2,4,35,0,30,6,7,0,13,4,30,2,0,0,2,1,30,2,11,0,13,1,30,4,9,0,13,4,30,8,0,0,8,1,-15,3,1
2,4,5,0,30,3,2,0,5,2,30,2,2,0,4,0,30,2,3,0,5,0,30,1,4,0,5,0,30,0,2,0,2,0,-27,3,0
2,0,6,2,30,8,1,0,9,4,30,2,0,0,2,0,30,2,7,0,9,0,30,4,5,0,9,0,30,4,1,0,5,0,-27,3,0
2,3,8,3,30,7,0,0,7,5,30,2,0,0,2,0,30,2,5,0,7,0,30,6,1,0,7,4,30,3,0,0,3,0,-27,3,0
2,4,8,3,30,7,0,0,7,5,30,2,0,0,2,0,30,2,5,0,7,0,30,6,1,0,7,4,30,3,0,0,3,0,-27,3,0
2,0,13,1,30,7,0,0,7,1,30,4,0,0,4,2,30,6,1,0,7,5,30,6,1,0,7,6,30,4,0,0,4,1,-15,3,1
2,3,13,1,30,7,0,0,7,0,30,4,0,0,4,2,30,6,1,0,7,5,30,6,1,0,7,6,30,4,0,0,4,1,-15,3,1
2,4,13,1,30,7,0,0,7,0,30,4,0,0,4,2,30,6,1,0,7,5,30,6,1,0,7,6,30,4,0,0,4,1,-15,3,1
2,1,17,4,30,9,5,0,14,2,30,6,0,0,6,0,30,7,7,0,14,2,30,7,7,0,14,0,30,4,0,0,4,1,-15,3,1
2,2,17,4,30,9,5,0,14,2,30,6,0,0,6,0,30,7,7,0,14,2,30,7,7,0,14,0,30,4,0,0,4,1,-15,3,1
2,1,19,0,30,4,9,0,13,1,30,8,0,0,8,1,30,10,3,0,13,0,30,3,10,0,13,1,30,8,1,0,9,1,-15,3,1
2,2,19,0,30,4,9,0,13,1,30,8,0,0,8,1,30,10,3,0,13,0,30,3,10,0,13,1,30,8,1,0,9,1,-15,3,1
2,0,25,2,30,4,10,0,14,5,30,6,0,0,6,0,30,4,10,0,14,1,30,8,6,0,14,8,30,6,0,0,6,1,-15,3,1
2,2,25,2,30,4,10,0,14,5,30,6,0,0,6,0,30,4,10,0,14,1,30,8,6,0,14,8,30,6,0,0,6,1,-15,3,1
2,1,27,1,30,6,9,0,15,4,30,2,0,0,2,0,30,3,12,0,15,0,30,4,11,0,15,3,30,6,0,0,6,1,-15,3,1
2,2,27,1,30,6,9,0,15,4,30,2,0,0,2,0,30,3,12,0,15,0,30,4,11,0,15,3,30,6,0,0,6,1,-15,3,1
2,1,13,1,30,6,1,0,7,0,30,4,0,0,4,2,30,5,2,0,7,7,30,6,1,0,7,4,30,4,0,0,4,1,-15,3,1
2,4,13,1,30,6,1,0,7,0,30,4,0,0,4,2,30,5,2,0,7,7,30,6,1,0,7,4,30,4,0,0,4,1,-15,3,1
2,4,25,2,30,6,8,0,14,3,30,6,0,0,6,0,30,12,2,0,14,1,30,5,9,0,14,2,30,5,1,0,6,1,-15,3,1
2,4,27,0,30,7,8,0,15,0,30,2,0,0,2,0,30,6,9,0,15,2,30,3,12,0,15,2,30,6,0,0,6,1,-15,3,1
2,1,13,5,30,3,0,0,3,1,30,2,0,0,2,0,30,2,1,0,3,4,30,2,1,0,3,2,30,2,0,0,2,1,-15,3,1
2,3,13,6,30,7,0,0,7,3,30,4,0,0,4,7,30,6,1,0,7,5,30,6,1,0,7,2,30,4,0,0,4,1,-15,3,1
2,4,13,6,30,7,0,0,7,3,30,4,0,0,4,7,30,6,1,0,7,5,30,6,1,0,7,2,30,4,0,0,4,1,-15,3,1
2,2,17,2,30,9,5,0,14,3,30,6,0,0,6,0,30,5,9,0,14,4,30,7,7,0,14,6,30,4,0,0,4,1,-15,3,1
2,2,19,0,30,3,10,0,13,3,30,5,3,0,8,0,30,4,9,0,13,5,30,5,8,0,13,2,30,9,0,0,9,1,-15,3,1
2,4,19,0,30,3,10,0,13,0,30,5,3,0,8,0,30,4,9,0,13,5,30,5,8,0,13,2,30,9,0,0,9,1,-15,3,1
2,1,25,2,30,5,9,0,14,2,30,6,0,0,6,0,30,12,2,0,14,1,30,5,9,0,14,4,30,5,1,0,6,1,-15,3,1
2,2,25,2,30,5,9,0,14,2,30,6,0,0,6,0,30,12,2,0,14,1,30,5,9,0,14,4,30,5,1,0,6,1,-15,3,1
2,0,27,1,30,4,11,0,15,5,30,2,0,0,2,0,30,7,8,0,15,1,30,5,10,0,15,3,30,6,0,0,6,1,-15,3,1
2,2,27,1,30,4,11,0,15,5,30,2,0,0,2,0,30,7,8,0,15,1,30,5,10,0,15,3,30,6,0,0,6,1,-15,3,1
2,1,41,1,30,8,4,0,12,5,30,6,2,0,8,0,30,10,2,0,12,0,30,3,9,0,12,3,30,6,1,0,7,1,-15,3,1
2,3,41,1,30,8,4,0,12,5,30,6,2,0,8,0,30,10,2,0,12,0,30,3,9,0,12,3,30,6,1,0,7,1,-15,3,1
2,0,4,2,30,7,1,0,8,5,30,4,0,0,4,0,30,2,6,0,8,0,30,7,1,0,8,1,30,4,0,0,4,0,-27,3,0
2,1,4,2,30,7,1,0,8,5,30,4,0,0,4,0,30,2,6,0,8,0,30,7,1,0,8,1,30,4,0,0,4,0,-27,3,0
2,3,4,2,30,7,1,0,8,5,30,4,0,0,4,0,30,2,6,0,8,0,30,7,1,0,8,1,30,4,0,0,4,0,-27,3,0
2,2,13,4,30,7,0,0,7,0,30,4,0,0,4,2,30,7,0,0,7,8,30,4,3,0,7,0,30,4,0,0,4,1,-15,3,1
2,4,13,4,30,7,0,0,7,0,30,4,0,0,4,2,30,7,0,0,7,8,30,4,3,0,7,0,30,4,0,0,4,1,-15,3,1
2,2,25,1,30,8,6,0,14,0,30,6,0,0,6,0,30,10,4,0,14,0,30,6,8,0,14,1,30,5,1,0,6,1,-15,3,1
2,2,26,0,30,7,2,0,9,4,30,2,2,0,4,2,30,0,9,0,9,0,30,1,8,0,9,3,30,3,0,0,3,1,-15,3,1
2,0,27,1,30,4,11,0,15,3,30,2,0,0,2,0,30,10,5,0,15,1,30,3,12,0,15,3,30,6,0,0,6,1,-15,3,1
2,2,27,1,30,4,11,0,15,3,30,2,0,0,2,0,30,10,5,0,15,1,30,3,12,0,15,3,30,6,0,0,6,1,-15,3,1
2,3,27,1,30,4,11,0,15,3,30,2,0,0,2,0,30,10,5,0,15,1,30,3,12,0,15,3,30,6,0,0,6,1,-15,3,1
2,4,27,1,30,4,11,0,15,3,30,2,0,0,2,0,30,10,5,0,15,1,30,3,12,0,15,3,30,6,0,0,6,1,-15,3,1
2,1,35,1,30,6,7,0,13,2,30,2,0,0,2,1,30,11,2,0,13,0,30,3,10,0,13,3,30,8,0,0,8,1,-15,3,1
2,3,35,1,30,6,7,0,13,2,30,2,0,0,2,1,30,11,2,0,13,0,30,3,10,0,13,3,30,8,0,0,8,1,-15,3,1
2,4,35,1,30,6,7,0,13,2,30,2,0,0,2,1,30,11,2,0,13,0,30,3,10,0,13,3,30,8,0,0,8,1,-15,3,1
2,4,6,0,30,8,1,0,9,3,30,2,0,0,2,0,30,6,3,0,9,0,30,4,5,0,9,0,30,5,0,0,5,0,-27,3,0
2,2,13,3,30,6,1,0,7,0,30,4,0,0,4,2,30,6,1,0,7,10,30,6,1,0,7,3,30,4,0,0,4,1,-15,3,1
2,4,13,3,30,6,1,0,7,0,30,4,0,0,4,2,30,6,1,0,7,10,30,6,1,0,7,3,30,4,0,0,4,1,-15,3,1
2,1,17,5,30,9,5,0,14,2,30,6,0,0,6,0,30,7,7,0,14,2,30,4,10,0,14,6,30,4,0,0,4,1,-15,3,1
2,1,25,0,30,5,9,0,14,2,30,6,0,0,6,1,30,14,0,0,14,1,30,5,9,0,14,3,30,5,1,0,6,1,-15,3,1
2,3,25,0,30,5,9,0,14,2,30,6,0,0,6,1,30,14,0,0,14,1,30,5,9,0,14,3,30,5,1,0,6,1,-15,3,1
2,1,31,1,30,5,7,0,12,6,30,8,0,0,8,5,30,5,7,0,12,4,30,7,5,0,12,4,30,6,0,0,6,1,-15,3,1
2,4,31,1,30,5,7,0,12,6,30,8,0,0,8,5,30,5,7,0,12,0,30,7,5,0,12,4,30,6,0,0,6,1,-15,3,1
2,0,43,0,30,11,3,0,14,7,30,6,0,0,6,0,30,4,10,0,14,5,30,1,13,0,14,10,30,5,0,0,5,1,-15,3,1
2,3,43,0,30,11,3,0,14,7,30,6,0,0,6,0,30,4,10,0,14,5,30,1,13,0,14,5,30,5,0,0,5,1,-15,3,1
2,3,3,0,30,0,4,0,4,2,30,4,0,0,4,0,30,1,3,0,4,5,30,1,3,0,4,0,30,3,0,0,3,0,-27,3,0
2,4,3,0,30,0,4,0,4,2,30,4,0,0,4,0,30,1,3,0,4,5,30,1,3,0,4,0,30,3,0,0,3,0,-27,3,0
2,3,7,0,30,4,0,0,4,2,30,2,0,0,2,0,30,1,3,0,4,0,30,1,3,0,4,2,30,1,1,0,2,0,-27,3,0
2,3,11,0,30,5,7,0,12,1,30,4,0,0,4,0,30,6,6,0,12,6,30,7,5,0,12,6,30,4,0,0,4,1,-15,3,1
2,4,11,0,30,5,7,0,12,1,30,4,0,0,4,0,30,6,6,0,12,6,30,7,5,0,12,6,30,4,0,0,4,1,-15,3,1
2,1,13,2,30,7,0,0,7,0,30,4,0,0,4,2,30,7,0,0,7,5,30,6,1,0,7,5,30,4,0,0,4,1,-15,3,1
2,3,13,2,30,7,0,0,7,0,30,4,0,0,4,2,30,7,0,0,7,5,30,6,1,0,7,1,30,4,0,0,4,1,-15,3,1
2,3,15,0,30,5,8,0,13,1,30,5,1,0,6,0,30,3,10,0,13,1,30,6,7,0,13,2,30,9,0,0,9,1,-15,3,1
2,3,19,0,30,4,9,0,13,2,30,6,2,0,8,0,30,5,8,0,13,0,30,3,10,0,13,1,30,8,1,0,9,1,-15,3,1
2,0,21,2,30,6,4,0,10,4,30,6,0,0,6,1,30,3,7,0,10,2,30,5,5,0,10,7,30,4,0,0,4,1,-15,3,1
2,4,22,1,30,6,2,0,8,1,30,2,0,0,2,0,30,4,4,0,8,4,30,2,6,0,8,6,30,4,0,0,4,1,-15,3,1
2,1,41,0,30,7,5,0,12,4,30,8,0,0,8,0,30,11,1,0,12,0,30,3,9,0,12,1,30,0,7,0,7,1,-15,3,1
2,3,11,0,30,1,3,0,4,0,30,0,0,0,0,0,30,2,2,0,4,5,30,2,2,0,4,2,30,1,0,0,1,1,-15,3,1
2,4,11,0,30,1,3,0,4,0,30,0,0,0,0,0,30,2,2,0,4,5,30,2,2,0,4,2,30,1,0,0,1,1,-15,3,1
2,1,13,2,30,7,0,0,7,1,30,4,0,0,4,3,30,5,2,0,7,10,30,7,0,0,7,2,30,4,0,0,4,1,-15,3,1
2,4,13,2,30,7,0,0,7,1,30,4,0,0,4,3,30,5,2,0,7,3,30,7,0,0,7,2,30,4,0,0,4,1,-15,3,1
2,3,19,0,30,2,11,0,13,2,30,8,0,0,8,0,30,6,7,0,13,0,30,4,9,0,13,1,30,8,1,0,9,1,-15,3,1
2,2,25,1,30,5,9,0,14,4,30,6,0,0,6,1,30,7,7,0,14,1,30,9,5,0,14,4,30,6,0,0,6,1,-15,3,1
2,3,25,1,30,5,9,0,14,4,30,6,0,0,6,1,30,7,7,0,14,1,30,9,5,0,14,4,30,6,0,0,6,1,-15,3,1
2,3,27,1,30,4,11,0,15,5,30,2,0,0,2,0,30,3,12,0,15,4,30,2,13,0,15,0,30,5,1,0,6,1,-15,3,1
2,3,29,0,30,7,7,0,14,6,30,12,0,0,12,0,30,3,11,0,14,0,30,1,13,0,14,0,30,9,0,0,9,1,-15,3,1
2,0,38,0,30,4,6,0,10,7,30,6,0,0,6,0,30,1,9,0,10,0,30,4,6,0,10,6,30,6,0,0,6,1,-15,3,1
2,3,39,0,30,5,6,0,11,7,30,6,0,0,6,0,30,4,7,0,11,2,30,2,9,0,11,4,30,5,0,0,5,1,-15,3,1
2,0,4,2,30,7,1,0,8,5,30,4,0,0,4,1,30,1,7,0,8,0,30,8,0,0,8,3,30,3,1,0,4,0,-27,3,0
2,3,4,2,30,7,1,0,8,5,30,4,0,0,4,1,30,1,7,0,8,0,30,8,0,0,8,3,30,3,1,0,4,0,-27,3,0
2,3,19,0,30,3,10,0,13,2,30,7,1,0,8,0,30,4,9,0,13,0,30,2,11,0,13,1,30,9,0,0,9,1,-15,3,1
2,4,19,0,30,3,10,0,13,2,30,7,1,0,8,0,30,4,9,0,13,0,30,2,11,0,13,1,30,9,0,0,9,1,-15,3,1
2,4,25,4,30,8,6,0,14,3,30,5,1,0,6,0,30,6,8,0,14,4,30,4,10,0,14,0,30,5,1,0,6,1,-15,3,1
2,0,27,0,30,4,11,0,15,4,30,2,0,0,2,0,30,8,7,0,15,3,30,6,9,0,15,1,30,6,0,0,6,1,-15,3,1
2,1,27,0,30,4,11,0,15,4,30,2,0,0,2,0,30,8,7,0,15,3,30,6,9,0,15,1,30,6,0,0,6,1,-15,3,1
2,2,27,0,30,4,11,0,15,4,30,2,0,0,2,0,30,8,7,0,15,3,30,6,9,0,15,1,30,6,0,0,6,1,-15,3,1
2,4,27,0,30,4,11,0,15,0,30,2,0,0,2,0,30,8,7,0,15,3,30,6,9,0,15,1,30,6,0,0,6,1,-15,3,1
2,3,31,1,30,12,0,0,12,5,30,8,0,0,8,3,30,6,6,0,12,0,30,3,9,0,12,0,30,3,3,0,6,1,-15,3,1
2,1,5,0,30,2,3,0,5,3,30,3,1,0,4,2,30,1,4,0,5,0,30,1,4,0,5,0,30,0,2,0,2,0,-27,3,0
2,2,5,0,30,2,3,0,5,3,30,3,1,0,4,2,30,1,4,0,5,0,30,1,4,0,5,0,30,0,2,0,2,0,-27,3,0
2,3,5,0,30,2,3,0,5,3,30,3,1,0,4,2,30,1,4,0,5,0,30,1,4,0,5,0,30,0,2,0,2,0,-27,3,0
2,4,5,0,30,2,3,0,5,3,30,3,1,0,4,2,30,1,4,0,5,0,30,1,4,0,5,0,30,0,2,0,2,0,-27,3,0
2,4,8,2,30,7,0,0,7,4,30,2,0,0,2,3,30,3,4,0,7,0,30,6,1,0,7,3,30,3,0,0,3,0,-27,3,0
2,1,13,4,30,6,1,0,7,1,30,4,0,0,4,2,30,7,0,0,7,4,30,7,0,0,7,3,30,4,0,0,4,1,-15,3,1
2,2,13,4,30,6,1,0,7,1,30,4,0,0,4,2,30,7,0,0,7,4,30,7,0,0,7,3,30,4,0,0,4,1,-15,3,1
2,4,13,4,30,6,1,0,7,1,30,4,0,0,4,2,30,7,0,0,7,4,30,7,0,0,7,3,30,4,0,0,4,1,-15,3,1
2,4,15,0,30,3,10,0,13,1,30,6,0,0,6,0,30,3,10,0,13,0,30,5,8,0,13,2,30,7,2,0,9,1,-15,3,1
2,2,19,0,30,1,12,0,13,2,30,6,2,0,8,0,30,4,9,0,13,1,30,6,7,0,13,1,30,8,1,0,9,1,-15,3,1
2,3,19,0,30,1,12,0,13,2,30,6,2,0,8,0,30,4,9,0,13,1,30,6,7,0,13,1,30,8,1,0,9,1,-15,3,1
2,4,19,0,30,1,12,0,13,2,30,6,2,0,8,0,30,4,9,0,13,1,30,6,7,0,13,1,30,8,1,0,9,1,-15,3,1
2,4,21,2,30,8,2,0,10,4,30,6,0,0,6,1,30,3,7,0,10,3,30,5,5,0,10,1,30,4,0,0,4,1,-15,3,1
2,1,25,1,30,5,9,0,14,2,30,6,0,0,6,0,30,9,5,0,14,1,30,5,9,0,14,4,30,6,0,0,6,1,-15,3,1
2,2,25,1,30,5,9,0,14,2,30,6,0,0,6,0,30,9,5,0,14,1,30,5,9,0,14,4,30,6,0,0,6,1,-15,3,1
2,4,25,1,30,5,9,0,14,2,30,6,0,0,6,0,30,9,5,0,14,1,30,5,9,0,14,4,30,6,0,0,6,1,-15,3,1
2,2,27,1,30,4,11,0,15,3,30,1,1,0,2,0,30,6,9,0,15,2,30,5,10,0,15,5,30,6,0,0,6,1,-15,3,1
2,4,29,0,30,4,10,0,14,6,30,12,0,0,12,0,30,3,11,0,14,0,30,2,12,0,14,0,30,9,0,0,9,1,-15,3,1
2,2,6,2,30,8,1,0,9,4,30,2,0,0,2,0,30,2,7,0,9,0,30,4,5,0,9,1,30,2,3,0,5,0,-27,3,0
2,2,9,8,30,3,1,0,4,4,30,2,0,0,2,0,30,1,3,0,4,0,30,0,4,0,4,3,30,1,0,0,1,0,-27,3,0
2,3,9,8,30,3,1,0,4,4,30,2,0,0,2,0,30,1,3,0,4,0,30,0,4,0,4,3,30,1,0,0,1,0,-27,3,0
2,4,9,8,30,3,1,0,4,4,30,2,0,0,2,0,30,1,3,0,4,0,30,0,4,0,4,3,30,1,0,0,1,0,-27,3,0
2,3,9,5,30,10,1,0,11,4,30,6,0,0,6,1,30,3,8,0,11,0,30,2,9,0,11,3,30,4,0,0,4,0,-27,3,0
2,2,11,1,30,3,9,0,12,0,30,4,0,0,4,0,30,12,0,0,12,11,30,3,9,0,12,2,30,4,0,0,4,1,-15,3,1
2,2,13,1,30,6,1,0,7,0,30,4,0,0,4,2,30,6,1,0,7,6,30,7,0,0,7,2,30,3,1,0,4,1,-15,3,1
2,3,13,1,30,6,1,0,7,0,30,4,0,0,4,2,30,6,1,0,7,6,30,7,0,0,7,2,30,3,1,0,4,1,-15,3,1
2,4,13,1,30,6,1,0,7,0,30,4,0,0,4,2,30,6,1,0,7,6,30,7,0,0,7,2,30,3,1,0,4,1,-15,3,1
2,2,17,3,30,8,6,0,14,3,30,6,0,0,6,0,30,6,8,0,14,1,30,7,7,0,14,2,30,4,0,0,4,1,-15,3,1
2,3,17,3,30,8,6,0,14,3,30,6,0,0,6,0,30,6,8,0,14,1,30,7,7,0,14,2,30,4,0,0,4,1,-15,3,1
2,2,19,0,30,4,9,0,13,0,30,6,2,0,8,1,30,6,7,0,13,4,30,4,9,0,13,1,30,7,2,0,9,1,-15,3,1
2,4,19,0,30,4,9,0,13,0,30,6,2,0,8,1,30,6,7,0,13,0,30,4,9,0,13,1,30,7,2,0,9,1,-15,3,1
2,3,23,1,30,4,9,0,13,2,30,6,0,0,6,1,30,12,1,0,13,1,30,5,8,0,13,4,30,5,1,0,6,1,-15,3,1
2,4,23,1,30,4,9,0,13,2,30,6,0,0,6,1,30,12,1,0,13,1,30,5,8,0,13,4,30,5,1,0,6,1,-15,3,1
2,3,25,1,30,7,7,0,14,1,30,6,0,0,6,0,30,10,4,0,14,1,30,6,8,0,14,4,30,6,0,0,6,1,-15,3,1
2,2,27,1,30,3,12,0,15,4,30,1,1,0,2,0,30,6,9,0,15,2,30,5,10,0,15,4,30,6,0,0,6,1,-15,3,1
2,3,27,1,30,3,12,0,15,4,30,1,1,0,2,0,30,6,9,0,15,2,30,5,10,0,15,4,30,6,0,0,6,1,-15,3,1
2,4,27,1,30,3,12,0,15,4,30,1,1,0,2,0,30,6,9,0,15,2,30,5,10,0,15,4,30,6,0,0,6,1,-15,3,1
2,2,29,0,30,5,9,0,14,6,30,12,0,0,12,0,30,4,10,0,14,0,30,0,14,0,14,5,30,9,0,0,9,1,-15,3,1
2,4,31,1,30,6,6,0,12,5,30,8,0,0,8,3,30,8,4,0,12,0,30,5,7,0,12,2,30,6,0,0,6,1,-15,3,1
2,1,33,1,30,4,7,0,11,5,30,4,0,0,4,3,30,9,2,0,11,0,30,5,6,0,11,7,30,4,0,0,4,1,-15,3,1
2,3,33,1,30,4,7,0,11,5,30,4,0,0,4,3,30,9,2,0,11,0,30,5,6,0,11,7,30,4,0,0,4,1,-15,3,1
2,2,5,0,30,1,4,0,5,3,30,2,2,0,4,0,30,0,5,0,5,0,30,1,4,0,5,0,30,1,1,0,2,0,-27,3,0
2,4,5,0,30,1,4,0,5,3,30,2,2,0,4,0,30,0,5,0,5,0,30,1,4,0,5,0,30,1,1,0,2,0,-27,3,0
2,4,8,1,30,7,0,0,7,3,30,2,0,0,2,3,30,7,0,0,7,2,30,7,0,0,7,0,30,3,0,0,3,0,-27,3,0
2,2,13,1,30,5,2,0,7,0,30,4,0,0,4,0,30,5,2,0,7,13,30,7,0,0,7,3,30,4,0,0,4,1,-15,3,1
2,0,17,6,30,11,3,0,14,3,30,6,0,0,6,0,30,4,10,0,14,1,30,5,9,0,14,4,30,4,0,0,4,1,-15,3,1
2,1,17,6,30,11,3,0,14,3,30,6,0,0,6,0,30,4,10,0,14,1,30,5,9,0,14,4,30,4,0,0,4,1,-15,3,1
2,3,17,6,30,11,3,0,14,3,30,6,0,0,6,0,30,4,10,0,14,1,30,5,9,0,14,4,30,4,0,0,4,1,-15,3,1
2,4,17,6,30,11,3,0,14,3,30,6,0,0,6,0,30,4,10,0,14,1,30,5,9,0,14,4,30,4,0,0,4,1,-15,3,1
2,3,25,1,30,8,6,0,14,5,30,5,1,0,6,0,30,6,8,0,14,1,30,4,10,0,14,4,30,6,0,0,6,1,-15,3,1
2,4,25,1,30,8,6,0,14,5,30,5,1,0,6,0,30,6,8,0,14,1,30,4,10,0,14,4,30,6,0,0,6,1,-15,3,1
2,3,39,0,30,4,7,0,11,6,30,6,0,0,6,0,30,7,4,0,11,0,30,4,7,0,11,1,30,5,0,0,5,1,-15,3,1
2,0,4,5,30,7,1,0,8,4,30,2,2,0,4,3,30,2,6,0,8,0,30,5,3,0,8,1,30,3,1,0,4,0,-27,3,0
2,3,4,5,30,7,1,0,8,4,30,2,2,0,4,3,30,2,6,0,8,0,30,5,3,0,8,1,30,3,1,0,4,0,-27,3,0
2,1,5,0,30,5,0,0,5,3,30,3,1,0,4,0,30,0,5,0,5,0,30,1,4,0,5,0,30,0,2,0,2,0,-27,3,0
2,3,13,2,30,6,1,0,7,0,30,4,0,0,4,0,30,6,1,0,7,4,30,7,0,0,7,4,30,4,0,0,4,1,-15,3,1
2,3,15,1,30,4,9,0,13,0,30,5,1,0,6,0,30,6,7,0,13,1,30,4,9,0,13,1,30,6,3,0,9,1,-15,3,1
2,2,17,2,30,11,3,0,14,3,30,6,0,0,6,0,30,3,11,0,14,1,30,6,8,0,14,3,30,4,0,0,4,1,-15,3,1
2,3,17,2,30,11,3,0,14,3,30,6,0,0,6,0,30,3,11,0,14,1,30,6,8,0,14,3,30,4,0,0,4,1,-15,3,1
2,4,17,2,30,11,3,0,14,3,30,6,0,0,6,0,30,3,11,0,14,1,30,6,8,0,14,3,30,4,0,0,4,1,-15,3,1
2,2,19,0,30,5,8,0,13,0,30,6,2,0,8,4,30,7,6,0,13,0,30,6,7,0,13,0,30,8,1,0,9,1,-15,3,1
2,3,19,0,30,5,8,0,13,0,30,6,2,0,8,4,30,7,6,0,13,0,30,6,7,0,13,0,30,8,1,0,9,1,-15,3,1
2,4,19,0,30,5,8,0,13,0,30,6,2,0,8,4,30,7,6,0,13,0,30,6,7,0,13,0,30,8,1,0,9,1,-15,3,1
2,3,23,1,30,4,9,0,13,1,30,6,0,0,6,2,30,13,0,0,13,1,30,6,7,0,13,4,30,6,0,0,6,1,-15,3,1
2,2,25,1,30,7,7,0,14,4,30,6,0,0,6,0,30,5,9,0,14,2,30,5,9,0,14,5,30,6,0,0,6,1,-15,3,1
2,4,25,1,30,7,7,0,14,4,30,6,0,0,6,0,30,5,9,0,14,2,30,5,9,0,14,5,30,6,0,0,6,1,-15,3,1
2,0,27,1,30,5,10,0,15,5,30,2,0,0,2,0,30,3,12,0,15,0,30,5,10,0,15,1,30,5,1,0,6,1,-15,3,1
2,4,27,1,30,5,10,0,15,5,30,2,0,0,2,0,30,3,12,0,15,0,30,5,10,0,15,1,30,5,1,0,6,1,-15,3,1
2,3,29,1,30,9,5,0,14,5,30,10,2,0,12,0,30,9,5,0,14,0,30,1,13,0,14,0,30,7,2,0,9,1,-15,3,1
2,4,29,1,30,9,5,0,14,5,30,10,2,0,12,0,30,9,5,0,14,0,30,1,13,0,14,0,30,7,2,0,9,1,-15,3,1
2,0,31,1,30,5,7,0,12,4,30,8,0,0,8,3,30,8,4,0,12,0,30,3,9,0,12,3,30,2,4,0,6,1,-15,3,1
2,4,31,1,30,5,7,0,12,4,30,8,0,0,8,3,30,8,4,0,12,0,30,3,9,0,12,0,30,2,4,0,6,1,-15,3,1
2,0,41,0,30,7,5,0,12,7,30,8,0,0,8,0,30,3,9,0,12,0,30,4,8,0,12,7,30,7,0,0,7,1,-15,3,1
2,2,41,0,30,7,5,0,12,7,30,8,0,0,8,0,30,3,9,0,12,0,30,4,8,0,12,7,30,7,0,0,7,1,-15,3,1
2,4,15,0,30,2,11,0,13,1,30,6,0,0,6,0,30,4,9,0,13,1,30,7,6,0,13,2,30,6,3,0,9,1,-15,3,1
2,2,17,6,30,11,3,0,14,4,30,6,0,0,6,0,30,3,11,0,14,1,30,6,8,0,14,1,30,4,0,0,4,1,-15,3,1
2,2,19,0,30,7,6,0,13,2,30,6,2,0,8,0,30,5,8,0,13,1,30,6,7,0,13,1,30,9,0,0,9,1,-15,3,1
2,0,21,3,30,6,4,0,10,4,30,6,0,0,6,1,30,3,7,0,10,2,30,4,6,0,10,2,30,4,0,0,4,1,-15,3,1
2,2,21,3,30,6,4,0,10,4,30,6,0,0,6,1,30,3,7,0,10,2,30,4,6,0,10,2,30,4,0,0,4,1,-15,3,1
2,2,23,1,30,7,6,0,13,3,30,6,0,0,6,6,30,8,5,0,13,1,30,6,7,0,13,0,30,6,0,0,6,1,-15,3,1
2,4,23,1,30,7,6,0,13,3,30,6,0,0,6,6,30,8,5,0,13,1,30,6,7,0,13,0,30,6,0,0,6,1,-15,3,1
2,3,27,0,30,5,10,0,15,2,30,2,0,0,2,0,30,13,2,0,15,0,30,4,11,0,15,1,30,6,0,0,6,1,-15,3,1
2,4,27,0,30,5,10,0,15,2,30,2,0,0,2,0,30,13,2,0,15,0,30,4,11,0,15,1,30,6,0,0,6,1,-15,3,1
2,3,31,1,30,5,7,0,12,7,30,8,0,0,8,3,30,4,8,0,12,2,30,8,4,0,12,1,30,6,0,0,6,1,-15,3,1
2,2,35,1,30,5,8,0,13,4,30,2,0,0,2,2,30,9,4,0,13,2,30,3,10,0,13,5,30,8,0,0,8,1,-15,3,1
2,3,35,1,30,5,8,0,13,4,30,2,0,0,2,2,30,9,4,0,13,2,30,3,10,0,13,5,30,8,0,0,8,1,-15,3,1
2,4,35,1,30,5,8,0,13,4,30,2,0,0,2,2,30,9,4,0,13,2,30,3,10,0,13,5,30,8,0,0,8,1,-15,3,1
2,1,17,4,30,10,4,0,14,4,30,6,0,0,6,0,30,3,11,0,14,5,30,5,9,0,14,5,30,4,0,0,4,1,-15,3,1
2,4,17,4,30,10,4,0,14,4,30,6,0,0,6,0,30,3,11,0,14,5,30,5,9,0,14,5,30,4,0,0,4,1,-15,3,1
2,3,19,0,30,4,9,0,13,1,30,8,0,0,8,0,30,4,9,0,13,1,30,5,8,0,13,1,30,6,3,0,9,1,-15,3,1
2,4,23,4,30,5,8,0,13,3,30,6,0,0,6,4,30,12,1,0,13,1,30,6,7,0,13,0,30,5,1,0,6,1,-15,3,1
2,4,25,1,30,8,6,0,14,4,30,6,0,0,6,0,30,5,9,0,14,1,30,5,9,0,14,0,30,5,1,0,6,1,-15,3,1
2,1,27,2,30,5,10,0,15,2,30,1,1,0,2,0,30,11,4,0,15,0,30,8,7,0,15,0,30,3,3,0,6,1,-15,3,1
2,2,27,2,30,5,10,0,15,2,30,1,1,0,2,0,30,11,4,0,15,0,30,8,7,0,15,0,30,3,3,0,6,1,-15,3,1
2,3,47,0,30,0,14,0,14,6,30,4,0,0,4,0,30,4,10,0,14,0,30,2,12,0,14,7,30,7,0,0,7,1,-15,3,1
2,4,4,4,30,8,0,0,8,4,30,4,0,0,4,1,30,2,6,0,8,0,30,4,4,0,8,2,30,4,0,0,4,0,-27,3,0
2,3,8,3,30,7,0,0,7,5,30,2,0,0,2,0,30,1,6,0,7,2,30,7,0,0,7,1,30,3,0,0,3,0,-27,3,0
2,4,8,3,30,7,0,0,7,5,30,2,0,0,2,0,30,1,6,0,7,2,30,7,0,0,7,1,30,3,0,0,3,0,-27,3,0
2,2,12,3,30,6,1,0,7,3,30,2,4,0,6,2,30,2,5,0,7,3,30,4,3,0,7,4,30,3,0,0,3,1,-15,3,1
2,4,12,3,30,6,1,0,7,3,30,2,4,0,6,2,30,2,5,0,7,3,30,4,3,0,7,4,30,3,0,0,3,1,-15,3,1
2,4,25,1,30,4,10,0,14,4,30,6,0,0,6,0,30,7,7,0,14,1,30,5,9,0,14,4,30,5,1,0,6,1,-15,3,1
2,3,27,4,30,6,9,0,15,0,30,2,0,0,2,0,30,13,2,0,15,0,30,3,12,0,15,0,30,2,4,0,6,1,-15,3,1
2,4,27,4,30,6,9,0,15,0,30,2,0,0,2,0,30,13,2,0,15,0,30,3,12,0,15,0,30,2,4,0,6,1,-15,3,1
2,0,38,0,30,2,8,0,10,7,30,6,0,0,6,0,30,1,9,0,10,0,30,5,5,0,10,10,30,6,0,0,6,1,-15,3,1
2,0,17,3,30,9,5,0,14,3,30,6,0,0,6,0,30,7,7,0,14,3,30,8,6,0,14,4,30,4,0,0,4,1,-15,3,1
2,1,17,3,30,9,5,0,14,3,30,6,0,0,6,0,30,7,7,0,14,3,30,8,6,0,14,4,30,4,0,0,4,1,-15,3,1
2,2,17,3,30,9,5,0,14,3,30,6,0,0,6,0,30,7,7,0,14,3,30,8,6,0,14,4,30,4,0,0,4,1,-15,3,1
2,3,17,3,30,9,5,0,14,3,30,6,0,0,6,0,30,7,7,0,14,3,30,8,6,0,14,4,30,4,0,0,4,1,-15,3,1
2,4,17,3,30,9,5,0,14,3,30,6,0,0,6,0,30,7,7,0,14,3,30,8,6,0,14,4,30,4,0,0,4,1,-15,3,1
2,2,19,0,30,6,7,0,13,2,30,5,3,0,8,0,30,4,9,0,13,0,30,7,6,0,13,0,30,9,0,0,9,1,-15,3,1
2,2,29,0,30,7,7,0,14,6,30,11,1,0,12,0,30,3,11,0,14,0,30,1,13,0,14,5,30,9,0,0,9,1,-15,3,1
2,1,31,5,30,6,6,0,12,4,30,8,0,0,8,4,30,12,0,0,12,0,30,3,9,0,12,3,30,3,3,0,6,1,-15,3,1
2,3,31,5,30,6,6,0,12,4,30,8,0,0,8,4,30,12,0,0,12,0,30,3,9,0,12,3,30,3,3,0,6,1,-15,3,1
2,3,38,0,30,3,7,0,10,7,30,6,0,0,6,0,30,1,9,0,10,0,30,4,6,0,10,7,30,6,0,0,6,1,-15,3,1
2,3,41,1,30,8,4,0,12,7,30,7,1,0,8,0,30,3,9,0,12,2,30,2,10,0,12,1,30,6,1,0,7,1,-15,3,1
2,4,41,1,30,8,4,0,12,7,30,7,1,0,8,0,30,3,9,0,12,2,30,2,10,0,12,1,30,6,1,0,7,1,-15,3,1
2,4,8,2,30,7,0,0,7,4,30,2,0,0,2,6,30,3,4,0,7,0,30,6,1,0,7,2,30,3,0,0,3,0,-27,3,0
2,1,13,4,30,7,0,0,7,0,30,4,0,0,4,2,30,6,1,0,7,9,30,5,2,0,7,5,30,4,0,0,4,1,-15,3,1
2,4,13,4,30,7,0,0,7,0,30,4,0,0,4,2,30,6,1,0,7,9,30,5,2,0,7,5,30,4,0,0,4,1,-15,3,1
2,1,17,3,30,11,3,0,14,2,30,6,0,0,6,0,30,5,9,0,14,1,30,7,7,0,14,1,30,4,0,0,4,1,-15,3,1
2,2,17,3,30,11,3,0,14,2,30,6,0,0,6,0,30,5,9,0,14,1,30,7,7,0,14,1,30,4,0,0,4,1,-15,3,1
2,4,19,0,30,4,9,0,13,1,30,5,3,0,8,0,30,8,5,0,13,1,30,5,8,0,13,0,30,8,1,0,9,1,-15,3,1
2,0,21,2,30,6,4,0,10,3,30,5,1,0,6,1,30,3,7,0,10,3,30,4,6,0,10,5,30,4,0,0,4,1,-15,3,1
2,2,25,0,30,8,6,0,14,1,30,6,0,0,6,0,30,10,4,0,14,1,30,7,7,0,14,4,30,6,0,0,6,1,-15,3,1
2,3,25,0,30,8,6,0,14,1,30,6,0,0,6,0,30,10,4,0,14,1,30,7,7,0,14,4,30,6,0,0,6,1,-15,3,1
2,1,4,2,30,6,2,0,8,3,30,2,2,0,4,0,30,3,5,0,8,0,30,6,2,0,8,5,30,4,0,0,4,0,-27,3,0
2,1,5,2,30,3,2,0,5,3,30,0,4,0,4,0,30,1,4,0,5,0,30,1,4,0,5,0,30,2,0,0,2,0,-27,3,0
2,2,5,2,30,3,2,0,5,3,30,0,4,0,4,0,30,1,4,0,5,0,30,1,4,0,5,0,30,2,0,0,2,0,-27,3,0
2,2,27,1,30,5,10,0,15,4,30,2,0,0,2,0,30,2,13,0,15,1,30,6,9,0,15,4,30,6,0,0,6,1,-15,3,1
2,3,27,1,30,5,10,0,15,4,30,2,0,0,2,0,30,2,13,0,15,1,30,6,9,0,15,4,30,6,0,0,6,1,-15,3,1
2,2,41,0,30,7,5,0,12,7,30,5,3,0,8,0,30,7,5,0,12,0,30,3,9,0,12,3,30,7,0,0,7,1,-15,3,1
2,4,41,0,30,7,5,0,12,7,30,5,3,0,8,0,30,7,5,0,12,0,30,3,9,0,12,3,30,7,0,0,7,1,-15,3,1
2,4,8,1,30,7,0,0,7,3,30,2,0,0,2,0,30,4,3,0,7,2,30,6,1,0,7,4,30,3,0,0,3,0,-27,3,0
2,1,17,2,30,10,4,0,14,2,30,6,0,0,6,0,30,7,7,0,14,1,30,6,8,0,14,7,30,4,0,0,4,1,-15,3,1
2,4,23,1,30,7,6,0,13,4,30,6,0,0,6,9,30,8,5,0,13,0,30,4,9,0,13,1,30,6,0,0,6,1,-15,3,1
2,2,27,1,30,5,10,0,15,4,30,1,1,0,2,0,30,8,7,0,15,0,30,6,9,0,15,4,30,6,0,0,6,1,-15,3,1
2,2,31,0,30,4,8,0,12,7,30,8,0,0,8,4,30,6,6,0,12,5,30,8,4,0,12,4,30,6,0,0,6,1,-15,3,1
2,0,41,0,30,4,8,0,12,6,30,8,0,0,8,0,30,7,5,0,12,1,30,4,8,0,12,6,30,7,0,0,7,1,-15,3,1
2,2,41,0,30,4,8,0,12,6,30,8,0,0,8,0,30,7,5,0,12,0,30,4,8,0,12,6,30,7,0,0,7,1,-15,3,1
2,3,41,0,30,4,8,0,12,6,30,8,0,0,8,0,30,7,5,0,12,0,30,4,8,0,12,6,30,7,0,0,7,1,-15,3,1
2,4,41,0,30,4,8,0,12,6,30,8,0,0,8,0,30,7,5,0,12,0,30,4,8,0,12,6,30,7,0,0,7,1,-15,3,1
2,3,8,0,30,7,0,0,7,4,30,2,0,0,2,4,30,2,5,0,7,0,30,5,2,0,7,3,30,3,0,0,3,0,-27,3,0
2,4,13,5,30,7,0,0,7,2,30,4,0,0,4,1,30,6,1,0,7,0,30,5,2,0,7,4,30,4,0,0,4,1,-15,3,1
2,1,17,3,30,8,6,0,14,2,30,6,0,0,6,0,30,9,5,0,14,1,30,6,8,0,14,1,30,3,1,0,4,1,-15,3,1
2,2,17,3,30,8,6,0,14,2,30,6,0,0,6,0,30,9,5,0,14,1,30,6,8,0,14,1,30,3,1,0,4,1,-15,3,1
2,3,17,3,30,8,6,0,14,2,30,6,0,0,6,0,30,9,5,0,14,1,30,6,8,0,14,1,30,3,1,0,4,1,-15,3,1
2,4,17,3,30,8,6,0,14,2,30,6,0,0,6,0,30,9,5,0,14,1,30,6,8,0,14,1,30,3,1,0,4,1,-15,3,1
2,3,19,0,30,3,10,0,13,2,30,8,0,0,8,0,30,8,5,0,13,4,30,4,9,0,13,2,30,8,1,0,9,1,-15,3,1
2,2,23,1,30,6,7,0,13,3,30,6,0,0,6,6,30,12,1,0,13,0,30,5,8,0,13,5,30,6,0,0,6,1,-15,3,1
2,1,27,1,30,6,9,0,15,3,30,2,0,0,2,0,30,1,14,0,15,0,30,1,14,0,15,6,30,6,0,0,6,1,-15,3,1
2,2,27,1,30,6,9,0,15,3,30,2,0,0,2,0,30,1,14,0,15,0,30,1,14,0,15,6,30,6,0,0,6,1,-15,3,1
2,1,4,2,30,8,0,0,8,5,30,4,0,0,4,1,30,2,6,0,8,0,30,8,0,0,8,2,30,3,1,0,4,0,-27,3,0
2,3,4,2,30,8,0,0,8,5,30,4,0,0,4,1,30,2,6,0,8,0,30,8,0,0,8,2,30,3,1,0,4,0,-27,3,0
2,4,17,2,30,9,5,0,14,2,30,6,0,0,6,0,30,6,8,0,14,1,30,6,8,0,14,4,30,4,0,0,4,1,-15,3,1
2,1,19,0,30,4,9,0,13,2,30,6,2,0,8,0,30,6,7,0,13,3,30,4,9,0,13,1,30,8,1,0,9,1,-15,3,1
2,4,23,1,30,8,5,0,13,1,30,6,0,0,6,4,30,13,0,0,13,0,30,6,7,0,13,1,30,5,1,0,6,1,-15,3,1
2,1,25,4,30,6,8,0,14,3,30,6,0,0,6,0,30,6,8,0,14,1,30,5,9,0,14,6,30,5,1,0,6,1,-15,3,1
2,3,25,4,30,6,8,0,14,3,30,6,0,0,6,0,30,6,8,0,14,1,30,5,9,0,14,6,30,5,1,0,6,1,-15,3,1
2,4,25,4,30,6,8,0,14,3,30,6,0,0,6,0,30,6,8,0,14,1,30,5,9,0,14,6,30,5,1,0,6,1,-15,3,1
2,2,13,1,30,5,2,0,7,0,30,4,0,0,4,0,30,6,1,0,7,6,30,6,1,0,7,5,30,4,0,0,4,1,-15,3,1
2,3,13,1,30,5,2,0,7,0,30,4,0,0,4,0,30,6,1,0,7,6,30,6,1,0,7,5,30,4,0,0,4,1,-15,3,1
2,3,23,1,30,5,8,0,13,3,30,6,0,0,6,6,30,12,1,0,13,0,30,5,8,0,13,1,30,6,0,0,6,1,-15,3,1
2,2,33,3,30,8,3,0,11,4,30,4,0,0,4,0,30,10,1,0,11,0,30,3,8,0,11,4,30,4,0,0,4,1,-15,3,1
2,3,33,3,30,8,3,0,11,4,30,4,0,0,4,0,30,10,1,0,11,0,30,3,8,0,11,4,30,4,0,0,4,1,-15,3,1
2,1,5,0,30,2,3,0,5,3,30,1,3,0,4,0,30,1,4,0,5,0,30,1,4,0,5,1,30,2,0,0,2,0,-27,3,0
2,2,5,0,30,2,3,0,5,3,30,1,3,0,4,0,30,1,4,0,5,0,30,1,4,0,5,1,30,2,0,0,2,0,-27,3,0
2,1,13,2,30,7,0,0,7,0,30,4,0,0,4,2,30,6,1,0,7,7,30,7,0,0,7,4,30,4,0,0,4,1,-15,3,1
2,4,15,0,30,3,10,0,13,1,30,6,0,0,6,0,30,3,10,0,13,1,30,4,9,0,13,2,30,8,1,0,9,1,-15,3,1
2,2,17,3,30,9,5,0,14,2,30,6,0,0,6,0,30,7,7,0,14,1,30,6,8,0,14,8,30,4,0,0,4,1,-15,3,1
2,3,19,1,30,2,11,0,13,3,30,6,2,0,8,0,30,4,9,0,13,4,30,5,8,0,13,3,30,9,0,0,9,1,-15,3,1
2,4,19,1,30,2,11,0,13,3,30,6,2,0,8,0,30,4,9,0,13,4,30,5,8,0,13,3,30,9,0,0,9,1,-15,3,1
2,3,21,2,30,6,4,0,10,4,30,6,0,0,6,0,30,3,7,0,10,3,30,5,5,0,10,2,30,4,0,0,4,1,-15,3,1
2,3,25,1,30,5,9,0,14,6,30,6,0,0,6,0,30,3,11,0,14,0,30,9,5,0,14,5,30,6,0,0,6,1,-15,3,1
2,4,31,2,30,8,4,0,12,3,30,8,0,0,8,4,30,12,0,0,12,0,30,3,9,0,12,0,30,2,4,0,6,1,-15,3,1
2,2,39,0,30,3,8,0,11,6,30,6,0,0,6,0,30,4,7,0,11,0,30,2,9,0,11,7,30,5,0,0,5,1,-15,3,1
2,3,13,0,30,6,1,0,7,1,30,4,0,0,4,2,30,7,0,0,7,6,30,6,1,0,7,4,30,4,0,0,4,1,-15,3,1
2,4,13,0,30,6,1,0,7,1,30,4,0,0,4,2,30,7,0,0,7,6,30,6,1,0,7,4,30,4,0,0,4,1,-15,3,1
2,4,19,0,30,3,10,0,13,2,30,5,3,0,8,0,30,8,5,0,13,3,30,5,8,0,13,3,30,8,1,0,9,1,-15,3,1
2,4,23,2,30,7,6,0,13,2,30,6,0,0,6,4,30,9,4,0,13,3,30,6,7,0,13,0,30,4,2,0,6,1,-15,3,1
2,4,26,0,30,5,4,0,9,6,30,4,0,0,4,7,30,1,8,0,9,0,30,1,8,0,9,5,30,3,0,0,3,1,-15,3,1
2,0,27,1,30,3,12,0,15,2,30,1,1,0,2,5,30,11,4,0,15,0,30,3,12,0,15,2,30,6,0,0,6,1,-15,3,1
2,2,27,1,30,3,12,0,15,2,30,1,1,0,2,5,30,11,4,0,15,0,30,3,12,0,15,0,30,6,0,0,6,1,-15,3,1
2,0,4,2,30,6,2,0,8,5,30,4,0,0,4,2,30,1,7,0,8,3,30,7,1,0,8,1,30,3,1,0,4,0,-27,3,0
2,4,13,1,30,6,1,0,7,1,30,4,0,0,4,2,30,5,2,0,7,6,30,5,2,0,7,2,30,4,0,0,4,1,-15,3,1
2,1,17,5,30,10,4,0,14,4,30,6,0,0,6,0,30,3,11,0,14,1,30,6,8,0,14,1,30,3,1,0,4,1,-15,3,1
2,3,17,5,30,10,4,0,14,4,30,6,0,0,6,0,30,3,11,0,14,1,30,6,8,0,14,1,30,3,1,0,4,1,-15,3,1
2,1,21,1,30,5,5,0,10,3,30,4,2,0,6,0,30,4,6,0,10,3,30,6,4,0,10,5,30,4,0,0,4,1,-15,3,1
2,1,25,1,30,4,10,0,14,2,30,6,0,0,6,0,30,7,7,0,14,1,30,9,5,0,14,7,30,6,0,0,6,1,-15,3,1
2,2,25,1,30,4,10,0,14,2,30,6,0,0,6,0,30,7,7,0,14,1,30,9,5,0,14,7,30,6,0,0,6,1,-15,3,1
2,3,27,1,30,5,10,0,15,4,30,2,0,0,2,0,30,4,11,0,15,0,30,6,9,0,15,5,30,6,0,0,6,1,-15,3,1
2,1,31,2,30,7,5,0,12,4,30,8,0,0,8,6,30,9,3,0,12,0,30,3,9,0,12,1,30,3,3,0,6,1,-15,3,1
2,4,31,2,30,7,5,0,12,4,30,8,0,0,8,6,30,9,3,0,12,0,30,3,9,0,12,1,30,3,3,0,6,1,-15,3,1
2,3,47,0,30,1,13,0,14,9,30,4,0,0,4,0,30,3,11,0,14,0,30,9,5,0,14,0,30,5,2,0,7,1,-15,3,1
2,1,5,0,30,0,5,0,5,3,30,1,3,0,4,4,30,0,5,0,5,0,30,1,4,0,5,0,30,1,1,0,2,0,-27,3,0
2,3,8,0,30,7,0,0,7,4,30,2,0,0,2,0,30,2,5,0,7,3,30,7,0,0,7,6,30,3,0,0,3,0,-27,3,0
2,4,8,0,30,7,0,0,7,4,30,2,0,0,2,0,30,2,5,0,7,3,30,7,0,0,7,6,30,3,0,0,3,0,-27,3,0
2,1,13,2,30,5,2,0,7,0,30,4,0,0,4,2,30,7,0,0,7,7,30,6,1,0,7,6,30,4,0,0,4,1,-15,3,1
2,3,17,0,30,9,5,0,14,2,30,6,0,0,6,0,30,6,8,0,14,4,30,5,9,0,14,5,30,4,0,0,4,1,-15,3,1
2,3,19,0,30,5,8,0,13,2,30,6,2,0,8,0,30,4,9,0,13,5,30,8,5,0,13,2,30,8,1,0,9,1,-15,3,1
2,0,21,3,30,8,2,0,10,3,30,4,2,0,6,0,30,3,7,0,10,3,30,3,7,0,10,2,30,4,0,0,4,1,-15,3,1
2,1,21,3,30,8,2,0,10,3,30,4,2,0,6,0,30,3,7,0,10,3,30,3,7,0,10,2,30,4,0,0,4,1,-15,3,1
2,4,25,1,30,7,7,0,14,5,30,6,0,0,6,4,30,3,11,0,14,1,30,6,8,0,14,4,30,5,1,0,6,1,-15,3,1
2,0,27,3,30,4,11,0,15,1,30,1,1,0,2,0,30,12,3,0,15,0,30,5,10,0,15,2,30,6,0,0,6,1,-15,3,1
2,2,27,3,30,4,11,0,15,1,30,1,1,0,2,0,30,12,3,0,15,0,30,5,10,0,15,2,30,6,0,0,6,1,-15,3,1
2,2,31,1,30,7,5,0,12,4,30,8,0,0,8,3,30,8,4,0,12,0,30,3,9,0,12,1,30,3,3,0,6,1,-15,3,1
2,4,31,1,30,7,5,0,12,4,30,8,0,0,8,3,30,8,4,0,12,0,30,3,9,0,12,0,30,3,3,0,6,1,-15,3,1
2,2,43,3,30,7,7,0,14,7,30,6,0,0,6,0,30,7,7,0,14,1,30,1,13,0,14,4,30,5,0,0,5,1,-15,3,1
2,3,43,3,30,7,7,0,14,7,30,6,0,0,6,0,30,7,7,0,14,1,30,1,13,0,14,4,30,5,0,0,5,1,-15,3,1
2,4,23,2,30,5,8,0,13,4,30,6,0,0,6,7,30,8,5,0,13,0,30,5,8,0,13,3,30,6,0,0,6,1,-15,3,1
2,3,25,1,30,7,7,0,14,3,30,6,0,0,6,0,30,6,8,0,14,1,30,7,7,0,14,3,30,4,2,0,6,1,-15,3,1
2,2,29,0,30,7,7,0,14,5,30,8,4,0,12,0,30,5,9,0,14,0,30,1,13,0,14,2,30,9,0,0,9,1,-15,3,1
2,3,29,0,30,7,7,0,14,5,30,8,4,0,12,0,30,5,9,0,14,0,30,1,13,0,14,2,30,9,0,0,9,1,-15,3,1
2,4,39,0,30,6,5,0,11,7,30,6,0,0,6,0,30,4,7,0,11,0,30,2,9,0,11,3,30,5,0,0,5,1,-15,3,1
2,1,13,2,30,7,0,0,7,2,30,4,0,0,4,2,30,6,1,0,7,5,30,6,1,0,7,3,30,4,0,0,4,1,-15,3,1
2,2,13,2,30,7,0,0,7,2,30,4,0,0,4,2,30,6,1,0,7,5,30,6,1,0,7,3,30,4,0,0,4,1,-15,3,1
2,4,13,2,30,7,0,0,7,0,30,4,0,0,4,2,30,6,1,0,7,5,30,6,1,0,7,3,30,4,0,0,4,1,-15,3,1
2,4,17,3,30,10,4,0,14,3,30,6,0,0,6,0,30,5,9,0,14,3,30,5,9,0,14,0,30,4,0,0,4,1,-15,3,1
2,1,19,0,30,9,4,0,13,1,30,4,4,0,8,0,30,6,7,0,13,0,30,3,10,0,13,1,30,8,1,0,9,1,-15,3,1
2,3,19,0,30,9,4,0,13,1,30,4,4,0,8,0,30,6,7,0,13,0,30,3,10,0,13,1,30,8,1,0,9,1,-15,3,1
2,4,19,0,30,9,4,0,13,1,30,4,4,0,8,0,30,6,7,0,13,0,30,3,10,0,13,1,30,8,1,0,9,1,-15,3,1
2,2,27,3,30,6,9,0,15,0,30,2,0,0,2,0,30,6,9,0,15,0,30,3,12,0,15,1,30,5,1,0,6,1,-15,3,1
2,4,31,4,30,4,8,0,12,7,30,8,0,0,8,3,30,7,5,0,12,0,30,8,4,0,12,2,30,6,0,0,6,1,-15,3,1
2,1,33,2,30,5,6,0,11,5,30,4,0,0,4,1,30,9,2,0,11,0,30,4,7,0,11,5,30,4,0,0,4,1,-15,3,1
2,3,33,2,30,5,6,0,11,5,30,4,0,0,4,1,30,9,2,0,11,0,30,4,7,0,11,5,30,4,0,0,4,1,-15,3,1
2,4,35,0,30,8,5,0,13,5,30,2,0,0,2,1,30,6,7,0,13,0,30,3,10,0,13,4,30,8,0,0,8,1,-15,3,1
2,2,11,2,30,4,8,0,12,1,30,4,0,0,4,0,30,5,7,0,12,7,30,5,7,0,12,8,30,4,0,0,4,1,-15,3,1
2,4,17,3,30,8,6,0,14,3,30,6,0,0,6,0,30,5,9,0,14,2,30,5,9,0,14,2,30,3,1,0,4,1,-15,3,1
2,4,22,1,30,6,2,0,8,3,30,2,0,0,2,1,30,4,4,0,8,0,30,6,2,0,8,5,30,4,0,0,4,1,-15,3,1
2,3,25,0,30,7,7,0,14,3,30,6,0,0,6,0,30,6,8,0,14,1,30,10,4,0,14,3,30,5,1,0,6,1,-15,3,1
2,1,27,2,30,6,9,0,15,3,30,1,1,0,2,0,30,6,9,0,15,2,30,6,9,0,15,3,30,6,0,0,6,1,-15,3,1
2,3,31,3,30,5,7,0,12,5,30,8,0,0,8,3,30,10,2,0,12,0,30,5,7,0,12,1,30,6,0,0,6,1,-15,3,1
2,2,7,2,30,4,0,0,4,3,30,2,0,0,2,0,30,1,3,0,4,0,30,0,4,0,4,2,30,2,0,0,2,0,-27,3,0
2,0,17,2,30,10,4,0,14,3,30,6,0,0,6,0,30,4,10,0,14,5,30,5,9,0,14,4,30,4,0,0,4,1,-15,3,1
2,1,17,2,30,10,4,0,14,3,30,6,0,0,6,0,30,4,10,0,14,5,30,5,9,0,14,4,30,4,0,0,4,1,-15,3,1
2,2,19,0,30,2,11,0,13,2,30,7,1,0,8,0,30,4,9,0,13,5,30,4,9,0,13,2,30,9,0,0,9,1,-15,3,1
2,4,19,0,30,2,11,0,13,2,30,7,1,0,8,0,30,4,9,0,13,5,30,4,9,0,13,2,30,9,0,0,9,1,-15,3,1
2,2,25,1,30,8,6,0,14,4,30,6,0,0,6,0,30,7,7,0,14,1,30,6,8,0,14,5,30,5,1,0,6,1,-15,3,1
2,3,25,1,30,8,6,0,14,4,30,6,0,0,6,0,30,7,7,0,14,1,30,6,8,0,14,5,30,5,1,0,6,1,-15,3,1
2,4,25,1,30,8,6,0,14,4,30,6,0,0,6,0,30,7,7,0,14,1,30,6,8,0,14,5,30,5,1,0,6,1,-15,3,1
2,1,27,1,30,5,10,0,15,3,30,1,1,0,2,0,30,5,10,0,15,6,30,5,10,0,15,2,30,6,0,0,6,1,-15,3,1
2,3,31,3,30,9,3,0,12,4,30,8,0,0,8,3,30,11,1,0,12,0,30,6,6,0,12,0,30,3,3,0,6,1,-15,3,1
2,2,37,0,30,5,6,0,11,5,30,8,0,0,8,3,30,9,2,0,11,2,30,5,6,0,11,5,30,6,0,0,6,1,-15,3,1
2,3,37,0,30,5,6,0,11,5,30,8,0,0,8,3,30,9,2,0,11,2,30,5,6,0,11,5,30,6,0,0,6,1,-15,3,1
2,2,39,0,30,1,10,0,11,6,30,6,0,0,6,0,30,4,7,0,11,1,30,3,8,0,11,0,30,5,0,0,5,1,-15,3,1
2,2,15,5,30,4,9,0,13,1,30,5,1,0,6,0,30,4,9,0,13,1,30,4,9,0,13,2,30,7,2,0,9,1,-15,3,1
2,3,15,5,30,4,9,0,13,1,30,5,1,0,6,0,30,4,9,0,13,1,30,4,9,0,13,2,30,7,2,0,9,1,-15,3,1
2,4,15,5,30,4,9,0,13,1,30,5,1,0,6,0,30,4,9,0,13,1,30,4,9,0,13,2,30,7,2,0,9,1,-15,3,1
2,2,17,2,30,6,8,0,14,3,30,6,0,0,6,0,30,4,10,0,14,5,30,6,8,0,14,4,30,4,0,0,4,1,-15,3,1
2,4,17,2,30,6,8,0,14,3,30,6,0,0,6,0,30,4,10,0,14,5,30,6,8,0,14,4,30,4,0,0,4,1,-15,3,1
2,0,21,2,30,7,3,0,10,3,30,5,1,0,6,1,30,4,6,0,10,5,30,5,5,0,10,4,30,4,0,0,4,1,-15,3,1
2,1,21,2,30,7,3,0,10,3,30,5,1,0,6,1,30,4,6,0,10,5,30,5,5,0,10,4,30,4,0,0,4,1,-15,3,1
2,3,21,2,30,7,3,0,10,3,30,5,1,0,6,1,30,4,6,0,10,5,30,5,5,0,10,4,30,4,0,0,4,1,-15,3,1
2,4,21,2,30,7,3,0,10,3,30,5,1,0,6,1,30,4,6,0,10,5,30,5,5,0,10,4,30,4,0,0,4,1,-15,3,1
2,2,23,2,30,6,7,0,13,3,30,6,0,0,6,5,30,13,0,0,13,0,30,3,10,0,13,3,30,6,0,0,6,1,-15,3,1
2,4,23,2,30,6,7,0,13,3,30,6,0,0,6,5,30,13,0,0,13,0,30,3,10,0,13,3,30,6,0,0,6,1,-15,3,1
2,2,25,0,30,8,6,0,14,3,30,6,0,0,6,0,30,6,8,0,14,1,30,7,7,0,14,4,30,6,0,0,6,1,-15,3,1
2,2,27,1,30,5,10,0,15,4,30,2,0,0,2,0,30,5,10,0,15,3,30,5,10,0,15,2,30,6,0,0,6,1,-15,3,1
2,3,27,1,30,5,10,0,15,4,30,2,0,0,2,0,30,5,10,0,15,3,30,5,10,0,15,2,30,6,0,0,6,1,-15,3,1
2,4,27,1,30,5,10,0,15,4,30,2,0,0,2,0,30,5,10,0,15,3,30,5,10,0,15,2,30,6,0,0,6,1,-15,3,1
2,4,31,4,30,7,5,0,12,4,30,8,0,0,8,3,30,10,2,0,12,0,30,3,9,0,12,1,30,1,5,0,6,1,-15,3,1
2,4,39,2,30,3,8,0,11,7,30,6,0,0,6,0,30,4,7,0,11,0,30,3,8,0,11,2,30,4,1,0,5,1,-15,3,1
2,0,4,2,30,6,2,0,8,4,30,4,0,0,4,0,30,2,6,0,8,5,30,1,7,0,8,1,30,3,1,0,4,0,-27,3,0
2,3,4,2,30,6,2,0,8,4,30,4,0,0,4,0,30,2,6,0,8,5,30,1,7,0,8,1,30,3,1,0,4,0,-27,3,0
2,4,4,2,30,6,2,0,8,4,30,4,0,0,4,0,30,2,6,0,8,5,30,1,7,0,8,1,30,3,1,0,4,0,-27,3,0
2,4,7,0,30,0,4,0,4,2,30,2,0,0,2,3,30,1,3,0,4,0,30,1,3,0,4,2,30,1,1,0,2,0,-27,3,0
2,3,13,1,30,3,0,0,3,0,30,2,0,0,2,0,30,2,1,0,3,6,30,3,0,0,3,3,30,2,0,0,2,1,-15,3,1
2,2,13,2,30,7,0,0,7,0,30,4,0,0,4,2,30,5,2,0,7,11,30,7,0,0,7,2,30,4,0,0,4,1,-15,3,1
2,3,17,4,30,9,5,0,14,3,30,6,0,0,6,0,30,7,7,0,14,1,30,6,8,0,14,2,30,4,0,0,4,1,-15,3,1
2,0,21,2,30,6,4,0,10,4,30,4,2,0,6,0,30,3,7,0,10,4,30,5,5,0,10,4,30,4,0,0,4,1,-15,3,1
2,3,21,2,30,6,4,0,10,4,30,4,2,0,6,0,30,3,7,0,10,4,30,5,5,0,10,3,30,4,0,0,4,1,-15,3,1
2,4,21,2,30,6,4,0,10,4,30,4,2,0,6,0,30,3,7,0,10,4,30,5,5,0,10,3,30,4,0,0,4,1,-15,3,1
2,3,25,3,30,9,5,0,14,4,30,6,0,0,6,0,30,8,6,0,14,1,30,4,10,0,14,3,30,5,1,0,6,1,-15,3,1
2,2,27,1,30,4,11,0,15,3,30,2,0,0,2,0,30,5,10,0,15,1,30,5,10,0,15,1,30,6,0,0,6,1,-15,3,1
2,4,29,0,30,8,6,0,14,6,30,11,1,0,12,0,30,3,11,0,14,0,30,1,13,0,14,0,30,9,0,0,9,1,-15,3,1
2,2,31,5,30,10,2,0,12,4,30,8,0,0,8,3,30,8,4,0,12,0,30,3,9,0,12,0,30,2,4,0,6,1,-15,3,1
2,3,31,5,30,10,2,0,12,4,30,8,0,0,8,3,30,8,4,0,12,0,30,3,9,0,12,0,30,2,4,0,6,1,-15,3,1
2,1,1,0,30,7,3,0,10,4,30,2,0,0,2,1,30,4,6,0,10,3,30,7,3,0,10,4,30,6,0,0,6,0,-27,3,0
2,3,1,0,30,7,3,0,10,4,30,2,0,0,2,1,30,4,6,0,10,3,30,7,3,0,10,1,30,6,0,0,6,0,-27,3,0
2,3,8,2,30,7,0,0,7,4,30,2,0,0,2,0,30,2,5,0,7,1,30,7,0,0,7,8,30,3,0,0,3,0,-27,3,0
2,1,13,1,30,5,2,0,7,0,30,4,0,0,4,2,30,6,1,0,7,11,30,5,2,0,7,5,30,4,0,0,4,1,-15,3,1
2,2,13,1,30,5,2,0,7,0,30,4,0,0,4,2,30,6,1,0,7,11,30,5,2,0,7,5,30,4,0,0,4,1,-15,3,1
2,3,17,2,30,9,5,0,14,3,30,6,0,0,6,0,30,4,10,0,14,3,30,6,8,0,14,0,30,4,0,0,4,1,-15,3,1
2,4,17,2,30,9,5,0,14,3,30,6,0,0,6,0,30,4,10,0,14,3,30,6,8,0,14,0,30,4,0,0,4,1,-15,3,1
2,3,19,0,30,3,10,0,13,2,30,8,0,0,8,0,30,8,5,0,13,3,30,7,6,0,13,1,30,8,1,0,9,1,-15,3,1
2,4,19,0,30,3,10,0,13,2,30,8,0,0,8,0,30,8,5,0,13,3,30,7,6,0,13,1,30,8,1,0,9,1,-15,3,1
2,3,31,1,30,3,9,0,12,4,30,8,0,0,8,4,30,12,0,0,12,0,30,8,4,0,12,1,30,3,3,0,6,1,-15,3,1
2,4,31,1,30,3,9,0,12,4,30,8,0,0,8,4,30,12,0,0,12,0,30,8,4,0,12,1,30,3,3,0,6,1,-15,3,1
2,0,5,5,30,2,3,0,5,3,30,1,3,0,4,0,30,0,5,0,5,0,30,1,4,0,5,0,30,0,2,0,2,0,-27,3,0
2,2,5,5,30,2,3,0,5,3,30,1,3,0,4,0,30,0,5,0,5,0,30,1,4,0,5,0,30,0,2,0,2,0,-27,3,0
2,2,13,2,30,7,0,0,7,0,30,4,0,0,4,2,30,5,2,0,7,9,30,4,3,0,7,2,30,4,0,0,4,1,-15,3,1
2,4,13,2,30,7,0,0,7,0,30,4,0,0,4,2,30,5,2,0,7,9,30,4,3,0,7,2,30,4,0,0,4,1,-15,3,1
2,3,19,0,30,5,8,0,13,1,30,3,5,0,8,0,30,6,7,0,13,6,30,4,9,0,13,0,30,9,0,0,9,1,-15,3,1
2,2,25,0,30,5,9,0,14,3,30,6,0,0,6,0,30,7,7,0,14,3,30,7,7,0,14,6,30,6,0,0,6,1,-15,3,1
2,3,25,0,30,5,9,0,14,3,30,6,0,0,6,0,30,7,7,0,14,3,30,7,7,0,14,6,30,6,0,0,6,1,-15,3,1
2,4,25,0,30,5,9,0,14,3,30,6,0,0,6,0,30,7,7,0,14,3,30,7,7,0,14,6,30,6,0,0,6,1,-15,3,1
2,3,45,0,30,12,1,0,13,9,30,10,0,0,10,0,30,4,9,0,13,0,30,4,9,0,13,8,30,5,0,0,5,1,-15,3,1
2,3,3,0,30,0,4,0,4,1,30,4,0,0,4,0,30,1,3,0,4,4,30,2,2,0,4,0,30,1,2,0,3,0,-27,3,0
2,4,3,0,30,0,4,0,4,1,30,4,0,0,4,0,30,1,3,0,4,4,30,2,2,0,4,0,30,1,2,0,3,0,-27,3,0
2,2,4,8,30,7,1,0,8,4,30,3,1,0,4,0,30,1,7,0,8,0,30,4,4,0,8,2,30,4,0,0,4,0,-27,3,0
2,3,4,8,30,7,1,0,8,4,30,3,1,0,4,0,30,1,7,0,8,0,30,4,4,0,8,2,30,4,0,0,4,0,-27,3,0
2,0,5,3,30,5,0,0,5,3,30,4,0,0,4,0,30,0,5,0,5,0,30,1,4,0,5,0,30,0,2,0,2,0,-27,3,0
2,1,5,3,30,5,0,0,5,3,30,4,0,0,4,0,30,0,5,0,5,0,30,1,4,0,5,0,30,0,2,0,2,0,-27,3,0
2,2,13,4,30,5,2,0,7,1,30,4,0,0,4,0,30,6,1,0,7,3,30,6,1,0,7,5,30,4,0,0,4,1,-15,3,1
2,4,25,2,30,8,6,0,14,3,30,6,0,0,6,0,30,7,7,0,14,1,30,6,8,0,14,3,30,5,1,0,6,1,-15,3,1
2,2,31,1,30,4,8,0,12,8,30,8,0,0,8,3,30,4,8,0,12,2,30,9,3,0,12,4,30,6,0,0,6,1,-15,3,1
2,2,41,0,30,7,5,0,12,4,30,4,4,0,8,3,30,12,0,0,12,0,30,3,9,0,12,1,30,2,5,0,7,1,-15,3,1
2,4,3,1,30,0,4,0,4,3,30,4,0,0,4,0,30,0,4,0,4,5,30,2,2,0,4,0,30,1,2,0,3,0,-27,3,0
2,4,13,3,30,7,0,0,7,0,30,4,0,0,4,2,30,6,1,0,7,11,30,6,1,0,7,0,30,4,0,0,4,1,-15,3,1
2,2,17,3,30,9,5,0,14,3,30,6,0,0,6,0,30,3,11,0,14,2,30,5,9,0,14,1,30,4,0,0,4,1,-15,3,1
2,3,17,3,30,9,5,0,14,3,30,6,0,0,6,0,30,3,11,0,14,2,30,5,9,0,14,1,30,4,0,0,4,1,-15,3,1
2,4,23,1,30,4,9,0,13,2,30,6,0,0,6,5,30,11,2,0,13,0,30,6,7,0,13,2,30,6,0,0,6,1,-15,3,1
2,1,25,1,30,4,10,0,14,4,30,6,0,0,6,0,30,13,1,0,14,1,30,5,9,0,14,5,30,5,1,0,6,1,-15,3,1
2,3,27,1,30,4,11,0,15,5,30,2,0,0,2,0,30,2,13,0,15,0,30,3,12,0,15,7,30,6,0,0,6,1,-15,3,1
2,4,29,0,30,3,11,0,14,6,30,11,1,0,12,0,30,3,11,0,14,0,30,3,11,0,14,0,30,9,0,0,9,1,-15,3,1
2,3,32,0,30,6,3,0,9,4,30,2,0,0,2,4,30,7,2,0,9,1,30,3,6,0,9,3,30,2,0,0,2,1,-15,3,1
2,0,41,0,30,9,3,0,12,3,30,4,4,0,8,0,30,12,0,0,12,0,30,3,9,0,12,3,30,2,5,0,7,1,-15,3,1
2,3,41,0,30,9,3,0,12,3,30,4,4,0,8,0,30,12,0,0,12,0,30,3,9,0,12,3,30,2,5,0,7,1,-15,3,1
2,4,13,3,30,6,1,0,7,1,30,4,0,0,4,2,30,5,2,0,7,10,30,5,2,0,7,2,30,4,0,0,4,1,-15,3,1
2,2,17,5,30,11,3,0,14,4,30,6,0,0,6,0,30,4,10,0,14,2,30,6,8,0,14,3,30,4,0,0,4,1,-15,3,1
2,3,17,5,30,11,3,0,14,4,30,6,0,0,6,0,30,4,10,0,14,2,30,6,8,0,14,3,30,4,0,0,4,1,-15,3,1
2,4,17,5,30,11,3,0,14,4,30,6,0,0,6,0,30,4,10,0,14,2,30,6,8,0,14,3,30,4,0,0,4,1,-15,3,1
2,3,19,0,30,4,9,0,13,2,30,5,3,0,8,0,30,7,6,0,13,2,30,4,9,0,13,2,30,8,1,0,9,1,-15,3,1
2,4,19,0,30,4,9,0,13,2,30,5,3,0,8,0,30,7,6,0,13,2,30,4,9,0,13,2,30,8,1,0,9,1,-15,3,1
2,4,23,1,30,4,9,0,13,2,30,6,0,0,6,5,30,13,0,0,13,0,30,6,7,0,13,2,30,6,0,0,6,1,-15,3,1
2,4,27,0,30,4,11,0,15,0,30,2,0,0,2,0,30,9,6,0,15,4,30,6,9,0,15,2,30,6,0,0,6,1,-15,3,1
2,4,29,0,30,7,7,0,14,6,30,10,2,0,12,0,30,6,8,0,14,0,30,1,13,0,14,2,30,9,0,0,9,1,-15,3,1
2,3,32,0,30,9,0,0,9,4,30,2,0,0,2,0,30,9,0,0,9,1,30,2,7,0,9,3,30,2,0,0,2,1,-15,3,1
2,4,32,0,30,9,0,0,9,4,30,2,0,0,2,0,30,9,0,0,9,1,30,2,7,0,9,3,30,2,0,0,2,1,-15,3,1
2,0,6,0,30,8,1,0,9,4,30,2,0,0,2,1,30,4,5,0,9,1,30,7,2,0,9,0,30,3,2,0,5,0,-27,3,0
2,3,8,2,30,7,0,0,7,3,30,2,0,0,2,4,30,2,5,0,7,0,30,4,3,0,7,5,30,3,0,0,3,0,-27,3,0
2,2,13,1,30,3,4,0,7,0,30,4,0,0,4,2,30,5,2,0,7,6,30,6,1,0,7,7,30,4,0,0,4,1,-15,3,1
2,0,17,5,30,12,2,0,14,2,30,6,0,0,6,0,30,6,8,0,14,2,30,5,9,0,14,1,30,4,0,0,4,1,-15,3,1
2,2,17,5,30,12,2,0,14,2,30,6,0,0,6,0,30,6,8,0,14,2,30,5,9,0,14,1,30,4,0,0,4,1,-15,3,1
2,3,17,5,30,12,2,0,14,2,30,6,0,0,6,0,30,6,8,0,14,2,30,5,9,0,14,1,30,4,0,0,4,1,-15,3,1
2,2,19,0,30,3,10,0,13,2,30,5,3,0,8,0,30,5,8,0,13,3,30,5,8,0,13,3,30,8,1,0,9,1,-15,3,1
2,4,19,0,30,3,10,0,13,2,30,5,3,0,8,0,30,5,8,0,13,3,30,5,8,0,13,3,30,8,1,0,9,1,-15,3,1
2,2,25,1,30,7,7,0,14,3,30,6,0,0,6,0,30,8,6,0,14,1,30,5,9,0,14,3,30,5,1,0,6,1,-15,3,1
2,1,27,1,30,4,11,0,15,3,30,1,1,0,2,0,30,6,9,0,15,0,30,8,7,0,15,3,30,6,0,0,6,1,-15,3,1
2,3,27,1,30,4,11,0,15,3,30,1,1,0,2,0,30,6,9,0,15,0,30,8,7,0,15,3,30,6,0,0,6,1,-15,3,1
2,4,27,1,30,4,11,0,15,3,30,1,1,0,2,0,30,6,9,0,15,0,30,8,7,0,15,3,30,6,0,0,6,1,-15,3,1
2,3,29,0,30,7,7,0,14,6,30,11,1,0,12,0,30,3,11,0,14,0,30,0,14,0,14,3,30,9,0,0,9,1,-15,3,1
2,4,35,0,30,12,1,0,13,6,30,2,0,0,2,4,30,3,10,0,13,3,30,4,9,0,13,2,30,8,0,0,8,1,-15,3,1
2,2,6,0,30,9,0,0,9,4,30,2,0,0,2,0,30,2,7,0,9,0,30,3,6,0,9,3,30,5,0,0,5,0,-27,3,0
2,3,6,0,30,9,0,0,9,4,30,2,0,0,2,0,30,2,7,0,9,0,30,3,6,0,9,3,30,5,0,0,5,0,-27,3,0
2,4,8,1,30,7,0,0,7,3,30,2,0,0,2,6,30,3,4,0,7,2,30,7,0,0,7,3,30,3,0,0,3,0,-27,3,0
2,2,11,1,30,3,9,0,12,0,30,4,0,0,4,0,30,5,7,0,12,5,30,4,8,0,12,4,30,4,0,0,4,1,-15,3,1
2,2,23,1,30,6,7,0,13,4,30,6,0,0,6,4,30,9,4,0,13,1,30,6,7,0,13,5,30,6,0,0,6,1,-15,3,1
2,4,23,1,30,6,7,0,13,4,30,6,0,0,6,4,30,9,4,0,13,1,30,6,7,0,13,5,30,6,0,0,6,1,-15,3,1
2,3,25,1,30,7,7,0,14,5,30,6,0,0,6,0,30,5,9,0,14,1,30,8,6,0,14,3,30,5,1,0,6,1,-15,3,1
2,4,25,1,30,7,7,0,14,5,30,6,0,0,6,0,30,5,9,0,14,1,30,8,6,0,14,3,30,5,1,0,6,1,-15,3,1
2,2,31,6,30,7,5,0,12,5,30,8,0,0,8,3,30,8,4,0,12,0,30,3,9,0,12,0,30,2,4,0,6,1,-15,3,1
2,0,41,0,30,5,7,0,12,6,30,7,1,0,8,0,30,7,5,0,12,0,30,5,7,0,12,2,30,7,0,0,7,1,-15,3,1
2,4,41,0,30,5,7,0,12,6,30,7,1,0,8,0,30,7,5,0,12,0,30,5,7,0,12,2,30,7,0,0,7,1,-15,3,1
2,0,47,2,30,7,7,0,14,9,30,4,0,0,4,0,30,3,11,0,14,0,30,2,12,0,14,6,30,7,0,0,7,1,-15,3,1
2,2,47,2,30,7,7,0,14,9,30,4,0,0,4,0,30,3,11,0,14,0,30,2,12,0,14,6,30,7,0,0,7,1,-15,3,1
2,3,47,2,30,7,7,0,14,9,30,4,0,0,4,0,30,3,11,0,14,0,30,2,12,0,14,6,30,7,0,0,7,1,-15,3,1
2,4,47,2,30,7,7,0,14,9,30,4,0,0,4,0,30,3,11,0,14,0,30,2,12,0,14,6,30,7,0,0,7,1,-15,3,1
2,4,7,0,30,3,6,0,9,0,30,4,0,0,4,1,30,6,3,0,9,12,30,3,6,0,9,1,30,4,2,0,6,0,-27,3,0
2,1,17,2,30,9,5,0,14,3,30,6,0,0,6,0,30,5,9,0,14,5,30,6,8,0,14,7,30,4,0,0,4,1,-15,3,1
2,0,25,4,30,6,8,0,14,3,30,6,0,0,6,0,30,6,8,0,14,1,30,5,9,0,14,4,30,5,1,0,6,1,-15,3,1
2,4,29,0,30,5,9,0,14,6,30,11,1,0,12,0,30,1,13,0,14,0,30,0,14,0,14,2,30,9,0,0,9,1,-15,3,1
2,1,31,3,30,6,6,0,12,4,30,8,0,0,8,4,30,10,2,0,12,0,30,5,7,0,12,0,30,3,3,0,6,1,-15,3,1
2,0,38,6,30,6,4,0,10,9,30,6,0,0,6,0,30,1,9,0,10,0,30,2,8,0,10,0,30,5,1,0,6,1,-15,3,1
2,3,8,2,30,7,0,0,7,4,30,2,0,0,2,0,30,4,3,0,7,0,30,5,2,0,7,3,30,3,0,0,3,0,-27,3,0
2,2,11,1,30,5,7,0,12,2,30,4,0,0,4,0,30,7,5,0,12,4,30,7,5,0,12,0,30,4,0,0,4,1,-15,3,1
2,3,11,1,30,5,7,0,12,2,30,4,0,0,4,0,30,7,5,0,12,4,30,7,5,0,12,0,30,4,0,0,4,1,-15,3,1
2,4,11,1,30,5,7,0,12,2,30,4,0,0,4,0,30,7,5,0,12,4,30,7,5,0,12,0,30,4,0,0,4,1,-15,3,1
2,3,13,1,30,3,0,0,3,1,30,2,0,0,2,0,30,2,1,0,3,4,30,3,0,0,3,2,30,2,0,0,2,1,-15,3,1
2,1,13,1,30,7,0,0,7,0,30,4,0,0,4,2,30,5,2,0,7,10,30,7,0,0,7,1,30,4,0,0,4,1,-15,3,1
2,1,17,5,30,10,4,0,14,3,30,6,0,0,6,0,30,5,9,0,14,1,30,4,10,0,14,2,30,4,0,0,4,1,-15,3,1
2,2,17,5,30,10,4,0,14,3,30,6,0,0,6,0,30,5,9,0,14,1,30,4,10,0,14,2,30,4,0,0,4,1,-15,3,1
2,1,19,0,30,4,9,0,13,2,30,7,1,0,8,0,30,5,8,0,13,1,30,4,9,0,13,1,30,8,1,0,9,1,-15,3,1
2,2,23,1,30,5,8,0,13,3,30,6,0,0,6,2,30,12,1,0,13,2,30,6,7,0,13,4,30,6,0,0,6,1,-15,3,1
2,3,23,1,30,5,8,0,13,3,30,6,0,0,6,2,30,12,1,0,13,2,30,6,7,0,13,4,30,6,0,0,6,1,-15,3,1
2,4,23,1,30,5,8,0,13,3,30,6,0,0,6,2,30,12,1,0,13,2,30,6,7,0,13,4,30,6,0,0,6,1,-15,3,1
2,0,25,2,30,11,3,0,14,5,30,6,0,0,6,0,30,3,11,0,14,1,30,5,9,0,14,7,30,6,0,0,6,1,-15,3,1
2,1,25,2,30,11,3,0,14,5,30,6,0,0,6,0,30,3,11,0,14,1,30,5,9,0,14,7,30,6,0,0,6,1,-15,3,1
2,1,27,1,30,3,12,0,15,2,30,2,0,0,2,0,30,4,11,0,15,1,30,4,11,0,15,5,30,6,0,0,6,1,-15,3,1
2,2,27,1,30,3,12,0,15,2,30,2,0,0,2,0,30,4,11,0,15,1,30,4,11,0,15,5,30,6,0,0,6,1,-15,3,1
2,4,9,0,30,8,3,0,11,2,30,5,1,0,6,0,30,9,2,0,11,3,30,3,8,0,11,2,30,2,2,0,4,0,-27,3,0
2,2,11,2,30,7,5,0,12,1,30,4,0,0,4,0,30,7,5,0,12,2,30,6,6,0,12,4,30,4,0,0,4,1,-15,3,1
2,4,15,0,30,3,10,0,13,1,30,6,0,0,6,0,30,3,10,0,13,1,30,5,8,0,13,2,30,9,0,0,9,1,-15,3,1
2,2,19,0,30,4,9,0,13,2,30,6,2,0,8,0,30,4,9,0,13,0,30,7,6,0,13,2,30,8,1,0,9,1,-15,3,1
2,0,25,3,30,4,10,0,14,6,30,5,1,0,6,0,30,6,8,0,14,1,30,6,8,0,14,5,30,5,1,0,6,1,-15,3,1
2,1,25,3,30,4,10,0,14,6,30,5,1,0,6,0,30,6,8,0,14,1,30,6,8,0,14,5,30,5,1,0,6,1,-15,3,1
2,2,25,3,30,4,10,0,14,6,30,5,1,0,6,0,30,6,8,0,14,1,30,6,8,0,14,5,30,5,1,0,6,1,-15,3,1
2,2,27,0,30,6,9,0,15,3,30,2,0,0,2,0,30,4,11,0,15,2,30,4,11,0,15,2,30,6,0,0,6,1,-15,3,1
2,4,27,0,30,6,9,0,15,3,30,2,0,0,2,0,30,4,11,0,15,0,30,4,11,0,15,2,30,6,0,0,6,1,-15,3,1
2,3,32,0,30,7,2,0,9,4,30,2,0,0,2,0,30,7,2,0,9,1,30,3,6,0,9,4,30,2,0,0,2,1,-15,3,1
2,1,6,1,30,8,1,0,9,4,30,2,0,0,2,0,30,2,7,0,9,2,30,4,5,0,9,0,30,3,2,0,5,0,-27,3,0
2,2,6,1,30,8,1,0,9,4,30,2,0,0,2,0,30,2,7,0,9,2,30,4,5,0,9,0,30,3,2,0,5,0,-27,3,0
2,4,6,1,30,8,1,0,9,4,30,2,0,0,2,0,30,2,7,0,9,2,30,4,5,0,9,0,30,3,2,0,5,0,-27,3,0
2,1,17,2,30,10,4,0,14,3,30,6,0,0,6,0,30,3,11,0,14,1,30,8,6,0,14,5,30,4,0,0,4,1,-15,3,1
2,3,17,2,30,10,4,0,14,3,30,6,0,0,6,0,30,3,11,0,14,0,30,8,6,0,14,5,30,4,0,0,4,1,-15,3,1
2,1,19,0,30,4,9,0,13,1,30,8,0,0,8,0,30,7,6,0,13,0,30,4,9,0,13,1,30,7,2,0,9,1,-15,3,1
2,2,19,0,30,4,9,0,13,1,30,8,0,0,8,0,30,7,6,0,13,0,30,4,9,0,13,1,30,7,2,0,9,1,-15,3,1
2,3,23,1,30,4,9,0,13,0,30,6,0,0,6,6,30,13,0,0,13,3,30,6,7,0,13,4,30,6,0,0,6,1,-15,3,1
2,1,25,1,30,7,7,0,14,4,30,6,0,0,6,0,30,9,5,0,14,1,30,4,10,0,14,5,30,5,1,0,6,1,-15,3,1
2,2,25,1,30,7,7,0,14,4,30,6,0,0,6,0,30,9,5,0,14,1,30,4,10,0,14,5,30,5,1,0,6,1,-15,3,1
2,1,27,1,30,4,11,0,15,3,30,2,0,0,2,0,30,2,13,0,15,2,30,4,11,0,15,6,30,6,0,0,6,1,-15,3,1
2,2,27,1,30,4,11,0,15,3,30,2,0,0,2,0,30,2,13,0,15,2,30,4,11,0,15,6,30,6,0,0,6,1,-15,3,1
2,4,29,0,30,5,9,0,14,6,30,9,3,0,12,0,30,3,11,0,14,0,30,3,11,0,14,4,30,9,0,0,9,1,-15,3,1
2,2,39,2,30,5,6,0,11,5,30,6,0,0,6,2,30,11,0,0,11,0,30,2,9,0,11,0,30,4,1,0,5,1,-15,3,1
2,1,4,7,30,8,0,0,8,3,30,4,0,0,4,0,30,3,5,0,8,0,30,0,8,0,8,1,30,4,0,0,4,0,-27,3,0
2,4,4,7,30,8,0,0,8,3,30,4,0,0,4,0,30,3,5,0,8,0,30,0,8,0,8,1,30,4,0,0,4,0,-27,3,0
2,4,11,2,30,6,6,0,12,0,30,4,0,0,4,0,30,7,5,0,12,8,30,4,8,0,12,5,30,4,0,0,4,1,-15,3,1
2,1,13,2,30,7,0,0,7,0,30,4,0,0,4,5,30,6,1,0,7,8,30,5,2,0,7,4,30,4,0,0,4,1,-15,3,1
2,2,13,2,30,7,0,0,7,0,30,4,0,0,4,5,30,6,1,0,7,8,30,5,2,0,7,4,30,4,0,0,4,1,-15,3,1
2,4,25,0,30,4,10,0,14,5,30,6,0,0,6,0,30,7,7,0,14,1,30,9,5,0,14,4,30,5,1,0,6,1,-15,3,1
2,4,29,0,30,5,9,0,14,6,30,12,0,0,12,0,30,4,10,0,14,0,30,1,13,0,14,1,30,9,0,0,9,1,-15,3,1
2,3,31,2,30,7,5,0,12,3,30,8,0,0,8,3,30,12,0,0,12,0,30,3,9,0,12,1,30,1,5,0,6,1,-15,3,1
2,4,31,2,30,7,5,0,12,3,30,8,0,0,8,3,30,12,0,0,12,0,30,3,9,0,12,1,30,1,5,0,6,1,-15,3,1
2,3,39,0,30,2,9,0,11,6,30,6,0,0,6,0,30,7,4,0,11,0,30,4,7,0,11,6,30,5,0,0,5,1,-15,3,1
2,4,39,0,30,2,9,0,11,6,30,6,0,0,6,0,30,7,4,0,11,0,30,4,7,0,11,6,30,5,0,0,5,1,-15,3,1
2,2,45,0,30,8,5,0,13,10,30,10,0,0,10,0,30,0,13,0,13,0,30,4,9,0,13,9,30,5,0,0,5,1,-15,3,1
2,3,45,0,30,8,5,0,13,10,30,10,0,0,10,0,30,0,13,0,13,0,30,4,9,0,13,9,30,5,0,0,5,1,-15,3,1
2,1,4,2,30,5,3,0,8,5,30,4,0,0,4,0,30,1,7,0,8,0,30,5,3,0,8,4,30,4,0,0,4,0,-27,3,0
2,3,4,2,30,5,3,0,8,5,30,4,0,0,4,0,30,1,7,0,8,0,30,5,3,0,8,4,30,4,0,0,4,0,-27,3,0
2,4,17,3,30,8,6,0,14,2,30,6,0,0,6,0,30,10,4,0,14,0,30,6,8,0,14,5,30,4,0,0,4,1,-15,3,1
2,2,19,0,30,3,10,0,13,0,30,5,3,0,8,0,30,5,8,0,13,7,30,4,9,0,13,3,30,8,1,0,9,1,-15,3,1
2,4,19,0,30,3,10,0,13,0,30,5,3,0,8,0,30,5,8,0,13,7,30,4,9,0,13,3,30,8,1,0,9,1,-15,3,1
2,1,25,1,30,8,6,0,14,2,30,6,0,0,6,0,30,10,4,0,14,1,30,4,10,0,14,4,30,5,1,0,6,1,-15,3,1
2,2,25,1,30,8,6,0,14,2,30,6,0,0,6,0,30,10,4,0,14,1,30,4,10,0,14,4,30,5,1,0,6,1,-15,3,1
2,4,25,1,30,8,6,0,14,2,30,6,0,0,6,0,30,10,4,0,14,1,30,4,10,0,14,4,30,5,1,0,6,1,-15,3,1
2,4,35,1,30,8,5,0,13,4,30,2,0,0,2,1,30,6,7,0,13,3,30,2,11,0,13,2,30,8,0,0,8,1,-15,3,1
2,1,17,2,30,11,3,0,14,3,30,6,0,0,6,0,30,3,11,0,14,1,30,5,9,0,14,5,30,4,0,0,4,1,-15,3,1
2,3,17,2,30,11,3,0,14,3,30,6,0,0,6,0,30,3,11,0,14,1,30,5,9,0,14,5,30,4,0,0,4,1,-15,3,1
2,1,19,0,30,4,9,0,13,1,30,8,0,0,8,0,30,7,6,0,13,1,30,5,8,0,13,1,30,8,1,0,9,1,-15,3,1
2,3,19,0,30,4,9,0,13,1,30,8,0,0,8,0,30,7,6,0,13,1,30,5,8,0,13,1,30,8,1,0,9,1,-15,3,1
2,2,25,1,30,5,9,0,14,3,30,6,0,0,6,0,30,8,6,0,14,1,30,9,5,0,14,3,30,5,1,0,6,1,-15,3,1
2,3,25,1,30,5,9,0,14,3,30,6,0,0,6,0,30,8,6,0,14,1,30,9,5,0,14,3,30,5,1,0,6,1,-15,3,1
2,2,27,1,30,4,11,0,15,4,30,2,0,0,2,0,30,5,10,0,15,0,30,4,11,0,15,1,30,5,1,0,6,1,-15,3,1
2,3,27,1,30,4,11,0,15,4,30,2,0,0,2,0,30,5,10,0,15,0,30,4,11,0,15,1,30,5,1,0,6,1,-15,3,1
2,3,29,0,30,5,9,0,14,6,30,12,0,0,12,0,30,3,11,0,14,0,30,1,13,0,14,4,30,9,0,0,9,1,-15,3,1
2,1,35,0,30,5,8,0,13,2,30,2,0,0,2,1,30,13,0,0,13,5,30,2,11,0,13,6,30,8,0,0,8,1,-15,3,1
2,2,35,0,30,5,8,0,13,2,30,2,0,0,2,1,30,13,0,0,13,5,30,2,11,0,13,6,30,8,0,0,8,1,-15,3,1
2,3,35,0,30,5,8,0,13,2,30,2,0,0,2,1,30,13,0,0,13,5,30,2,11,0,13,6,30,8,0,0,8,1,-15,3,1
2,2,43,0,30,5,9,0,14,7,30,6,0,0,6,0,30,4,10,0,14,1,30,1,13,0,14,6,30,5,0,0,5,1,-15,3,1
2,3,43,0,30,5,9,0,14,7,30,6,0,0,6,0,30,4,10,0,14,1,30,1,13,0,14,6,30,5,0,0,5,1,-15,3,1
2,4,43,0,30,5,9,0,14,7,30,6,0,0,6,0,30,4,10,0,14,1,30,1,13,0,14,6,30,5,0,0,5,1,-15,3,1
2,3,47,0,30,0,14,0,14,7,30,4,0,0,4,0,30,7,7,0,14,1,30,7,7,0,14,0,30,6,1,0,7,1,-15,3,1
2,4,47,0,30,0,14,0,14,7,30,4,0,0,4,0,30,7,7,0,14,1,30,7,7,0,14,0,30,6,1,0,7,1,-15,3,1
2,3,3,5,30,2,2,0,4,4,30,4,0,0,4,0,30,0,4,0,4,0,30,0,4,0,4,0,30,1,2,0,3,0,-27,3,0
2,4,3,5,30,2,2,0,4,4,30,4,0,0,4,0,30,0,4,0,4,0,30,0,4,0,4,0,30,1,2,0,3,0,-27,3,0
2,2,5,0,30,1,4,0,5,2,30,3,1,0,4,1,30,0,5,0,5,0,30,1,4,0,5,0,30,0,2,0,2,0,-27,3,0
2,3,5,0,30,1,4,0,5,2,30,3,1,0,4,1,30,0,5,0,5,0,30,1,4,0,5,0,30,0,2,0,2,0,-27,3,0
2,4,5,0,30,1,4,0,5,2,30,3,1,0,4,1,30,0,5,0,5,0,30,1,4,0,5,0,30,0,2,0,2,0,-27,3,0
2,4,17,2,30,7,7,0,14,2,30,6,0,0,6,0,30,6,8,0,14,4,30,5,9,0,14,4,30,4,0,0,4,1,-15,3,1
2,2,19,0,30,2,11,0,13,2,30,8,0,0,8,0,30,5,8,0,13,0,30,5,8,0,13,1,30,7,2,0,9,1,-15,3,1
2,4,23,3,30,7,6,0,13,2,30,6,0,0,6,3,30,13,0,0,13,0,30,5,8,0,13,2,30,5,1,0,6,1,-15,3,1
2,2,25,1,30,7,7,0,14,4,30,6,0,0,6,0,30,6,8,0,14,1,30,5,9,0,14,4,30,5,1,0,6,1,-15,3,1
2,0,27,1,30,5,10,0,15,2,30,1,1,0,2,0,30,6,9,0,15,0,30,6,9,0,15,4,30,6,0,0,6,1,-15,3,1
2,1,27,1,30,5,10,0,15,2,30,1,1,0,2,0,30,6,9,0,15,0,30,6,9,0,15,4,30,6,0,0,6,1,-15,3,1
2,2,27,1,30,5,10,0,15,2,30,1,1,0,2,0,30,6,9,0,15,0,30,6,9,0,15,4,30,6,0,0,6,1,-15,3,1
2,4,27,1,30,5,10,0,15,2,30,1,1,0,2,0,30,6,9,0,15,0,30,6,9,0,15,4,30,6,0,0,6,1,-15,3,1
2,4,31,2,30,7,5,0,12,6,30,8,0,0,8,3,30,4,8,0,12,0,30,3,9,0,12,0,30,5,1,0,6,1,-15,3,1
2,3,39,0,30,4,7,0,11,5,30,6,0,0,6,0,30,9,2,0,11,0,30,2,9,0,11,1,30,5,0,0,5,1,-15,3,1
2,3,45,0,30,4,9,0,13,9,30,10,0,0,10,0,30,0,13,0,13,0,30,5,8,0,13,6,30,5,0,0,5,1,-15,3,1
2,2,1,0,30,4,6,0,10,4,30,2,0,0,2,4,30,4,6,0,10,4,30,10,0,0,10,6,30,6,0,0,6,0,-27,3,0
2,3,1,0,30,4,6,0,10,4,30,2,0,0,2,4,30,4,6,0,10,4,30,10,0,0,10,6,30,6,0,0,6,0,-27,3,0
2,4,1,0,30,4,6,0,10,4,30,2,0,0,2,4,30,4,6,0,10,4,30,10,0,0,10,6,30,6,0,0,6,0,-27,3,0
2,1,5,1,30,2,3,0,5,3,30,0,4,0,4,0,30,0,5,0,5,0,30,1,4,0,5,0,30,2,0,0,2,0,-27,3,0
2,2,5,1,30,2,3,0,5,3,30,0,4,0,4,0,30,0,5,0,5,0,30,1,4,0,5,0,30,2,0,0,2,0,-27,3,0
2,4,5,1,30,2,3,0,5,3,30,0,4,0,4,0,30,0,5,0,5,0,30,1,4,0,5,0,30,2,0,0,2,0,-27,3,0
2,4,8,4,30,7,0,0,7,5,30,2,0,0,2,0,30,1,6,0,7,0,30,5,2,0,7,6,30,3,0,0,3,0,-27,3,0
2,3,11,1,30,6,6,0,12,2,30,4,0,0,4,0,30,5,7,0,12,0,30,7,5,0,12,0,30,4,0,0,4,1,-15,3,1
2,3,17,4,30,10,4,0,14,2,30,6,0,0,6,0,30,5,9,0,14,2,30,3,11,0,14,3,30,4,0,0,4,1,-15,3,1
2,4,17,4,30,10,4,0,14,2,30,6,0,0,6,0,30,5,9,0,14,2,30,3,11,0,14,3,30,4,0,0,4,1,-15,3,1
2,4,23,0,30,4,9,0,13,2,30,6,0,0,6,3,30,11,2,0,13,6,30,6,7,0,13,3,30,6,0,0,6,1,-15,3,1
2,3,25,2,30,9,5,0,14,0,30,6,0,0,6,0,30,12,2,0,14,1,30,5,9,0,14,3,30,5,1,0,6,1,-15,3,1
2,2,13,3,30,5,2,0,7,0,30,4,0,0,4,1,30,6,1,0,7,6,30,7,0,0,7,6,30,4,0,0,4,1,-15,3,1
2,4,13,3,30,5,2,0,7,0,30,4,0,0,4,0,30,6,1,0,7,6,30,7,0,0,7,6,30,4,0,0,4,1,-15,3,1
2,2,17,3,30,9,5,0,14,2,30,6,0,0,6,0,30,8,6,0,14,5,30,5,9,0,14,6,30,4,0,0,4,1,-15,3,1
2,3,17,3,30,9,5,0,14,2,30,6,0,0,6,0,30,8,6,0,14,5,30,5,9,0,14,6,30,4,0,0,4,1,-15,3,1
2,2,19,0,30,2,11,0,13,2,30,4,4,0,8,0,30,7,6,0,13,5,30,6,7,0,13,4,30,9,0,0,9,1,-15,3,1
2,4,19,0,30,2,11,0,13,2,30,4,4,0,8,0,30,7,6,0,13,5,30,6,7,0,13,4,30,9,0,0,9,1,-15,3,1
2,2,25,2,30,5,9,0,14,4,30,6,0,0,6,0,30,10,4,0,14,1,30,7,7,0,14,3,30,6,0,0,6,1,-15,3,1
2,4,25,2,30,5,9,0,14,4,30,6,0,0,6,0,30,10,4,0,14,1,30,7,7,0,14,3,30,6,0,0,6,1,-15,3,1
2,2,4,2,30,6,2,0,8,4,30,4,0,0,4,1,30,5,3,0,8,0,30,7,1,0,8,1,30,4,0,0,4,0,-27,3,0
2,0,5,0,30,2,3,0,5,3,30,0,4,0,4,0,30,1,4,0,5,0,30,1,4,0,5,1,30,0,2,0,2,0,-27,3,0
2,3,8,0,30,7,0,0,7,4,30,2,0,0,2,3,30,2,5,0,7,0,30,5,2,0,7,3,30,3,0,0,3,0,-27,3,0
2,4,8,0,30,7,0,0,7,4,30,2,0,0,2,3,30,2,5,0,7,0,30,5,2,0,7,3,30,3,0,0,3,0,-27,3,0
2,4,11,5,30,7,5,0,12,0,30,4,0,0,4,0,30,9,3,0,12,0,30,2,10,0,12,2,30,4,0,0,4,1,-15,3,1
2,1,13,3,30,6,1,0,7,1,30,4,0,0,4,2,30,6,1,0,7,5,30,6,1,0,7,2,30,4,0,0,4,1,-15,3,1
2,4,17,3,30,8,6,0,14,3,30,6,0,0,6,0,30,6,8,0,14,2,30,5,9,0,14,3,30,4,0,0,4,1,-15,3,1
2,3,19,0,30,3,10,0,13,1,30,7,1,0,8,0,30,8,5,0,13,5,30,4,9,0,13,1,30,8,1,0,9,1,-15,3,1
2,3,25,1,30,7,7,0,14,3,30,6,0,0,6,0,30,7,7,0,14,1,30,5,9,0,14,4,30,5,1,0,6,1,-15,3,1
2,1,27,5,30,4,11,0,15,3,30,2,0,0,2,0,30,5,10,0,15,0,30,4,11,0,15,1,30,4,2,0,6,1,-15,3,1
2,4,3,0,30,0,4,0,4,2,30,4,0,0,4,2,30,1,3,0,4,0,30,0,4,0,4,0,30,1,2,0,3,0,-27,3,0
2,2,13,3,30,6,1,0,7,0,30,4,0,0,4,2,30,6,1,0,7,11,30,5,2,0,7,4,30,4,0,0,4,1,-15,3,1
2,4,13,3,30,6,1,0,7,0,30,4,0,0,4,2,30,6,1,0,7,11,30,5,2,0,7,4,30,4,0,0,4,1,-15,3,1
2,2,17,5,30,8,6,0,14,3,30,6,0,0,6,0,30,7,7,0,14,1,30,6,8,0,14,0,30,2,2,0,4,1,-15,3,1
2,4,19,0,30,4,9,0,13,2,30,5,3,0,8,0,30,7,6,0,13,4,30,5,8,0,13,0,30,8,1,0,9,1,-15,3,1
2,0,27,1,30,4,11,0,15,1,30,1,1,0,2,0,30,6,9,0,15,2,30,6,9,0,15,3,30,6,0,0,6,1,-15,3,1
2,1,27,1,30,4,11,0,15,1,30,1,1,0,2,0,30,6,9,0,15,2,30,6,9,0,15,3,30,6,0,0,6,1,-15,3,1
2,2,27,1,30,4,11,0,15,1,30,1,1,0,2,0,30,6,9,0,15,2,30,6,9,0,15,3,30,6,0,0,6,1,-15,3,1
2,3,27,1,30,4,11,0,15,1,30,1,1,0,2,0,30,6,9,0,15,2,30,6,9,0,15,3,30,6,0,0,6,1,-15,3,1
2,4,27,1,30,4,11,0,15,1,30,1,1,0,2,0,30,6,9,0,15,2,30,6,9,0,15,3,30,6,0,0,6,1,-15,3,1
2,4,31,3,30,5,7,0,12,4,30,8,0,0,8,3,30,10,2,0,12,0,30,5,7,0,12,0,30,4,2,0,6,1,-15,3,1
2,1,33,1,30,4,7,0,11,5,30,4,0,0,4,1,30,9,2,0,11,0,30,3,8,0,11,6,30,4,0,0,4,1,-15,3,1
2,4,39,0,30,4,7,0,11,6,30,6,0,0,6,0,30,5,6,0,11,0,30,3,8,0,11,3,30,5,0,0,5,1,-15,3,1
2,2,4,2,30,6,2,0,8,4,30,4,0,0,4,2,30,1,7,0,8,0,30,4,4,0,8,1,30,4,0,0,4,0,-27,3,0
2,2,5,0,30,1,4,0,5,3,30,3,1,0,4,1,30,0,5,0,5,0,30,1,4,0,5,0,30,1,1,0,2,0,-27,3,0
2,3,5,0,30,1,4,0,5,3,30,3,1,0,4,1,30,0,5,0,5,0,30,1,4,0,5,0,30,1,1,0,2,0,-27,3,0
2,3,11,0,30,2,2,0,4,0,30,0,0,0,0,0,30,1,3,0,4,4,30,4,0,0,4,0,30,1,0,0,1,1,-15,3,1
2,4,11,0,30,2,2,0,4,0,30,0,0,0,0,0,30,1,3,0,4,4,30,4,0,0,4,0,30,1,0,0,1,1,-15,3,1
2,0,15,0,30,2,2,0,4,0,30,4,2,0,6,0,30,2,2,0,4,10,30,4,0,0,4,1,30,4,0,0,4,1,-15,3,1
2,0,25,1,30,5,9,0,14,5,30,6,0,0,6,0,30,6,8,0,14,1,30,7,7,0,14,4,30,5,1,0,6,1,-15,3,1
2,1,25,1,30,5,9,0,14,5,30,6,0,0,6,0,30,6,8,0,14,1,30,7,7,0,14,4,30,5,1,0,6,1,-15,3,1
2,4,25,1,30,5,9,0,14,5,30,6,0,0,6,0,30,6,8,0,14,1,30,7,7,0,14,1,30,5,1,0,6,1,-15,3,1
2,0,26,0,30,9,0,0,9,5,30,4,0,0,4,2,30,0,9,0,9,0,30,3,6,0,9,4,30,2,1,0,3,1,-15,3,1
2,1,26,0,30,9,0,0,9,5,30,4,0,0,4,2,30,0,9,0,9,0,30,3,6,0,9,4,30,2,1,0,3,1,-15,3,1
2,2,26,0,30,9,0,0,9,5,30,4,0,0,4,2,30,0,9,0,9,0,30,3,6,0,9,4,30,2,1,0,3,1,-15,3,1
2,1,27,1,30,5,10,0,15,3,30,2,0,0,2,0,30,2,13,0,15,1,30,6,9,0,15,1,30,6,0,0,6,1,-15,3,1
2,2,27,1,30,5,10,0,15,3,30,2,0,0,2,0,30,2,13,0,15,1,30,6,9,0,15,1,30,6,0,0,6,1,-15,3,1
2,3,27,1,30,5,10,0,15,3,30,2,0,0,2,0,30,2,13,0,15,1,30,6,9,0,15,1,30,6,0,0,6,1,-15,3,1
2,4,29,0,30,9,5,0,14,5,30,7,5,0,12,0,30,2,12,0,14,0,30,6,8,0,14,0,30,7,2,0,9,1,-15,3,1
2,0,4,2,30,6,2,0,8,5,30,4,0,0,4,3,30,2,6,0,8,0,30,6,2,0,8,6,30,3,1,0,4,0,-27,3,0
2,4,4,2,30,6,2,0,8,5,30,4,0,0,4,3,30,2,6,0,8,0,30,6,2,0,8,6,30,3,1,0,4,0,-27,3,0
2,2,6,2,30,7,2,0,9,4,30,2,0,0,2,0,30,2,7,0,9,0,30,4,5,0,9,0,30,4,1,0,5,0,-27,3,0
2,1,17,2,30,8,6,0,14,3,30,6,0,0,6,0,30,3,11,0,14,4,30,8,6,0,14,7,30,4,0,0,4,1,-15,3,1
2,3,17,2,30,8,6,0,14,3,30,6,0,0,6,0,30,3,11,0,14,4,30,8,6,0,14,7,30,4,0,0,4,1,-15,3,1
2,3,21,2,30,6,4,0,10,3,30,6,0,0,6,1,30,5,5,0,10,3,30,4,6,0,10,3,30,4,0,0,4,1,-15,3,1
2,3,23,6,30,6,7,0,13,2,30,6,0,0,6,1,30,11,2,0,13,0,30,6,7,0,13,2,30,6,0,0,6,1,-15,3,1
2,3,25,1,30,5,9,0,14,3,30,6,0,0,6,0,30,5,9,0,14,3,30,7,7,0,14,2,30,6,0,0,6,1,-15,3,1
2,3,27,0,30,5,10,0,15,4,30,2,0,0,2,0,30,6,9,0,15,4,30,6,9,0,15,0,30,6,0,0,6,1,-15,3,1
2,2,29,0,30,7,7,0,14,3,30,12,0,0,12,0,30,7,7,0,14,0,30,1,13,0,14,0,30,8,1,0,9,1,-15,3,1
2,4,29,0,30,7,7,0,14,3,30,12,0,0,12,0,30,7,7,0,14,0,30,1,13,0,14,0,30,8,1,0,9,1,-15,3,1
2,3,47,0,30,0,14,0,14,6,30,4,0,0,4,0,30,4,10,0,14,0,30,2,12,0,14,8,30,7,0,0,7,1,-15,3,1
2,2,4,3,30,8,0,0,8,4,30,2,2,0,4,0,30,1,7,0,8,0,30,5,3,0,8,4,30,4,0,0,4,0,-27,3,0
2,2,17,3,30,10,4,0,14,3,30,6,0,0,6,0,30,5,9,0,14,2,30,4,10,0,14,1,30,4,0,0,4,1,-15,3,1
2,3,17,3,30,10,4,0,14,3,30,6,0,0,6,0,30,5,9,0,14,2,30,4,10,0,14,1,30,4,0,0,4,1,-15,3,1
2,4,17,3,30,10,4,0,14,3,30,6,0,0,6,0,30,5,9,0,14,2,30,4,10,0,14,1,30,4,0,0,4,1,-15,3,1
2,3,19,0,30,1,12,0,13,2,30,8,0,0,8,0,30,7,6,0,13,0,30,3,10,0,13,2,30,8,1,0,9,1,-15,3,1
2,0,27,1,30,4,11,0,15,2,30,2,0,0,2,0,30,10,5,0,15,11,30,5,10,0,15,1,30,5,1,0,6,1,-15,3,1
2,3,29,0,30,8,6,0,14,6,30,8,4,0,12,0,30,3,11,0,14,0,30,3,11,0,14,4,30,9,0,0,9,1,-15,3,1
2,2,39,2,30,4,7,0,11,5,30,6,0,0,6,0,30,8,3,0,11,0,30,2,9,0,11,3,30,5,0,0,5,1,-15,3,1
2,3,39,2,30,4,7,0,11,5,30,6,0,0,6,0,30,8,3,0,11,0,30,2,9,0,11,3,30,5,0,0,5,1,-15,3,1
2,0,5,2,30,2,3,0,5,3,30,0,4,0,4,2,30,2,3,0,5,0,30,1,4,0,5,0,30,0,2,0,2,0,-27,3,0
2,1,5,2,30,2,3,0,5,3,30,0,4,0,4,2,30,2,3,0,5,0,30,1,4,0,5,0,30,0,2,0,2,0,-27,3,0
2,3,5,2,30,2,3,0,5,3,30,0,4,0,4,2,30,2,3,0,5,0,30,1,4,0,5,0,30,0,2,0,2,0,-27,3,0
2,4,8,0,30,7,0,0,7,3,30,2,0,0,2,0,30,4,3,0,7,0,30,5,2,0,7,3,30,3,0,0,3,0,-27,3,0
2,1,17,6,30,8,6,0,14,2,30,6,0,0,6,0,30,6,8,0,14,1,30,5,9,0,14,5,30,3,1,0,4,1,-15,3,1
2,2,17,6,30,8,6,0,14,2,30,6,0,0,6,0,30,6,8,0,14,1,30,5,9,0,14,5,30,3,1,0,4,1,-15,3,1
2,4,17,6,30,8,6,0,14,2,30,6,0,0,6,0,30,6,8,0,14,1,30,5,9,0,14,5,30,3,1,0,4,1,-15,3,1
2,2,19,0,30,3,10,0,13,1,30,8,0,0,8,0,30,6,7,0,13,0,30,4,9,0,13,1,30,7,2,0,9,1,-15,3,1
2,3,25,0,30,6,8,0,14,3,30,6,0,0,6,0,30,6,8,0,14,1,30,9,5,0,14,6,30,6,0,0,6,1,-15,3,1
2,0,27,1,30,4,11,0,15,4,30,2,0,0,2,0,30,2,13,0,15,1,30,4,11,0,15,5,30,6,0,0,6,1,-15,3,1
2,2,27,1,30,4,11,0,15,4,30,2,0,0,2,0,30,2,13,0,15,1,30,4,11,0,15,5,30,6,0,0,6,1,-15,3,1
2,3,29,0,30,6,8,0,14,5,30,12,0,0,12,0,30,5,9,0,14,0,30,1,13,0,14,0,30,8,1,0,9,1,-15,3,1
2,0,4,2,30,7,1,0,8,5,30,4,0,0,4,2,30,1,7,0,8,0,30,4,4,0,8,2,30,3,1,0,4,0,-27,3,0
2,1,4,2,30,7,1,0,8,5,30,4,0,0,4,2,30,1,7,0,8,0,30,4,4,0,8,2,30,3,1,0,4,0,-27,3,0
2,4,4,2,30,7,1,0,8,5,30,4,0,0,4,2,30,1,7,0,8,0,30,4,4,0,8,2,30,3,1,0,4,0,-27,3,0
2,1,11,0,30,4,8,0,12,1,30,4,0,0,4,0,30,6,6,0,12,7,30,5,7,0,12,4,30,4,0,0,4,1,-15,3,1
2,4,11,0,30,4,8,0,12,1,30,4,0,0,4,0,30,6,6,0,12,7,30,5,7,0,12,4,30,4,0,0,4,1,-15,3,1
2,2,13,2,30,7,0,0,7,0,30,4,0,0,4,2,30,6,1,0,7,11,30,7,0,0,7,4,30,4,0,0,4,1,-15,3,1
2,4,25,1,30,4,10,0,14,5,30,6,0,0,6,0,30,7,7,0,14,1,30,5,9,0,14,3,30,5,1,0,6,1,-15,3,1
2,2,27,4,30,5,10,0,15,3,30,2,0,0,2,0,30,4,11,0,15,0,30,8,7,0,15,2,30,4,2,0,6,1,-15,3,1
2,4,31,3,30,7,5,0,12,5,30,8,0,0,8,3,30,8,4,0,12,0,30,4,8,0,12,1,30,3,3,0,6,1,-15,3,1
2,3,39,3,30,7,4,0,11,6,30,6,0,0,6,1,30,7,4,0,11,0,30,2,9,0,11,1,30,3,2,0,5,1,-15,3,1
2,1,5,0,30,1,4,0,5,3,30,0,4,0,4,0,30,1,4,0,5,0,30,1,4,0,5,0,30,1,1,0,2,0,-27,3,0
2,4,5,0,30,1,4,0,5,3,30,0,4,0,4,0,30,1,4,0,5,0,30,1,4,0,5,0,30,1,1,0,2,0,-27,3,0
2,3,8,4,30,7,0,0,7,4,30,2,0,0,2,1,30,1,6,0,7,0,30,4,3,0,7,4,30,3,0,0,3,0,-27,3,0
2,2,11,2,30,6,6,0,12,2,30,4,0,0,4,0,30,3,9,0,12,0,30,6,6,0,12,4,30,4,0,0,4,1,-15,3,1
2,4,11,2,30,6,6,0,12,2,30,4,0,0,4,0,30,3,9,0,12,0,30,6,6,0,12,4,30,4,0,0,4,1,-15,3,1
2,3,13,3,30,7,0,0,7,0,30,4,0,0,4,0,30,6,1,0,7,3,30,6,1,0,7,5,30,4,0,0,4,1,-15,3,1
2,4,17,3,30,8,6,0,14,2,30,6,0,0,6,0,30,7,7,0,14,2,30,5,9,0,14,2,30,4,0,0,4,1,-15,3,1
2,0,19,0,30,2,11,0,13,2,30,7,1,0,8,0,30,7,6,0,13,3,30,4,9,0,13,0,30,8,1,0,9,1,-15,3,1
2,1,19,0,30,2,11,0,13,2,30,7,1,0,8,0,30,7,6,0,13,3,30,4,9,0,13,0,30,8,1,0,9,1,-15,3,1
2,3,19,0,30,2,11,0,13,2,30,7,1,0,8,0,30,7,6,0,13,3,30,4,9,0,13,0,30,8,1,0,9,1,-15,3,1
2,4,19,0,30,2,11,0,13,2,30,7,1,0,8,0,30,7,6,0,13,3,30,4,9,0,13,0,30,8,1,0,9,1,-15,3,1
2,0,27,1,30,5,10,0,15,3,30,1,1,0,2,0,30,7,8,0,15,1,30,4,11,0,15,5,30,6,0,0,6,1,-15,3,1
2,1,27,1,30,5,10,0,15,3,30,1,1,0,2,0,30,7,8,0,15,1,30,4,11,0,15,5,30,6,0,0,6,1,-15,3,1
2,0,29,0,30,6,8,0,14,5,30,11,1,0,12,0,30,2,12,0,14,0,30,0,14,0,14,3,30,9,0,0,9,1,-15,3,1
2,2,29,0,30,6,8,0,14,5,30,11,1,0,12,0,30,2,12,0,14,0,30,0,14,0,14,3,30,9,0,0,9,1,-15,3,1
2,3,29,0,30,6,8,0,14,5,30,11,1,0,12,0,30,2,12,0,14,0,30,0,14,0,14,3,30,9,0,0,9,1,-15,3,1
2,4,32,0,30,7,2,0,9,3,30,2,0,0,2,0,30,8,1,0,9,1,30,2,7,0,9,6,30,2,0,0,2,1,-15,3,1
2,4,35,0,30,7,6,0,13,5,30,2,0,0,2,1,30,5,8,0,13,2,30,6,7,0,13,0,30,8,0,0,8,1,-15,3,1
2,1,4,2,30,8,0,0,8,4,30,4,0,0,4,0,30,3,5,0,8,0,30,6,2,0,8,3,30,3,1,0,4,0,-27,3,0
2,1,5,0,30,2,3,0,5,3,30,0,4,0,4,1,30,0,5,0,5,0,30,1,4,0,5,0,30,1,1,0,2,0,-27,3,0
2,4,5,0,30,2,3,0,5,3,30,0,4,0,4,1,30,0,5,0,5,0,30,1,4,0,5,0,30,1,1,0,2,0,-27,3,0
2,3,11,0,30,5,7,0,12,2,30,4,0,0,4,0,30,4,8,0,12,3,30,8,4,0,12,5,30,4,0,0,4,1,-15,3,1
2,2,13,9,30,7,0,0,7,2,30,4,0,0,4,6,30,5,2,0,7,1,30,6,1,0,7,2,30,4,0,0,4,1,-15,3,1
2,4,13,9,30,7,0,0,7,2,30,4,0,0,4,6,30,5,2,0,7,1,30,6,1,0,7,2,30,4,0,0,4,1,-15,3,1
2,3,15,0,30,6,7,0,13,0,30,6,0,0,6,0,30,5,8,0,13,1,30,4,9,0,13,4,30,6,3,0,9,1,-15,3,1
2,3,17,1,30,5,9,0,14,3,30,6,0,0,6,0,30,6,8,0,14,3,30,8,6,0,14,5,30,4,0,0,4,1,-15,3,1
2,4,19,0,30,4,9,0,13,1,30,5,3,0,8,0,30,9,4,0,13,0,30,7,6,0,13,1,30,7,2,0,9,1,-15,3,1
2,2,21,3,30,6,4,0,10,2,30,5,1,0,6,1,30,7,3,0,10,0,30,3,7,0,10,3,30,4,0,0,4,1,-15,3,1
2,3,21,3,30,6,4,0,10,2,30,5,1,0,6,1,30,7,3,0,10,0,30,3,7,0,10,3,30,4,0,0,4,1,-15,3,1
2,0,31,1,30,5,7,0,12,7,30,8,0,0,8,3,30,4,8,0,12,1,30,8,4,0,12,2,30,6,0,0,6,1,-15,3,1
2,3,31,1,30,5,7,0,12,7,30,8,0,0,8,3,30,4,8,0,12,1,30,8,4,0,12,2,30,6,0,0,6,1,-15,3,1
2,1,13,2,30,5,2,0,7,0,30,4,0,0,4,3,30,7,0,0,7,6,30,6,1,0,7,4,30,4,0,0,4,1,-15,3,1
2,4,15,0,30,4,9,0,13,1,30,6,0,0,6,0,30,4,9,0,13,1,30,6,7,0,13,2,30,8,1,0,9,1,-15,3,1
2,3,17,4,30,9,5,0,14,2,30,6,0,0,6,0,30,7,7,0,14,2,30,6,8,0,14,4,30,4,0,0,4,1,-15,3,1
2,4,17,4,30,9,5,0,14,2,30,6,0,0,6,0,30,7,7,0,14,2,30,6,8,0,14,4,30,4,0,0,4,1,-15,3,1
2,3,21,2,30,6,4,0,10,3,30,6,0,0,6,1,30,4,6,0,10,2,30,3,7,0,10,3,30,4,0,0,4,1,-15,3,1
2,3,25,1,30,5,9,0,14,5,30,6,0,0,6,0,30,5,9,0,14,0,30,6,8,0,14,4,30,6,0,0,6,1,-15,3,1
2,2,26,1,30,6,3,0,9,5,30,4,0,0,4,2,30,1,8,0,9,0,30,5,4,0,9,6,30,3,0,0,3,1,-15,3,1
2,3,26,1,30,6,3,0,9,5,30,4,0,0,4,2,30,1,8,0,9,0,30,5,4,0,9,6,30,3,0,0,3,1,-15,3,1
2,4,26,1,30,6,3,0,9,5,30,4,0,0,4,2,30,1,8,0,9,0,30,5,4,0,9,6,30,3,0,0,3,1,-15,3,1
2,0,27,1,30,5,10,0,15,5,30,2,0,0,2,0,30,3,12,0,15,2,30,6,9,0,15,0,30,6,0,0,6,1,-15,3,1
2,0,29,0,30,5,9,0,14,5,30,12,0,0,12,0,30,6,8,0,14,2,30,3,11,0,14,0,30,7,2,0,9,1,-15,3,1
2,1,29,0,30,5,9,0,14,5,30,12,0,0,12,0,30,6,8,0,14,2,30,3,11,0,14,0,30,7,2,0,9,1,-15,3,1
2,1,31,7,30,9,3,0,12,5,30,8,0,0,8,3,30,8,4,0,12,0,30,3,9,0,12,1,30,1,5,0,6,1,-15,3,1
2,2,35,0,30,6,7,0,13,3,30,2,0,0,2,1,30,10,3,0,13,0,30,4,9,0,13,3,30,8,0,0,8,1,-15,3,1
2,3,35,0,30,6,7,0,13,3,30,2,0,0,2,1,30,10,3,0,13,0,30,4,9,0,13,3,30,8,0,0,8,1,-15,3,1
2,2,8,2,30,7,0,0,7,4,30,2,0,0,2,0,30,4,3,0,7,0,30,6,1,0,7,2,30,3,0,0,3,0,-27,3,0
2,2,11,2,30,4,8,0,12,0,30,4,0,0,4,0,30,8,4,0,12,7,30,3,9,0,12,6,30,4,0,0,4,1,-15,3,1
2,1,13,1,30,6,1,0,7,0,30,4,0,0,4,2,30,7,0,0,7,7,30,5,2,0,7,6,30,4,0,0,4,1,-15,3,1
2,2,13,1,30,6,1,0,7,0,30,4,0,0,4,2,30,7,0,0,7,7,30,5,2,0,7,6,30,4,0,0,4,1,-15,3,1
2,4,13,1,30,6,1,0,7,0,30,4,0,0,4,2,30,7,0,0,7,7,30,5,2,0,7,6,30,4,0,0,4,1,-15,3,1
2,2,17,4,30,10,4,0,14,2,30,6,0,0,6,1,30,9,5,0,14,1,30,6,8,0,14,2,30,4,0,0,4,1,-15,3,1
2,4,17,4,30,10,4,0,14,2,30,6,0,0,6,1,30,9,5,0,14,1,30,6,8,0,14,2,30,4,0,0,4,1,-15,3,1
2,1,19,2,30,4,9,0,13,1,30,8,0,0,8,0,30,7,6,0,13,4,30,3,10,0,13,2,30,6,3,0,9,1,-15,3,1
2,3,19,2,30,4,9,0,13,1,30,8,0,0,8,0,30,7,6,0,13,4,30,3,10,0,13,0,30,6,3,0,9,1,-15,3,1
2,4,19,2,30,4,9,0,13,1,30,8,0,0,8,0,30,7,6,0,13,4,30,3,10,0,13,0,30,6,3,0,9,1,-15,3,1
2,4,23,2,30,7,6,0,13,3,30,6,0,0,6,4,30,11,2,0,13,0,30,7,6,0,13,1,30,5,1,0,6,1,-15,3,1
2,2,25,1,30,10,4,0,14,5,30,6,0,0,6,0,30,4,10,0,14,1,30,5,9,0,14,5,30,5,1,0,6,1,-15,3,1
2,2,45,0,30,4,9,0,13,9,30,10,0,0,10,0,30,0,13,0,13,0,30,4,9,0,13,9,30,5,0,0,5,1,-15,3,1
2,3,45,0,30,4,9,0,13,9,30,10,0,0,10,0,30,0,13,0,13,0,30,4,9,0,13,9,30,5,0,0,5,1,-15,3,1
2,2,4,3,30,8,0,0,8,5,30,4,0,0,4,0,30,2,6,0,8,0,30,7,1,0,8,1,30,2,2,0,4,0,-27,3,0
2,3,15,1,30,6,7,0,13,1,30,5,1,0,6,0,30,3,10,0,13,2,30,2,11,0,13,3,30,9,0,0,9,1,-15,3,1
2,4,15,1,30,6,7,0,13,1,30,5,1,0,6,0,30,3,10,0,13,2,30,2,11,0,13,3,30,9,0,0,9,1,-15,3,1
2,3,17,2,30,8,6,0,14,3,30,6,0,0,6,0,30,4,10,0,14,4,30,5,9,0,14,5,30,4,0,0,4,1,-15,3,1
2,1,23,3,30,6,7,0,13,2,30,6,0,0,6,7,30,13,0,0,13,0,30,4,9,0,13,2,30,6,0,0,6,1,-15,3,1
2,3,23,3,30,6,7,0,13,2,30,6,0,0,6,7,30,13,0,0,13,0,30,4,9,0,13,2,30,6,0,0,6,1,-15,3,1
2,1,27,1,30,4,11,0,15,6,30,2,0,0,2,0,30,2,13,0,15,1,30,8,7,0,15,5,30,6,0,0,6,1,-15,3,1
2,4,29,0,30,7,7,0,14,5,30,10,2,0,12,0,30,7,7,0,14,0,30,1,13,0,14,0,30,8,1,0,9,1,-15,3,1
2,4,31,5,30,8,4,0,12,3,30,8,0,0,8,3,30,12,0,0,12,0,30,3,9,0,12,0,30,2,4,0,6,1,-15,3,1
2,3,39,0,30,3,8,0,11,6,30,6,0,0,6,0,30,6,5,0,11,1,30,3,8,0,11,5,30,5,0,0,5,1,-15,3,1
2,2,15,0,30,8,5,0,13,0,30,6,0,0,6,0,30,7,6,0,13,1,30,5,8,0,13,0,30,4,5,0,9,1,-15,3,1
2,3,15,0,30,8,5,0,13,0,30,6,0,0,6,0,30,7,6,0,13,1,30,5,8,0,13,0,30,4,5,0,9,1,-15,3,1
2,3,19,0,30,2,11,0,13,2,30,8,0,0,8,0,30,7,6,0,13,3,30,2,11,0,13,3,30,8,1,0,9,1,-15,3,1
2,2,25,5,30,6,8,0,14,3,30,6,0,0,6,0,30,8,6,0,14,2,30,9,5,0,14,0,30,5,1,0,6,1,-15,3,1
2,0,27,1,30,6,9,0,15,5,30,2,0,0,2,0,30,3,12,0,15,4,30,6,9,0,15,0,30,4,2,0,6,1,-15,3,1
2,3,31,3,30,8,4,0,12,3,30,8,0,0,8,3,30,10,2,0,12,0,30,3,9,0,12,0,30,2,4,0,6,1,-15,3,1
2,4,31,3,30,8,4,0,12,3,30,8,0,0,8,3,30,10,2,0,12,0,30,3,9,0,12,0,30,2,4,0,6,1,-15,3,1
2,3,35,0,30,9,4,0,13,5,30,2,0,0,2,5,30,4,9,0,13,0,30,1,12,0,13,5,30,8,0,0,8,1,-15,3,1
2,4,35,0,30,9,4,0,13,5,30,2,0,0,2,5,30,4,9,0,13,0,30,1,12,0,13,5,30,8,0,0,8,1,-15,3,1
2,2,6,0,30,7,2,0,9,3,30,2,0,0,2,0,30,4,5,0,9,0,30,4,5,0,9,0,30,3,2,0,5,0,-27,3,0
2,3,6,0,30,7,2,0,9,3,30,2,0,0,2,0,30,4,5,0,9,0,30,4,5,0,9,0,30,3,2,0,5,0,-27,3,0
2,1,17,1,30,8,6,0,14,3,30,6,0,0,6,0,30,6,8,0,14,8,30,6,8,0,14,5,30,4,0,0,4,1,-15,3,1
2,4,17,1,30,8,6,0,14,3,30,6,0,0,6,0,30,6,8,0,14,8,30,6,8,0,14,5,30,4,0,0,4,1,-15,3,1
2,1,19,0,30,4,9,0,13,2,30,6,2,0,8,0,30,4,9,0,13,7,30,4,9,0,13,5,30,9,0,0,9,1,-15,3,1
2,2,19,0,30,4,9,0,13,2,30,6,2,0,8,0,30,4,9,0,13,7,30,4,9,0,13,5,30,9,0,0,9,1,-15,3,1
2,4,19,0,30,4,9,0,13,2,30,6,2,0,8,0,30,4,9,0,13,7,30,4,9,0,13,5,30,9,0,0,9,1,-15,3,1
2,2,25,1,30,5,9,0,14,4,30,6,0,0,6,0,30,4,10,0,14,3,30,6,8,0,14,8,30,6,0,0,6,1,-15,3,1
2,3,27,1,30,5,10,0,15,3,30,2,0,0,2,0,30,6,9,0,15,1,30,7,8,0,15,0,30,6,0,0,6,1,-15,3,1
2,4,27,1,30,5,10,0,15,3,30,2,0,0,2,0,30,6,9,0,15,1,30,7,8,0,15,0,30,6,0,0,6,1,-15,3,1
2,2,35,0,30,7,6,0,13,3,30,2,0,0,2,1,30,6,7,0,13,2,30,5,8,0,13,6,30,8,0,0,8,1,-15,3,1
2,4,35,0,30,7,6,0,13,3,30,2,0,0,2,1,30,6,7,0,13,2,30,5,8,0,13,6,30,8,0,0,8,1,-15,3,1
2,2,4,2,30,6,2,0,8,5,30,4,0,0,4,1,30,1,7,0,8,0,30,6,2,0,8,1,30,4,0,0,4,0,-27,3,0
2,4,4,2,30,6,2,0,8,5,30,4,0,0,4,1,30,1,7,0,8,0,30,6,2,0,8,1,30,4,0,0,4,0,-27,3,0
2,4,6,1,30,6,3,0,9,4,30,2,0,0,2,0,30,2,7,0,9,0,30,4,5,0,9,1,30,5,0,0,5,0,-27,3,0
2,2,11,0,30,6,6,0,12,0,30,4,0,0,4,1,30,8,4,0,12,6,30,5,7,0,12,4,30,4,0,0,4,1,-15,3,1
2,3,11,0,30,6,6,0,12,0,30,4,0,0,4,1,30,8,4,0,12,6,30,5,7,0,12,4,30,4,0,0,4,1,-15,3,1
2,1,13,2,30,6,1,0,7,2,30,4,0,0,4,7,30,6,1,0,7,6,30,6,1,0,7,4,30,4,0,0,4,1,-15,3,1
2,4,15,2,30,7,6,0,13,1,30,5,1,0,6,0,30,5,8,0,13,1,30,1,12,0,13,2,30,9,0,0,9,1,-15,3,1
2,3,17,2,30,9,5,0,14,2,30,6,0,0,6,0,30,7,7,0,14,1,30,6,8,0,14,4,30,4,0,0,4,1,-15,3,1
2,0,19,0,30,3,10,0,13,1,30,8,0,0,8,0,30,9,4,0,13,5,30,7,6,0,13,1,30,8,1,0,9,1,-15,3,1
2,2,23,1,30,7,6,0,13,3,30,6,0,0,6,6,30,12,1,0,13,0,30,4,9,0,13,4,30,6,0,0,6,1,-15,3,1
2,4,25,0,30,7,7,0,14,3,30,6,0,0,6,0,30,7,7,0,14,0,30,7,7,0,14,4,30,5,1,0,6,1,-15,3,1
2,1,27,3,30,4,11,0,15,4,30,2,0,0,2,0,30,7,8,0,15,4,30,3,12,0,15,1,30,4,2,0,6,1,-15,3,1
2,3,27,3,30,4,11,0,15,4,30,2,0,0,2,0,30,7,8,0,15,4,30,3,12,0,15,1,30,4,2,0,6,1,-15,3,1
2,4,29,0,30,5,9,0,14,6,30,12,0,0,12,0,30,5,9,0,14,0,30,1,13,0,14,3,30,9,0,0,9,1,-15,3,1
2,4,31,1,30,6,6,0,12,5,30,8,0,0,8,6,30,9,3,0,12,0,30,3,9,0,12,0,30,5,1,0,6,1,-15,3,1
2,3,32,0,30,5,4,0,9,4,30,2,0,0,2,2,30,9,0,0,9,1,30,3,6,0,9,2,30,2,0,0,2,1,-15,3,1
2,2,38,0,30,4,6,0,10,6,30,6,0,0,6,0,30,1,9,0,10,0,30,2,8,0,10,6,30,6,0,0,6,1,-15,3,1
2,2,4,5,30,8,0,0,8,4,30,4,0,0,4,0,30,6,2,0,8,0,30,4,4,0,8,1,30,4,0,0,4,0,-27,3,0
2,4,4,5,30,8,0,0,8,4,30,4,0,0,4,0,30,6,2,0,8,0,30,4,4,0,8,1,30,4,0,0,4,0,-27,3,0
2,0,5,0,30,5,0,0,5,3,30,3,1,0,4,1,30,0,5,0,5,0,30,1,4,0,5,0,30,0,2,0,2,0,-27,3,0
2,1,5,0,30,5,0,0,5,3,30,3,1,0,4,1,30,0,5,0,5,0,30,1,4,0,5,0,30,0,2,0,2,0,-27,3,0
2,3,5,0,30,5,0,0,5,3,30,3,1,0,4,1,30,0,5,0,5,0,30,1,4,0,5,0,30,0,2,0,2,0,-27,3,0
2,4,5,0,30,5,0,0,5,3,30,3,1,0,4,1,30,0,5,0,5,0,30,1,4,0,5,0,30,0,2,0,2,0,-27,3,0
2,4,11,3,30,6,6,0,12,1,30,4,0,0,4,0,30,5,7,0,12,5,30,3,9,0,12,4,30,4,0,0,4,1,-15,3,1
2,2,13,1,30,6,1,0,7,0,30,4,0,0,4,2,30,5,2,0,7,4,30,5,2,0,7,5,30,4,0,0,4,1,-15,3,1
2,4,13,1,30,6,1,0,7,0,30,4,0,0,4,2,30,5,2,0,7,4,30,5,2,0,7,5,30,4,0,0,4,1,-15,3,1
2,2,19,0,30,2,11,0,13,3,30,8,0,0,8,0,30,4,9,0,13,7,30,7,6,0,13,3,30,9,0,0,9,1,-15,3,1
2,3,27,1,30,3,12,0,15,4,30,2,0,0,2,0,30,6,9,0,15,0,30,4,11,0,15,5,30,5,1,0,6,1,-15,3,1
2,4,27,1,30,3,12,0,15,4,30,2,0,0,2,0,30,6,9,0,15,0,30,4,11,0,15,5,30,5,1,0,6,1,-15,3,1
2,1,5,0,30,2,3,0,5,3,30,3,1,0,4,3,30,1,4,0,5,0,30,1,4,0,5,0,30,2,0,0,2,0,-27,3,0
2,2,5,0,30,2,3,0,5,3,30,3,1,0,4,3,30,1,4,0,5,0,30,1,4,0,5,0,30,2,0,0,2,0,-27,3,0
2,4,5,0,30,2,3,0,5,3,30,3,1,0,4,3,30,1,4,0,5,0,30,1,4,0,5,0,30,2,0,0,2,0,-27,3,0
2,4,8,2,30,7,0,0,7,3,30,2,0,0,2,0,30,4,3,0,7,0,30,5,2,0,7,0,30,3,0,0,3,0,-27,3,0
2,1,13,1,30,5,2,0,7,0,30,4,0,0,4,2,30,7,0,0,7,4,30,7,0,0,7,5,30,4,0,0,4,1,-15,3,1
2,3,13,1,30,5,2,0,7,0,30,4,0,0,4,2,30,7,0,0,7,4,30,7,0,0,7,5,30,4,0,0,4,1,-15,3,1
2,4,13,1,30,5,2,0,7,0,30,4,0,0,4,2,30,7,0,0,7,4,30,7,0,0,7,5,30,4,0,0,4,1,-15,3,1
2,2,17,2,30,8,6,0,14,3,30,6,0,0,6,0,30,3,11,0,14,1,30,7,7,0,14,6,30,4,0,0,4,1,-15,3,1
2,2,19,0,30,5,8,0,13,1,30,4,4,0,8,0,30,4,9,0,13,9,30,5,8,0,13,3,30,9,0,0,9,1,-15,3,1
2,4,23,1,30,6,7,0,13,0,30,6,0,0,6,4,30,13,0,0,13,0,30,4,9,0,13,2,30,6,0,0,6,1,-15,3,1
2,1,27,5,30,5,10,0,15,2,30,1,1,0,2,0,30,7,8,0,15,0,30,3,12,0,15,4,30,6,0,0,6,1,-15,3,1
2,4,27,5,30,5,10,0,15,2,30,1,1,0,2,0,30,7,8,0,15,0,30,3,12,0,15,4,30,6,0,0,6,1,-15,3,1
2,2,31,4,30,5,7,0,12,7,30,8,0,0,8,0,30,4,8,0,12,0,30,8,4,0,12,4,30,6,0,0,6,1,-15,3,1
2,0,5,3,30,2,3,0,5,3,30,0,4,0,4,0,30,2,3,0,5,1,30,2,3,0,5,1,30,0,2,0,2,0,-27,3,0
2,1,5,3,30,2,3,0,5,3,30,0,4,0,4,0,30,2,3,0,5,1,30,2,3,0,5,1,30,0,2,0,2,0,-27,3,0
2,2,5,3,30,2,3,0,5,3,30,0,4,0,4,0,30,2,3,0,5,1,30,2,3,0,5,1,30,0,2,0,2,0,-27,3,0
2,3,5,3,30,2,3,0,5,3,30,0,4,0,4,0,30,2,3,0,5,1,30,2,3,0,5,1,30,0,2,0,2,0,-27,3,0
2,2,13,6,30,7,0,0,7,3,30,4,0,0,4,6,30,5,2,0,7,1,30,4,3,0,7,1,30,4,0,0,4,1,-15,3,1
2,3,23,1,30,7,6,0,13,2,30,6,0,0,6,3,30,12,1,0,13,1,30,6,7,0,13,4,30,6,0,0,6,1,-15,3,1
2,4,25,0,30,9,5,0,14,4,30,6,0,0,6,0,30,6,8,0,14,1,30,6,8,0,14,4,30,5,1,0,6,1,-15,3,1
2,2,27,1,30,4,11,0,15,3,30,2,0,0,2,0,30,5,10,0,15,2,30,3,12,0,15,2,30,6,0,0,6,1,-15,3,1
2,4,27,1,30,4,11,0,15,0,30,2,0,0,2,0,30,5,10,0,15,2,30,3,12,0,15,2,30,6,0,0,6,1,-15,3,1
2,4,32,0,30,7,2,0,9,4,30,2,0,0,2,1,30,8,1,0,9,1,30,2,7,0,9,3,30,2,0,0,2,1,-15,3,1
2,0,4,2,30,7,1,0,8,4,30,2,2,0,4,0,30,2,6,0,8,0,30,8,0,0,8,6,30,3,1,0,4,0,-27,3,0
2,4,8,2,30,7,0,0,7,4,30,2,0,0,2,3,30,5,2,0,7,0,30,6,1,0,7,0,30,2,1,0,3,0,-27,3,0
2,4,11,1,30,4,8,0,12,2,30,4,0,0,4,0,30,4,8,0,12,0,30,6,6,0,12,0,30,4,0,0,4,1,-15,3,1
2,4,15,0,30,6,7,0,13,0,30,5,1,0,6,0,30,4,9,0,13,1,30,5,8,0,13,2,30,7,2,0,9,1,-15,3,1
2,4,17,0,30,9,5,0,14,2,30,6,0,0,6,0,30,9,5,0,14,3,30,5,9,0,14,3,30,4,0,0,4,1,-15,3,1
2,1,27,1,30,6,9,0,15,2,30,2,0,0,2,0,30,12,3,0,15,0,30,4,11,0,15,1,30,4,2,0,6,1,-15,3,1
2,2,31,1,30,4,8,0,12,7,30,8,0,0,8,3,30,5,7,0,12,0,30,11,1,0,12,6,30,6,0,0,6,1,-15,3,1
2,4,6,0,30,5,4,0,9,4,30,2,0,0,2,0,30,2,7,0,9,0,30,4,5,0,9,0,30,5,0,0,5,0,-27,3,0
2,3,8,1,30,7,0,0,7,2,30,2,0,0,2,4,30,5,2,0,7,2,30,7,0,0,7,1,30,3,0,0,3,0,-27,3,0
2,4,8,1,30,7,0,0,7,2,30,2,0,0,2,4,30,5,2,0,7,2,30,7,0,0,7,1,30,3,0,0,3,0,-27,3,0
2,3,13,2,30,4,3,0,7,0,30,4,0,0,4,2,30,5,2,0,7,5,30,5,2,0,7,6,30,4,0,0,4,1,-15,3,1
2,4,13,2,30,4,3,0,7,0,30,4,0,0,4,2,30,5,2,0,7,5,30,5,2,0,7,6,30,4,0,0,4,1,-15,3,1
2,2,17,3,30,9,5,0,14,2,30,6,0,0,6,0,30,8,6,0,14,2,30,7,7,0,14,5,30,4,0,0,4,1,-15,3,1
2,4,17,3,30,9,5,0,14,2,30,6,0,0,6,0,30,8,6,0,14,2,30,7,7,0,14,5,30,4,0,0,4,1,-15,3,1
2,4,19,3,30,4,9,0,13,2,30,8,0,0,8,0,30,7,6,0,13,4,30,5,8,0,13,0,30,6,3,0,9,1,-15,3,1
2,2,23,2,30,7,6,0,13,2,30,6,0,0,6,3,30,12,1,0,13,0,30,8,5,0,13,2,30,6,0,0,6,1,-15,3,1
2,4,23,0,30,7,6,0,13,2,30,6,0,0,6,3,30,12,1,0,13,0,30,8,5,0,13,2,30,6,0,0,6,1,-15,3,1
2,3,25,0,30,7,7,0,14,5,30,6,0,0,6,0,30,3,11,0,14,1,30,8,6,0,14,3,30,6,0,0,6,1,-15,3,1
2,4,25,0,30,7,7,0,14,5,30,6,0,0,6,0,30,3,11,0,14,1,30,8,6,0,14,3,30,6,0,0,6,1,-15,3,1
2,0,27,1,30,5,10,0,15,3,30,2,0,0,2,0,30,9,6,0,15,0,30,4,11,0,15,1,30,5,1,0,6,1,-15,3,1
2,1,27,1,30,5,10,0,15,3,30,2,0,0,2,0,30,9,6,0,15,0,30,4,11,0,15,1,30,5,1,0,6,1,-15,3,1
2,2,29,1,30,5,9,0,14,6,30,12,0,0,12,0,30,3,11,0,14,0,30,1,13,0,14,1,30,9,0,0,9,1,-15,3,1
2,3,29,1,30,5,9,0,14,6,30,12,0,0,12,0,30,3,11,0,14,0,30,1,13,0,14,1,30,9,0,0,9,1,-15,3,1
2,4,29,1,30,5,9,0,14,6,30,12,0,0,12,0,30,3,11,0,14,0,30,1,13,0,14,1,30,9,0,0,9,1,-15,3,1
2,3,39,0,30,3,8,0,11,7,30,6,0,0,6,0,30,3,8,0,11,0,30,4,7,0,11,8,30,5,0,0,5,1,-15,3,1
2,3,43,0,30,5,9,0,14,8,30,6,0,0,6,0,30,4,10,0,14,1,30,1,13,0,14,3,30,5,0,0,5,1,-15,3,1
2,0,4,3,30,7,1,0,8,5,30,4,0,0,4,0,30,2,6,0,8,0,30,6,2,0,8,3,30,4,0,0,4,0,-27,3,0
2,1,4,3,30,7,1,0,8,5,30,4,0,0,4,0,30,2,6,0,8,0,30,6,2,0,8,3,30,4,0,0,4,0,-27,3,0
2,4,8,2,30,7,0,0,7,4,30,2,0,0,2,4,30,2,5,0,7,0,30,4,3,0,7,1,30,3,0,0,3,0,-27,3,0
2,2,10,0,30,3,6,0,9,1,30,2,2,0,4,1,30,2,7,0,9,4,30,2,7,0,9,3,30,4,1,0,5,1,-15,3,1
2,3,10,0,30,3,6,0,9,1,30,2,2,0,4,1,30,2,7,0,9,4,30,2,7,0,9,3,30,4,1,0,5,1,-15,3,1
2,4,10,0,30,3,6,0,9,1,30,2,2,0,4,1,30,2,7,0,9,4,30,2,7,0,9,3,30,4,1,0,5,1,-15,3,1
2,2,13,3,30,7,0,0,7,0,30,4,0,0,4,1,30,6,1,0,7,9,30,7,0,0,7,3,30,4,0,0,4,1,-15,3,1
2,3,15,1,30,5,8,0,13,1,30,6,0,0,6,0,30,3,10,0,13,1,30,4,9,0,13,1,30,6,3,0,9,1,-15,3,1
2,4,17,4,30,9,5,0,14,2,30,6,0,0,6,0,30,8,6,0,14,2,30,5,9,0,14,2,30,3,1,0,4,1,-15,3,1
2,2,19,0,30,3,10,0,13,1,30,7,1,0,8,0,30,9,4,0,13,2,30,6,7,0,13,3,30,7,2,0,9,1,-15,3,1
2,3,19,0,30,3,10,0,13,1,30,7,1,0,8,0,30,9,4,0,13,2,30,6,7,0,13,3,30,7,2,0,9,1,-15,3,1
2,4,25,1,30,5,9,0,14,3,30,6,0,0,6,0,30,12,2,0,14,1,30,4,10,0,14,0,30,5,1,0,6,1,-15,3,1
2,1,27,1,30,4,11,0,15,3,30,2,0,0,2,0,30,7,8,0,15,4,30,6,9,0,15,4,30,6,0,0,6,1,-15,3,1
2,3,27,1,30,4,11,0,15,2,30,2,0,0,2,0,30,7,8,0,15,4,30,6,9,0,15,4,30,6,0,0,6,1,-15,3,1
2,4,1,0,30,5,5,0,10,3,30,2,0,0,2,1,30,6,4,0,10,7,30,7,3,0,10,6,30,6,0,0,6,0,-27,3,0
2,4,3,0,30,0,4,0,4,2,30,4,0,0,4,2,30,1,3,0,4,1,30,2,2,0,4,0,30,2,1,0,3,0,-27,3,0
2,0,4,2,30,6,2,0,8,5,30,2,2,0,4,0,30,1,7,0,8,0,30,5,3,0,8,2,30,4,0,0,4,0,-27,3,0
2,4,4,2,30,6,2,0,8,5,30,2,2,0,4,0,30,1,7,0,8,0,30,5,3,0,8,0,30,4,0,0,4,0,-27,3,0
2,0,5,0,30,5,0,0,5,3,30,4,0,0,4,0,30,0,5,0,5,0,30,1,4,0,5,2,30,0,2,0,2,0,-27,3,0
2,1,5,0,30,5,0,0,5,3,30,4,0,0,4,0,30,0,5,0,5,0,30,1,4,0,5,2,30,0,2,0,2,0,-27,3,0
2,2,5,0,30,5,0,0,5,3,30,4,0,0,4,0,30,0,5,0,5,0,30,1,4,0,5,2,30,0,2,0,2,0,-27,3,0
2,3,5,0,30,5,0,0,5,3,30,4,0,0,4,0,30,0,5,0,5,0,30,1,4,0,5,2,30,0,2,0,2,0,-27,3,0
2,4,5,0,30,5,0,0,5,3,30,4,0,0,4,0,30,0,5,0,5,0,30,1,4,0,5,2,30,0,2,0,2,0,-27,3,0
2,3,6,0,30,6,3,0,9,4,30,2,0,0,2,0,30,2,7,0,9,0,30,4,5,0,9,3,30,5,0,0,5,0,-27,3,0
2,4,6,0,30,6,3,0,9,4,30,2,0,0,2,0,30,2,7,0,9,0,30,4,5,0,9,3,30,5,0,0,5,0,-27,3,0
2,3,19,0,30,2,11,0,13,2,30,8,0,0,8,0,30,4,9,0,13,2,30,8,5,0,13,0,30,6,3,0,9,1,-15,3,1
2,4,23,1,30,6,7,0,13,0,30,6,0,0,6,2,30,13,0,0,13,0,30,4,9,0,13,2,30,6,0,0,6,1,-15,3,1
2,0,26,0,30,9,0,0,9,4,30,4,0,0,4,2,30,2,7,0,9,3,30,2,7,0,9,5,30,2,1,0,3,1,-15,3,1
2,2,27,0,30,5,10,0,15,3,30,1,1,0,2,0,30,6,9,0,15,2,30,2,13,0,15,0,30,5,1,0,6,1,-15,3,1
2,3,35,0,30,7,6,0,13,3,30,2,0,0,2,1,30,6,7,0,13,2,30,3,10,0,13,3,30,8,0,0,8,1,-15,3,1
2,4,35,0,30,7,6,0,13,3,30,2,0,0,2,1,30,6,7,0,13,2,30,3,10,0,13,3,30,8,0,0,8,1,-15,3,1
2,2,7,1,30,4,0,0,4,2,30,2,0,0,2,0,30,1,3,0,4,0,30,1,3,0,4,0,30,2,0,0,2,0,-27,3,0
2,4,13,1,30,5,2,0,7,0,30,4,0,0,4,2,30,6,1,0,7,14,30,7,0,0,7,3,30,4,0,0,4,1,-15,3,1
2,4,15,1,30,4,9,0,13,1,30,6,0,0,6,0,30,4,9,0,13,1,30,8,5,0,13,2,30,6,3,0,9,1,-15,3,1
2,1,17,4,30,10,4,0,14,3,30,6,0,0,6,0,30,4,10,0,14,1,30,5,9,0,14,1,30,4,0,0,4,1,-15,3,1
2,2,19,0,30,3,10,0,13,1,30,8,0,0,8,0,30,9,4,0,13,5,30,4,9,0,13,2,30,7,2,0,9,1,-15,3,1
2,3,19,0,30,3,10,0,13,1,30,8,0,0,8,0,30,9,4,0,13,5,30,4,9,0,13,2,30,7,2,0,9,1,-15,3,1
2,4,19,0,30,3,10,0,13,1,30,8,0,0,8,0,30,9,4,0,13,5,30,4,9,0,13,2,30,7,2,0,9,1,-15,3,1
2,0,27,1,30,5,10,0,15,2,30,1,1,0,2,0,30,9,6,0,15,0,30,3,12,0,15,2,30,6,0,0,6,1,-15,3,1
2,2,35,0,30,7,6,0,13,5,30,2,0,0,2,4,30,5,8,0,13,1,30,2,11,0,13,4,30,8,0,0,8,1,-15,3,1
2,4,43,0,30,12,2,0,14,6,30,6,0,0,6,0,30,4,10,0,14,1,30,1,13,0,14,6,30,5,0,0,5,1,-15,3,1
2,2,47,0,30,1,13,0,14,5,30,4,0,0,4,0,30,7,7,0,14,0,30,2,12,0,14,6,30,7,0,0,7,1,-15,3,1
2,4,5,0,30,2,3,0,5,3,30,3,1,0,4,0,30,0,5,0,5,0,30,1,4,0,5,2,30,0,2,0,2,0,-27,3,0
2,4,11,0,30,5,7,0,12,1,30,4,0,0,4,0,30,6,6,0,12,3,30,5,7,0,12,0,30,4,0,0,4,1,-15,3,1
2,1,19,0,30,5,8,0,13,2,30,8,0,0,8,0,30,4,9,0,13,3,30,3,10,0,13,3,30,9,0,0,9,1,-15,3,1
2,0,27,2,30,5,10,0,15,5,30,2,0,0,2,0,30,2,13,0,15,0,30,7,8,0,15,4,30,6,0,0,6,1,-15,3,1
2,2,27,2,30,5,10,0,15,5,30,2,0,0,2,0,30,2,13,0,15,0,30,7,8,0,15,4,30,6,0,0,6,1,-15,3,1
2,3,27,2,30,5,10,0,15,5,30,2,0,0,2,0,30,2,13,0,15,0,30,7,8,0,15,4,30,6,0,0,6,1,-15,3,1
2,4,27,2,30,5,10,0,15,5,30,2,0,0,2,0,30,2,13,0,15,0,30,7,8,0,15,4,30,6,0,0,6,1,-15,3,1
2,3,29,0,30,7,7,0,14,6,30,10,2,0,12,0,30,2,12,0,14,0,30,6,8,0,14,0,30,7,2,0,9,1,-15,3,1
2,4,29,0,30,7,7,0,14,6,30,10,2,0,12,0,30,2,12,0,14,0,30,6,8,0,14,0,30,7,2,0,9,1,-15,3,1
2,4,31,2,30,7,5,0,12,3,30,8,0,0,8,4,30,10,2,0,12,0,30,3,9,0,12,0,30,2,4,0,6,1,-15,3,1
2,3,35,0,30,8,5,0,13,2,30,2,0,0,2,1,30,7,6,0,13,0,30,4,9,0,13,0,30,8,0,0,8,1,-15,3,1
2,3,7,0,30,3,6,0,9,2,30,4,0,0,4,0,30,8,1,0,9,6,30,3,6,0,9,3,30,5,1,0,6,0,-27,3,0
2,2,8,1,30,7,0,0,7,5,30,2,0,0,2,4,30,1,6,0,7,0,30,6,1,0,7,5,30,3,0,0,3,0,-27,3,0
2,4,8,1,30,7,0,0,7,5,30,2,0,0,2,4,30,1,6,0,7,0,30,6,1,0,7,5,30,3,0,0,3,0,-27,3,0
2,4,11,0,30,4,8,0,12,0,30,4,0,0,4,0,30,7,5,0,12,0,30,3,9,0,12,1,30,4,0,0,4,1,-15,3,1
2,4,25,0,30,4,10,0,14,5,30,6,0,0,6,0,30,8,6,0,14,1,30,5,9,0,14,3,30,5,1,0,6,1,-15,3,1
2,3,27,1,30,4,11,0,15,4,30,2,0,0,2,0,30,7,8,0,15,0,30,4,11,0,15,1,30,4,2,0,6,1,-15,3,1
2,3,31,1,30,5,7,0,12,7,30,8,0,0,8,3,30,4,8,0,12,0,30,7,5,0,12,5,30,6,0,0,6,1,-15,3,1
2,4,32,0,30,3,6,0,9,4,30,2,0,0,2,0,30,8,1,0,9,1,30,2,7,0,9,3,30,2,0,0,2,1,-15,3,1
2,2,33,1,30,6,5,0,11,6,30,4,0,0,4,0,30,6,5,0,11,0,30,6,5,0,11,4,30,4,0,0,4,1,-15,3,1
2,3,17,2,30,8,6,0,14,2,30,6,0,0,6,0,30,5,9,0,14,1,30,5,9,0,14,2,30,4,0,0,4,1,-15,3,1
2,4,17,2,30,8,6,0,14,2,30,6,0,0,6,0,30,5,9,0,14,1,30,5,9,0,14,2,30,4,0,0,4,1,-15,3,1
2,2,19,0,30,3,10,0,13,1,30,5,3,0,8,4,30,5,8,0,13,0,30,7,6,0,13,0,30,8,1,0,9,1,-15,3,1
2,2,27,2,30,4,11,0,15,3,30,2,0,0,2,0,30,4,11,0,15,3,30,7,8,0,15,0,30,6,0,0,6,1,-15,3,1
2,4,31,1,30,9,3,0,12,4,30,8,0,0,8,3,30,8,4,0,12,0,30,5,7,0,12,0,30,2,4,0,6,1,-15,3,1
2,2,4,2,30,8,0,0,8,4,30,4,0,0,4,0,30,2,6,0,8,0,30,3,5,0,8,0,30,4,0,0,4,0,-27,3,0
2,3,4,2,30,8,0,0,8,4,30,4,0,0,4,0,30,2,6,0,8,0,30,3,5,0,8,0,30,4,0,0,4,0,-27,3,0
2,3,7,0,30,1,3,0,4,2,30,2,0,0,2,2,30,2,2,0,4,0,30,1,3,0,4,1,30,1,1,0,2,0,-27,3,0
2,3,17,3,30,9,5,0,14,2,30,6,0,0,6,0,30,6,8,0,14,0,30,6,8,0,14,1,30,4,0,0,4,1,-15,3,1
2,3,19,0,30,3,10,0,13,2,30,5,3,0,8,0,30,4,9,0,13,4,30,4,9,0,13,0,30,8,1,0,9,1,-15,3,1
2,3,23,3,30,5,8,0,13,2,30,6,0,0,6,4,30,12,1,0,13,0,30,5,8,0,13,1,30,5,1,0,6,1,-15,3,1
2,3,27,0,30,10,5,0,15,0,30,2,0,0,2,0,30,9,6,0,15,1,30,3,12,0,15,2,30,6,0,0,6,1,-15,3,1
2,1,29,0,30,6,8,0,14,6,30,10,2,0,12,0,30,2,12,0,14,0,30,1,13,0,14,5,30,9,0,0,9,1,-15,3,1
2,2,35,1,30,8,5,0,13,3,30,1,1,0,2,1,30,6,7,0,13,2,30,3,10,0,13,6,30,8,0,0,8,1,-15,3,1
2,3,35,1,30,8,5,0,13,3,30,1,1,0,2,1,30,6,7,0,13,2,30,3,10,0,13,6,30,8,0,0,8,1,-15,3,1
2,2,38,0,30,1,9,0,10,7,30,6,0,0,6,0,30,1,9,0,10,0,30,5,5,0,10,9,30,6,0,0,6,1,-15,3,1
2,3,7,1,30,8,1,0,9,3,30,4,0,0,4,0,30,5,4,0,9,0,30,3,6,0,9,1,30,4,2,0,6,0,-27,3,0
2,2,13,2,30,7,0,0,7,1,30,4,0,0,4,2,30,6,1,0,7,2,30,6,1,0,7,5,30,4,0,0,4,1,-15,3,1
2,2,17,3,30,8,6,0,14,3,30,6,0,0,6,0,30,5,9,0,14,2,30,5,9,0,14,3,30,4,0,0,4,1,-15,3,1
2,4,17,3,30,8,6,0,14,3,30,6,0,0,6,0,30,5,9,0,14,2,30,5,9,0,14,3,30,4,0,0,4,1,-15,3,1
2,2,21,1,30,7,3,0,10,3,30,6,0,0,6,1,30,3,7,0,10,6,30,4,6,0,10,4,30,4,0,0,4,1,-15,3,1
2,3,21,1,30,7,3,0,10,3,30,6,0,0,6,1,30,3,7,0,10,6,30,4,6,0,10,4,30,4,0,0,4,1,-15,3,1
2,3,23,2,30,5,8,0,13,3,30,6,0,0,6,7,30,12,1,0,13,1,30,4,9,0,13,2,30,6,0,0,6,1,-15,3,1
2,4,23,2,30,5,8,0,13,3,30,6,0,0,6,7,30,12,1,0,13,1,30,4,9,0,13,2,30,6,0,0,6,1,-15,3,1
2,0,27,1,30,5,10,0,15,3,30,2,0,0,2,0,30,6,9,0,15,0,30,6,9,0,15,5,30,6,0,0,6,1,-15,3,1
2,2,27,1,30,5,10,0,15,3,30,2,0,0,2,0,30,6,9,0,15,0,30,6,9,0,15,5,30,6,0,0,6,1,-15,3,1
2,3,27,1,30,5,10,0,15,3,30,2,0,0,2,0,30,6,9,0,15,0,30,6,9,0,15,5,30,6,0,0,6,1,-15,3,1
2,4,27,1,30,5,10,0,15,3,30,2,0,0,2,0,30,6,9,0,15,0,30,6,9,0,15,5,30,6,0,0,6,1,-15,3,1
2,0,31,4,30,6,6,0,12,4,30,8,0,0,8,3,30,12,0,0,12,0,30,3,9,0,12,0,30,4,2,0,6,1,-15,3,1
2,3,35,0,30,6,7,0,13,4,30,2,0,0,2,1,30,7,6,0,13,4,30,6,7,0,13,0,30,8,0,0,8,1,-15,3,1
2,1,41,0,30,6,6,0,12,6,30,8,0,0,8,0,30,8,4,0,12,1,30,2,10,0,12,4,30,7,0,0,7,1,-15,3,1
2,2,11,2,30,5,7,0,12,0,30,4,0,0,4,0,30,9,3,0,12,3,30,7,5,0,12,5,30,4,0,0,4,1,-15,3,1
2,4,13,0,30,6,1,0,7,0,30,4,0,0,4,1,30,6,1,0,7,14,30,4,3,0,7,4,30,4,0,0,4,1,-15,3,1
2,2,17,4,30,10,4,0,14,3,30,6,0,0,6,0,30,4,10,0,14,1,30,6,8,0,14,6,30,4,0,0,4,1,-15,3,1
2,3,17,4,30,10,4,0,14,3,30,6,0,0,6,0,30,4,10,0,14,1,30,6,8,0,14,6,30,4,0,0,4,1,-15,3,1
2,4,23,2,30,6,7,0,13,3,30,6,0,0,6,9,30,11,2,0,13,0,30,5,8,0,13,2,30,5,1,0,6,1,-15,3,1
2,0,27,1,30,3,12,0,15,5,30,2,0,0,2,0,30,2,13,0,15,2,30,3,12,0,15,6,30,6,0,0,6,1,-15,3,1
2,0,41,0,30,7,5,0,12,8,30,8,0,0,8,0,30,3,9,0,12,1,30,4,8,0,12,4,30,6,1,0,7,1,-15,3,1
2,2,41,0,30,7,5,0,12,8,30,8,0,0,8,0,30,3,9,0,12,1,30,4,8,0,12,4,30,6,1,0,7,1,-15,3,1
2,3,41,0,30,7,5,0,12,8,30,8,0,0,8,0,30,3,9,0,12,1,30,4,8,0,12,4,30,6,1,0,7,1,-15,3,1
2,2,5,0,30,2,3,0,5,3,30,1,3,0,4,2,30,0,5,0,5,1,30,1,4,0,5,0,30,0,2,0,2,0,-27,3,0
2,4,5,0,30,2,3,0,5,3,30,1,3,0,4,2,30,0,5,0,5,1,30,1,4,0,5,0,30,0,2,0,2,0,-27,3,0
2,2,13,3,30,7,0,0,7,2,30,4,0,0,4,0,30,6,1,0,7,5,30,6,1,0,7,3,30,4,0,0,4,1,-15,3,1
2,4,13,3,30,7,0,0,7,2,30,4,0,0,4,0,30,6,1,0,7,5,30,6,1,0,7,3,30,4,0,0,4,1,-15,3,1
2,2,19,0,30,4,9,0,13,0,30,5,3,0,8,0,30,9,4,0,13,9,30,5,8,0,13,3,30,8,1,0,9,1,-15,3,1
2,1,25,1,30,3,11,0,14,1,30,6,0,0,6,4,30,14,0,0,14,1,30,5,9,0,14,3,30,5,1,0,6,1,-15,3,1
2,0,31,4,30,6,6,0,12,7,30,8,0,0,8,3,30,4,8,0,12,1,30,8,4,0,12,4,30,6,0,0,6,1,-15,3,1
2,1,4,3,30,7,1,0,8,4,30,3,1,0,4,0,30,2,6,0,8,0,30,4,4,0,8,2,30,4,0,0,4,0,-27,3,0
2,2,4,3,30,7,1,0,8,4,30,3,1,0,4,0,30,2,6,0,8,0,30,4,4,0,8,2,30,4,0,0,4,0,-27,3,0
2,4,6,1,30,8,1,0,9,4,30,2,0,0,2,0,30,2,7,0,9,1,30,4,5,0,9,0,30,2,3,0,5,0,-27,3,0
2,2,13,4,30,7,0,0,7,0,30,4,0,0,4,2,30,6,1,0,7,13,30,5,2,0,7,5,30,4,0,0,4,1,-15,3,1
2,4,13,4,30,7,0,0,7,0,30,4,0,0,4,2,30,6,1,0,7,13,30,5,2,0,7,5,30,4,0,0,4,1,-15,3,1
2,1,17,4,30,9,5,0,14,3,30,6,0,0,6,0,30,7,7,0,14,2,30,7,7,0,14,3,30,4,0,0,4,1,-15,3,1
2,2,17,4,30,9,5,0,14,3,30,6,0,0,6,0,30,7,7,0,14,2,30,7,7,0,14,3,30,4,0,0,4,1,-15,3,1
2,3,17,4,30,9,5,0,14,3,30,6,0,0,6,0,30,7,7,0,14,2,30,7,7,0,14,3,30,4,0,0,4,1,-15,3,1
2,4,17,4,30,9,5,0,14,3,30,6,0,0,6,0,30,7,7,0,14,2,30,7,7,0,14,3,30,4,0,0,4,1,-15,3,1
2,3,19,0,30,4,9,0,13,2,30,8,0,0,8,0,30,4,9,0,13,3,30,4,9,0,13,4,30,6,3,0,9,1,-15,3,1
2,0,21,2,30,6,4,0,10,4,30,4,2,0,6,1,30,3,7,0,10,3,30,6,4,0,10,1,30,4,0,0,4,1,-15,3,1
2,3,21,2,30,6,4,0,10,4,30,4,2,0,6,1,30,3,7,0,10,3,30,6,4,0,10,1,30,4,0,0,4,1,-15,3,1
2,2,23,1,30,5,8,0,13,3,30,6,0,0,6,6,30,13,0,0,13,1,30,6,7,0,13,2,30,6,0,0,6,1,-15,3,1
2,4,23,1,30,5,8,0,13,3,30,6,0,0,6,6,30,13,0,0,13,1,30,6,7,0,13,2,30,6,0,0,6,1,-15,3,1
2,2,25,1,30,7,7,0,14,4,30,6,0,0,6,0,30,6,8,0,14,2,30,6,8,0,14,4,30,6,0,0,6,1,-15,3,1
2,3,25,1,30,7,7,0,14,4,30,6,0,0,6,0,30,6,8,0,14,2,30,6,8,0,14,4,30,6,0,0,6,1,-15,3,1
2,4,25,1,30,7,7,0,14,4,30,6,0,0,6,0,30,6,8,0,14,2,30,6,8,0,14,4,30,6,0,0,6,1,-15,3,1
2,0,27,1,30,5,10,0,15,2,30,2,0,0,2,0,30,5,10,0,15,3,30,4,11,0,15,4,30,6,0,0,6,1,-15,3,1
2,2,27,1,30,5,10,0,15,2,30,2,0,0,2,0,30,5,10,0,15,3,30,4,11,0,15,4,30,6,0,0,6,1,-15,3,1
2,3,27,1,30,5,10,0,15,2,30,2,0,0,2,0,30,5,10,0,15,3,30,4,11,0,15,4,30,6,0,0,6,1,-15,3,1
2,4,27,1,30,5,10,0,15,2,30,2,0,0,2,0,30,5,10,0,15,3,30,4,11,0,15,4,30,6,0,0,6,1,-15,3,1
2,2,29,0,30,6,8,0,14,6,30,12,0,0,12,0,30,5,9,0,14,0,30,1,13,0,14,2,30,9,0,0,9,1,-15,3,1
2,3,29,0,30,6,8,0,14,6,30,12,0,0,12,0,30,5,9,0,14,0,30,1,13,0,14,2,30,9,0,0,9,1,-15,3,1
2,4,31,3,30,9,3,0,12,4,30,8,0,0,8,6,30,9,3,0,12,0,30,3,9,0,12,0,30,2,4,0,6,1,-15,3,1
2,2,35,4,30,6,7,0,13,4,30,2,0,0,2,1,30,12,1,0,13,0,30,1,12,0,13,3,30,8,0,0,8,1,-15,3,1
2,3,35,4,30,6,7,0,13,4,30,2,0,0,2,1,30,12,1,0,13,0,30,1,12,0,13,3,30,8,0,0,8,1,-15,3,1
2,3,3,0,30,0,4,0,4,2,30,4,0,0,4,0,30,3,1,0,4,3,30,1,3,0,4,0,30,2,1,0,3,0,-27,3,0
2,1,4,2,30,7,1,0,8,4,30,4,0,0,4,0,30,2,6,0,8,0,30,4,4,0,8,3,30,4,0,0,4,0,-27,3,0
2,2,5,3,30,1,4,0,5,3,30,4,0,0,4,0,30,2,3,0,5,0,30,1,4,0,5,1,30,1,1,0,2,0,-27,3,0
2,4,5,3,30,1,4,0,5,3,30,4,0,0,4,0,30,2,3,0,5,0,30,1,4,0,5,1,30,1,1,0,2,0,-27,3,0
2,2,13,2,30,7,0,0,7,0,30,4,0,0,4,4,30,7,0,0,7,6,30,6,1,0,7,2,30,4,0,0,4,1,-15,3,1
2,3,17,3,30,9,5,0,14,1,30,6,0,0,6,0,30,9,5,0,14,1,30,5,9,0,14,4,30,4,0,0,4,1,-15,3,1
2,4,17,3,30,9,5,0,14,1,30,6,0,0,6,0,30,9,5,0,14,1,30,5,9,0,14,4,30,4,0,0,4,1,-15,3,1
2,3,27,1,30,5,10,0,15,4,30,2,0,0,2,0,30,2,13,0,15,0,30,4,11,0,15,4,30,6,0,0,6,1,-15,3,1
2,2,29,0,30,9,5,0,14,5,30,12,0,0,12,0,30,3,11,0,14,0,30,1,13,0,14,1,30,9,0,0,9,1,-15,3,1
2,3,11,0,30,4,8,0,12,1,30,4,0,0,4,0,30,3,9,0,12,3,30,4,8,0,12,2,30,4,0,0,4,1,-15,3,1
2,4,11,0,30,4,8,0,12,1,30,4,0,0,4,0,30,3,9,0,12,3,30,4,8,0,12,2,30,4,0,0,4,1,-15,3,1
2,4,15,0,30,4,9,0,13,0,30,6,0,0,6,0,30,4,9,0,13,0,30,7,6,0,13,2,30,5,4,0,9,1,-15,3,1
2,2,25,1,30,4,10,0,14,4,30,6,0,0,6,0,30,6,8,0,14,1,30,8,6,0,14,3,30,6,0,0,6,1,-15,3,1
2,3,25,1,30,4,10,0,14,4,30,6,0,0,6,0,30,6,8,0,14,1,30,8,6,0,14,3,30,6,0,0,6,1,-15,3,1
2,3,27,2,30,4,11,0,15,4,30,1,1,0,2,0,30,2,13,0,15,0,30,6,9,0,15,1,30,6,0,0,6,1,-15,3,1
2,4,27,2,30,4,11,0,15,4,30,1,1,0,2,0,30,2,13,0,15,0,30,6,9,0,15,1,30,6,0,0,6,1,-15,3,1
2,1,11,1,30,6,6,0,12,2,30,4,0,0,4,5,30,5,7,0,12,0,30,7,5,0,12,1,30,4,0,0,4,1,-15,3,1
2,4,11,1,30,6,6,0,12,2,30,4,0,0,4,5,30,5,7,0,12,0,30,7,5,0,12,1,30,4,0,0,4,1,-15,3,1
2,3,15,0,30,6,7,0,13,1,30,5,1,0,6,0,30,3,10,0,13,2,30,5,8,0,13,4,30,9,0,0,9,1,-15,3,1
2,0,25,2,30,3,11,0,14,3,30,6,0,0,6,0,30,9,5,0,14,1,30,7,7,0,14,6,30,6,0,0,6,1,-15,3,1
2,2,25,2,30,3,11,0,14,3,30,6,0,0,6,0,30,9,5,0,14,1,30,7,7,0,14,2,30,6,0,0,6,1,-15,3,1
2,1,27,0,30,7,8,0,15,4,30,2,0,0,2,0,30,2,13,0,15,0,30,8,7,0,15,2,30,6,0,0,6,1,-15,3,1
2,2,27,0,30,7,8,0,15,4,30,2,0,0,2,0,30,2,13,0,15,0,30,8,7,0,15,2,30,6,0,0,6,1,-15,3,1
2,3,27,0,30,7,8,0,15,4,30,2,0,0,2,0,30,2,13,0,15,0,30,8,7,0,15,2,30,6,0,0,6,1,-15,3,1
2,4,27,0,30,7,8,0,15,4,30,2,0,0,2,0,30,2,13,0,15,0,30,8,7,0,15,2,30,6,0,0,6,1,-15,3,1
2,1,29,0,30,12,2,0,14,5,30,12,0,0,12,0,30,4,10,0,14,0,30,1,13,0,14,0,30,7,2,0,9,1,-15,3,1
2,1,33,1,30,2,9,0,11,4,30,4,0,0,4,2,30,11,0,0,11,2,30,3,8,0,11,7,30,4,0,0,4,1,-15,3,1
2,3,33,1,30,2,9,0,11,4,30,4,0,0,4,2,30,11,0,0,11,2,30,3,8,0,11,7,30,4,0,0,4,1,-15,3,1
2,0,4,2,30,6,2,0,8,5,30,4,0,0,4,0,30,1,7,0,8,3,30,8,0,0,8,1,30,3,1,0,4,0,-27,3,0
2,3,4,0,30,6,2,0,8,5,30,4,0,0,4,0,30,1,7,0,8,3,30,8,0,0,8,1,30,3,1,0,4,0,-27,3,0
2,4,8,4,30,7,0,0,7,4,30,2,0,0,2,0,30,3,4,0,7,0,30,3,4,0,7,0,30,2,1,0,3,0,-27,3,0
2,0,19,3,30,9,4,0,13,2,30,5,3,0,8,0,30,4,9,0,13,4,30,7,6,0,13,0,30,8,1,0,9,1,-15,3,1
2,1,19,3,30,9,4,0,13,2,30,5,3,0,8,0,30,4,9,0,13,4,30,7,6,0,13,0,30,8,1,0,9,1,-15,3,1
2,2,19,3,30,9,4,0,13,2,30,5,3,0,8,0,30,4,9,0,13,4,30,7,6,0,13,0,30,8,1,0,9,1,-15,3,1
2,3,19,3,30,9,4,0,13,2,30,5,3,0,8,0,30,4,9,0,13,4,30,7,6,0,13,0,30,8,1,0,9,1,-15,3,1
2,3,23,1,30,7,6,0,13,1,30,6,0,0,6,2,30,13,0,0,13,0,30,5,8,0,13,3,30,6,0,0,6,1,-15,3,1
2,1,27,1,30,4,11,0,15,5,30,2,0,0,2,0,30,5,10,0,15,0,30,5,10,0,15,5,30,6,0,0,6,1,-15,3,1
2,2,27,1,30,4,11,0,15,5,30,2,0,0,2,0,30,5,10,0,15,0,30,5,10,0,15,5,30,6,0,0,6,1,-15,3,1
2,3,27,1,30,4,11,0,15,5,30,2,0,0,2,0,30,5,10,0,15,0,30,5,10,0,15,5,30,6,0,0,6,1,-15,3,1
2,4,27,1,30,4,11,0,15,5,30,2,0,0,2,0,30,5,10,0,15,0,30,5,10,0,15,5,30,6,0,0,6,1,-15,3,1
2,2,29,0,30,5,9,0,14,6,30,10,2,0,12,0,30,3,11,0,14,0,30,3,11,0,14,4,30,9,0,0,9,1,-15,3,1
2,3,29,0,30,5,9,0,14,6,30,10,2,0,12,0,30,3,11,0,14,0,30,3,11,0,14,4,30,9,0,0,9,1,-15,3,1
2,4,29,0,30,5,9,0,14,6,30,10,2,0,12,0,30,3,11,0,14,0,30,3,11,0,14,4,30,9,0,0,9,1,-15,3,1
2,4,31,5,30,7,5,0,12,5,30,8,0,0,8,3,30,10,2,0,12,0,30,7,5,0,12,0,30,4,2,0,6,1,-15,3,1
2,1,5,0,30,2,3,0,5,2,30,3,1,0,4,1,30,2,3,0,5,0,30,1,4,0,5,0,30,0,2,0,2,0,-27,3,0
2,2,13,2,30,7,0,0,7,0,30,4,0,0,4,2,30,5,2,0,7,9,30,6,1,0,7,1,30,4,0,0,4,1,-15,3,1
2,1,17,3,30,7,7,0,14,2,30,6,0,0,6,0,30,7,7,0,14,2,30,6,8,0,14,5,30,2,2,0,4,1,-15,3,1
2,2,17,3,30,7,7,0,14,2,30,6,0,0,6,0,30,7,7,0,14,2,30,6,8,0,14,5,30,2,2,0,4,1,-15,3,1
2,3,17,3,30,7,7,0,14,2,30,6,0,0,6,0,30,7,7,0,14,2,30,6,8,0,14,5,30,2,2,0,4,1,-15,3,1
2,4,17,3,30,7,7,0,14,2,30,6,0,0,6,0,30,7,7,0,14,2,30,6,8,0,14,5,30,2,2,0,4,1,-15,3,1
2,4,19,0,30,2,11,0,13,3,30,8,0,0,8,0,30,4,9,0,13,6,30,5,8,0,13,1,30,8,1,0,9,1,-15,3,1
2,3,25,1,30,2,12,0,14,5,30,6,0,0,6,0,30,10,4,0,14,1,30,4,10,0,14,1,30,6,0,0,6,1,-15,3,1
2,4,27,1,30,4,11,0,15,4,30,2,0,0,2,0,30,3,12,0,15,2,30,4,11,0,15,4,30,6,0,0,6,1,-15,3,1
2,3,35,0,30,6,7,0,13,5,30,2,0,0,2,1,30,5,8,0,13,1,30,4,9,0,13,6,30,8,0,0,8,1,-15,3,1
2,4,39,0,30,6,5,0,11,7,30,6,0,0,6,0,30,4,7,0,11,1,30,3,8,0,11,4,30,5,0,0,5,1,-15,3,1
2,4,45,1,30,12,1,0,13,8,30,10,0,0,10,0,30,6,7,0,13,0,30,4,9,0,13,6,30,5,0,0,5,1,-15,3,1
2,0,5,0,30,2,3,0,5,3,30,3,1,0,4,0,30,0,5,0,5,0,30,3,2,0,5,0,30,0,2,0,2,0,-27,3,0
2,3,5,0,30,2,3,0,5,3,30,3,1,0,4,0,30,0,5,0,5,0,30,3,2,0,5,0,30,0,2,0,2,0,-27,3,0
2,3,8,6,30,7,0,0,7,3,30,2,0,0,2,3,30,6,1,0,7,0,30,4,3,0,7,0,30,3,0,0,3,0,-27,3,0
2,2,13,1,30,3,0,0,3,1,30,2,0,0,2,0,30,3,0,0,3,7,30,2,1,0,3,3,30,2,0,0,2,1,-15,3,1
2,2,13,4,30,6,1,0,7,0,30,4,0,0,4,2,30,6,1,0,7,11,30,6,1,0,7,3,30,4,0,0,4,1,-15,3,1
2,4,15,1,30,4,9,0,13,1,30,6,0,0,6,0,30,4,9,0,13,1,30,3,10,0,13,2,30,7,2,0,9,1,-15,3,1
2,3,23,3,30,5,8,0,13,2,30,6,0,0,6,5,30,13,0,0,13,0,30,5,8,0,13,2,30,6,0,0,6,1,-15,3,1
2,2,27,1,30,6,9,0,15,3,30,2,0,0,2,0,30,6,9,0,15,0,30,6,9,0,15,4,30,6,0,0,6,1,-15,3,1
2,3,27,1,30,6,9,0,15,3,30,2,0,0,2,0,30,6,9,0,15,0,30,6,9,0,15,4,30,6,0,0,6,1,-15,3,1
2,4,27,1,30,6,9,0,15,3,30,2,0,0,2,0,30,6,9,0,15,0,30,6,9,0,15,4,30,6,0,0,6,1,-15,3,1
2,3,33,1,30,4,7,0,11,4,30,4,0,0,4,0,30,11,0,0,11,0,30,6,5,0,11,7,30,4,0,0,4,1,-15,3,1
2,2,39,0,30,4,7,0,11,5,30,6,0,0,6,0,30,6,5,0,11,2,30,2,9,0,11,5,30,5,0,0,5,1,-15,3,1
2,3,39,0,30,4,7,0,11,5,30,6,0,0,6,0,30,6,5,0,11,2,30,2,9,0,11,5,30,5,0,0,5,1,-15,3,1
2,4,39,0,30,4,7,0,11,5,30,6,0,0,6,0,30,6,5,0,11,2,30,2,9,0,11,5,30,5,0,0,5,1,-15,3,1
2,3,4,0,30,8,0,0,8,4,30,4,0,0,4,0,30,4,4,0,8,0,30,5,3,0,8,4,30,4,0,0,4,0,-27,3,0
2,0,5,1,30,2,3,0,5,3,30,2,2,0,4,0,30,0,5,0,5,0,30,1,4,0,5,1,30,2,0,0,2,0,-27,3,0
2,4,5,1,30,2,3,0,5,3,30,2,2,0,4,0,30,0,5,0,5,0,30,1,4,0,5,1,30,2,0,0,2,0,-27,3,0
2,4,7,0,30,1,3,0,4,2,30,2,0,0,2,1,30,1,3,0,4,0,30,1,3,0,4,3,30,1,1,0,2,0,-27,3,0
2,2,13,1,30,6,1,0,7,1,30,4,0,0,4,1,30,6,1,0,7,5,30,7,0,0,7,4,30,4,0,0,4,1,-15,3,1
2,4,13,0,30,6,1,0,7,1,30,4,0,0,4,1,30,6,1,0,7,5,30,7,0,0,7,4,30,4,0,0,4,1,-15,3,1
2,3,17,3,30,8,6,0,14,3,30,6,0,0,6,0,30,6,8,0,14,1,30,7,7,0,14,3,30,4,0,0,4,1,-15,3,1
2,3,23,2,30,6,7,0,13,1,30,6,0,0,6,2,30,11,2,0,13,0,30,6,7,0,13,2,30,5,1,0,6,1,-15,3,1
2,4,27,1,30,3,12,0,15,3,30,2,0,0,2,0,30,3,12,0,15,0,30,3,12,0,15,0,30,6,0,0,6,1,-15,3,1
2,3,31,1,30,7,5,0,12,4,30,8,0,0,8,0,30,4,8,0,12,0,30,3,9,0,12,2,30,6,0,0,6,1,-15,3,1
2,3,35,6,30,8,5,0,13,3,30,2,0,0,2,1,30,7,6,0,13,3,30,2,11,0,13,2,30,7,1,0,8,1,-15,3,1
2,0,39,0,30,2,9,0,11,7,30,6,0,0,6,5,30,4,7,0,11,1,30,3,8,0,11,7,30,5,0,0,5,1,-15,3,1
2,3,4,10,30,8,0,0,8,4,30,4,0,0,4,1,30,1,7,0,8,0,30,0,8,0,8,4,30,3,1,0,4,0,-27,3,0
2,4,11,1,30,6,6,0,12,2,30,4,0,0,4,0,30,3,9,0,12,2,30,6,6,0,12,5,30,4,0,0,4,1,-15,3,1
2,3,17,6,30,11,3,0,14,4,30,6,0,0,6,0,30,3,11,0,14,2,30,5,9,0,14,3,30,4,0,0,4,1,-15,3,1
2,3,23,1,30,5,8,0,13,1,30,6,0,0,6,7,30,12,1,0,13,0,30,7,6,0,13,4,30,6,0,0,6,1,-15,3,1
2,0,25,1,30,5,9,0,14,5,30,6,0,0,6,0,30,6,8,0,14,2,30,6,8,0,14,5,30,6,0,0,6,1,-15,3,1
2,1,25,1,30,5,9,0,14,5,30,6,0,0,6,0,30,6,8,0,14,2,30,6,8,0,14,5,30,6,0,0,6,1,-15,3,1
2,3,39,0,30,5,6,0,11,6,30,6,0,0,6,0,30,7,4,0,11,0,30,4,7,0,11,3,30,5,0,0,5,1,-15,3,1
2,0,4,4,30,7,1,0,8,5,30,4,0,0,4,0,30,1,7,0,8,0,30,4,4,0,8,1,30,3,1,0,4,0,-27,3,0
2,1,4,4,30,7,1,0,8,5,30,4,0,0,4,0,30,1,7,0,8,0,30,4,4,0,8,1,30,3,1,0,4,0,-27,3,0
2,2,4,4,30,7,1,0,8,5,30,4,0,0,4,0,30,1,7,0,8,0,30,4,4,0,8,1,30,3,1,0,4,0,-27,3,0
2,3,4,4,30,7,1,0,8,5,30,4,0,0,4,0,30,1,7,0,8,0,30,4,4,0,8,1,30,3,1,0,4,0,-27,3,0
2,3,8,1,30,7,0,0,7,3,30,2,0,0,2,0,30,5,2,0,7,0,30,6,1,0,7,1,30,3,0,0,3,0,-27,3,0
2,1,13,4,30,7,0,0,7,1,30,4,0,0,4,2,30,6,1,0,7,10,30,6,1,0,7,1,30,4,0,0,4,1,-15,3,1
2,2,13,4,30,7,0,0,7,1,30,4,0,0,4,2,30,6,1,0,7,10,30,6,1,0,7,1,30,4,0,0,4,1,-15,3,1
2,4,13,4,30,7,0,0,7,1,30,4,0,0,4,2,30,6,1,0,7,10,30,6,1,0,7,1,30,4,0,0,4,1,-15,3,1
2,1,17,3,30,11,3,0,14,3,30,6,0,0,6,0,30,4,10,0,14,1,30,6,8,0,14,3,30,4,0,0,4,1,-15,3,1
2,2,17,3,30,11,3,0,14,3,30,6,0,0,6,0,30,4,10,0,14,1,30,6,8,0,14,3,30,4,0,0,4,1,-15,3,1
2,3,17,3,30,11,3,0,14,3,30,6,0,0,6,0,30,4,10,0,14,1,30,6,8,0,14,3,30,4,0,0,4,1,-15,3,1
2,3,26,0,30,7,2,0,9,5,30,4,0,0,4,3,30,2,7,0,9,0,30,4,5,0,9,7,30,3,0,0,3,1,-15,3,1
2,1,27,2,30,4,11,0,15,3,30,1,1,0,2,0,30,6,9,0,15,3,30,5,10,0,15,5,30,6,0,0,6,1,-15,3,1
2,3,13,13,30,7,0,0,7,2,30,4,0,0,4,1,30,6,1,0,7,2,30,3,4,0,7,0,30,4,0,0,4,1,-15,3,1
2,2,17,1,30,7,7,0,14,2,30,6,0,0,6,0,30,7,7,0,14,1,30,8,6,0,14,4,30,4,0,0,4,1,-15,3,1
2,3,17,1,30,7,7,0,14,2,30,6,0,0,6,0,30,7,7,0,14,1,30,8,6,0,14,4,30,4,0,0,4,1,-15,3,1
2,4,17,1,30,7,7,0,14,2,30,6,0,0,6,0,30,7,7,0,14,1,30,8,6,0,14,4,30,4,0,0,4,1,-15,3,1
2,2,19,0,30,4,9,0,13,2,30,5,3,0,8,0,30,4,9,0,13,6,30,5,8,0,13,3,30,9,0,0,9,1,-15,3,1
2,3,23,1,30,5,8,0,13,2,30,6,0,0,6,9,30,13,0,0,13,0,30,7,6,0,13,2,30,6,0,0,6,1,-15,3,1
2,3,25,1,30,7,7,0,14,3,30,6,0,0,6,0,30,8,6,0,14,1,30,5,9,0,14,4,30,5,1,0,6,1,-15,3,1
2,4,25,1,30,7,7,0,14,3,30,6,0,0,6,0,30,8,6,0,14,1,30,5,9,0,14,4,30,5,1,0,6,1,-15,3,1
2,0,27,1,30,4,11,0,15,3,30,1,1,0,2,0,30,6,9,0,15,2,30,4,11,0,15,5,30,6,0,0,6,1,-15,3,1
2,1,27,1,30,4,11,0,15,3,30,1,1,0,2,0,30,6,9,0,15,2,30,4,11,0,15,5,30,6,0,0,6,1,-15,3,1
2,3,27,1,30,4,11,0,15,3,30,1,1,0,2,0,30,6,9,0,15,2,30,4,11,0,15,5,30,6,0,0,6,1,-15,3,1
2,1,29,0,30,5,9,0,14,6,30,11,1,0,12,0,30,7,7,0,14,0,30,0,14,0,14,4,30,9,0,0,9,1,-15,3,1
2,2,29,0,30,5,9,0,14,6,30,11,1,0,12,0,30,7,7,0,14,0,30,0,14,0,14,4,30,9,0,0,9,1,-15,3,1
2,3,29,0,30,5,9,0,14,6,30,11,1,0,12,0,30,7,7,0,14,0,30,0,14,0,14,4,30,9,0,0,9,1,-15,3,1
2,4,3,0,30,1,3,0,4,3,30,4,0,0,4,0,30,0,4,0,4,5,30,1,3,0,4,0,30,1,2,0,3,0,-27,3,0
2,2,5,0,30,2,3,0,5,3,30,2,2,0,4,0,30,1,4,0,5,0,30,1,4,0,5,0,30,1,1,0,2,0,-27,3,0
2,3,5,0,30,2,3,0,5,3,30,2,2,0,4,0,30,1,4,0,5,0,30,1,4,0,5,0,30,1,1,0,2,0,-27,3,0
2,4,8,3,30,7,0,0,7,4,30,2,0,0,2,0,30,1,6,0,7,0,30,7,0,0,7,2,30,3,0,0,3,0,-27,3,0
2,2,13,1,30,6,1,0,7,0,30,4,0,0,4,2,30,5,2,0,7,4,30,7,0,0,7,3,30,4,0,0,4,1,-15,3,1
2,2,17,4,30,12,2,0,14,2,30,6,0,0,6,0,30,6,8,0,14,1,30,5,9,0,14,4,30,4,0,0,4,1,-15,3,1
2,4,17,4,30,12,2,0,14,2,30,6,0,0,6,0,30,6,8,0,14,1,30,5,9,0,14,4,30,4,0,0,4,1,-15,3,1
2,0,19,0,30,2,11,0,13,2,30,7,1,0,8,0,30,5,8,0,13,8,30,4,9,0,13,2,30,6,3,0,9,1,-15,3,1
2,2,19,0,30,2,11,0,13,2,30,7,1,0,8,0,30,5,8,0,13,8,30,4,9,0,13,2,30,6,3,0,9,1,-15,3,1
2,0,25,1,30,3,11,0,14,6,30,6,0,0,6,0,30,5,9,0,14,7,30,7,7,0,14,6,30,6,0,0,6,1,-15,3,1
2,2,25,1,30,3,11,0,14,4,30,6,0,0,6,0,30,5,9,0,14,7,30,7,7,0,14,6,30,6,0,0,6,1,-15,3,1
2,0,27,2,30,6,9,0,15,2,30,2,0,0,2,0,30,3,12,0,15,4,30,4,11,0,15,4,30,6,0,0,6,1,-15,3,1
2,1,27,2,30,6,9,0,15,2,30,2,0,0,2,0,30,3,12,0,15,4,30,4,11,0,15,4,30,6,0,0,6,1,-15,3,1
2,2,27,2,30,6,9,0,15,2,30,2,0,0,2,0,30,3,12,0,15,4,30,4,11,0,15,4,30,6,0,0,6,1,-15,3,1
2,3,29,2,30,6,8,0,14,6,30,12,0,0,12,0,30,3,11,0,14,0,30,1,13,0,14,0,30,9,0,0,9,1,-15,3,1
2,4,29,2,30,6,8,0,14,6,30,12,0,0,12,0,30,3,11,0,14,0,30,1,13,0,14,0,30,9,0,0,9,1,-15,3,1
2,0,4,2,30,8,0,0,8,4,30,2,2,0,4,5,30,5,3,0,8,0,30,5,3,0,8,1,30,3,1,0,4,0,-27,3,0
2,4,5,0,30,2,3,0,5,3,30,2,2,0,4,0,30,1,4,0,5,0,30,2,3,0,5,1,30,0,2,0,2,0,-27,3,0
2,1,9,0,30,3,1,0,4,3,30,2,0,0,2,1,30,0,4,0,4,5,30,1,3,0,4,1,30,1,0,0,1,0,-27,3,0
2,2,9,0,30,3,1,0,4,3,30,2,0,0,2,1,30,0,4,0,4,5,30,1,3,0,4,1,30,1,0,0,1,0,-27,3,0
2,1,13,1,30,6,1,0,7,1,30,4,0,0,4,2,30,5,2,0,7,13,30,6,1,0,7,3,30,4,0,0,4,1,-15,3,1
2,2,17,4,30,10,4,0,14,3,30,6,0,0,6,0,30,5,9,0,14,0,30,5,9,0,14,1,30,4,0,0,4,1,-15,3,1
2,4,17,4,30,10,4,0,14,3,30,6,0,0,6,0,30,5,9,0,14,0,30,5,9,0,14,1,30,4,0,0,4,1,-15,3,1
2,3,19,0,30,4,9,0,13,1,30,7,1,0,8,0,30,7,6,0,13,0,30,6,7,0,13,1,30,8,1,0,9,1,-15,3,1
2,4,22,1,30,7,1,0,8,4,30,2,0,0,2,4,30,4,4,0,8,1,30,0,8,0,8,3,30,3,1,0,4,1,-15,3,1
2,3,23,1,30,5,8,0,13,2,30,6,0,0,6,3,30,13,0,0,13,0,30,5,8,0,13,3,30,6,0,0,6,1,-15,3,1
2,1,27,1,30,8,7,0,15,2,30,1,1,0,2,0,30,5,10,0,15,0,30,4,11,0,15,4,30,6,0,0,6,1,-15,3,1
2,2,32,0,30,8,1,0,9,4,30,2,0,0,2,1,30,8,1,0,9,1,30,2,7,0,9,4,30,2,0,0,2,1,-15,3,1
2,2,35,2,30,6,7,0,13,3,30,2,0,0,2,5,30,13,0,0,13,0,30,1,12,0,13,1,30,8,0,0,8,1,-15,3,1
2,4,35,2,30,6,7,0,13,3,30,2,0,0,2,5,30,13,0,0,13,0,30,1,12,0,13,1,30,8,0,0,8,1,-15,3,1
2,3,36,0,30,7,2,0,9,4,30,2,0,0,2,2,30,9,0,0,9,1,30,1,8,0,9,5,30,3,0,0,3,1,-15,3,1
2,3,7,0,30,1,3,0,4,2,30,2,0,0,2,3,30,1,3,0,4,0,30,1,3,0,4,1,30,1,1,0,2,0,-27,3,0
2,1,13,2,30,7,0,0,7,0,30,4,0,0,4,1,30,7,0,0,7,9,30,5,2,0,7,5,30,4,0,0,4,1,-15,3,1
2,2,13,2,30,7,0,0,7,0,30,4,0,0,4,1,30,7,0,0,7,9,30,5,2,0,7,5,30,4,0,0,4,1,-15,3,1
2,4,13,2,30,7,0,0,7,0,30,4,0,0,4,1,30,7,0,0,7,9,30,5,2,0,7,5,30,4,0,0,4,1,-15,3,1
2,2,17,2,30,10,4,0,14,2,30,6,0,0,6,0,30,5,9,0,14,2,30,5,9,0,14,7,30,4,0,0,4,1,-15,3,1
2,4,27,1,30,7,8,0,15,4,30,2,0,0,2,0,30,6,9,0,15,0,30,6,9,0,15,1,30,5,1,0,6,1,-15,3,1
2,3,3,0,30,0,4,0,4,3,30,4,0,0,4,1,30,0,4,0,4,5,30,4,0,0,4,0,30,3,0,0,3,0,-27,3,0
2,4,3,0,30,0,4,0,4,3,30,4,0,0,4,1,30,0,4,0,4,5,30,4,0,0,4,0,30,3,0,0,3,0,-27,3,0
2,2,4,0,30,7,1,0,8,4,30,4,0,0,4,0,30,1,7,0,8,0,30,4,4,0,8,6,30,4,0,0,4,0,-27,3,0
2,0,5,0,30,1,4,0,5,3,30,2,2,0,4,0,30,0,5,0,5,0,30,1,4,0,5,2,30,2,0,0,2,0,-27,3,0
2,2,5,0,30,1,4,0,5,3,30,2,2,0,4,0,30,0,5,0,5,0,30,1,4,0,5,2,30,2,0,0,2,0,-27,3,0
2,3,5,0,30,1,4,0,5,3,30,2,2,0,4,0,30,0,5,0,5,0,30,1,4,0,5,2,30,2,0,0,2,0,-27,3,0
2,2,12,3,30,5,2,0,7,3,30,4,2,0,6,0,30,2,5,0,7,5,30,7,0,0,7,3,30,3,0,0,3,1,-15,3,1
2,3,12,3,30,5,2,0,7,3,30,4,2,0,6,0,30,2,5,0,7,5,30,7,0,0,7,3,30,3,0,0,3,1,-15,3,1
2,4,12,3,30,5,2,0,7,3,30,4,2,0,6,0,30,2,5,0,7,5,30,7,0,0,7,3,30,3,0,0,3,1,-15,3,1
2,0,19,0,30,3,10,0,13,2,30,5,3,0,8,0,30,4,9,0,13,8,30,5,8,0,13,1,30,9,0,0,9,1,-15,3,1
2,1,19,0,30,3,10,0,13,2,30,5,3,0,8,0,30,4,9,0,13,8,30,5,8,0,13,1,30,9,0,0,9,1,-15,3,1
2,4,22,4,30,7,1,0,8,2,30,2,0,0,2,0,30,4,4,0,8,0,30,3,5,0,8,1,30,1,3,0,4,1,-15,3,1
2,1,25,1,30,5,9,0,14,0,30,6,0,0,6,0,30,14,0,0,14,1,30,4,10,0,14,3,30,5,1,0,6,1,-15,3,1
2,3,25,1,30,5,9,0,14,0,30,6,0,0,6,0,30,14,0,0,14,1,30,4,10,0,14,3,30,5,1,0,6,1,-15,3,1
2,2,31,2,30,6,6,0,12,7,30,8,0,0,8,3,30,4,8,0,12,0,30,8,4,0,12,2,30,6,0,0,6,1,-15,3,1
2,3,31,2,30,6,6,0,12,7,30,8,0,0,8,3,30,4,8,0,12,0,30,8,4,0,12,2,30,6,0,0,6,1,-15,3,1
2,4,31,2,30,6,6,0,12,7,30,8,0,0,8,3,30,4,8,0,12,0,30,8,4,0,12,2,30,6,0,0,6,1,-15,3,1
2,1,13,3,30,6,1,0,7,0,30,4,0,0,4,2,30,6,1,0,7,8,30,5,2,0,7,2,30,4,0,0,4,1,-15,3,1
2,4,13,3,30,6,1,0,7,0,30,4,0,0,4,2,30,6,1,0,7,8,30,5,2,0,7,2,30,4,0,0,4,1,-15,3,1
2,4,19,0,30,3,10,0,13,2,30,2,6,0,8,0,30,4,9,0,13,2,30,9,4,0,13,3,30,9,0,0,9,1,-15,3,1
2,3,21,3,30,8,2,0,10,4,30,5,1,0,6,0,30,2,8,0,10,6,30,5,5,0,10,4,30,4,0,0,4,1,-15,3,1
2,4,21,3,30,8,2,0,10,4,30,5,1,0,6,0,30,2,8,0,10,6,30,5,5,0,10,4,30,4,0,0,4,1,-15,3,1
2,2,25,4,30,9,5,0,14,5,30,6,0,0,6,0,30,3,11,0,14,1,30,7,7,0,14,3,30,5,1,0,6,1,-15,3,1
2,4,25,4,30,9,5,0,14,5,30,6,0,0,6,0,30,3,11,0,14,0,30,7,7,0,14,3,30,5,1,0,6,1,-15,3,1
2,1,26,2,30,9,0,0,9,5,30,4,0,0,4,2,30,0,9,0,9,0,30,1,8,0,9,5,30,3,0,0,3,1,-15,3,1
2,2,26,2,30,9,0,0,9,5,30,4,0,0,4,2,30,0,9,0,9,0,30,1,8,0,9,5,30,3,0,0,3,1,-15,3,1
2,3,26,2,30,9,0,0,9,5,30,4,0,0,4,2,30,0,9,0,9,0,30,1,8,0,9,5,30,3,0,0,3,1,-15,3,1
2,0,27,1,30,5,10,0,15,3,30,1,1,0,2,0,30,6,9,0,15,0,30,6,9,0,15,1,30,6,0,0,6,1,-15,3,1
2,4,27,1,30,5,10,0,15,3,30,1,1,0,2,0,30,6,9,0,15,0,30,6,9,0,15,1,30,6,0,0,6,1,-15,3,1
2,1,33,1,30,2,9,0,11,6,30,4,0,0,4,0,30,7,4,0,11,0,30,6,5,0,11,6,30,4,0,0,4,1,-15,3,1
2,2,33,1,30,2,9,0,11,6,30,4,0,0,4,0,30,7,4,0,11,0,30,6,5,0,11,6,30,4,0,0,4,1,-15,3,1
2,3,38,0,30,3,7,0,10,7,30,6,0,0,6,0,30,1,9,0,10,0,30,3,7,0,10,8,30,6,0,0,6,1,-15,3,1
2,4,43,0,30,5,9,0,14,8,30,6,0,0,6,0,30,4,10,0,14,1,30,1,13,0,14,0,30,5,0,0,5,1,-15,3,1
2,2,8,1,30,7,0,0,7,5,30,2,0,0,2,0,30,1,6,0,7,1,30,7,0,0,7,5,30,3,0,0,3,0,-27,3,0
2,3,23,2,30,5,8,0,13,0,30,6,0,0,6,3,30,13,0,0,13,0,30,5,8,0,13,2,30,6,0,0,6,1,-15,3,1
2,0,27,1,30,5,10,0,15,4,30,1,1,0,2,0,30,3,12,0,15,4,30,4,11,0,15,4,30,6,0,0,6,1,-15,3,1
2,1,27,1,30,5,10,0,15,4,30,1,1,0,2,0,30,3,12,0,15,4,30,4,11,0,15,4,30,6,0,0,6,1,-15,3,1
2,2,27,1,30,5,10,0,15,4,30,1,1,0,2,0,30,3,12,0,15,4,30,4,11,0,15,4,30,6,0,0,6,1,-15,3,1
2,4,27,1,30,5,10,0,15,4,30,1,1,0,2,0,30,3,12,0,15,4,30,4,11,0,15,4,30,6,0,0,6,1,-15,3,1
2,3,29,0,30,5,9,0,14,4,30,12,0,0,12,0,30,5,9,0,14,0,30,0,14,0,14,2,30,9,0,0,9,1,-15,3,1
2,3,31,2,30,9,3,0,12,4,30,8,0,0,8,0,30,9,3,0,12,0,30,3,9,0,12,1,30,3,3,0,6,1,-15,3,1
2,3,32,0,30,5,4,0,9,4,30,2,0,0,2,0,30,9,0,0,9,1,30,3,6,0,9,3,30,2,0,0,2,1,-15,3,1
2,4,32,0,30,5,4,0,9,4,30,2,0,0,2,0,30,9,0,0,9,1,30,3,6,0,9,3,30,2,0,0,2,1,-15,3,1
2,3,39,0,30,1,10,0,11,6,30,6,0,0,6,0,30,8,3,0,11,2,30,4,7,0,11,5,30,5,0,0,5,1,-15,3,1
2,2,13,2,30,7,0,0,7,0,30,4,0,0,4,4,30,7,0,0,7,4,30,6,1,0,7,4,30,4,0,0,4,1,-15,3,1
2,4,13,2,30,7,0,0,7,0,30,4,0,0,4,4,30,7,0,0,7,4,30,6,1,0,7,4,30,4,0,0,4,1,-15,3,1
2,2,15,1,30,4,9,0,13,1,30,5,1,0,6,0,30,3,10,0,13,1,30,7,6,0,13,3,30,9,0,0,9,1,-15,3,1
2,4,15,1,30,4,9,0,13,1,30,5,1,0,6,0,30,3,10,0,13,1,30,7,6,0,13,3,30,9,0,0,9,1,-15,3,1
2,1,17,1,30,9,5,0,14,2,30,6,0,0,6,0,30,6,8,0,14,4,30,5,9,0,14,3,30,4,0,0,4,1,-15,3,1
2,2,19,0,30,2,11,0,13,2,30,4,4,0,8,0,30,6,7,0,13,3,30,7,6,0,13,0,30,8,1,0,9,1,-15,3,1
2,3,19,0,30,2,11,0,13,2,30,4,4,0,8,0,30,6,7,0,13,3,30,7,6,0,13,0,30,8,1,0,9,1,-15,3,1
2,4,22,2,30,8,0,0,8,3,30,2,0,0,2,4,30,5,3,0,8,0,30,5,3,0,8,1,30,1,3,0,4,1,-15,3,1
2,3,23,3,30,5,8,0,13,4,30,6,0,0,6,5,30,10,3,0,13,0,30,6,7,0,13,1,30,6,0,0,6,1,-15,3,1
2,4,23,3,30,5,8,0,13,4,30,6,0,0,6,5,30,10,3,0,13,0,30,6,7,0,13,1,30,6,0,0,6,1,-15,3,1
2,2,8,3,30,7,0,0,7,3,30,2,0,0,2,3,30,7,0,0,7,1,30,7,0,0,7,0,30,3,0,0,3,0,-27,3,0
2,4,8,3,30,7,0,0,7,3,30,2,0,0,2,3,30,7,0,0,7,1,30,7,0,0,7,0,30,3,0,0,3,0,-27,3,0
2,3,13,0,30,6,1,0,7,1,30,4,0,0,4,4,30,6,1,0,7,3,30,7,0,0,7,1,30,4,0,0,4,1,-15,3,1
2,3,19,1,30,4,9,0,13,2,30,6,2,0,8,0,30,5,8,0,13,0,30,6,7,0,13,0,30,7,2,0,9,1,-15,3,1
2,0,27,1,30,4,11,0,15,3,30,1,1,0,2,0,30,9,6,0,15,4,30,4,11,0,15,4,30,4,2,0,6,1,-15,3,1
2,2,27,1,30,4,11,0,15,3,30,1,1,0,2,0,30,9,6,0,15,4,30,4,11,0,15,4,30,4,2,0,6,1,-15,3,1
2,2,31,1,30,5,7,0,12,6,30,8,0,0,8,3,30,4,8,0,12,0,30,7,5,0,12,5,30,6,0,0,6,1,-15,3,1
2,1,4,2,30,6,2,0,8,5,30,4,0,0,4,4,30,1,7,0,8,0,30,5,3,0,8,0,30,3,1,0,4,0,-27,3,0
2,2,4,2,30,6,2,0,8,5,30,4,0,0,4,4,30,1,7,0,8,0,30,5,3,0,8,0,30,3,1,0,4,0,-27,3,0
2,4,4,2,30,6,2,0,8,5,30,4,0,0,4,4,30,1,7,0,8,0,30,5,3,0,8,0,30,3,1,0,4,0,-27,3,0
2,3,17,4,30,8,6,0,14,1,30,6,0,0,6,3,30,13,1,0,14,1,30,3,11,0,14,5,30,4,0,0,4,1,-15,3,1
2,1,21,3,30,5,5,0,10,3,30,5,1,0,6,0,30,2,8,0,10,5,30,3,7,0,10,6,30,4,0,0,4,1,-15,3,1
2,2,21,3,30,5,5,0,10,3,30,5,1,0,6,0,30,2,8,0,10,5,30,3,7,0,10,6,30,4,0,0,4,1,-15,3,1
2,2,23,2,30,6,7,0,13,4,30,6,0,0,6,6,30,10,3,0,13,0,30,4,9,0,13,5,30,6,0,0,6,1,-15,3,1
2,3,27,4,30,5,10,0,15,5,30,2,0,0,2,0,30,7,8,0,15,0,30,3,12,0,15,2,30,6,0,0,6,1,-15,3,1
2,4,13,3,30,5,2,0,7,1,30,4,0,0,4,2,30,5,2,0,7,10,30,4,3,0,7,3,30,4,0,0,4,1,-15,3,1
2,0,17,3,30,8,6,0,14,3,30,6,0,0,6,0,30,3,11,0,14,2,30,4,10,0,14,6,30,4,0,0,4,1,-15,3,1
2,1,17,3,30,8,6,0,14,3,30,6,0,0,6,0,30,3,11,0,14,2,30,4,10,0,14,6,30,4,0,0,4,1,-15,3,1
2,4,17,3,30,8,6,0,14,3,30,6,0,0,6,0,30,3,11,0,14,2,30,4,10,0,14,6,30,4,0,0,4,1,-15,3,1
2,1,25,2,30,4,10,0,14,2,30,6,0,0,6,0,30,14,0,0,14,1,30,4,10,0,14,4,30,5,1,0,6,1,-15,3,1
2,0,27,1,30,2,13,0,15,4,30,2,0,0,2,0,30,3,12,0,15,4,30,5,10,0,15,7,30,6,0,0,6,1,-15,3,1
2,4,31,0,30,12,0,0,12,3,30,8,0,0,8,4,30,10,2,0,12,0,30,3,9,0,12,0,30,1,5,0,6,1,-15,3,1
2,3,4,2,30,7,1,0,8,4,30,4,0,0,4,1,30,2,6,0,8,0,30,4,4,0,8,1,30,3,1,0,4,0,-27,3,0
2,2,5,0,30,1,4,0,5,2,30,3,1,0,4,0,30,1,4,0,5,0,30,1,4,0,5,1,30,0,2,0,2,0,-27,3,0
2,3,5,0,30,1,4,0,5,2,30,3,1,0,4,0,30,1,4,0,5,0,30,1,4,0,5,1,30,0,2,0,2,0,-27,3,0
2,3,6,0,30,7,2,0,9,4,30,2,0,0,2,0,30,3,6,0,9,0,30,3,6,0,9,2,30,5,0,0,5,0,-27,3,0
2,4,6,0,30,7,2,0,9,4,30,2,0,0,2,0,30,3,6,0,9,0,30,3,6,0,9,2,30,5,0,0,5,0,-27,3,0
2,3,15,0,30,5,8,0,13,1,30,6,0,0,6,0,30,3,10,0,13,1,30,5,8,0,13,4,30,9,0,0,9,1,-15,3,1
2,4,15,0,30,5,8,0,13,1,30,6,0,0,6,0,30,3,10,0,13,1,30,5,8,0,13,4,30,9,0,0,9,1,-15,3,1
2,2,17,3,30,6,8,0,14,2,30,6,0,0,6,0,30,6,8,0,14,5,30,5,9,0,14,5,30,4,0,0,4,1,-15,3,1
2,4,17,3,30,6,8,0,14,2,30,6,0,0,6,0,30,6,8,0,14,5,30,5,9,0,14,5,30,4,0,0,4,1,-15,3,1
2,3,27,0,30,3,12,0,15,2,30,1,1,0,2,0,30,8,7,0,15,0,30,3,12,0,15,0,30,6,0,0,6,1,-15,3,1
2,0,29,0,30,5,9,0,14,6,30,10,2,0,12,1,30,3,11,0,14,0,30,0,14,0,14,3,30,9,0,0,9,1,-15,3,1
2,2,6,1,30,8,1,0,9,3,30,2,0,0,2,0,30,4,5,0,9,0,30,4,5,0,9,0,30,2,3,0,5,0,-27,3,0
2,1,13,2,30,7,0,0,7,0,30,4,0,0,4,2,30,6,1,0,7,10,30,6,1,0,7,4,30,4,0,0,4,1,-15,3,1
2,2,13,2,30,7,0,0,7,0,30,4,0,0,4,2,30,6,1,0,7,10,30,6,1,0,7,4,30,4,0,0,4,1,-15,3,1
2,4,13,2,30,7,0,0,7,0,30,4,0,0,4,2,30,6,1,0,7,10,30,6,1,0,7,4,30,4,0,0,4,1,-15,3,1
2,0,19,1,30,6,7,0,13,2,30,6,2,0,8,4,30,7,6,0,13,1,30,4,9,0,13,2,30,7,2,0,9,1,-15,3,1
2,1,19,1,30,6,7,0,13,2,30,6,2,0,8,4,30,7,6,0,13,1,30,4,9,0,13,2,30,7,2,0,9,1,-15,3,1
2,3,19,1,30,6,7,0,13,2,30,6,2,0,8,4,30,7,6,0,13,1,30,4,9,0,13,2,30,7,2,0,9,1,-15,3,1
2,4,19,1,30,6,7,0,13,2,30,6,2,0,8,4,30,7,6,0,13,1,30,4,9,0,13,2,30,7,2,0,9,1,-15,3,1
2,0,27,1,30,3,12,0,15,5,30,2,0,0,2,0,30,6,9,0,15,0,30,6,9,0,15,2,30,6,0,0,6,1,-15,3,1
2,1,27,1,30,3,12,0,15,5,30,2,0,0,2,0,30,6,9,0,15,0,30,6,9,0,15,2,30,6,0,0,6,1,-15,3,1
2,2,27,1,30,3,12,0,15,5,30,2,0,0,2,0,30,6,9,0,15,0,30,6,9,0,15,2,30,6,0,0,6,1,-15,3,1
2,4,27,1,30,3,12,0,15,5,30,2,0,0,2,0,30,6,9,0,15,0,30,6,9,0,15,2,30,6,0,0,6,1,-15,3,1
2,3,1,0,30,7,3,0,10,4,30,2,0,0,2,1,30,4,6,0,10,6,30,7,3,0,10,6,30,6,0,0,6,0,-27,3,0
2,1,4,4,30,8,0,0,8,5,30,4,0,0,4,0,30,1,7,0,8,1,30,7,1,0,8,2,30,4,0,0,4,0,-27,3,0
2,1,13,4,30,7,0,0,7,2,30,4,0,0,4,2,30,6,1,0,7,5,30,5,2,0,7,5,30,4,0,0,4,1,-15,3,1
2,4,15,0,30,4,9,0,13,0,30,6,0,0,6,0,30,3,10,0,13,1,30,5,8,0,13,2,30,6,3,0,9,1,-15,3,1
2,4,17,3,30,9,5,0,14,3,30,6,0,0,6,0,30,5,9,0,14,2,30,8,6,0,14,0,30,3,1,0,4,1,-15,3,1
2,3,19,1,30,5,8,0,13,2,30,3,5,0,8,0,30,9,4,0,13,0,30,4,9,0,13,2,30,8,1,0,9,1,-15,3,1
2,4,19,1,30,5,8,0,13,2,30,3,5,0,8,0,30,9,4,0,13,0,30,4,9,0,13,2,30,8,1,0,9,1,-15,3,1
2,3,23,1,30,3,10,0,13,3,30,6,0,0,6,0,30,11,2,0,13,5,30,10,3,0,13,7,30,6,0,0,6,1,-15,3,1
2,2,43,0,30,8,6,0,14,7,30,6,0,0,6,0,30,4,10,0,14,1,30,7,7,0,14,10,30,5,0,0,5,1,-15,3,1
2,3,43,0,30,8,6,0,14,7,30,6,0,0,6,0,30,4,10,0,14,1,30,7,7,0,14,10,30,5,0,0,5,1,-15,3,1
2,0,4,2,30,6,2,0,8,5,30,4,0,0,4,1,30,2,6,0,8,0,30,6,2,0,8,2,30,4,0,0,4,0,-27,3,0
2,4,4,0,30,6,2,0,8,5,30,4,0,0,4,1,30,2,6,0,8,0,30,6,2,0,8,2,30,4,0,0,4,0,-27,3,0
2,4,7,0,30,5,4,0,9,2,30,4,0,0,4,0,30,6,3,0,9,4,30,2,7,0,9,1,30,4,2,0,6,0,-27,3,0
2,4,11,0,30,4,8,0,12,0,30,4,0,0,4,0,30,8,4,0,12,0,30,6,6,0,12,0,30,4,0,0,4,1,-15,3,1
2,1,17,2,30,9,5,0,14,3,30,6,0,0,6,0,30,4,10,0,14,1,30,5,9,0,14,1,30,4,0,0,4,1,-15,3,1
2,2,17,2,30,9,5,0,14,3,30,6,0,0,6,0,30,4,10,0,14,1,30,5,9,0,14,1,30,4,0,0,4,1,-15,3,1
2,0,21,1,30,6,4,0,10,3,30,5,1,0,6,1,30,3,7,0,10,3,30,3,7,0,10,5,30,4,0,0,4,1,-15,3,1
2,2,21,1,30,6,4,0,10,3,30,5,1,0,6,1,30,3,7,0,10,3,30,3,7,0,10,5,30,4,0,0,4,1,-15,3,1
2,3,21,1,30,6,4,0,10,3,30,5,1,0,6,1,30,3,7,0,10,3,30,3,7,0,10,5,30,4,0,0,4,1,-15,3,1
2,4,21,1,30,6,4,0,10,3,30,5,1,0,6,1,30,3,7,0,10,3,30,3,7,0,10,5,30,4,0,0,4,1,-15,3,1
2,3,23,2,30,5,8,0,13,4,30,6,0,0,6,3,30,10,3,0,13,0,30,5,8,0,13,5,30,6,0,0,6,1,-15,3,1
2,4,27,0,30,4,11,0,15,4,30,2,0,0,2,0,30,5,10,0,15,4,30,6,9,0,15,3,30,5,1,0,6,1,-15,3,1
2,3,29,0,30,9,5,0,14,4,30,12,0,0,12,0,30,6,8,0,14,0,30,1,13,0,14,0,30,7,2,0,9,1,-15,3,1
2,4,31,3,30,6,6,0,12,4,30,7,1,0,8,3,30,12,0,0,12,0,30,3,9,0,12,1,30,3,3,0,6,1,-15,3,1
2,2,11,1,30,4,8,0,12,0,30,3,1,0,4,0,30,8,4,0,12,8,30,7,5,0,12,5,30,4,0,0,4,1,-15,3,1
2,2,13,3,30,5,2,0,7,0,30,4,0,0,4,3,30,7,0,0,7,8,30,6,1,0,7,4,30,4,0,0,4,1,-15,3,1
2,4,23,3,30,5,8,0,13,3,30,6,0,0,6,0,30,13,0,0,13,1,30,6,7,0,13,5,30,6,0,0,6,1,-15,3,1
2,1,25,1,30,5,9,0,14,3,30,6,0,0,6,0,30,6,8,0,14,1,30,9,5,0,14,7,30,6,0,0,6,1,-15,3,1
2,2,25,1,30,5,9,0,14,3,30,6,0,0,6,0,30,6,8,0,14,1,30,9,5,0,14,7,30,6,0,0,6,1,-15,3,1
2,2,27,2,30,6,9,0,15,4,30,2,0,0,2,0,30,2,13,0,15,0,30,6,9,0,15,0,30,6,0,0,6,1,-15,3,1
2,1,31,8,30,6,6,0,12,6,30,8,0,0,8,3,30,7,5,0,12,0,30,3,9,0,12,0,30,3,3,0,6,1,-15,3,1
2,2,31,8,30,6,6,0,12,6,30,8,0,0,8,3,30,7,5,0,12,0,30,3,9,0,12,0,30,3,3,0,6,1,-15,3,1
2,1,33,0,30,4,7,0,11,5,30,4,0,0,4,5,30,10,1,0,11,0,30,3,8,0,11,7,30,4,0,0,4,1,-15,3,1
2,2,33,0,30,4,7,0,11,5,30,4,0,0,4,5,30,10,1,0,11,0,30,3,8,0,11,7,30,4,0,0,4,1,-15,3,1
2,3,33,0,30,4,7,0,11,5,30,4,0,0,4,5,30,10,1,0,11,0,30,3,8,0,11,7,30,4,0,0,4,1,-15,3,1
2,4,39,0,30,3,8,0,11,6,30,6,0,0,6,0,30,4,7,0,11,2,30,2,9,0,11,5,30,5,0,0,5,1,-15,3,1
2,3,47,0,30,1,13,0,14,9,30,4,0,0,4,0,30,3,11,0,14,0,30,9,5,0,14,8,30,7,0,0,7,1,-15,3,1
2,4,5,0,30,1,4,0,5,2,30,3,1,0,4,0,30,1,4,0,5,0,30,2,3,0,5,2,30,2,0,0,2,0,-27,3,0
2,1,7,0,30,1,3,0,4,2,30,2,0,0,2,0,30,1,3,0,4,0,30,1,3,0,4,2,30,2,0,0,2,0,-27,3,0
2,2,19,1,30,5,8,0,13,2,30,3,5,0,8,0,30,4,9,0,13,6,30,6,7,0,13,3,30,9,0,0,9,1,-15,3,1
2,4,19,1,30,5,8,0,13,2,30,3,5,0,8,0,30,4,9,0,13,6,30,6,7,0,13,3,30,9,0,0,9,1,-15,3,1
2,3,21,3,30,9,1,0,10,4,30,6,0,0,6,1,30,3,7,0,10,2,30,4,6,0,10,0,30,4,0,0,4,1,-15,3,1
2,2,27,1,30,4,11,0,15,3,30,1,1,0,2,0,30,4,11,0,15,2,30,6,9,0,15,0,30,4,2,0,6,1,-15,3,1
2,3,27,1,30,4,11,0,15,3,30,1,1,0,2,0,30,4,11,0,15,2,30,6,9,0,15,0,30,4,2,0,6,1,-15,3,1
2,4,29,4,30,9,5,0,14,7,30,8,4,0,12,0,30,3,11,0,14,1,30,0,14,0,14,0,30,8,1,0,9,1,-15,3,1
2,2,45,0,30,3,10,0,13,8,30,10,0,0,10,0,30,5,8,0,13,0,30,4,9,0,13,7,30,5,0,0,5,1,-15,3,1
2,3,45,0,30,3,10,0,13,8,30,10,0,0,10,0,30,5,8,0,13,0,30,4,9,0,13,7,30,5,0,0,5,1,-15,3,1
2,0,4,2,30,7,1,0,8,5,30,4,0,0,4,0,30,2,6,0,8,0,30,8,0,0,8,1,30,3,1,0,4,0,-27,3,0
2,1,4,2,30,7,1,0,8,5,30,4,0,0,4,0,30,2,6,0,8,0,30,8,0,0,8,1,30,3,1,0,4,0,-27,3,0
2,4,8,2,30,7,0,0,7,4,30,2,0,0,2,6,30,5,2,0,7,0,30,5,2,0,7,1,30,3,0,0,3,0,-27,3,0
2,4,13,4,30,7,0,0,7,0,30,4,0,0,4,2,30,5,2,0,7,7,30,7,0,0,7,6,30,4,0,0,4,1,-15,3,1
2,2,19,0,30,3,10,0,13,2,30,8,0,0,8,0,30,4,9,0,13,0,30,9,4,0,13,1,30,7,2,0,9,1,-15,3,1
2,4,19,0,30,3,10,0,13,2,30,8,0,0,8,0,30,4,9,0,13,0,30,9,4,0,13,1,30,7,2,0,9,1,-15,3,1
2,1,25,1,30,7,7,0,14,1,30,6,0,0,6,0,30,10,4,0,14,1,30,5,9,0,14,5,30,5,1,0,6,1,-15,3,1
2,3,37,1,30,4,7,0,11,5,30,8,0,0,8,4,30,11,0,0,11,2,30,3,8,0,11,6,30,6,0,0,6,1,-15,3,1
2,4,6,0,30,8,1,0,9,3,30,2,0,0,2,0,30,4,5,0,9,0,30,3,6,0,9,1,30,3,2,0,5,0,-27,3,0
2,1,13,1,30,6,1,0,7,0,30,4,0,0,4,2,30,6,1,0,7,7,30,6,1,0,7,5,30,4,0,0,4,1,-15,3,1
2,4,17,4,30,10,4,0,14,3,30,6,0,0,6,0,30,6,8,0,14,2,30,4,10,0,14,2,30,4,0,0,4,1,-15,3,1
2,4,22,1,30,5,3,0,8,2,30,2,0,0,2,0,30,5,3,0,8,1,30,4,4,0,8,2,30,3,1,0,4,1,-15,3,1
2,3,26,1,30,6,3,0,9,6,30,0,4,0,4,1,30,0,9,0,9,0,30,6,3,0,9,2,30,2,1,0,3,1,-15,3,1
2,1,33,4,30,8,3,0,11,5,30,4,0,0,4,0,30,6,5,0,11,0,30,3,8,0,11,5,30,4,0,0,4,1,-15,3,1
2,2,33,4,30,8,3,0,11,5,30,4,0,0,4,0,30,6,5,0,11,0,30,3,8,0,11,5,30,4,0,0,4,1,-15,3,1
2,4,33,4,30,8,3,0,11,5,30,4,0,0,4,0,30,6,5,0,11,0,30,3,8,0,11,5,30,4,0,0,4,1,-15,3,1
2,2,35,1,30,7,6,0,13,6,30,2,0,0,2,1,30,2,11,0,13,2,30,3,10,0,13,6,30,8,0,0,8,1,-15,3,1
2,3,37,0,30,8,3,0,11,6,30,8,0,0,8,10,30,7,4,0,11,2,30,3,8,0,11,1,30,2,4,0,6,1,-15,3,1
2,4,37,0,30,8,3,0,11,6,30,8,0,0,8,10,30,7,4,0,11,2,30,3,8,0,11,1,30,2,4,0,6,1,-15,3,1
2,2,39,0,30,5,6,0,11,6,30,6,0,0,6,2,30,7,4,0,11,0,30,2,9,0,11,5,30,5,0,0,5,1,-15,3,1
2,3,39,0,30,5,6,0,11,6,30,6,0,0,6,2,30,7,4,0,11,0,30,2,9,0,11,5,30,5,0,0,5,1,-15,3,1
2,0,6,1,30,9,0,0,9,4,30,2,0,0,2,0,30,2,7,0,9,0,30,4,5,0,9,0,30,2,3,0,5,0,-27,3,0
2,1,6,1,30,9,0,0,9,4,30,2,0,0,2,0,30,2,7,0,9,0,30,4,5,0,9,0,30,2,3,0,5,0,-27,3,0
2,3,6,1,30,9,0,0,9,4,30,2,0,0,2,0,30,2,7,0,9,0,30,4,5,0,9,0,30,2,3,0,5,0,-27,3,0
2,4,6,1,30,9,0,0,9,4,30,2,0,0,2,0,30,2,7,0,9,0,30,4,5,0,9,0,30,2,3,0,5,0,-27,3,0
2,3,7,1,30,4,5,0,9,3,30,4,0,0,4,0,30,5,4,0,9,4,30,3,6,0,9,1,30,4,2,0,6,0,-27,3,0
2,1,19,1,30,7,6,0,13,1,30,4,4,0,8,0,30,7,6,0,13,7,30,4,9,0,13,2,30,8,1,0,9,1,-15,3,1
2,2,19,1,30,7,6,0,13,1,30,4,4,0,8,0,30,7,6,0,13,7,30,4,9,0,13,2,30,8,1,0,9,1,-15,3,1
2,4,23,2,30,6,7,0,13,3,30,6,0,0,6,5,30,11,2,0,13,0,30,6,7,0,13,3,30,6,0,0,6,1,-15,3,1
2,0,25,1,30,5,9,0,14,5,30,6,0,0,6,0,30,4,10,0,14,1,30,9,5,0,14,4,30,6,0,0,6,1,-15,3,1
2,4,25,1,30,5,9,0,14,4,30,6,0,0,6,0,30,4,10,0,14,1,30,9,5,0,14,4,30,6,0,0,6,1,-15,3,1
2,1,26,0,30,7,2,0,9,5,30,4,0,0,4,2,30,0,9,0,9,0,30,2,7,0,9,6,30,3,0,0,3,1,-15,3,1
2,2,26,0,30,7,2,0,9,5,30,4,0,0,4,2,30,0,9,0,9,0,30,2,7,0,9,6,30,3,0,0,3,1,-15,3,1
2,3,26,0,30,7,2,0,9,5,30,4,0,0,4,2,30,0,9,0,9,0,30,2,7,0,9,6,30,3,0,0,3,1,-15,3,1
2,1,27,1,30,5,10,0,15,3,30,2,0,0,2,0,30,3,12,0,15,3,30,7,8,0,15,2,30,6,0,0,6,1,-15,3,1
2,2,27,1,30,5,10,0,15,3,30,2,0,0,2,0,30,3,12,0,15,3,30,7,8,0,15,2,30,6,0,0,6,1,-15,3,1
2,3,27,1,30,5,10,0,15,3,30,2,0,0,2,0,30,3,12,0,15,3,30,7,8,0,15,2,30,6,0,0,6,1,-15,3,1
2,4,29,0,30,7,7,0,14,5,30,12,0,0,12,0,30,5,9,0,14,0,30,1,13,0,14,0,30,6,3,0,9,1,-15,3,1
2,4,31,0,30,7,5,0,12,5,30,8,0,0,8,3,30,8,4,0,12,0,30,3,9,0,12,1,30,5,1,0,6,1,-15,3,1
2,4,32,0,30,3,6,0,9,5,30,2,0,0,2,3,30,8,1,0,9,1,30,3,6,0,9,0,30,2,0,0,2,1,-15,3,1
2,1,35,0,30,8,5,0,13,5,30,1,1,0,2,1,30,5,8,0,13,0,30,7,6,0,13,7,30,8,0,0,8,1,-15,3,1
2,2,35,0,30,8,5,0,13,5,30,1,1,0,2,1,30,5,8,0,13,0,30,7,6,0,13,7,30,8,0,0,8,1,-15,3,1
2,3,35,0,30,8,5,0,13,5,30,1,1,0,2,1,30,5,8,0,13,0,30,7,6,0,13,7,30,8,0,0,8,1,-15,3,1
2,2,13,2,30,7,0,0,7,0,30,4,0,0,4,4,30,7,0,0,7,4,30,7,0,0,7,3,30,4,0,0,4,1,-15,3,1
2,4,13,2,30,7,0,0,7,0,30,4,0,0,4,4,30,7,0,0,7,3,30,7,0,0,7,3,30,4,0,0,4,1,-15,3,1
2,4,15,0,30,5,8,0,13,0,30,6,0,0,6,0,30,4,9,0,13,1,30,4,9,0,13,2,30,8,1,0,9,1,-15,3,1
2,2,17,2,30,8,6,0,14,3,30,6,0,0,6,0,30,7,7,0,14,4,30,6,8,0,14,1,30,3,1,0,4,1,-15,3,1
2,4,19,0,30,8,5,0,13,2,30,3,5,0,8,0,30,6,7,0,13,7,30,4,9,0,13,3,30,8,1,0,9,1,-15,3,1
2,1,21,1,30,6,4,0,10,3,30,4,2,0,6,0,30,3,7,0,10,5,30,5,5,0,10,5,30,4,0,0,4,1,-15,3,1
2,3,29,0,30,4,10,0,14,6,30,11,1,0,12,0,30,3,11,0,14,0,30,6,8,0,14,4,30,9,0,0,9,1,-15,3,1
2,3,17,3,30,10,4,0,14,3,30,6,0,0,6,0,30,6,8,0,14,2,30,6,8,0,14,4,30,4,0,0,4,1,-15,3,1
2,4,17,3,30,10,4,0,14,3,30,6,0,0,6,0,30,6,8,0,14,2,30,6,8,0,14,4,30,4,0,0,4,1,-15,3,1
2,2,19,0,30,3,10,0,13,2,30,8,0,0,8,0,30,5,8,0,13,4,30,3,10,0,13,2,30,8,1,0,9,1,-15,3,1
2,4,19,0,30,3,10,0,13,2,30,8,0,0,8,0,30,5,8,0,13,4,30,3,10,0,13,2,30,8,1,0,9,1,-15,3,1
2,3,23,1,30,6,7,0,13,3,30,6,0,0,6,5,30,13,0,0,13,0,30,6,7,0,13,1,30,6,0,0,6,1,-15,3,1
2,0,26,1,30,7,2,0,9,6,30,4,0,0,4,5,30,0,9,0,9,0,30,3,6,0,9,7,30,3,0,0,3,1,-15,3,1
2,3,26,1,30,7,2,0,9,6,30,4,0,0,4,5,30,0,9,0,9,0,30,3,6,0,9,1,30,3,0,0,3,1,-15,3,1
2,2,31,3,30,7,5,0,12,4,30,8,0,0,8,3,30,6,6,0,12,0,30,3,9,0,12,3,30,3,3,0,6,1,-15,3,1
2,4,31,3,30,7,5,0,12,4,30,8,0,0,8,3,30,6,6,0,12,0,30,3,9,0,12,3,30,3,3,0,6,1,-15,3,1
2,3,33,5,30,4,7,0,11,6,30,4,0,0,4,0,30,7,4,0,11,0,30,3,8,0,11,6,30,4,0,0,4,1,-15,3,1
2,4,35,2,30,8,5,0,13,3,30,2,0,0,2,1,30,8,5,0,13,4,30,1,12,0,13,3,30,8,0,0,8,1,-15,3,1
2,2,11,2,30,6,6,0,12,1,30,4,0,0,4,3,30,4,8,0,12,3,30,4,8,0,12,4,30,4,0,0,4,1,-15,3,1
2,3,11,2,30,6,6,0,12,1,30,4,0,0,4,3,30,4,8,0,12,3,30,4,8,0,12,4,30,4,0,0,4,1,-15,3,1
2,2,17,3,30,9,5,0,14,2,30,6,0,0,6,0,30,8,6,0,14,1,30,6,8,0,14,5,30,4,0,0,4,1,-15,3,1
2,3,17,3,30,9,5,0,14,2,30,6,0,0,6,0,30,8,6,0,14,1,30,6,8,0,14,5,30,4,0,0,4,1,-15,3,1
2,4,29,0,30,8,6,0,14,6,30,10,2,0,12,0,30,3,11,0,14,0,30,1,13,0,14,6,30,9,0,0,9,1,-15,3,1
2,3,13,2,30,7,0,0,7,0,30,4,0,0,4,1,30,6,1,0,7,6,30,3,4,0,7,2,30,4,0,0,4,1,-15,3,1
2,3,19,0,30,5,8,0,13,2,30,5,3,0,8,0,30,5,8,0,13,2,30,7,6,0,13,0,30,9,0,0,9,1,-15,3,1
2,0,25,2,30,3,11,0,14,4,30,6,0,0,6,0,30,10,4,0,14,1,30,5,9,0,14,5,30,6,0,0,6,1,-15,3,1
2,1,25,2,30,3,11,0,14,4,30,6,0,0,6,0,30,10,4,0,14,1,30,5,9,0,14,5,30,6,0,0,6,1,-15,3,1
2,4,25,2,30,3,11,0,14,4,30,6,0,0,6,0,30,10,4,0,14,1,30,5,9,0,14,5,30,6,0,0,6,1,-15,3,1
2,2,27,1,30,4,11,0,15,4,30,1,1,0,2,0,30,2,13,0,15,0,30,4,11,0,15,6,30,6,0,0,6,1,-15,3,1
2,0,5,1,30,5,0,0,5,3,30,2,2,0,4,0,30,0,5,0,5,0,30,1,4,0,5,0,30,0,2,0,2,0,-27,3,0
2,1,5,1,30,5,0,0,5,3,30,2,2,0,4,0,30,0,5,0,5,0,30,1,4,0,5,0,30,0,2,0,2,0,-27,3,0
2,2,5,1,30,5,0,0,5,3,30,2,2,0,4,0,30,0,5,0,5,0,30,1,4,0,5,0,30,0,2,0,2,0,-27,3,0
2,3,5,1,30,5,0,0,5,3,30,2,2,0,4,0,30,0,5,0,5,0,30,1,4,0,5,0,30,0,2,0,2,0,-27,3,0
2,4,5,1,30,5,0,0,5,3,30,2,2,0,4,0,30,0,5,0,5,0,30,1,4,0,5,0,30,0,2,0,2,0,-27,3,0
2,1,13,1,30,7,0,0,7,0,30,4,0,0,4,2,30,5,2,0,7,4,30,4,3,0,7,5,30,4,0,0,4,1,-15,3,1
2,3,17,4,30,11,3,0,14,3,30,6,0,0,6,0,30,4,10,0,14,0,30,6,8,0,14,7,30,4,0,0,4,1,-15,3,1
2,0,27,2,30,4,11,0,15,3,30,2,0,0,2,3,30,7,8,0,15,0,30,8,7,0,15,2,30,4,2,0,6,1,-15,3,1
2,1,27,2,30,4,11,0,15,3,30,2,0,0,2,3,30,7,8,0,15,0,30,8,7,0,15,2,30,4,2,0,6,1,-15,3,1
2,2,27,2,30,4,11,0,15,3,30,2,0,0,2,3,30,7,8,0,15,0,30,8,7,0,15,2,30,4,2,0,6,1,-15,3,1
2,4,27,2,30,4,11,0,15,3,30,2,0,0,2,3,30,7,8,0,15,0,30,8,7,0,15,0,30,4,2,0,6,1,-15,3,1
2,3,29,1,30,7,7,0,14,5,30,8,4,0,12,0,30,3,11,0,14,0,30,1,13,0,14,3,30,9,0,0,9,1,-15,3,1
2,4,29,1,30,7,7,0,14,5,30,8,4,0,12,0,30,3,11,0,14,0,30,1,13,0,14,3,30,9,0,0,9,1,-15,3,1
2,2,31,0,30,4,8,0,12,6,30,8,0,0,8,3,30,7,5,0,12,0,30,9,3,0,12,2,30,6,0,0,6,1,-15,3,1
2,3,31,0,30,4,8,0,12,6,30,8,0,0,8,3,30,7,5,0,12,0,30,9,3,0,12,2,30,6,0,0,6,1,-15,3,1
2,4,31,0,30,4,8,0,12,6,30,8,0,0,8,3,30,7,5,0,12,0,30,9,3,0,12,2,30,6,0,0,6,1,-15,3,1
2,3,35,0,30,6,7,0,13,5,30,2,0,0,2,1,30,2,11,0,13,0,30,5,8,0,13,9,30,8,0,0,8,1,-15,3,1
2,4,38,0,30,2,8,0,10,6,30,4,2,0,6,0,30,1,9,0,10,0,30,2,8,0,10,6,30,6,0,0,6,1,-15,3,1
2,4,11,0,30,1,3,0,4,0,30,0,0,0,0,0,30,0,4,0,4,4,30,2,2,0,4,2,30,1,0,0,1,1,-15,3,1
2,3,19,0,30,2,11,0,13,2,30,5,3,0,8,0,30,11,2,0,13,3,30,4,9,0,13,2,30,9,0,0,9,1,-15,3,1
2,4,25,1,30,5,9,0,14,5,30,6,0,0,6,0,30,6,8,0,14,0,30,5,9,0,14,3,30,5,1,0,6,1,-15,3,1
2,0,27,1,30,3,12,0,15,3,30,2,0,0,2,0,30,7,8,0,15,3,30,5,10,0,15,3,30,6,0,0,6,1,-15,3,1
2,2,27,1,30,3,12,0,15,3,30,2,0,0,2,0,30,7,8,0,15,3,30,5,10,0,15,2,30,6,0,0,6,1,-15,3,1
2,4,27,1,30,3,12,0,15,3,30,2,0,0,2,0,30,7,8,0,15,3,30,5,10,0,15,2,30,6,0,0,6,1,-15,3,1
2,4,29,0,30,6,8,0,14,6,30,12,0,0,12,0,30,3,11,0,14,0,30,1,13,0,14,3,30,9,0,0,9,1,-15,3,1
2,3,43,0,30,7,7,0,14,6,30,6,0,0,6,0,30,4,10,0,14,1,30,4,10,0,14,4,30,5,0,0,5,1,-15,3,1
2,2,15,0,30,4,9,0,13,0,30,6,0,0,6,0,30,3,10,0,13,4,30,4,9,0,13,2,30,7,2,0,9,1,-15,3,1
2,3,15,0,30,4,9,0,13,0,30,6,0,0,6,0,30,3,10,0,13,4,30,4,9,0,13,2,30,7,2,0,9,1,-15,3,1
2,4,15,0,30,4,9,0,13,0,30,6,0,0,6,0,30,3,10,0,13,4,30,4,9,0,13,2,30,7,2,0,9,1,-15,3,1
2,2,27,4,30,6,9,0,15,4,30,2,0,0,2,0,30,10,5,0,15,0,30,5,10,0,15,0,30,3,3,0,6,1,-15,3,1
2,3,27,4,30,6,9,0,15,4,30,2,0,0,2,0,30,10,5,0,15,0,30,5,10,0,15,0,30,3,3,0,6,1,-15,3,1
2,4,29,0,30,6,8,0,14,6,30,12,0,0,12,0,30,6,8,0,14,0,30,1,13,0,14,3,30,9,0,0,9,1,-15,3,1
2,3,32,0,30,4,5,0,9,5,30,2,0,0,2,4,30,5,4,0,9,1,30,3,6,0,9,5,30,2,0,0,2,1,-15,3,1
2,4,4,2,30,6,2,0,8,4,30,3,1,0,4,0,30,2,6,0,8,0,30,3,5,0,8,0,30,4,0,0,4,0,-27,3,0
2,4,15,2,30,3,10,0,13,1,30,6,0,0,6,0,30,5,8,0,13,1,30,3,10,0,13,0,30,5,4,0,9,1,-15,3,1
2,1,17,2,30,9,5,0,14,2,30,6,0,0,6,0,30,7,7,0,14,4,30,3,11,0,14,3,30,4,0,0,4,1,-15,3,1
2,3,22,4,30,6,2,0,8,3,30,2,0,0,2,0,30,7,1,0,8,1,30,3,5,0,8,1,30,2,2,0,4,1,-15,3,1
2,4,22,4,30,6,2,0,8,3,30,2,0,0,2,0,30,7,1,0,8,1,30,3,5,0,8,1,30,2,2,0,4,1,-15,3,1
2,3,23,1,30,8,5,0,13,2,30,6,0,0,6,1,30,13,0,0,13,0,30,5,8,0,13,3,30,6,0,0,6,1,-15,3,1
2,4,23,1,30,8,5,0,13,2,30,6,0,0,6,1,30,13,0,0,13,0,30,5,8,0,13,3,30,6,0,0,6,1,-15,3,1
2,3,25,0,30,4,10,0,14,5,30,6,0,0,6,0,30,8,6,0,14,3,30,7,7,0,14,4,30,6,0,0,6,1,-15,3,1
2,4,25,0,30,4,10,0,14,5,30,6,0,0,6,0,30,8,6,0,14,3,30,7,7,0,14,4,30,6,0,0,6,1,-15,3,1
2,1,26,0,30,8,1,0,9,5,30,4,0,0,4,2,30,0,9,0,9,0,30,4,5,0,9,6,30,3,0,0,3,1,-15,3,1
2,2,26,0,30,8,1,0,9,5,30,4,0,0,4,2,30,0,9,0,9,0,30,4,5,0,9,6,30,3,0,0,3,1,-15,3,1
2,1,27,5,30,5,10,0,15,3,30,1,1,0,2,0,30,3,12,0,15,0,30,5,10,0,15,2,30,6,0,0,6,1,-15,3,1
2,3,27,5,30,5,10,0,15,3,30,1,1,0,2,0,30,3,12,0,15,0,30,5,10,0,15,2,30,6,0,0,6,1,-15,3,1
2,4,27,5,30,5,10,0,15,3,30,1,1,0,2,0,30,3,12,0,15,0,30,5,10,0,15,2,30,6,0,0,6,1,-15,3,1
2,0,29,5,30,7,7,0,14,6,30,12,0,0,12,0,30,2,12,0,14,0,30,0,14,0,14,0,30,6,3,0,9,1,-15,3,1
2,1,29,5,30,7,7,0,14,6,30,12,0,0,12,0,30,2,12,0,14,0,30,0,14,0,14,0,30,6,3,0,9,1,-15,3,1
2,2,29,5,30,7,7,0,14,6,30,12,0,0,12,0,30,2,12,0,14,0,30,0,14,0,14,0,30,6,3,0,9,1,-15,3,1
2,3,29,5,30,7,7,0,14,6,30,12,0,0,12,0,30,2,12,0,14,0,30,0,14,0,14,0,30,6,3,0,9,1,-15,3,1
2,4,11,0,30,6,6,0,12,1,30,4,0,0,4,0,30,6,6,0,12,8,30,5,7,0,12,3,30,4,0,0,4,1,-15,3,1
2,2,15,0,30,5,8,0,13,0,30,6,0,0,6,0,30,4,9,0,13,1,30,4,9,0,13,2,30,9,0,0,9,1,-15,3,1
2,4,15,0,30,5,8,0,13,0,30,6,0,0,6,0,30,4,9,0,13,1,30,4,9,0,13,2,30,9,0,0,9,1,-15,3,1
2,4,17,0,30,8,6,0,14,2,30,6,0,0,6,0,30,4,10,0,14,1,30,6,8,0,14,5,30,4,0,0,4,1,-15,3,1
2,1,19,0,30,4,9,0,13,0,30,3,5,0,8,3,30,6,7,0,13,3,30,7,6,0,13,2,30,9,0,0,9,1,-15,3,1
2,2,19,0,30,4,9,0,13,0,30,3,5,0,8,3,30,6,7,0,13,3,30,7,6,0,13,2,30,9,0,0,9,1,-15,3,1
2,1,21,4,30,9,1,0,10,4,30,6,0,0,6,1,30,3,7,0,10,3,30,5,5,0,10,1,30,4,0,0,4,1,-15,3,1
2,4,23,2,30,5,8,0,13,3,30,6,0,0,6,6,30,10,3,0,13,0,30,4,9,0,13,2,30,6,0,0,6,1,-15,3,1
2,2,25,0,30,8,6,0,14,4,30,6,0,0,6,0,30,9,5,0,14,1,30,5,9,0,14,3,30,5,1,0,6,1,-15,3,1
2,3,25,0,30,8,6,0,14,4,30,6,0,0,6,0,30,9,5,0,14,1,30,5,9,0,14,3,30,5,1,0,6,1,-15,3,1
2,4,25,0,30,8,6,0,14,4,30,6,0,0,6,0,30,9,5,0,14,1,30,5,9,0,14,3,30,5,1,0,6,1,-15,3,1
2,3,27,1,30,4,11,0,15,3,30,2,0,0,2,0,30,3,12,0,15,1,30,7,8,0,15,6,30,6,0,0,6,1,-15,3,1
2,4,29,0,30,7,7,0,14,4,30,10,2,0,12,0,30,4,10,0,14,0,30,3,11,0,14,0,30,6,3,0,9,1,-15,3,1
2,0,31,3,30,6,6,0,12,4,30,8,0,0,8,6,30,11,1,0,12,0,30,3,9,0,12,0,30,4,2,0,6,1,-15,3,1
2,1,31,3,30,6,6,0,12,4,30,8,0,0,8,6,30,11,1,0,12,0,30,3,9,0,12,0,30,4,2,0,6,1,-15,3,1
2,2,31,3,30,6,6,0,12,4,30,8,0,0,8,6,30,11,1,0,12,0,30,3,9,0,12,0,30,4,2,0,6,1,-15,3,1
2,3,31,3,30,6,6,0,12,4,30,8,0,0,8,6,30,11,1,0,12,0,30,3,9,0,12,0,30,4,2,0,6,1,-15,3,1
2,4,31,3,30,6,6,0,12,4,30,8,0,0,8,6,30,11,1,0,12,0,30,3,9,0,12,0,30,4,2,0,6,1,-15,3,1
2,2,35,0,30,6,7,0,13,5,30,2,0,0,2,1,30,5,8,0,13,0,30,1,12,0,13,3,30,8,0,0,8,1,-15,3,1
2,3,4,2,30,7,1,0,8,4,30,2,2,0,4,1,30,4,4,0,8,0,30,4,4,0,8,3,30,4,0,0,4,0,-27,3,0
2,3,5,0,30,1,4,0,5,2,30,2,2,0,4,0,30,0,5,0,5,0,30,1,4,0,5,3,30,2,0,0,2,0,-27,3,0
2,4,5,0,30,1,4,0,5,2,30,2,2,0,4,0,30,0,5,0,5,0,30,1,4,0,5,3,30,2,0,0,2,0,-27,3,0
2,1,17,3,30,10,4,0,14,3,30,6,0,0,6,0,30,5,9,0,14,1,30,6,8,0,14,6,30,4,0,0,4,1,-15,3,1
2,2,17,3,30,10,4,0,14,3,30,6,0,0,6,0,30,5,9,0,14,1,30,6,8,0,14,6,30,4,0,0,4,1,-15,3,1
2,3,17,3,30,10,4,0,14,3,30,6,0,0,6,0,30,5,9,0,14,1,30,6,8,0,14,6,30,4,0,0,4,1,-15,3,1
2,0,25,1,30,6,8,0,14,4,30,6,0,0,6,0,30,9,5,0,14,1,30,5,9,0,14,5,30,6,0,0,6,1,-15,3,1
2,1,25,1,30,6,8,0,14,4,30,6,0,0,6,0,30,9,5,0,14,1,30,5,9,0,14,5,30,6,0,0,6,1,-15,3,1
2,1,26,0,30,4,5,0,9,5,30,4,0,0,4,2,30,0,9,0,9,1,30,4,5,0,9,6,30,3,0,0,3,1,-15,3,1
2,2,26,0,30,4,5,0,9,5,30,4,0,0,4,2,30,0,9,0,9,1,30,4,5,0,9,6,30,3,0,0,3,1,-15,3,1
2,2,27,2,30,6,9,0,15,2,30,1,1,0,2,2,30,4,11,0,15,0,30,6,9,0,15,4,30,6,0,0,6,1,-15,3,1
2,4,31,0,30,5,7,0,12,5,30,8,0,0,8,3,30,8,4,0,12,1,30,8,4,0,12,0,30,4,2,0,6,1,-15,3,1
2,4,33,2,30,5,6,0,11,5,30,4,0,0,4,2,30,8,3,0,11,0,30,3,8,0,11,5,30,4,0,0,4,1,-15,3,1
2,3,35,1,30,7,6,0,13,4,30,2,0,0,2,1,30,4,9,0,13,1,30,4,9,0,13,5,30,8,0,0,8,1,-15,3,1
2,2,1,0,30,7,3,0,10,4,30,2,0,0,2,1,30,4,6,0,10,4,30,6,4,0,10,1,30,6,0,0,6,0,-27,3,0
2,3,1,0,30,7,3,0,10,4,30,2,0,0,2,1,30,4,6,0,10,4,30,6,4,0,10,1,30,6,0,0,6,0,-27,3,0
2,4,1,0,30,7,3,0,10,4,30,2,0,0,2,1,30,4,6,0,10,4,30,6,4,0,10,1,30,6,0,0,6,0,-27,3,0
2,4,11,1,30,6,6,0,12,0,30,4,0,0,4,0,30,8,4,0,12,4,30,4,8,0,12,3,30,4,0,0,4,1,-15,3,1
2,3,17,0,30,6,8,0,14,2,30,6,0,0,6,0,30,7,7,0,14,1,30,5,9,0,14,4,30,4,0,0,4,1,-15,3,1
2,4,17,0,30,6,8,0,14,2,30,6,0,0,6,0,30,7,7,0,14,1,30,5,9,0,14,4,30,4,0,0,4,1,-15,3,1
2,2,25,1,30,6,8,0,14,2,30,6,0,0,6,0,30,12,2,0,14,0,30,5,9,0,14,4,30,4,2,0,6,1,-15,3,1
2,3,25,1,30,6,8,0,14,2,30,6,0,0,6,0,30,12,2,0,14,0,30,5,9,0,14,4,30,4,2,0,6,1,-15,3,1
2,2,27,0,30,4,11,0,15,3,30,2,0,0,2,0,30,3,12,0,15,0,30,7,8,0,15,8,30,6,0,0,6,1,-15,3,1
2,4,29,0,30,5,9,0,14,6,30,12,0,0,12,0,30,2,12,0,14,0,30,1,13,0,14,0,30,9,0,0,9,1,-15,3,1
2,4,39,0,30,3,8,0,11,6,30,6,0,0,6,0,30,5,6,0,11,0,30,4,7,0,11,5,30,5,0,0,5,1,-15,3,1
2,2,11,0,30,1,3,0,4,0,30,0,0,0,0,0,30,1,3,0,4,5,30,1,3,0,4,2,30,1,0,0,1,1,-15,3,1
2,2,17,4,30,9,5,0,14,3,30,6,0,0,6,0,30,6,8,0,14,1,30,7,7,0,14,2,30,4,0,0,4,1,-15,3,1
2,3,17,4,30,9,5,0,14,3,30,6,0,0,6,0,30,6,8,0,14,1,30,7,7,0,14,2,30,4,0,0,4,1,-15,3,1
2,0,25,1,30,5,9,0,14,5,30,6,0,0,6,0,30,6,8,0,14,4,30,9,5,0,14,4,30,6,0,0,6,1,-15,3,1
2,3,27,1,30,7,8,0,15,2,30,2,0,0,2,0,30,3,12,0,15,2,30,4,11,0,15,0,30,4,2,0,6,1,-15,3,1
2,4,31,4,30,5,7,0,12,4,30,8,0,0,8,2,30,12,0,0,12,0,30,3,9,0,12,0,30,3,3,0,6,1,-15,3,1
2,2,4,2,30,7,1,0,8,5,30,4,0,0,4,0,30,1,7,0,8,0,30,6,2,0,8,1,30,3,1,0,4,0,-27,3,0
2,1,13,1,30,6,1,0,7,0,30,4,0,0,4,2,30,5,2,0,7,11,30,7,0,0,7,4,30,4,0,0,4,1,-15,3,1
2,2,13,1,30,6,1,0,7,0,30,4,0,0,4,2,30,5,2,0,7,11,30,7,0,0,7,4,30,4,0,0,4,1,-15,3,1
2,3,17,5,30,11,3,0,14,2,30,6,0,0,6,0,30,7,7,0,14,1,30,4,10,0,14,2,30,4,0,0,4,1,-15,3,1
2,0,21,3,30,7,3,0,10,4,30,6,0,0,6,1,30,3,7,0,10,3,30,5,5,0,10,1,30,4,0,0,4,1,-15,3,1
2,4,23,1,30,5,8,0,13,4,30,6,0,0,6,9,30,10,3,0,13,0,30,6,7,0,13,1,30,5,1,0,6,1,-15,3,1
2,3,25,3,30,6,8,0,14,3,30,6,0,0,6,0,30,9,5,0,14,1,30,5,9,0,14,3,30,5,1,0,6,1,-15,3,1
2,4,25,3,30,6,8,0,14,3,30,6,0,0,6,0,30,9,5,0,14,1,30,5,9,0,14,3,30,5,1,0,6,1,-15,3,1
2,1,27,5,30,10,5,0,15,4,30,2,0,0,2,0,30,5,10,0,15,0,30,5,10,0,15,2,30,2,4,0,6,1,-15,3,1
2,4,27,5,30,10,5,0,15,4,30,2,0,0,2,0,30,5,10,0,15,0,30,5,10,0,15,2,30,2,4,0,6,1,-15,3,1
2,1,31,4,30,8,4,0,12,4,30,8,0,0,8,3,30,11,1,0,12,0,30,3,9,0,12,1,30,4,2,0,6,1,-15,3,1
2,2,31,4,30,8,4,0,12,4,30,8,0,0,8,3,30,11,1,0,12,0,30,3,9,0,12,1,30,4,2,0,6,1,-15,3,1
2,3,38,0,30,1,9,0,10,7,30,4,2,0,6,0,30,1,9,0,10,0,30,5,5,0,10,6,30,6,0,0,6,1,-15,3,1
2,4,19,0,30,3,10,0,13,1,30,6,2,0,8,0,30,12,1,0,13,1,30,4,9,0,13,0,30,8,1,0,9,1,-15,3,1
2,4,22,1,30,7,1,0,8,3,30,2,0,0,2,0,30,4,4,0,8,1,30,4,4,0,8,4,30,4,0,0,4,1,-15,3,1
2,3,27,2,30,5,10,0,15,3,30,1,1,0,2,0,30,8,7,0,15,2,30,4,11,0,15,1,30,4,2,0,6,1,-15,3,1
2,4,27,2,30,5,10,0,15,3,30,1,1,0,2,0,30,8,7,0,15,2,30,4,11,0,15,1,30,4,2,0,6,1,-15,3,1
2,3,29,0,30,4,10,0,14,6,30,10,2,0,12,0,30,7,7,0,14,0,30,0,14,0,14,2,30,9,0,0,9,1,-15,3,1
2,4,29,0,30,4,10,0,14,6,30,10,2,0,12,0,30,7,7,0,14,0,30,0,14,0,14,2,30,9,0,0,9,1,-15,3,1
2,4,31,3,30,6,6,0,12,4,30,8,0,0,8,3,30,11,1,0,12,1,30,5,7,0,12,0,30,4,2,0,6,1,-15,3,1
2,3,33,1,30,2,9,0,11,5,30,4,0,0,4,1,30,9,2,0,11,2,30,3,8,0,11,4,30,4,0,0,4,1,-15,3,1
2,3,38,0,30,3,7,0,10,7,30,6,0,0,6,0,30,1,9,0,10,0,30,2,8,0,10,8,30,6,0,0,6,1,-15,3,1
2,2,39,0,30,5,6,0,11,7,30,6,0,0,6,0,30,6,5,0,11,2,30,4,7,0,11,4,30,5,0,0,5,1,-15,3,1
2,3,39,0,30,5,6,0,11,7,30,6,0,0,6,0,30,6,5,0,11,2,30,4,7,0,11,4,30,5,0,0,5,1,-15,3,1
2,2,43,4,30,7,7,0,14,8,30,6,0,0,6,0,30,4,10,0,14,1,30,1,13,0,14,7,30,5,0,0,5,1,-15,3,1
2,2,1,0,30,4,6,0,10,4,30,2,0,0,2,1,30,4,6,0,10,6,30,8,2,0,10,6,30,6,0,0,6,0,-27,3,0
2,4,3,0,30,0,4,0,4,2,30,4,0,0,4,0,30,0,4,0,4,2,30,2,2,0,4,0,30,1,2,0,3,0,-27,3,0
2,0,4,2,30,7,1,0,8,5,30,4,0,0,4,0,30,2,6,0,8,0,30,8,0,0,8,4,30,4,0,0,4,0,-27,3,0
2,1,4,2,30,7,1,0,8,5,30,4,0,0,4,0,30,2,6,0,8,0,30,8,0,0,8,4,30,4,0,0,4,0,-27,3,0
2,2,15,2,30,4,9,0,13,0,30,6,0,0,6,0,30,5,8,0,13,1,30,5,8,0,13,2,30,6,3,0,9,1,-15,3,1
2,4,15,2,30,4,9,0,13,0,30,6,0,0,6,0,30,5,8,0,13,1,30,5,8,0,13,2,30,6,3,0,9,1,-15,3,1
2,2,17,4,30,9,5,0,14,3,30,6,0,0,6,0,30,7,7,0,14,5,30,6,8,0,14,6,30,4,0,0,4,1,-15,3,1
2,2,19,0,30,1,12,0,13,0,30,8,0,0,8,0,30,11,2,0,13,3,30,3,10,0,13,1,30,8,1,0,9,1,-15,3,1
2,3,19,0,30,1,12,0,13,0,30,8,0,0,8,0,30,11,2,0,13,3,30,3,10,0,13,1,30,8,1,0,9,1,-15,3,1
2,4,19,0,30,1,12,0,13,0,30,8,0,0,8,0,30,11,2,0,13,3,30,3,10,0,13,1,30,8,1,0,9,1,-15,3,1
2,1,21,1,30,6,4,0,10,3,30,6,0,0,6,1,30,5,5,0,10,4,30,5,5,0,10,3,30,4,0,0,4,1,-15,3,1
2,3,23,2,30,6,7,0,13,3,30,5,1,0,6,1,30,13,0,0,13,0,30,6,7,0,13,5,30,6,0,0,6,1,-15,3,1
2,1,27,1,30,8,7,0,15,4,30,2,0,0,2,0,30,4,11,0,15,1,30,7,8,0,15,2,30,6,0,0,6,1,-15,3,1
2,3,27,1,30,8,7,0,15,4,30,2,0,0,2,0,30,4,11,0,15,1,30,7,8,0,15,2,30,6,0,0,6,1,-15,3,1
2,4,27,1,30,8,7,0,15,4,30,2,0,0,2,0,30,4,11,0,15,1,30,7,8,0,15,2,30,6,0,0,6,1,-15,3,1
2,4,29,0,30,9,5,0,14,5,30,12,0,0,12,0,30,3,11,0,14,0,30,4,10,0,14,0,30,6,3,0,9,1,-15,3,1
2,4,31,1,30,7,5,0,12,4,30,8,0,0,8,3,30,8,4,0,12,0,30,3,9,0,12,0,30,2,4,0,6,1,-15,3,1
2,2,1,0,30,6,4,0,10,4,30,2,0,0,2,1,30,4,6,0,10,6,30,8,2,0,10,6,30,6,0,0,6,0,-27,3,0
2,3,1,0,30,6,4,0,10,4,30,2,0,0,2,1,30,4,6,0,10,6,30,8,2,0,10,6,30,6,0,0,6,0,-27,3,0
2,2,11,0,30,1,3,0,4,0,30,0,0,0,0,0,30,3,1,0,4,3,30,4,0,0,4,1,30,1,0,0,1,1,-15,3,1
2,3,11,0,30,1,3,0,4,0,30,0,0,0,0,0,30,3,1,0,4,3,30,4,0,0,4,1,30,1,0,0,1,1,-15,3,1
2,4,11,0,30,1,3,0,4,0,30,0,0,0,0,0,30,3,1,0,4,3,30,4,0,0,4,1,30,1,0,0,1,1,-15,3,1
2,2,13,3,30,6,1,0,7,0,30,4,0,0,4,2,30,6,1,0,7,7,30,6,1,0,7,4,30,4,0,0,4,1,-15,3,1
2,4,13,3,30,6,1,0,7,0,30,4,0,0,4,2,30,6,1,0,7,7,30,6,1,0,7,4,30,4,0,0,4,1,-15,3,1
2,2,17,3,30,9,5,0,14,1,30,6,0,0,6,0,30,9,5,0,14,1,30,6,8,0,14,5,30,4,0,0,4,1,-15,3,1
2,3,17,3,30,9,5,0,14,1,30,6,0,0,6,0,30,9,5,0,14,1,30,6,8,0,14,5,30,4,0,0,4,1,-15,3,1
2,1,19,0,30,4,9,0,13,3,30,7,1,0,8,0,30,4,9,0,13,8,30,4,9,0,13,0,30,9,0,0,9,1,-15,3,1
2,4,19,0,30,4,9,0,13,3,30,7,1,0,8,0,30,4,9,0,13,8,30,4,9,0,13,0,30,9,0,0,9,1,-15,3,1
2,2,27,0,30,4,11,0,15,3,30,2,0,0,2,0,30,2,13,0,15,3,30,4,11,0,15,6,30,6,0,0,6,1,-15,3,1
2,1,29,0,30,5,9,0,14,6,30,10,2,0,12,0,30,3,11,0,14,0,30,3,11,0,14,5,30,9,0,0,9,1,-15,3,1
2,4,47,0,30,4,10,0,14,10,30,4,0,0,4,0,30,3,11,0,14,3,30,3,11,0,14,1,30,7,0,0,7,1,-15,3,1
2,3,13,5,30,7,0,0,7,3,30,4,0,0,4,2,30,6,1,0,7,5,30,7,0,0,7,0,30,4,0,0,4,1,-15,3,1
2,3,17,2,30,9,5,0,14,2,30,6,0,0,6,0,30,8,6,0,14,1,30,6,8,0,14,2,30,4,0,0,4,1,-15,3,1
2,2,21,1,30,7,3,0,10,3,30,6,0,0,6,1,30,3,7,0,10,5,30,3,7,0,10,5,30,4,0,0,4,1,-15,3,1
2,0,27,1,30,5,10,0,15,3,30,2,0,0,2,0,30,2,13,0,15,3,30,6,9,0,15,2,30,6,0,0,6,1,-15,3,1
2,1,27,1,30,5,10,0,15,3,30,2,0,0,2,0,30,2,13,0,15,3,30,6,9,0,15,2,30,6,0,0,6,1,-15,3,1
2,2,27,1,30,5,10,0,15,3,30,2,0,0,2,0,30,2,13,0,15,3,30,6,9,0,15,2,30,6,0,0,6,1,-15,3,1
2,3,29,1,30,8,6,0,14,6,30,10,2,0,12,0,30,2,12,0,14,0,30,1,13,0,14,0,30,6,3,0,9,1,-15,3,1
2,2,45,0,30,2,11,0,13,9,30,10,0,0,10,0,30,4,9,0,13,1,30,9,4,0,13,10,30,5,0,0,5,1,-15,3,1
2,3,45,0,30,2,11,0,13,9,30,10,0,0,10,0,30,4,9,0,13,1,30,9,4,0,13,10,30,5,0,0,5,1,-15,3,1
2,2,4,2,30,8,0,0,8,3,30,2,2,0,4,0,30,3,5,0,8,0,30,2,6,0,8,3,30,3,1,0,4,0,-27,3,0
2,1,5,1,30,3,2,0,5,3,30,4,0,0,4,0,30,0,5,0,5,0,30,1,4,0,5,0,30,1,1,0,2,0,-27,3,0
2,2,5,1,30,3,2,0,5,3,30,4,0,0,4,0,30,0,5,0,5,0,30,1,4,0,5,0,30,1,1,0,2,0,-27,3,0
2,1,17,3,30,11,3,0,14,3,30,6,0,0,6,0,30,6,8,0,14,4,30,7,7,0,14,7,30,4,0,0,4,1,-15,3,1
2,1,25,1,30,5,9,0,14,3,30,6,0,0,6,0,30,6,8,0,14,1,30,6,8,0,14,5,30,6,0,0,6,1,-15,3,1
2,3,27,2,30,4,11,0,15,2,30,2,0,0,2,0,30,5,10,0,15,2,30,6,9,0,15,2,30,6,0,0,6,1,-15,3,1
2,4,27,2,30,4,11,0,15,2,30,2,0,0,2,0,30,5,10,0,15,2,30,6,9,0,15,2,30,6,0,0,6,1,-15,3,1
2,3,29,0,30,5,9,0,14,6,30,12,0,0,12,0,30,3,11,0,14,0,30,1,13,0,14,1,30,9,0,0,9,1,-15,3,1
2,4,29,0,30,5,9,0,14,6,30,12,0,0,12,0,30,3,11,0,14,0,30,1,13,0,14,1,30,9,0,0,9,1,-15,3,1
2,4,30,2,30,3,2,0,5,5,30,2,0,0,2,1,30,2,3,0,5,7,30,1,4,0,5,0,30,3,0,0,3,1,-15,3,1
2,3,35,0,30,6,7,0,13,5,30,2,0,0,2,1,30,2,11,0,13,1,30,4,9,0,13,3,30,8,0,0,8,1,-15,3,1
2,4,39,2,30,6,5,0,11,6,30,6,0,0,6,0,30,6,5,0,11,0,30,2,9,0,11,1,30,4,1,0,5,1,-15,3,1
2,0,4,4,30,8,0,0,8,5,30,4,0,0,4,0,30,2,6,0,8,2,30,7,1,0,8,1,30,3,1,0,4,0,-27,3,0
2,2,4,4,30,8,0,0,8,5,30,4,0,0,4,0,30,2,6,0,8,2,30,7,1,0,8,1,30,3,1,0,4,0,-27,3,0
2,1,17,3,30,9,5,0,14,3,30,6,0,0,6,0,30,6,8,0,14,6,30,5,9,0,14,1,30,3,1,0,4,1,-15,3,1
2,3,19,0,30,4,9,0,13,1,30,8,0,0,8,1,30,13,0,0,13,0,30,2,11,0,13,3,30,6,3,0,9,1,-15,3,1
2,2,25,1,30,11,3,0,14,2,30,6,0,0,6,0,30,11,3,0,14,1,30,4,10,0,14,5,30,4,2,0,6,1,-15,3,1
2,3,27,0,30,7,8,0,15,3,30,2,0,0,2,0,30,5,10,0,15,0,30,3,12,0,15,2,30,4,2,0,6,1,-15,3,1
2,4,27,0,30,7,8,0,15,3,30,2,0,0,2,0,30,5,10,0,15,0,30,3,12,0,15,2,30,4,2,0,6,1,-15,3,1
2,2,29,0,30,6,8,0,14,6,30,10,2,0,12,0,30,6,8,0,14,0,30,1,13,0,14,4,30,9,0,0,9,1,-15,3,1
2,3,29,0,30,6,8,0,14,6,30,10,2,0,12,0,30,6,8,0,14,0,30,1,13,0,14,4,30,9,0,0,9,1,-15,3,1
2,4,35,0,30,11,2,0,13,3,30,2,0,0,2,0,30,5,8,0,13,2,30,3,10,0,13,5,30,8,0,0,8,1,-15,3,1
2,2,41,0,30,8,4,0,12,5,30,8,0,0,8,0,30,8,4,0,12,3,30,3,9,0,12,2,30,7,0,0,7,1,-15,3,1
2,3,41,0,30,8,4,0,12,5,30,8,0,0,8,0,30,8,4,0,12,3,30,3,9,0,12,2,30,7,0,0,7,1,-15,3,1
2,0,5,0,30,1,4,0,5,3,30,0,4,0,4,0,30,0,5,0,5,0,30,1,4,0,5,2,30,1,1,0,2,0,-27,3,0
2,4,5,0,30,1,4,0,5,3,30,0,4,0,4,0,30,0,5,0,5,0,30,1,4,0,5,2,30,1,1,0,2,0,-27,3,0
2,1,13,1,30,5,2,0,7,1,30,4,0,0,4,3,30,7,0,0,7,8,30,4,3,0,7,0,30,3,1,0,4,1,-15,3,1
2,2,13,1,30,5,2,0,7,1,30,4,0,0,4,3,30,7,0,0,7,8,30,4,3,0,7,0,30,3,1,0,4,1,-15,3,1
2,4,13,1,30,5,2,0,7,1,30,4,0,0,4,3,30,7,0,0,7,8,30,4,3,0,7,0,30,3,1,0,4,1,-15,3,1
2,2,19,1,30,6,7,0,13,1,30,4,4,0,8,0,30,4,9,0,13,7,30,4,9,0,13,0,30,8,1,0,9,1,-15,3,1
2,4,19,1,30,6,7,0,13,1,30,4,4,0,8,0,30,4,9,0,13,7,30,4,9,0,13,0,30,8,1,0,9,1,-15,3,1
2,3,23,3,30,7,6,0,13,2,30,6,0,0,6,4,30,11,2,0,13,0,30,5,8,0,13,1,30,5,1,0,6,1,-15,3,1
2,4,23,3,30,7,6,0,13,2,30,6,0,0,6,4,30,11,2,0,13,0,30,5,8,0,13,1,30,5,1,0,6,1,-15,3,1
2,3,25,1,30,7,7,0,14,3,30,6,0,0,6,0,30,10,4,0,14,1,30,5,9,0,14,5,30,5,1,0,6,1,-15,3,1
2,2,27,1,30,5,10,0,15,4,30,1,1,0,2,0,30,6,9,0,15,0,30,4,11,0,15,4,30,6,0,0,6,1,-15,3,1
2,3,27,1,30,5,10,0,15,4,30,1,1,0,2,0,30,6,9,0,15,0,30,4,11,0,15,4,30,6,0,0,6,1,-15,3,1
2,3,29,0,30,7,7,0,14,6,30,10,2,0,12,0,30,4,10,0,14,0,30,0,14,0,14,4,30,9,0,0,9,1,-15,3,1
2,2,5,0,30,2,3,0,5,3,30,0,4,0,4,0,30,0,5,0,5,0,30,1,4,0,5,0,30,2,0,0,2,0,-27,3,0
2,4,8,0,30,7,0,0,7,4,30,2,0,0,2,0,30,2,5,0,7,0,30,5,2,0,7,4,30,3,0,0,3,0,-27,3,0
2,3,17,4,30,9,5,0,14,3,30,6,0,0,6,0,30,8,6,0,14,5,30,4,10,0,14,3,30,4,0,0,4,1,-15,3,1
2,4,17,4,30,9,5,0,14,3,30,6,0,0,6,0,30,8,6,0,14,5,30,4,10,0,14,3,30,4,0,0,4,1,-15,3,1
2,3,25,3,30,7,7,0,14,2,30,6,0,0,6,0,30,10,4,0,14,0,30,6,8,0,14,2,30,5,1,0,6,1,-15,3,1
2,4,25,3,30,7,7,0,14,2,30,6,0,0,6,0,30,10,4,0,14,0,30,6,8,0,14,2,30,5,1,0,6,1,-15,3,1
2,3,35,0,30,7,6,0,13,3,30,2,0,0,2,1,30,8,5,0,13,2,30,1,12,0,13,4,30,8,0,0,8,1,-15,3,1
2,3,39,0,30,3,8,0,11,6,30,6,0,0,6,0,30,5,6,0,11,0,30,2,9,0,11,2,30,5,0,0,5,1,-15,3,1
2,4,39,0,30,3,8,0,11,6,30,6,0,0,6,0,30,5,6,0,11,0,30,2,9,0,11,2,30,5,0,0,5,1,-15,3,1
2,2,41,1,30,9,3,0,12,7,30,8,0,0,8,0,30,3,9,0,12,0,30,3,9,0,12,1,30,2,5,0,7,1,-15,3,1
2,3,41,1,30,9,3,0,12,7,30,8,0,0,8,0,30,3,9,0,12,0,30,3,9,0,12,1,30,2,5,0,7,1,-15,3,1
2,4,41,1,30,9,3,0,12,7,30,8,0,0,8,0,30,3,9,0,12,0,30,3,9,0,12,1,30,2,5,0,7,1,-15,3,1
2,1,4,2,30,4,4,0,8,3,30,4,0,0,4,1,30,7,1,0,8,4,30,8,0,0,8,1,30,3,1,0,4,0,-27,3,0
2,3,4,2,30,4,4,0,8,3,30,4,0,0,4,1,30,7,1,0,8,4,30,8,0,0,8,0,30,3,1,0,4,0,-27,3,0
2,0,5,0,30,2,3,0,5,3,30,0,4,0,4,0,30,0,5,0,5,0,30,2,3,0,5,0,30,0,2,0,2,0,-27,3,0
2,3,5,0,30,2,3,0,5,3,30,0,4,0,4,0,30,0,5,0,5,0,30,2,3,0,5,0,30,0,2,0,2,0,-27,3,0
2,4,5,0,30,2,3,0,5,3,30,0,4,0,4,0,30,0,5,0,5,0,30,2,3,0,5,0,30,0,2,0,2,0,-27,3,0
2,3,8,5,30,7,0,0,7,4,30,2,0,0,2,3,30,4,3,0,7,0,30,4,3,0,7,1,30,3,0,0,3,0,-27,3,0
2,2,13,2,30,5,2,0,7,1,30,4,0,0,4,2,30,6,1,0,7,7,30,5,2,0,7,2,30,4,0,0,4,1,-15,3,1
2,3,16,0,30,6,3,0,9,2,30,7,1,0,8,0,30,2,7,0,9,3,30,1,8,0,9,0,30,4,0,0,4,1,-15,3,1
2,1,19,0,30,3,10,0,13,2,30,4,4,0,8,0,30,4,9,0,13,6,30,4,9,0,13,1,30,8,1,0,9,1,-15,3,1
2,4,19,0,30,3,10,0,13,2,30,4,4,0,8,0,30,4,9,0,13,6,30,4,9,0,13,1,30,8,1,0,9,1,-15,3,1
2,3,27,1,30,4,11,0,15,4,30,2,0,0,2,0,30,6,9,0,15,0,30,6,9,0,15,1,30,6,0,0,6,1,-15,3,1
2,4,35,0,30,5,8,0,13,5,30,2,0,0,2,10,30,2,11,0,13,0,30,4,9,0,13,4,30,8,0,0,8,1,-15,3,1
2,2,38,0,30,3,7,0,10,6,30,6,0,0,6,0,30,2,8,0,10,0,30,3,7,0,10,8,30,6,0,0,6,1,-15,3,1
2,4,17,1,30,5,9,0,14,3,30,6,0,0,6,0,30,3,11,0,14,2,30,5,9,0,14,6,30,4,0,0,4,1,-15,3,1
2,1,19,0,30,3,10,0,13,2,30,6,2,0,8,0,30,9,4,0,13,2,30,5,8,0,13,2,30,9,0,0,9,1,-15,3,1
2,3,19,0,30,3,10,0,13,2,30,6,2,0,8,0,30,9,4,0,13,2,30,5,8,0,13,2,30,9,0,0,9,1,-15,3,1
2,2,23,1,30,6,7,0,13,3,30,6,0,0,6,5,30,10,3,0,13,0,30,5,8,0,13,1,30,6,0,0,6,1,-15,3,1
2,3,23,1,30,6,7,0,13,3,30,6,0,0,6,5,30,10,3,0,13,0,30,5,8,0,13,1,30,6,0,0,6,1,-15,3,1
2,3,1,0,30,7,3,0,10,5,30,2,0,0,2,1,30,3,7,0,10,2,30,8,2,0,10,6,30,6,0,0,6,0,-27,3,0
2,4,5,0,30,2,3,0,5,4,30,0,4,0,4,0,30,0,5,0,5,0,30,1,4,0,5,1,30,2,0,0,2,0,-27,3,0
2,4,11,0,30,6,6,0,12,0,30,4,0,0,4,0,30,9,3,0,12,4,30,4,8,0,12,0,30,4,0,0,4,1,-15,3,1
2,4,13,5,30,7,0,0,7,0,30,4,0,0,4,3,30,7,0,0,7,4,30,5,2,0,7,2,30,4,0,0,4,1,-15,3,1
2,3,17,0,30,8,6,0,14,1,30,6,0,0,6,0,30,7,7,0,14,1,30,7,7,0,14,5,30,4,0,0,4,1,-15,3,1
2,4,17,0,30,8,6,0,14,1,30,6,0,0,6,0,30,7,7,0,14,1,30,7,7,0,14,5,30,4,0,0,4,1,-15,3,1
2,2,19,0,30,4,9,0,13,2,30,5,3,0,8,0,30,5,8,0,13,5,30,4,9,0,13,1,30,9,0,0,9,1,-15,3,1
2,2,25,1,30,10,4,0,14,4,30,6,0,0,6,0,30,4,10,0,14,2,30,7,7,0,14,5,30,4,2,0,6,1,-15,3,1
2,3,25,1,30,10,4,0,14,4,30,6,0,0,6,0,30,4,10,0,14,2,30,7,7,0,14,5,30,4,2,0,6,1,-15,3,1
2,4,25,1,30,10,4,0,14,4,30,6,0,0,6,0,30,4,10,0,14,2,30,7,7,0,14,5,30,4,2,0,6,1,-15,3,1
2,4,27,1,30,5,10,0,15,2,30,1,1,0,2,0,30,5,10,0,15,0,30,8,7,0,15,3,30,6,0,0,6,1,-15,3,1
2,3,29,0,30,7,7,0,14,6,30,11,1,0,12,0,30,4,10,0,14,0,30,0,14,0,14,0,30,9,0,0,9,1,-15,3,1
2,4,29,0,30,7,7,0,14,6,30,11,1,0,12,0,30,4,10,0,14,0,30,0,14,0,14,0,30,9,0,0,9,1,-15,3,1
2,3,31,7,30,6,6,0,12,4,30,8,0,0,8,3,30,11,1,0,12,0,30,3,9,0,12,0,30,2,4,0,6,1,-15,3,1
2,4,31,7,30,6,6,0,12,4,30,8,0,0,8,3,30,11,1,0,12,0,30,3,9,0,12,0,30,2,4,0,6,1,-15,3,1
2,4,32,0,30,9,0,0,9,4,30,2,0,0,2,1,30,8,1,0,9,1,30,3,6,0,9,3,30,2,0,0,2,1,-15,3,1
2,2,13,3,30,7,0,0,7,0,30,4,0,0,4,2,30,6,1,0,7,4,30,6,1,0,7,5,30,4,0,0,4,1,-15,3,1
2,3,13,3,30,7,0,0,7,0,30,4,0,0,4,2,30,6,1,0,7,4,30,6,1,0,7,5,30,4,0,0,4,1,-15,3,1
2,4,13,3,30,7,0,0,7,0,30,4,0,0,4,2,30,6,1,0,7,4,30,6,1,0,7,5,30,4,0,0,4,1,-15,3,1
2,3,17,3,30,10,4,0,14,3,30,6,0,0,6,0,30,5,9,0,14,1,30,5,9,0,14,3,30,4,0,0,4,1,-15,3,1
2,4,17,3,30,10,4,0,14,3,30,6,0,0,6,0,30,5,9,0,14,1,30,5,9,0,14,3,30,4,0,0,4,1,-15,3,1
2,1,19,0,30,5,8,0,13,3,30,3,5,0,8,5,30,6,7,0,13,0,30,4,9,0,13,1,30,9,0,0,9,1,-15,3,1
2,3,19,0,30,5,8,0,13,3,30,3,5,0,8,5,30,6,7,0,13,0,30,4,9,0,13,1,30,9,0,0,9,1,-15,3,1
2,1,25,0,30,6,8,0,14,4,30,6,0,0,6,0,30,7,7,0,14,2,30,10,4,0,14,5,30,6,0,0,6,1,-15,3,1
2,2,25,0,30,6,8,0,14,4,30,6,0,0,6,0,30,7,7,0,14,2,30,10,4,0,14,5,30,6,0,0,6,1,-15,3,1
2,3,25,0,30,6,8,0,14,4,30,6,0,0,6,0,30,7,7,0,14,2,30,10,4,0,14,5,30,6,0,0,6,1,-15,3,1
2,2,27,0,30,6,9,0,15,4,30,2,0,0,2,0,30,2,13,0,15,2,30,6,9,0,15,4,30,6,0,0,6,1,-15,3,1
2,3,27,0,30,6,9,0,15,4,30,2,0,0,2,0,30,2,13,0,15,2,30,6,9,0,15,4,30,6,0,0,6,1,-15,3,1
2,1,39,0,30,2,9,0,11,6,30,6,0,0,6,0,30,6,5,0,11,2,30,4,7,0,11,2,30,5,0,0,5,1,-15,3,1
2,4,3,0,30,1,3,0,4,3,30,4,0,0,4,0,30,0,4,0,4,0,30,2,2,0,4,1,30,3,0,0,3,0,-27,3,0
2,0,5,0,30,2,3,0,5,3,30,0,4,0,4,0,30,3,2,0,5,4,30,1,4,0,5,1,30,1,1,0,2,0,-27,3,0
2,2,5,0,30,2,3,0,5,3,30,0,4,0,4,0,30,3,2,0,5,4,30,1,4,0,5,1,30,1,1,0,2,0,-27,3,0
2,4,5,0,30,2,3,0,5,3,30,0,4,0,4,0,30,3,2,0,5,2,30,1,4,0,5,1,30,1,1,0,2,0,-27,3,0
2,3,8,1,30,7,0,0,7,3,30,2,0,0,2,0,30,6,1,0,7,1,30,5,2,0,7,2,30,3,0,0,3,0,-27,3,0
2,1,17,4,30,14,0,0,14,3,30,6,0,0,6,0,30,4,10,0,14,1,30,4,10,0,14,2,30,4,0,0,4,1,-15,3,1
2,4,17,4,30,14,0,0,14,3,30,6,0,0,6,0,30,4,10,0,14,1,30,4,10,0,14,2,30,4,0,0,4,1,-15,3,1
2,1,23,1,30,6,7,0,13,2,30,6,0,0,6,3,30,13,0,0,13,0,30,6,7,0,13,3,30,6,0,0,6,1,-15,3,1
2,4,23,1,30,6,7,0,13,0,30,6,0,0,6,3,30,13,0,0,13,0,30,6,7,0,13,3,30,6,0,0,6,1,-15,3,1
2,2,25,1,30,5,9,0,14,5,30,6,0,0,6,0,30,4,10,0,14,2,30,5,9,0,14,6,30,6,0,0,6,1,-15,3,1
2,3,27,2,30,6,9,0,15,5,30,2,0,0,2,0,30,2,13,0,15,0,30,5,10,0,15,5,30,6,0,0,6,1,-15,3,1
2,4,27,2,30,6,9,0,15,5,30,2,0,0,2,0,30,2,13,0,15,0,30,5,10,0,15,5,30,6,0,0,6,1,-15,3,1
2,4,31,2,30,9,3,0,12,3,30,8,0,0,8,0,30,9,3,0,12,0,30,3,9,0,12,0,30,5,1,0,6,1,-15,3,1
2,2,33,1,30,5,6,0,11,4,30,4,0,0,4,1,30,11,0,0,11,1,30,4,7,0,11,7,30,4,0,0,4,1,-15,3,1
2,3,33,1,30,5,6,0,11,4,30,4,0,0,4,1,30,11,0,0,11,1,30,4,7,0,11,7,30,4,0,0,4,1,-15,3,1
2,2,35,0,30,5,8,0,13,4,30,2,0,0,2,1,30,2,11,0,13,1,30,2,11,0,13,7,30,8,0,0,8,1,-15,3,1
2,4,41,1,30,10,2,0,12,6,30,7,1,0,8,0,30,3,9,0,12,0,30,3,9,0,12,5,30,4,3,0,7,1,-15,3,1
2,2,9,0,30,2,2,0,4,2,30,2,0,0,2,0,30,0,4,0,4,4,30,1,3,0,4,3,30,1,0,0,1,0,-27,3,0
2,4,13,8,30,7,0,0,7,2,30,4,0,0,4,0,30,6,1,0,7,2,30,6,1,0,7,1,30,4,0,0,4,1,-15,3,1
2,3,17,4,30,7,7,0,14,3,30,6,0,0,6,0,30,7,7,0,14,4,30,5,9,0,14,2,30,4,0,0,4,1,-15,3,1
2,1,19,0,30,2,11,0,13,2,30,3,5,0,8,0,30,6,7,0,13,0,30,3,10,0,13,0,30,8,1,0,9,1,-15,3,1
2,2,19,0,30,2,11,0,13,2,30,3,5,0,8,0,30,6,7,0,13,0,30,3,10,0,13,0,30,8,1,0,9,1,-15,3,1
2,3,19,0,30,2,11,0,13,2,30,3,5,0,8,0,30,6,7,0,13,0,30,3,10,0,13,0,30,8,1,0,9,1,-15,3,1
2,4,19,0,30,2,11,0,13,2,30,3,5,0,8,0,30,6,7,0,13,0,30,3,10,0,13,0,30,8,1,0,9,1,-15,3,1
2,4,38,0,30,5,5,0,10,7,30,6,0,0,6,0,30,2,8,0,10,0,30,3,7,0,10,6,30,6,0,0,6,1,-15,3,1
2,3,6,0,30,3,6,0,9,4,30,2,0,0,2,0,30,2,7,0,9,0,30,5,4,0,9,0,30,5,0,0,5,0,-27,3,0
2,4,6,0,30,3,6,0,9,4,30,2,0,0,2,0,30,2,7,0,9,0,30,5,4,0,9,0,30,5,0,0,5,0,-27,3,0
2,1,17,2,30,9,5,0,14,4,30,6,0,0,6,0,30,3,11,0,14,7,30,4,10,0,14,5,30,4,0,0,4,1,-15,3,1
2,2,17,2,30,9,5,0,14,4,30,6,0,0,6,0,30,3,11,0,14,7,30,4,10,0,14,5,30,4,0,0,4,1,-15,3,1
2,0,19,0,30,3,10,0,13,2,30,8,0,0,8,4,30,4,9,0,13,0,30,3,10,0,13,1,30,7,2,0,9,1,-15,3,1
2,1,19,0,30,3,10,0,13,2,30,8,0,0,8,4,30,4,9,0,13,0,30,3,10,0,13,1,30,7,2,0,9,1,-15,3,1
2,3,19,0,30,3,10,0,13,2,30,8,0,0,8,4,30,4,9,0,13,0,30,3,10,0,13,1,30,7,2,0,9,1,-15,3,1
2,2,25,5,30,5,9,0,14,6,30,6,0,0,6,0,30,6,8,0,14,0,30,10,4,0,14,4,30,5,1,0,6,1,-15,3,1
2,4,25,5,30,5,9,0,14,6,30,6,0,0,6,0,30,6,8,0,14,0,30,10,4,0,14,4,30,5,1,0,6,1,-15,3,1
2,0,26,3,30,9,0,0,9,5,30,4,0,0,4,2,30,0,9,0,9,0,30,1,8,0,9,7,30,3,0,0,3,1,-15,3,1
2,1,26,3,30,9,0,0,9,5,30,4,0,0,4,2,30,0,9,0,9,0,30,1,8,0,9,7,30,3,0,0,3,1,-15,3,1
2,3,26,0,30,9,0,0,9,5,30,4,0,0,4,2,30,0,9,0,9,0,30,1,8,0,9,7,30,3,0,0,3,1,-15,3,1
2,4,32,0,30,6,3,0,9,4,30,2,0,0,2,3,30,9,0,0,9,1,30,3,6,0,9,2,30,2,0,0,2,1,-15,3,1
2,0,5,0,30,1,4,0,5,3,30,2,2,0,4,4,30,0,5,0,5,0,30,1,4,0,5,0,30,0,2,0,2,0,-27,3,0
2,3,6,0,30,5,4,0,9,3,30,2,0,0,2,0,30,6,3,0,9,0,30,4,5,0,9,2,30,5,0,0,5,0,-27,3,0
2,4,6,0,30,5,4,0,9,3,30,2,0,0,2,0,30,6,3,0,9,0,30,4,5,0,9,2,30,5,0,0,5,0,-27,3,0
2,2,11,0,30,1,3,0,4,0,30,0,0,0,0,0,30,1,3,0,4,5,30,3,1,0,4,2,30,1,0,0,1,1,-15,3,1
2,1,13,4,30,7,0,0,7,2,30,4,0,0,4,2,30,5,2,0,7,4,30,7,0,0,7,0,30,4,0,0,4,1,-15,3,1
2,4,13,4,30,7,0,0,7,2,30,4,0,0,4,2,30,5,2,0,7,4,30,7,0,0,7,0,30,4,0,0,4,1,-15,3,1
2,3,15,1,30,8,5,0,13,1,30,5,1,0,6,0,30,4,9,0,13,1,30,5,8,0,13,2,30,3,6,0,9,1,-15,3,1
2,3,17,6,30,9,5,0,14,1,30,6,0,0,6,1,30,11,3,0,14,0,30,4,10,0,14,1,30,4,0,0,4,1,-15,3,1
2,3,19,0,30,3,10,0,13,2,30,8,0,0,8,0,30,5,8,0,13,2,30,4,9,0,13,0,30,8,1,0,9,1,-15,3,1
2,2,21,1,30,6,4,0,10,4,30,4,2,0,6,0,30,3,7,0,10,5,30,6,4,0,10,7,30,4,0,0,4,1,-15,3,1
2,3,23,2,30,7,6,0,13,3,30,6,0,0,6,9,30,9,4,0,13,0,30,5,8,0,13,1,30,6,0,0,6,1,-15,3,1
2,2,25,1,30,10,4,0,14,4,30,6,0,0,6,0,30,8,6,0,14,1,30,5,9,0,14,4,30,5,1,0,6,1,-15,3,1
2,3,25,1,30,10,4,0,14,4,30,6,0,0,6,0,30,8,6,0,14,1,30,5,9,0,14,4,30,5,1,0,6,1,-15,3,1
2,4,25,1,30,10,4,0,14,4,30,6,0,0,6,0,30,8,6,0,14,1,30,5,9,0,14,4,30,5,1,0,6,1,-15,3,1
2,4,32,0,30,6,3,0,9,6,30,2,0,0,2,0,30,3,6,0,9,1,30,4,5,0,9,5,30,2,0,0,2,1,-15,3,1
2,4,35,1,30,11,2,0,13,3,30,2,0,0,2,1,30,4,9,0,13,0,30,3,10,0,13,4,30,8,0,0,8,1,-15,3,1
2,3,38,0,30,3,7,0,10,7,30,6,0,0,6,4,30,1,9,0,10,0,30,2,8,0,10,1,30,6,0,0,6,1,-15,3,1
2,3,4,2,30,7,1,0,8,5,30,4,0,0,4,3,30,1,7,0,8,0,30,7,1,0,8,0,30,3,1,0,4,0,-27,3,0
2,4,4,2,30,7,1,0,8,5,30,4,0,0,4,3,30,1,7,0,8,0,30,7,1,0,8,0,30,3,1,0,4,0,-27,3,0
2,2,13,1,30,7,0,0,7,0,30,4,0,0,4,2,30,6,1,0,7,6,30,7,0,0,7,5,30,4,0,0,4,1,-15,3,1
2,4,13,1,30,7,0,0,7,0,30,4,0,0,4,2,30,6,1,0,7,6,30,7,0,0,7,5,30,4,0,0,4,1,-15,3,1
2,3,17,4,30,10,4,0,14,1,30,6,0,0,6,0,30,8,6,0,14,1,30,3,11,0,14,5,30,4,0,0,4,1,-15,3,1
2,1,19,0,30,1,12,0,13,3,30,7,1,0,8,0,30,4,9,0,13,7,30,6,7,0,13,1,30,9,0,0,9,1,-15,3,1
2,3,23,0,30,5,8,0,13,1,30,6,0,0,6,0,30,13,0,0,13,1,30,6,7,0,13,1,30,6,0,0,6,1,-15,3,1
2,4,23,0,30,5,8,0,13,1,30,6,0,0,6,0,30,13,0,0,13,1,30,6,7,0,13,1,30,6,0,0,6,1,-15,3,1
2,2,25,1,30,8,6,0,14,4,30,6,0,0,6,0,30,9,5,0,14,1,30,8,6,0,14,2,30,6,0,0,6,1,-15,3,1
2,1,27,1,30,7,8,0,15,0,30,1,1,0,2,0,30,6,9,0,15,0,30,3,12,0,15,1,30,4,2,0,6,1,-15,3,1
2,2,27,1,30,7,8,0,15,0,30,1,1,0,2,0,30,6,9,0,15,0,30,3,12,0,15,1,30,4,2,0,6,1,-15,3,1
2,2,39,0,30,3,8,0,11,6,30,6,0,0,6,0,30,6,5,0,11,0,30,2,9,0,11,3,30,5,0,0,5,1,-15,3,1
2,3,39,0,30,3,8,0,11,6,30,6,0,0,6,0,30,6,5,0,11,0,30,2,9,0,11,3,30,5,0,0,5,1,-15,3,1
2,1,13,3,30,7,0,0,7,0,30,4,0,0,4,1,30,6,1,0,7,5,30,5,2,0,7,4,30,4,0,0,4,1,-15,3,1
2,2,13,3,30,7,0,0,7,0,30,4,0,0,4,1,30,6,1,0,7,5,30,5,2,0,7,4,30,4,0,0,4,1,-15,3,1
2,3,13,3,30,7,0,0,7,0,30,4,0,0,4,1,30,6,1,0,7,5,30,5,2,0,7,4,30,4,0,0,4,1,-15,3,1
2,4,13,3,30,7,0,0,7,0,30,4,0,0,4,1,30,6,1,0,7,5,30,5,2,0,7,4,30,4,0,0,4,1,-15,3,1
2,2,25,1,30,6,8,0,14,3,30,6,0,0,6,0,30,6,8,0,14,2,30,5,9,0,14,5,30,6,0,0,6,1,-15,3,1
2,3,25,1,30,6,8,0,14,3,30,6,0,0,6,0,30,6,8,0,14,2,30,5,9,0,14,5,30,6,0,0,6,1,-15,3,1
2,2,31,5,30,8,4,0,12,4,30,8,0,0,8,3,30,8,4,0,12,0,30,4,8,0,12,1,30,4,2,0,6,1,-15,3,1
2,3,31,5,30,8,4,0,12,4,30,8,0,0,8,3,30,8,4,0,12,0,30,4,8,0,12,1,30,4,2,0,6,1,-15,3,1
2,4,31,5,30,8,4,0,12,4,30,8,0,0,8,3,30,8,4,0,12,0,30,4,8,0,12,1,30,4,2,0,6,1,-15,3,1
2,3,32,0,30,7,2,0,9,4,30,2,0,0,2,2,30,8,1,0,9,1,30,2,7,0,9,2,30,2,0,0,2,1,-15,3,1
2,2,38,0,30,2,8,0,10,7,30,6,0,0,6,0,30,1,9,0,10,0,30,4,6,0,10,5,30,6,0,0,6,1,-15,3,1
2,4,38,0,30,2,8,0,10,7,30,6,0,0,6,0,30,1,9,0,10,0,30,4,6,0,10,5,30,6,0,0,6,1,-15,3,1
2,2,1,0,30,4,6,0,10,4,30,2,0,0,2,1,30,4,6,0,10,8,30,9,1,0,10,6,30,6,0,0,6,0,-27,3,0
2,2,6,0,30,7,2,0,9,4,30,2,0,0,2,0,30,2,7,0,9,0,30,4,5,0,9,0,30,3,2,0,5,0,-27,3,0
2,3,8,1,30,7,0,0,7,4,30,2,0,0,2,3,30,2,5,0,7,2,30,7,0,0,7,0,30,3,0,0,3,0,-27,3,0
2,3,11,0,30,1,3,0,4,0,30,0,0,0,0,0,30,0,4,0,4,3,30,2,2,0,4,2,30,1,0,0,1,1,-15,3,1
2,2,13,2,30,6,1,0,7,1,30,4,0,0,4,2,30,6,1,0,7,3,30,5,2,0,7,1,30,4,0,0,4,1,-15,3,1
2,3,13,2,30,6,1,0,7,1,30,4,0,0,4,2,30,6,1,0,7,3,30,5,2,0,7,1,30,4,0,0,4,1,-15,3,1
2,2,17,0,30,8,6,0,14,2,30,6,0,0,6,0,30,6,8,0,14,1,30,5,9,0,14,5,30,4,0,0,4,1,-15,3,1
2,3,17,0,30,8,6,0,14,2,30,6,0,0,6,0,30,6,8,0,14,1,30,5,9,0,14,5,30,4,0,0,4,1,-15,3,1
2,2,27,1,30,8,7,0,15,4,30,2,0,0,2,0,30,7,8,0,15,0,30,4,11,0,15,1,30,5,1,0,6,1,-15,3,1
2,3,27,1,30,8,7,0,15,4,30,2,0,0,2,0,30,7,8,0,15,0,30,4,11,0,15,1,30,5,1,0,6,1,-15,3,1
2,4,27,1,30,8,7,0,15,4,30,2,0,0,2,0,30,7,8,0,15,0,30,4,11,0,15,1,30,5,1,0,6,1,-15,3,1
2,3,39,0,30,5,6,0,11,7,30,6,0,0,6,0,30,4,7,0,11,0,30,3,8,0,11,5,30,5,0,0,5,1,-15,3,1
2,4,39,0,30,5,6,0,11,7,30,6,0,0,6,0,30,4,7,0,11,0,30,3,8,0,11,5,30,5,0,0,5,1,-15,3,1
2,4,7,0,30,1,3,0,4,2,30,2,0,0,2,2,30,2,2,0,4,0,30,1,3,0,4,2,30,1,1,0,2,0,-27,3,0
2,2,8,4,30,7,0,0,7,4,30,2,0,0,2,6,30,4,3,0,7,0,30,5,2,0,7,4,30,3,0,0,3,0,-27,3,0
2,4,8,4,30,7,0,0,7,4,30,2,0,0,2,6,30,4,3,0,7,0,30,5,2,0,7,4,30,3,0,0,3,0,-27,3,0
2,3,9,0,30,4,7,0,11,3,30,6,0,0,6,1,30,7,4,0,11,5,30,3,8,0,11,1,30,4,0,0,4,0,-27,3,0
2,1,13,1,30,7,0,0,7,0,30,4,0,0,4,5,30,7,0,0,7,9,30,4,3,0,7,1,30,4,0,0,4,1,-15,3,1
2,2,13,1,30,7,0,0,7,0,30,4,0,0,4,5,30,7,0,0,7,9,30,4,3,0,7,1,30,4,0,0,4,1,-15,3,1
2,4,19,0,30,5,8,0,13,1,30,4,4,0,8,0,30,9,4,0,13,2,30,5,8,0,13,2,30,8,1,0,9,1,-15,3,1
2,0,21,2,30,7,3,0,10,4,30,4,2,0,6,0,30,3,7,0,10,3,30,5,5,0,10,7,30,4,0,0,4,1,-15,3,1
2,1,21,2,30,7,3,0,10,4,30,4,2,0,6,0,30,3,7,0,10,3,30,5,5,0,10,7,30,4,0,0,4,1,-15,3,1
2,3,21,0,30,7,3,0,10,4,30,4,2,0,6,0,30,3,7,0,10,3,30,5,5,0,10,7,30,4,0,0,4,1,-15,3,1
2,0,26,0,30,7,2,0,9,5,30,4,0,0,4,2,30,0,9,0,9,0,30,3,6,0,9,3,30,1,2,0,3,1,-15,3,1
2,2,26,0,30,7,2,0,9,5,30,4,0,0,4,2,30,0,9,0,9,0,30,3,6,0,9,3,30,1,2,0,3,1,-15,3,1
2,3,26,0,30,7,2,0,9,5,30,4,0,0,4,2,30,0,9,0,9,0,30,3,6,0,9,3,30,1,2,0,3,1,-15,3,1
2,4,26,0,30,7,2,0,9,5,30,4,0,0,4,2,30,0,9,0,9,0,30,3,6,0,9,3,30,1,2,0,3,1,-15,3,1
2,4,27,1,30,8,7,0,15,0,30,1,1,0,2,0,30,3,12,0,15,0,30,4,11,0,15,0,30,3,3,0,6,1,-15,3,1
2,0,4,2,30,6,2,0,8,5,30,4,0,0,4,0,30,1,7,0,8,2,30,8,0,0,8,3,30,4,0,0,4,0,-27,3,0
2,1,4,2,30,6,2,0,8,5,30,4,0,0,4,0,30,1,7,0,8,2,30,8,0,0,8,3,30,4,0,0,4,0,-27,3,0
2,1,13,1,30,5,2,0,7,0,30,4,0,0,4,2,30,6,1,0,7,6,30,5,2,0,7,5,30,4,0,0,4,1,-15,3,1
2,3,13,1,30,5,2,0,7,0,30,4,0,0,4,0,30,6,1,0,7,6,30,5,2,0,7,5,30,4,0,0,4,1,-15,3,1
2,2,27,1,30,4,11,0,15,4,30,2,0,0,2,0,30,4,11,0,15,3,30,4,11,0,15,4,30,6,0,0,6,1,-15,3,1
2,3,27,1,30,4,11,0,15,4,30,2,0,0,2,0,30,4,11,0,15,3,30,4,11,0,15,4,30,6,0,0,6,1,-15,3,1
2,4,27,1,30,4,11,0,15,4,30,2,0,0,2,0,30,4,11,0,15,3,30,4,11,0,15,4,30,6,0,0,6,1,-15,3,1
2,1,29,0,30,5,9,0,14,5,30,12,0,0,12,0,30,6,8,0,14,0,30,1,13,0,14,0,30,7,2,0,9,1,-15,3,1
2,2,29,0,30,5,9,0,14,5,30,12,0,0,12,0,30,6,8,0,14,0,30,1,13,0,14,0,30,7,2,0,9,1,-15,3,1
2,4,29,0,30,5,9,0,14,5,30,12,0,0,12,0,30,6,8,0,14,0,30,1,13,0,14,0,30,7,2,0,9,1,-15,3,1
2,3,31,1,30,5,7,0,12,5,30,8,0,0,8,3,30,8,4,0,12,0,30,9,3,0,12,1,30,4,2,0,6,1,-15,3,1
2,4,31,1,30,5,7,0,12,5,30,8,0,0,8,3,30,8,4,0,12,0,30,9,3,0,12,1,30,4,2,0,6,1,-15,3,1
2,2,39,0,30,4,7,0,11,6,30,6,0,0,6,0,30,6,5,0,11,0,30,2,9,0,11,6,30,5,0,0,5,1,-15,3,1
2,4,39,0,30,4,7,0,11,6,30,6,0,0,6,0,30,6,5,0,11,0,30,2,9,0,11,6,30,5,0,0,5,1,-15,3,1
2,1,5,0,30,3,2,0,5,3,30,0,4,0,4,0,30,0,5,0,5,0,30,1,4,0,5,2,30,2,0,0,2,0,-27,3,0
2,3,5,0,30,3,2,0,5,3,30,0,4,0,4,0,30,0,5,0,5,0,30,1,4,0,5,1,30,2,0,0,2,0,-27,3,0
2,3,7,0,30,0,4,0,4,2,30,2,0,0,2,0,30,1,3,0,4,0,30,1,3,0,4,2,30,2,0,0,2,0,-27,3,0
2,4,13,3,30,5,2,0,7,2,30,4,0,0,4,2,30,5,2,0,7,3,30,7,0,0,7,5,30,4,0,0,4,1,-15,3,1
2,1,23,2,30,5,8,0,13,2,30,6,0,0,6,2,30,13,0,0,13,5,30,6,7,0,13,2,30,5,1,0,6,1,-15,3,1
2,2,23,2,30,5,8,0,13,2,30,6,0,0,6,2,30,13,0,0,13,5,30,6,7,0,13,2,30,5,1,0,6,1,-15,3,1
2,1,26,0,30,5,4,0,9,5,30,4,0,0,4,7,30,1,8,0,9,0,30,2,7,0,9,6,30,3,0,0,3,1,-15,3,1
2,0,27,1,30,4,11,0,15,2,30,2,0,0,2,0,30,7,8,0,15,2,30,5,10,0,15,3,30,6,0,0,6,1,-15,3,1
2,2,27,1,30,4,11,0,15,2,30,2,0,0,2,0,30,7,8,0,15,2,30,5,10,0,15,3,30,6,0,0,6,1,-15,3,1
2,4,27,1,30,4,11,0,15,2,30,2,0,0,2,0,30,7,8,0,15,2,30,5,10,0,15,3,30,6,0,0,6,1,-15,3,1
2,1,29,0,30,9,5,0,14,6,30,12,0,0,12,0,30,3,11,0,14,0,30,1,13,0,14,0,30,9,0,0,9,1,-15,3,1
2,2,29,0,30,9,5,0,14,6,30,12,0,0,12,0,30,3,11,0,14,0,30,1,13,0,14,0,30,9,0,0,9,1,-15,3,1
2,1,37,1,30,6,5,0,11,5,30,8,0,0,8,2,30,9,2,0,11,0,30,4,7,0,11,4,30,6,0,0,6,1,-15,3,1
2,4,37,1,30,6,5,0,11,5,30,8,0,0,8,2,30,9,2,0,11,0,30,4,7,0,11,4,30,6,0,0,6,1,-15,3,1
2,3,39,0,30,4,7,0,11,6,30,6,0,0,6,0,30,8,3,0,11,0,30,4,7,0,11,2,30,5,0,0,5,1,-15,3,1
2,4,39,0,30,4,7,0,11,6,30,6,0,0,6,0,30,8,3,0,11,0,30,4,7,0,11,2,30,5,0,0,5,1,-15,3,1
2,2,41,0,30,7,5,0,12,6,30,8,0,0,8,0,30,6,6,0,12,0,30,3,9,0,12,1,30,5,2,0,7,1,-15,3,1
2,3,41,0,30,7,5,0,12,6,30,8,0,0,8,0,30,6,6,0,12,0,30,3,9,0,12,1,30,5,2,0,7,1,-15,3,1
2,3,47,0,30,0,14,0,14,7,30,4,0,0,4,0,30,4,10,0,14,0,30,2,12,0,14,9,30,7,0,0,7,1,-15,3,1
2,2,13,6,30,7,0,0,7,0,30,4,0,0,4,1,30,7,0,0,7,5,30,6,1,0,7,3,30,4,0,0,4,1,-15,3,1
2,3,17,3,30,9,5,0,14,4,30,6,0,0,6,0,30,5,9,0,14,4,30,3,11,0,14,1,30,4,0,0,4,1,-15,3,1
2,0,19,0,30,2,11,0,13,1,30,7,1,0,8,0,30,10,3,0,13,0,30,4,9,0,13,1,30,7,2,0,9,1,-15,3,1
2,3,19,0,30,2,11,0,13,1,30,7,1,0,8,0,30,10,3,0,13,0,30,4,9,0,13,1,30,7,2,0,9,1,-15,3,1
2,4,23,4,30,7,6,0,13,2,30,6,0,0,6,3,30,12,1,0,13,0,30,4,9,0,13,2,30,5,1,0,6,1,-15,3,1
2,3,25,2,30,8,6,0,14,5,30,6,0,0,6,0,30,6,8,0,14,1,30,5,9,0,14,4,30,5,1,0,6,1,-15,3,1
2,4,25,2,30,8,6,0,14,5,30,6,0,0,6,0,30,6,8,0,14,1,30,5,9,0,14,4,30,5,1,0,6,1,-15,3,1
2,4,27,1,30,4,11,0,15,4,30,2,0,0,2,0,30,6,9,0,15,1,30,6,9,0,15,3,30,6,0,0,6,1,-15,3,1
2,2,5,4,30,5,0,0,5,3,30,0,4,0,4,0,30,0,5,0,5,0,30,1,4,0,5,0,30,0,2,0,2,0,-27,3,0
2,3,5,4,30,5,0,0,5,3,30,0,4,0,4,0,30,0,5,0,5,0,30,1,4,0,5,0,30,0,2,0,2,0,-27,3,0
2,4,22,1,30,8,0,0,8,2,30,2,0,0,2,0,30,4,4,0,8,1,30,4,4,0,8,1,30,1,3,0,4,1,-15,3,1
2,2,23,1,30,5,8,0,13,3,30,6,0,0,6,3,30,10,3,0,13,0,30,5,8,0,13,3,30,6,0,0,6,1,-15,3,1
2,3,23,1,30,5,8,0,13,3,30,6,0,0,6,3,30,10,3,0,13,0,30,5,8,0,13,3,30,6,0,0,6,1,-15,3,1
2,4,23,1,30,5,8,0,13,3,30,6,0,0,6,3,30,10,3,0,13,0,30,5,8,0,13,3,30,6,0,0,6,1,-15,3,1
2,3,25,3,30,10,4,0,14,5,30,6,0,0,6,0,30,4,10,0,14,1,30,7,7,0,14,4,30,4,2,0,6,1,-15,3,1
2,4,25,3,30,10,4,0,14,5,30,6,0,0,6,0,30,4,10,0,14,1,30,7,7,0,14,4,30,4,2,0,6,1,-15,3,1
2,0,29,0,30,7,7,0,14,6,30,9,3,0,12,0,30,3,11,0,14,0,30,1,13,0,14,1,30,9,0,0,9,1,-15,3,1
2,2,29,0,30,7,7,0,14,6,30,9,3,0,12,0,30,3,11,0,14,0,30,1,13,0,14,1,30,9,0,0,9,1,-15,3,1
2,3,31,3,30,8,4,0,12,4,30,8,0,0,8,4,30,9,3,0,12,0,30,3,9,0,12,0,30,4,2,0,6,1,-15,3,1
2,4,31,3,30,8,4,0,12,4,30,8,0,0,8,4,30,9,3,0,12,0,30,3,9,0,12,0,30,4,2,0,6,1,-15,3,1
2,3,5,0,30,3,2,0,5,3,30,3,1,0,4,0,30,0,5,0,5,0,30,1,4,0,5,0,30,1,1,0,2,0,-27,3,0
2,2,13,3,30,6,1,0,7,0,30,4,0,0,4,2,30,7,0,0,7,8,30,5,2,0,7,4,30,4,0,0,4,1,-15,3,1
2,1,17,2,30,10,4,0,14,3,30,6,0,0,6,0,30,3,11,0,14,1,30,5,9,0,14,5,30,4,0,0,4,1,-15,3,1
2,2,19,0,30,3,10,0,13,2,30,5,3,0,8,0,30,7,6,0,13,5,30,4,9,0,13,2,30,9,0,0,9,1,-15,3,1
2,3,23,1,30,4,9,0,13,4,30,6,0,0,6,1,30,10,3,0,13,0,30,6,7,0,13,5,30,6,0,0,6,1,-15,3,1
2,4,23,1,30,4,9,0,13,4,30,6,0,0,6,1,30,10,3,0,13,0,30,6,7,0,13,5,30,6,0,0,6,1,-15,3,1
2,3,25,0,30,5,9,0,14,5,30,6,0,0,6,0,30,3,11,0,14,4,30,10,4,0,14,1,30,6,0,0,6,1,-15,3,1
2,4,25,0,30,5,9,0,14,5,30,6,0,0,6,0,30,3,11,0,14,4,30,10,4,0,14,1,30,6,0,0,6,1,-15,3,1
2,3,27,2,30,7,8,0,15,3,30,2,0,0,2,0,30,6,9,0,15,0,30,4,11,0,15,1,30,3,3,0,6,1,-15,3,1
2,3,29,0,30,5,9,0,14,6,30,12,0,0,12,0,30,5,9,0,14,0,30,1,13,0,14,2,30,9,0,0,9,1,-15,3,1
2,4,31,3,30,3,9,0,12,5,30,8,0,0,8,3,30,9,3,0,12,0,30,3,9,0,12,4,30,2,4,0,6,1,-15,3,1
2,3,36,0,30,3,6,0,9,5,30,2,0,0,2,4,30,6,3,0,9,1,30,5,4,0,9,8,30,3,0,0,3,1,-15,3,1
2,4,43,0,30,5,9,0,14,6,30,6,0,0,6,3,30,4,10,0,14,1,30,1,13,0,14,4,30,5,0,0,5,1,-15,3,1
2,3,7,0,30,4,5,0,9,2,30,4,0,0,4,0,30,8,1,0,9,5,30,3,6,0,9,3,30,5,1,0,6,0,-27,3,0
2,4,8,2,30,7,0,0,7,5,30,2,0,0,2,0,30,1,6,0,7,0,30,7,0,0,7,3,30,3,0,0,3,0,-27,3,0
2,3,17,2,30,11,3,0,14,2,30,6,0,0,6,0,30,7,7,0,14,2,30,6,8,0,14,0,30,3,1,0,4,1,-15,3,1
2,4,17,2,30,11,3,0,14,2,30,6,0,0,6,0,30,7,7,0,14,2,30,6,8,0,14,0,30,3,1,0,4,1,-15,3,1
2,1,19,0,30,6,7,0,13,2,30,7,1,0,8,0,30,4,9,0,13,4,30,5,8,0,13,1,30,8,1,0,9,1,-15,3,1
2,3,19,0,30,6,7,0,13,2,30,7,1,0,8,0,30,4,9,0,13,4,30,5,8,0,13,1,30,8,1,0,9,1,-15,3,1
2,3,22,3,30,5,3,0,8,3,30,2,0,0,2,1,30,5,3,0,8,1,30,7,1,0,8,1,30,2,2,0,4,1,-15,3,1
2,4,23,2,30,8,5,0,13,3,30,6,0,0,6,5,30,10,3,0,13,0,30,5,8,0,13,0,30,6,0,0,6,1,-15,3,1
2,3,25,1,30,8,6,0,14,4,30,6,0,0,6,0,30,6,8,0,14,1,30,5,9,0,14,4,30,5,1,0,6,1,-15,3,1
2,0,27,1,30,4,11,0,15,2,30,1,1,0,2,0,30,6,9,0,15,0,30,4,11,0,15,3,30,6,0,0,6,1,-15,3,1
2,4,27,1,30,4,11,0,15,2,30,1,1,0,2,0,30,6,9,0,15,0,30,4,11,0,15,3,30,6,0,0,6,1,-15,3,1
2,4,29,0,30,10,4,0,14,5,30,11,1,0,12,0,30,3,11,0,14,0,30,0,14,0,14,0,30,8,1,0,9,1,-15,3,1
2,3,31,6,30,9,3,0,12,4,30,8,0,0,8,3,30,8,4,0,12,0,30,3,9,0,12,0,30,1,5,0,6,1,-15,3,1
2,2,39,0,30,2,9,0,11,6,30,6,0,0,6,0,30,5,6,0,11,1,30,6,5,0,11,7,30,5,0,0,5,1,-15,3,1
2,2,21,2,30,6,4,0,10,4,30,6,0,0,6,0,30,3,7,0,10,2,30,5,5,0,10,5,30,4,0,0,4,1,-15,3,1
2,4,21,2,30,6,4,0,10,4,30,6,0,0,6,0,30,3,7,0,10,2,30,5,5,0,10,5,30,4,0,0,4,1,-15,3,1
2,3,25,0,30,4,10,0,14,3,30,6,0,0,6,0,30,7,7,0,14,4,30,9,5,0,14,5,30,6,0,0,6,1,-15,3,1
2,4,25,0,30,4,10,0,14,3,30,6,0,0,6,0,30,7,7,0,14,4,30,9,5,0,14,5,30,6,0,0,6,1,-15,3,1
2,0,27,1,30,6,9,0,15,5,30,2,0,0,2,0,30,2,13,0,15,2,30,4,11,0,15,3,30,6,0,0,6,1,-15,3,1
2,1,27,1,30,6,9,0,15,5,30,2,0,0,2,0,30,2,13,0,15,2,30,4,11,0,15,3,30,6,0,0,6,1,-15,3,1
2,3,27,1,30,6,9,0,15,5,30,2,0,0,2,0,30,2,13,0,15,2,30,4,11,0,15,0,30,6,0,0,6,1,-15,3,1
2,4,27,1,30,6,9,0,15,5,30,2,0,0,2,0,30,2,13,0,15,2,30,4,11,0,15,0,30,6,0,0,6,1,-15,3,1
2,0,17,3,30,10,4,0,14,4,30,6,0,0,6,0,30,3,11,0,14,1,30,8,6,0,14,6,30,4,0,0,4,1,-15,3,1
2,1,17,3,30,10,4,0,14,4,30,6,0,0,6,0,30,3,11,0,14,1,30,8,6,0,14,6,30,4,0,0,4,1,-15,3,1
2,2,17,3,30,10,4,0,14,4,30,6,0,0,6,0,30,3,11,0,14,1,30,8,6,0,14,6,30,4,0,0,4,1,-15,3,1
2,4,17,3,30,10,4,0,14,4,30,6,0,0,6,0,30,3,11,0,14,1,30,8,6,0,14,6,30,4,0,0,4,1,-15,3,1
2,2,19,0,30,4,9,0,13,1,30,7,1,0,8,0,30,7,6,0,13,1,30,3,10,0,13,2,30,7,2,0,9,1,-15,3,1
2,3,19,0,30,4,9,0,13,1,30,7,1,0,8,0,30,7,6,0,13,1,30,3,10,0,13,2,30,7,2,0,9,1,-15,3,1
2,1,25,1,30,13,1,0,14,2,30,6,0,0,6,0,30,5,9,0,14,1,30,5,9,0,14,4,30,6,0,0,6,1,-15,3,1
2,2,25,1,30,13,1,0,14,2,30,6,0,0,6,0,30,5,9,0,14,1,30,5,9,0,14,4,30,6,0,0,6,1,-15,3,1
2,4,25,1,30,13,1,0,14,2,30,6,0,0,6,0,30,5,9,0,14,1,30,5,9,0,14,4,30,6,0,0,6,1,-15,3,1
2,1,27,1,30,3,12,0,15,1,30,1,1,0,2,0,30,6,9,0,15,2,30,5,10,0,15,2,30,6,0,0,6,1,-15,3,1
2,2,27,1,30,3,12,0,15,1,30,1,1,0,2,0,30,6,9,0,15,2,30,5,10,0,15,2,30,6,0,0,6,1,-15,3,1
2,3,27,1,30,3,12,0,15,1,30,1,1,0,2,0,30,6,9,0,15,2,30,5,10,0,15,2,30,6,0,0,6,1,-15,3,1
2,3,29,0,30,7,7,0,14,5,30,10,2,0,12,0,30,4,10,0,14,0,30,0,14,0,14,1,30,9,0,0,9,1,-15,3,1
2,3,33,1,30,3,8,0,11,6,30,4,0,0,4,0,30,6,5,0,11,2,30,5,6,0,11,7,30,4,0,0,4,1,-15,3,1
2,2,11,3,30,4,8,0,12,2,30,4,0,0,4,0,30,6,6,0,12,7,30,7,5,0,12,3,30,4,0,0,4,1,-15,3,1
2,2,15,1,30,6,7,0,13,1,30,6,0,0,6,0,30,4,9,0,13,1,30,6,7,0,13,2,30,7,2,0,9,1,-15,3,1
2,1,17,3,30,8,6,0,14,3,30,6,0,0,6,0,30,6,8,0,14,2,30,9,5,0,14,6,30,4,0,0,4,1,-15,3,1
2,3,17,3,30,8,6,0,14,3,30,6,0,0,6,0,30,6,8,0,14,2,30,9,5,0,14,6,30,4,0,0,4,1,-15,3,1
2,4,17,3,30,8,6,0,14,3,30,6,0,0,6,0,30,6,8,0,14,2,30,9,5,0,14,6,30,4,0,0,4,1,-15,3,1
2,1,19,1,30,5,8,0,13,2,30,5,3,0,8,0,30,4,9,0,13,4,30,5,8,0,13,3,30,8,1,0,9,1,-15,3,1
2,4,19,1,30,5,8,0,13,2,30,5,3,0,8,0,30,4,9,0,13,4,30,5,8,0,13,3,30,8,1,0,9,1,-15,3,1
2,3,23,3,30,5,8,0,13,3,30,6,0,0,6,5,30,13,0,0,13,0,30,5,8,0,13,2,30,5,1,0,6,1,-15,3,1
2,4,23,3,30,5,8,0,13,3,30,6,0,0,6,5,30,13,0,0,13,0,30,5,8,0,13,2,30,5,1,0,6,1,-15,3,1
2,1,27,1,30,4,11,0,15,4,30,2,0,0,2,0,30,6,9,0,15,6,30,4,11,0,15,5,30,6,0,0,6,1,-15,3,1
2,3,27,1,30,4,11,0,15,4,30,2,0,0,2,0,30,6,9,0,15,6,30,4,11,0,15,5,30,6,0,0,6,1,-15,3,1
2,1,29,0,30,5,9,0,14,6,30,11,1,0,12,0,30,5,9,0,14,0,30,2,12,0,14,4,30,9,0,0,9,1,-15,3,1
2,3,29,0,30,5,9,0,14,6,30,11,1,0,12,0,30,5,9,0,14,0,30,2,12,0,14,4,30,9,0,0,9,1,-15,3,1
2,2,37,1,30,6,5,0,11,6,30,8,0,0,8,0,30,5,6,0,11,0,30,3,8,0,11,4,30,6,0,0,6,1,-15,3,1
2,0,45,0,30,8,5,0,13,10,30,10,0,0,10,0,30,2,11,0,13,0,30,4,9,0,13,9,30,5,0,0,5,1,-15,3,1
2,2,45,0,30,8,5,0,13,10,30,10,0,0,10,0,30,2,11,0,13,0,30,4,9,0,13,9,30,5,0,0,5,1,-15,3,1
2,3,45,0,30,8,5,0,13,10,30,10,0,0,10,0,30,2,11,0,13,0,30,4,9,0,13,9,30,5,0,0,5,1,-15,3,1
2,4,8,4,30,7,0,0,7,3,30,2,0,0,2,0,30,4,3,0,7,0,30,4,3,0,7,2,30,3,0,0,3,0,-27,3,0
2,4,11,0,30,1,3,0,4,0,30,0,0,0,0,0,30,2,2,0,4,4,30,3,1,0,4,2,30,1,0,0,1,1,-15,3,1
2,4,13,2,30,6,1,0,7,0,30,4,0,0,4,2,30,7,0,0,7,5,30,4,3,0,7,4,30,4,0,0,4,1,-15,3,1
2,2,17,3,30,10,4,0,14,2,30,6,0,0,6,0,30,6,8,0,14,0,30,5,9,0,14,6,30,4,0,0,4,1,-15,3,1
2,4,17,3,30,10,4,0,14,2,30,6,0,0,6,0,30,6,8,0,14,0,30,5,9,0,14,6,30,4,0,0,4,1,-15,3,1
2,2,19,0,30,2,11,0,13,2,30,4,4,0,8,0,30,6,7,0,13,3,30,5,8,0,13,1,30,9,0,0,9,1,-15,3,1
2,4,19,0,30,2,11,0,13,2,30,4,4,0,8,0,30,6,7,0,13,3,30,5,8,0,13,1,30,9,0,0,9,1,-15,3,1
2,3,35,0,30,7,6,0,13,3,30,2,0,0,2,1,30,6,7,0,13,6,30,3,10,0,13,1,30,8,0,0,8,1,-15,3,1
2,4,35,0,30,7,6,0,13,3,30,2,0,0,2,1,30,6,7,0,13,6,30,3,10,0,13,1,30,8,0,0,8,1,-15,3,1
2,3,45,8,30,5,8,0,13,13,30,10,0,0,10,0,30,1,12,0,13,0,30,4,9,0,13,5,30,5,0,0,5,1,-15,3,1
2,1,5,2,30,3,2,0,5,3,30,0,4,0,4,0,30,0,5,0,5,0,30,1,4,0,5,0,30,1,1,0,2,0,-27,3,0
2,2,5,2,30,3,2,0,5,3,30,0,4,0,4,0,30,0,5,0,5,0,30,1,4,0,5,0,30,1,1,0,2,0,-27,3,0
2,2,8,0,30,7,0,0,7,4,30,2,0,0,2,0,30,3,4,0,7,2,30,6,1,0,7,2,30,3,0,0,3,0,-27,3,0
2,3,8,0,30,7,0,0,7,4,30,2,0,0,2,0,30,3,4,0,7,2,30,6,1,0,7,2,30,3,0,0,3,0,-27,3,0
2,4,8,0,30,7,0,0,7,4,30,2,0,0,2,0,30,3,4,0,7,2,30,6,1,0,7,2,30,3,0,0,3,0,-27,3,0
2,4,11,3,30,7,5,0,12,1,30,4,0,0,4,0,30,7,5,0,12,0,30,5,7,0,12,4,30,4,0,0,4,1,-15,3,1
2,3,13,6,30,7,0,0,7,2,30,4,0,0,4,2,30,6,1,0,7,1,30,5,2,0,7,0,30,4,0,0,4,1,-15,3,1
2,4,13,6,30,7,0,0,7,2,30,4,0,0,4,2,30,6,1,0,7,1,30,5,2,0,7,0,30,4,0,0,4,1,-15,3,1
2,1,17,3,30,9,5,0,14,0,30,6,0,0,6,0,30,7,7,0,14,4,30,6,8,0,14,6,30,4,0,0,4,1,-15,3,1
2,2,23,1,30,3,10,0,13,5,30,6,0,0,6,0,30,4,9,0,13,6,30,9,4,0,13,7,30,6,0,0,6,1,-15,3,1
2,3,23,1,30,3,10,0,13,5,30,6,0,0,6,0,30,4,9,0,13,6,30,9,4,0,13,7,30,6,0,0,6,1,-15,3,1
2,2,29,1,30,5,9,0,14,6,30,10,2,0,12,0,30,6,8,0,14,0,30,1,13,0,14,0,30,9,0,0,9,1,-15,3,1
2,3,29,1,30,5,9,0,14,6,30,10,2,0,12,0,30,6,8,0,14,0,30,1,13,0,14,0,30,9,0,0,9,1,-15,3,1
2,2,5,0,30,0,5,0,5,2,30,2,2,0,4,0,30,1,4,0,5,0,30,1,4,0,5,0,30,0,2,0,2,0,-27,3,0
2,4,5,0,30,0,5,0,5,2,30,2,2,0,4,0,30,1,4,0,5,0,30,1,4,0,5,0,30,0,2,0,2,0,-27,3,0
2,4,11,0,30,5,7,0,12,0,30,4,0,0,4,0,30,10,2,0,12,2,30,7,5,0,12,4,30,4,0,0,4,1,-15,3,1
2,1,13,4,30,7,0,0,7,2,30,4,0,0,4,2,30,5,2,0,7,8,30,7,0,0,7,5,30,4,0,0,4,1,-15,3,1
2,4,17,2,30,10,4,0,14,1,30,6,0,0,6,0,30,8,6,0,14,0,30,5,9,0,14,4,30,4,0,0,4,1,-15,3,1
2,3,19,0,30,2,11,0,13,2,30,5,3,0,8,0,30,5,8,0,13,0,30,4,9,0,13,1,30,8,1,0,9,1,-15,3,1
2,4,19,0,30,2,11,0,13,2,30,5,3,0,8,0,30,5,8,0,13,0,30,4,9,0,13,1,30,8,1,0,9,1,-15,3,1
2,3,23,1,30,5,8,0,13,2,30,6,0,0,6,5,30,10,3,0,13,0,30,5,8,0,13,3,30,6,0,0,6,1,-15,3,1
2,3,25,2,30,7,7,0,14,5,30,6,0,0,6,0,30,8,6,0,14,1,30,5,9,0,14,4,30,5,1,0,6,1,-15,3,1
2,1,27,1,30,4,11,0,15,3,30,2,0,0,2,0,30,4,11,0,15,2,30,3,12,0,15,6,30,6,0,0,6,1,-15,3,1
2,2,29,0,30,5,9,0,14,5,30,9,3,0,12,0,30,7,7,0,14,0,30,1,13,0,14,0,30,9,0,0,9,1,-15,3,1
2,3,29,0,30,5,9,0,14,5,30,9,3,0,12,0,30,7,7,0,14,0,30,1,13,0,14,0,30,9,0,0,9,1,-15,3,1
2,2,33,3,30,2,9,0,11,5,30,4,0,0,4,1,30,10,1,0,11,0,30,3,8,0,11,6,30,4,0,0,4,1,-15,3,1
2,3,33,3,30,2,9,0,11,5,30,4,0,0,4,1,30,10,1,0,11,0,30,3,8,0,11,6,30,4,0,0,4,1,-15,3,1
2,0,38,0,30,4,6,0,10,7,30,6,0,0,6,0,30,2,8,0,10,0,30,4,6,0,10,6,30,6,0,0,6,1,-15,3,1
2,0,43,0,30,7,7,0,14,8,30,6,0,0,6,0,30,4,10,0,14,1,30,1,13,0,14,6,30,5,0,0,5,1,-15,3,1
2,3,43,0,30,7,7,0,14,8,30,6,0,0,6,0,30,4,10,0,14,1,30,1,13,0,14,6,30,5,0,0,5,1,-15,3,1
2,4,43,0,30,7,7,0,14,8,30,6,0,0,6,0,30,4,10,0,14,1,30,1,13,0,14,6,30,5,0,0,5,1,-15,3,1
2,1,13,2,30,7,0,0,7,0,30,4,0,0,4,3,30,7,0,0,7,6,30,6,1,0,7,0,30,4,0,0,4,1,-15,3,1
2,2,13,2,30,7,0,0,7,0,30,4,0,0,4,3,30,7,0,0,7,6,30,6,1,0,7,0,30,4,0,0,4,1,-15,3,1
2,3,15,0,30,5,8,0,13,0,30,5,1,0,6,0,30,4,9,0,13,1,30,4,9,0,13,2,30,6,3,0,9,1,-15,3,1
2,2,21,1,30,5,5,0,10,4,30,6,0,0,6,1,30,2,8,0,10,3,30,3,7,0,10,6,30,4,0,0,4,1,-15,3,1
2,2,25,3,30,12,2,0,14,3,30,6,0,0,6,0,30,8,6,0,14,1,30,5,9,0,14,2,30,5,1,0,6,1,-15,3,1
2,3,25,3,30,12,2,0,14,3,30,6,0,0,6,0,30,8,6,0,14,1,30,5,9,0,14,2,30,5,1,0,6,1,-15,3,1
2,1,27,1,30,5,10,0,15,3,30,2,0,0,2,0,30,7,8,0,15,0,30,4,11,0,15,0,30,5,1,0,6,1,-15,3,1
2,3,27,0,30,5,10,0,15,3,30,2,0,0,2,0,30,7,8,0,15,0,30,4,11,0,15,0,30,5,1,0,6,1,-15,3,1
2,3,29,0,30,7,7,0,14,6,30,12,0,0,12,0,30,3,11,0,14,0,30,1,13,0,14,2,30,9,0,0,9,1,-15,3,1
2,3,31,3,30,7,5,0,12,4,30,8,0,0,8,3,30,10,2,0,12,0,30,3,9,0,12,0,30,3,3,0,6,1,-15,3,1
2,4,31,3,30,7,5,0,12,4,30,8,0,0,8,3,30,10,2,0,12,0,30,3,9,0,12,0,30,3,3,0,6,1,-15,3,1
2,3,33,1,30,2,9,0,11,4,30,4,0,0,4,1,30,10,1,0,11,3,30,4,7,0,11,7,30,4,0,0,4,1,-15,3,1
2,0,41,0,30,5,7,0,12,6,30,8,0,0,8,0,30,7,5,0,12,1,30,4,8,0,12,5,30,7,0,0,7,1,-15,3,1
2,1,41,0,30,5,7,0,12,6,30,8,0,0,8,0,30,7,5,0,12,1,30,4,8,0,12,5,30,7,0,0,7,1,-15,3,1
2,3,41,0,30,5,7,0,12,6,30,8,0,0,8,0,30,7,5,0,12,1,30,4,8,0,12,5,30,7,0,0,7,1,-15,3,1
2,1,17,4,30,9,5,0,14,1,30,6,0,0,6,0,30,12,2,0,14,2,30,6,8,0,14,4,30,4,0,0,4,1,-15,3,1
2,4,17,4,30,9,5,0,14,1,30,6,0,0,6,0,30,12,2,0,14,2,30,6,8,0,14,4,30,4,0,0,4,1,-15,3,1
2,4,19,0,30,4,9,0,13,0,30,8,0,0,8,4,30,6,7,0,13,0,30,3,10,0,13,0,30,6,3,0,9,1,-15,3,1
2,0,21,2,30,6,4,0,10,4,30,4,2,0,6,0,30,3,7,0,10,3,30,6,4,0,10,6,30,4,0,0,4,1,-15,3,1
2,3,21,2,30,6,4,0,10,4,30,4,2,0,6,0,30,3,7,0,10,3,30,6,4,0,10,6,30,4,0,0,4,1,-15,3,1
2,0,41,0,30,8,4,0,12,6,30,6,2,0,8,0,30,4,8,0,12,0,30,3,9,0,12,5,30,7,0,0,7,1,-15,3,1
2,2,41,0,30,8,4,0,12,6,30,6,2,0,8,0,30,4,8,0,12,0,30,3,9,0,12,5,30,7,0,0,7,1,-15,3,1
2,3,41,0,30,8,4,0,12,6,30,6,2,0,8,0,30,4,8,0,12,0,30,3,9,0,12,5,30,7,0,0,7,1,-15,3,1
2,4,43,0,30,5,9,0,14,8,30,6,0,0,6,6,30,7,7,0,14,0,30,7,7,0,14,0,30,5,0,0,5,1,-15,3,1
2,0,5,0,30,2,3,0,5,3,30,3,1,0,4,0,30,0,5,0,5,2,30,1,4,0,5,0,30,0,2,0,2,0,-27,3,0
2,1,5,0,30,2,3,0,5,3,30,3,1,0,4,0,30,0,5,0,5,2,30,1,4,0,5,0,30,0,2,0,2,0,-27,3,0
2,2,5,0,30,2,3,0,5,3,30,3,1,0,4,0,30,0,5,0,5,2,30,1,4,0,5,0,30,0,2,0,2,0,-27,3,0
2,3,5,0,30,2,3,0,5,3,30,3,1,0,4,0,30,0,5,0,5,2,30,1,4,0,5,0,30,0,2,0,2,0,-27,3,0
2,3,7,1,30,6,3,0,9,3,30,4,0,0,4,2,30,6,3,0,9,5,30,2,7,0,9,1,30,5,1,0,6,0,-27,3,0
2,4,7,1,30,6,3,0,9,3,30,4,0,0,4,2,30,6,3,0,9,5,30,2,7,0,9,1,30,5,1,0,6,0,-27,3,0
2,3,11,0,30,5,7,0,12,0,30,4,0,0,4,0,30,9,3,0,12,3,30,7,5,0,12,5,30,4,0,0,4,1,-15,3,1
2,4,13,2,30,6,1,0,7,0,30,4,0,0,4,1,30,6,1,0,7,6,30,5,2,0,7,0,30,4,0,0,4,1,-15,3,1
2,3,17,2,30,8,6,0,14,3,30,6,0,0,6,0,30,2,12,0,14,2,30,6,8,0,14,5,30,4,0,0,4,1,-15,3,1
2,4,17,2,30,8,6,0,14,3,30,6,0,0,6,0,30,2,12,0,14,2,30,6,8,0,14,5,30,4,0,0,4,1,-15,3,1
2,0,21,2,30,7,3,0,10,4,30,6,0,0,6,1,30,3,7,0,10,5,30,5,5,0,10,2,30,4,0,0,4,1,-15,3,1
2,1,21,2,30,7,3,0,10,4,30,6,0,0,6,1,30,3,7,0,10,5,30,5,5,0,10,2,30,4,0,0,4,1,-15,3,1
2,3,21,2,30,7,3,0,10,4,30,6,0,0,6,1,30,3,7,0,10,5,30,5,5,0,10,2,30,4,0,0,4,1,-15,3,1
2,4,21,2,30,7,3,0,10,4,30,6,0,0,6,1,30,3,7,0,10,5,30,5,5,0,10,2,30,4,0,0,4,1,-15,3,1
2,3,25,1,30,6,8,0,14,4,30,6,0,0,6,3,30,10,4,0,14,1,30,4,10,0,14,4,30,5,1,0,6,1,-15,3,1
2,2,43,5,30,9,5,0,14,9,30,6,0,0,6,0,30,4,10,0,14,1,30,1,13,0,14,3,30,5,0,0,5,1,-15,3,1
2,3,43,5,30,9,5,0,14,9,30,6,0,0,6,0,30,4,10,0,14,1,30,1,13,0,14,3,30,5,0,0,5,1,-15,3,1
2,4,2,0,30,8,2,0,10,3,30,4,0,0,4,5,30,4,6,0,10,0,30,7,3,0,10,2,30,3,5,0,8,0,-27,3,0
2,2,6,0,30,7,2,0,9,4,30,2,0,0,2,2,30,3,6,0,9,0,30,5,4,0,9,3,30,5,0,0,5,0,-27,3,0
2,2,13,4,30,7,0,0,7,0,30,4,0,0,4,2,30,6,1,0,7,7,30,6,1,0,7,5,30,4,0,0,4,1,-15,3,1
2,4,13,4,30,7,0,0,7,0,30,4,0,0,4,2,30,6,1,0,7,7,30,6,1,0,7,5,30,4,0,0,4,1,-15,3,1
2,4,15,1,30,3,10,0,13,1,30,6,0,0,6,0,30,4,9,0,13,1,30,3,10,0,13,2,30,8,1,0,9,1,-15,3,1
2,1,19,0,30,4,9,0,13,2,30,5,3,0,8,0,30,5,8,0,13,7,30,6,7,0,13,1,30,8,1,0,9,1,-15,3,1
2,4,23,1,30,6,7,0,13,3,30,6,0,0,6,2,30,12,1,0,13,0,30,4,9,0,13,2,30,5,1,0,6,1,-15,3,1
2,2,27,0,30,4,11,0,15,3,30,2,0,0,2,0,30,10,5,0,15,0,30,5,10,0,15,4,30,6,0,0,6,1,-15,3,1
2,3,27,0,30,4,11,0,15,3,30,2,0,0,2,0,30,10,5,0,15,0,30,5,10,0,15,4,30,6,0,0,6,1,-15,3,1
2,1,38,0,30,3,7,0,10,5,30,6,0,0,6,2,30,10,0,0,10,0,30,4,6,0,10,5,30,6,0,0,6,1,-15,3,1
2,2,38,0,30,3,7,0,10,5,30,6,0,0,6,2,30,10,0,0,10,0,30,4,6,0,10,5,30,6,0,0,6,1,-15,3,1
2,3,38,0,30,3,7,0,10,5,30,6,0,0,6,2,30,10,0,0,10,0,30,4,6,0,10,5,30,6,0,0,6,1,-15,3,1
2,4,38,0,30,3,7,0,10,5,30,6,0,0,6,2,30,10,0,0,10,0,30,4,6,0,10,5,30,6,0,0,6,1,-15,3,1
2,3,39,0,30,1,10,0,11,6,30,6,0,0,6,0,30,4,7,0,11,0,30,2,9,0,11,2,30,5,0,0,5,1,-15,3,1
2,4,1,4,30,8,2,0,10,5,30,2,0,0,2,1,30,3,7,0,10,3,30,7,3,0,10,5,30,6,0,0,6,0,-27,3,0
2,1,17,4,30,10,4,0,14,3,30,6,0,0,6,0,30,7,7,0,14,2,30,6,8,0,14,2,30,4,0,0,4,1,-15,3,1
2,2,26,1,30,6,3,0,9,5,30,2,2,0,4,1,30,0,9,0,9,0,30,4,5,0,9,4,30,1,2,0,3,1,-15,3,1
2,1,27,1,30,7,8,0,15,3,30,2,0,0,2,2,30,8,7,0,15,0,30,9,6,0,15,0,30,2,4,0,6,1,-15,3,1
2,4,27,0,30,7,8,0,15,3,30,2,0,0,2,2,30,8,7,0,15,0,30,9,6,0,15,0,30,2,4,0,6,1,-15,3,1
2,4,29,1,30,8,6,0,14,4,30,8,4,0,12,0,30,5,9,0,14,0,30,2,12,0,14,0,30,9,0,0,9,1,-15,3,1
2,1,13,1,30,6,1,0,7,0,30,4,0,0,4,2,30,6,1,0,7,8,30,5,2,0,7,7,30,4,0,0,4,1,-15,3,1
2,2,13,1,30,6,1,0,7,0,30,4,0,0,4,2,30,6,1,0,7,8,30,5,2,0,7,7,30,4,0,0,4,1,-15,3,1
2,4,15,0,30,4,9,0,13,0,30,6,0,0,6,0,30,6,7,0,13,0,30,4,9,0,13,2,30,9,0,0,9,1,-15,3,1
2,2,19,0,30,4,9,0,13,1,30,6,2,0,8,0,30,7,6,0,13,1,30,8,5,0,13,0,30,8,1,0,9,1,-15,3,1
2,3,23,1,30,7,6,0,13,1,30,6,0,0,6,5,30,13,0,0,13,0,30,5,8,0,13,2,30,6,0,0,6,1,-15,3,1
2,1,25,2,30,5,9,0,14,3,30,6,0,0,6,0,30,8,6,0,14,1,30,5,9,0,14,4,30,5,1,0,6,1,-15,3,1
2,2,25,2,30,5,9,0,14,3,30,6,0,0,6,0,30,8,6,0,14,1,30,5,9,0,14,4,30,5,1,0,6,1,-15,3,1
2,4,25,2,30,5,9,0,14,3,30,6,0,0,6,0,30,8,6,0,14,1,30,5,9,0,14,4,30,5,1,0,6,1,-15,3,1
2,2,39,0,30,3,8,0,11,6,30,6,0,0,6,0,30,6,5,0,11,1,30,5,6,0,11,4,30,5,0,0,5,1,-15,3,1
2,4,39,0,30,3,8,0,11,6,30,6,0,0,6,0,30,6,5,0,11,1,30,5,6,0,11,4,30,5,0,0,5,1,-15,3,1
2,0,47,0,30,4,10,0,14,7,30,4,0,0,4,0,30,4,10,0,14,2,30,5,9,0,14,5,30,7,0,0,7,1,-15,3,1
2,2,47,0,30,4,10,0,14,7,30,4,0,0,4,0,30,4,10,0,14,2,30,5,9,0,14,5,30,7,0,0,7,1,-15,3,1
2,3,6,0,30,8,1,0,9,4,30,2,0,0,2,0,30,3,6,0,9,0,30,4,5,0,9,1,30,5,0,0,5,0,-27,3,0
2,4,6,0,30,8,1,0,9,4,30,2,0,0,2,0,30,3,6,0,9,0,30,4,5,0,9,1,30,5,0,0,5,0,-27,3,0
2,2,17,2,30,8,6,0,14,2,30,6,0,0,6,0,30,8,6,0,14,2,30,8,6,0,14,8,30,4,0,0,4,1,-15,3,1
2,3,23,2,30,6,7,0,13,2,30,6,0,0,6,5,30,13,0,0,13,0,30,6,7,0,13,1,30,5,1,0,6,1,-15,3,1
2,2,25,1,30,7,7,0,14,5,30,6,0,0,6,0,30,7,7,0,14,1,30,7,7,0,14,5,30,6,0,0,6,1,-15,3,1
2,4,25,1,30,7,7,0,14,5,30,6,0,0,6,0,30,7,7,0,14,1,30,7,7,0,14,5,30,6,0,0,6,1,-15,3,1
2,4,27,1,30,3,12,0,15,5,30,1,1,0,2,3,30,6,9,0,15,0,30,4,11,0,15,1,30,4,2,0,6,1,-15,3,1
2,3,29,0,30,6,8,0,14,5,30,10,2,0,12,0,30,5,9,0,14,0,30,0,14,0,14,2,30,9,0,0,9,1,-15,3,1
2,4,32,0,30,2,7,0,9,4,30,2,0,0,2,0,30,6,3,0,9,1,30,2,7,0,9,6,30,2,0,0,2,1,-15,3,1
2,4,45,0,30,5,8,0,13,9,30,10,0,0,10,0,30,2,11,0,13,0,30,4,9,0,13,6,30,5,0,0,5,1,-15,3,1
2,1,5,0,30,1,4,0,5,3,30,1,3,0,4,2,30,1,4,0,5,0,30,1,4,0,5,0,30,0,2,0,2,0,-27,3,0
2,3,5,0,30,1,4,0,5,3,30,1,3,0,4,2,30,1,4,0,5,0,30,1,4,0,5,0,30,0,2,0,2,0,-27,3,0
2,1,13,3,30,5,2,0,7,0,30,4,0,0,4,2,30,6,1,0,7,6,30,6,1,0,7,3,30,4,0,0,4,1,-15,3,1
2,4,13,3,30,5,2,0,7,0,30,4,0,0,4,2,30,6,1,0,7,6,30,6,1,0,7,3,30,4,0,0,4,1,-15,3,1
2,3,15,1,30,4,9,0,13,1,30,6,0,0,6,0,30,5,8,0,13,1,30,8,5,0,13,2,30,4,5,0,9,1,-15,3,1
2,4,19,0,30,4,9,0,13,1,30,4,4,0,8,0,30,9,4,0,13,3,30,4,9,0,13,1,30,8,1,0,9,1,-15,3,1
2,2,21,8,30,8,2,0,10,4,30,5,1,0,6,1,30,5,5,0,10,1,30,4,6,0,10,2,30,4,0,0,4,1,-15,3,1
2,3,21,8,30,8,2,0,10,4,30,5,1,0,6,1,30,5,5,0,10,1,30,4,6,0,10,2,30,4,0,0,4,1,-15,3,1
2,4,23,1,30,8,5,0,13,2,30,6,0,0,6,7,30,9,4,0,13,0,30,3,10,0,13,0,30,6,0,0,6,1,-15,3,1
2,4,31,1,30,5,7,0,12,5,30,8,0,0,8,3,30,10,2,0,12,0,30,3,9,0,12,2,30,6,0,0,6,1,-15,3,1
2,3,5,0,30,2,3,0,5,3,30,0,4,0,4,0,30,0,5,0,5,0,30,1,4,0,5,0,30,1,1,0,2,0,-27,3,0
2,4,8,1,30,6,1,0,7,4,30,2,0,0,2,7,30,2,5,0,7,0,30,5,2,0,7,5,30,3,0,0,3,0,-27,3,0
2,1,9,0,30,2,2,0,4,1,30,2,0,0,2,0,30,2,2,0,4,4,30,1,3,0,4,4,30,1,0,0,1,0,-27,3,0
2,2,9,0,30,2,2,0,4,1,30,2,0,0,2,0,30,2,2,0,4,4,30,1,3,0,4,4,30,1,0,0,1,0,-27,3,0
2,4,9,0,30,2,2,0,4,1,30,2,0,0,2,0,30,2,2,0,4,4,30,1,3,0,4,4,30,1,0,0,1,0,-27,3,0
2,4,19,0,30,4,9,0,13,2,30,4,4,0,8,0,30,7,6,0,13,2,30,4,9,0,13,0,30,9,0,0,9,1,-15,3,1
2,2,25,1,30,5,9,0,14,3,30,6,0,0,6,0,30,5,9,0,14,2,30,8,6,0,14,5,30,6,0,0,6,1,-15,3,1
2,2,27,1,30,6,9,0,15,4,30,1,1,0,2,0,30,3,12,0,15,1,30,5,10,0,15,4,30,6,0,0,6,1,-15,3,1
2,3,27,1,30,6,9,0,15,4,30,1,1,0,2,0,30,3,12,0,15,1,30,5,10,0,15,4,30,6,0,0,6,1,-15,3,1
2,4,27,1,30,6,9,0,15,4,30,1,1,0,2,0,30,3,12,0,15,1,30,5,10,0,15,4,30,6,0,0,6,1,-15,3,1
2,2,29,0,30,5,9,0,14,6,30,12,0,0,12,1,30,4,10,0,14,0,30,0,14,0,14,1,30,9,0,0,9,1,-15,3,1
2,3,29,0,30,5,9,0,14,6,30,12,0,0,12,1,30,4,10,0,14,0,30,0,14,0,14,1,30,9,0,0,9,1,-15,3,1
2,3,4,0,30,6,2,0,8,5,30,3,1,0,4,1,30,1,7,0,8,0,30,8,0,0,8,2,30,3,1,0,4,0,-27,3,0
2,4,6,0,30,5,4,0,9,4,30,2,0,0,2,0,30,3,6,0,9,1,30,5,4,0,9,1,30,5,0,0,5,0,-27,3,0
2,4,11,0,30,1,3,0,4,0,30,0,0,0,0,0,30,4,0,0,4,2,30,4,0,0,4,1,30,1,0,0,1,1,-15,3,1
2,4,11,1,30,5,7,0,12,0,30,4,0,0,4,0,30,9,3,0,12,3,30,7,5,0,12,5,30,4,0,0,4,1,-15,3,1
2,3,13,3,30,7,0,0,7,2,30,4,0,0,4,2,30,6,1,0,7,1,30,5,2,0,7,4,30,4,0,0,4,1,-15,3,1
2,4,13,3,30,7,0,0,7,2,30,4,0,0,4,2,30,6,1,0,7,1,30,5,2,0,7,4,30,4,0,0,4,1,-15,3,1
2,4,17,2,30,7,7,0,14,2,30,6,0,0,6,0,30,6,8,0,14,0,30,7,7,0,14,2,30,4,0,0,4,1,-15,3,1
2,3,19,0,30,3,10,0,13,2,30,8,0,0,8,0,30,6,7,0,13,4,30,6,7,0,13,1,30,7,2,0,9,1,-15,3,1
2,1,27,2,30,7,8,0,15,3,30,2,0,0,2,0,30,9,6,0,15,0,30,5,10,0,15,2,30,3,3,0,6,1,-15,3,1
2,4,27,2,30,7,8,0,15,3,30,2,0,0,2,0,30,9,6,0,15,0,30,5,10,0,15,2,30,3,3,0,6,1,-15,3,1
2,3,35,0,30,9,4,0,13,4,30,2,0,0,2,1,30,5,8,0,13,0,30,1,12,0,13,5,30,8,0,0,8,1,-15,3,1
2,2,37,0,30,8,3,0,11,5,30,6,2,0,8,0,30,9,2,0,11,2,30,3,8,0,11,0,30,6,0,0,6,1,-15,3,1
2,3,43,0,30,10,4,0,14,8,30,6,0,0,6,0,30,4,10,0,14,1,30,1,13,0,14,4,30,5,0,0,5,1,-15,3,1
2,0,17,2,30,8,6,0,14,4,30,6,0,0,6,0,30,2,12,0,14,1,30,8,6,0,14,5,30,4,0,0,4,1,-15,3,1
2,2,17,2,30,8,6,0,14,4,30,6,0,0,6,0,30,2,12,0,14,1,30,8,6,0,14,5,30,4,0,0,4,1,-15,3,1
2,3,17,2,30,8,6,0,14,4,30,6,0,0,6,0,30,2,12,0,14,1,30,8,6,0,14,5,30,4,0,0,4,1,-15,3,1
2,3,19,0,30,4,9,0,13,2,30,6,2,0,8,8,30,5,8,0,13,0,30,6,7,0,13,1,30,8,1,0,9,1,-15,3,1
2,2,25,2,30,7,7,0,14,5,30,6,0,0,6,0,30,6,8,0,14,1,30,5,9,0,14,4,30,5,1,0,6,1,-15,3,1
2,3,25,2,30,7,7,0,14,5,30,6,0,0,6,0,30,6,8,0,14,1,30,5,9,0,14,4,30,5,1,0,6,1,-15,3,1
2,2,11,2,30,4,8,0,12,0,30,4,0,0,4,0,30,6,6,0,12,8,30,4,8,0,12,6,30,4,0,0,4,1,-15,3,1
2,3,13,3,30,3,0,0,3,1,30,2,0,0,2,1,30,3,0,0,3,4,30,2,1,0,3,3,30,2,0,0,2,1,-15,3,1
2,4,15,0,30,4,9,0,13,0,30,6,0,0,6,0,30,3,10,0,13,1,30,3,10,0,13,2,30,7,2,0,9,1,-15,3,1
2,2,17,2,30,10,4,0,14,1,30,6,0,0,6,0,30,8,6,0,14,1,30,5,9,0,14,6,30,4,0,0,4,1,-15,3,1
2,3,17,2,30,10,4,0,14,1,30,6,0,0,6,0,30,8,6,0,14,1,30,5,9,0,14,6,30,4,0,0,4,1,-15,3,1
2,1,19,0,30,3,10,0,13,2,30,7,1,0,8,0,30,6,7,0,13,0,30,3,10,0,13,1,30,9,0,0,9,1,-15,3,1
2,4,19,0,30,3,10,0,13,2,30,7,1,0,8,0,30,6,7,0,13,0,30,3,10,0,13,1,30,9,0,0,9,1,-15,3,1
2,2,25,1,30,5,9,0,14,3,30,6,0,0,6,2,30,12,2,0,14,1,30,4,10,0,14,3,30,5,1,0,6,1,-15,3,1
2,3,25,1,30,5,9,0,14,3,30,6,0,0,6,2,30,12,2,0,14,1,30,4,10,0,14,3,30,5,1,0,6,1,-15,3,1
2,3,31,1,30,5,7,0,12,5,30,8,0,0,8,0,30,9,3,0,12,0,30,9,3,0,12,0,30,5,1,0,6,1,-15,3,1
2,4,31,1,30,5,7,0,12,5,30,8,0,0,8,0,30,9,3,0,12,0,30,9,3,0,12,0,30,5,1,0,6,1,-15,3,1
2,1,4,2,30,6,2,0,8,4,30,4,0,0,4,1,30,3,5,0,8,0,30,7,1,0,8,2,30,3,1,0,4,0,-27,3,0
2,2,13,1,30,5,2,0,7,0,30,4,0,0,4,2,30,7,0,0,7,7,30,5,2,0,7,5,30,4,0,0,4,1,-15,3,1
2,4,13,1,30,5,2,0,7,0,30,4,0,0,4,2,30,7,0,0,7,7,30,5,2,0,7,5,30,4,0,0,4,1,-15,3,1
2,1,17,2,30,10,4,0,14,2,30,6,0,0,6,0,30,4,10,0,14,1,30,5,9,0,14,6,30,4,0,0,4,1,-15,3,1
2,2,25,0,30,5,9,0,14,4,30,6,0,0,6,0,30,8,6,0,14,3,30,5,9,0,14,6,30,6,0,0,6,1,-15,3,1
2,3,25,0,30,5,9,0,14,4,30,6,0,0,6,0,30,8,6,0,14,3,30,5,9,0,14,6,30,6,0,0,6,1,-15,3,1
2,2,27,1,30,4,11,0,15,3,30,1,1,0,2,0,30,2,13,0,15,0,30,6,9,0,15,4,30,6,0,0,6,1,-15,3,1
2,3,32,0,30,5,4,0,9,4,30,2,0,0,2,0,30,8,1,0,9,1,30,3,6,0,9,5,30,2,0,0,2,1,-15,3,1
2,4,32,0,30,5,4,0,9,4,30,2,0,0,2,0,30,8,1,0,9,1,30,3,6,0,9,5,30,2,0,0,2,1,-15,3,1
2,4,35,0,30,7,6,0,13,3,30,2,0,0,2,1,30,3,10,0,13,2,30,3,10,0,13,5,30,8,0,0,8,1,-15,3,1
2,3,38,0,30,3,7,0,10,7,30,6,0,0,6,0,30,1,9,0,10,0,30,0,10,0,10,8,30,6,0,0,6,1,-15,3,1
2,3,17,3,30,11,3,0,14,3,30,6,0,0,6,0,30,5,9,0,14,2,30,6,8,0,14,2,30,4,0,0,4,1,-15,3,1
2,4,17,3,30,11,3,0,14,3,30,6,0,0,6,0,30,5,9,0,14,2,30,6,8,0,14,2,30,4,0,0,4,1,-15,3,1
2,3,23,1,30,11,2,0,13,0,30,6,0,0,6,6,30,13,0,0,13,0,30,5,8,0,13,2,30,6,0,0,6,1,-15,3,1
2,3,25,1,30,8,6,0,14,3,30,6,0,0,6,0,30,6,8,0,14,1,30,4,10,0,14,4,30,5,1,0,6,1,-15,3,1
2,1,27,1,30,4,11,0,15,2,30,2,0,0,2,0,30,9,6,0,15,3,30,4,11,0,15,3,30,6,0,0,6,1,-15,3,1
2,2,27,1,30,4,11,0,15,2,30,2,0,0,2,0,30,9,6,0,15,3,30,4,11,0,15,3,30,6,0,0,6,1,-15,3,1
2,3,35,1,30,8,5,0,13,6,30,2,0,0,2,1,30,2,11,0,13,0,30,1,12,0,13,6,30,8,0,0,8,1,-15,3,1
2,4,1,0,30,5,5,0,10,3,30,2,0,0,2,1,30,6,4,0,10,4,30,6,4,0,10,6,30,6,0,0,6,0,-27,3,0
2,2,17,4,30,9,5,0,14,3,30,6,0,0,6,0,30,4,10,0,14,1,30,6,8,0,14,4,30,4,0,0,4,1,-15,3,1
2,1,19,0,30,6,7,0,13,1,30,6,2,0,8,0,30,5,8,0,13,5,30,6,7,0,13,0,30,8,1,0,9,1,-15,3,1
2,3,19,0,30,6,7,0,13,1,30,6,2,0,8,0,30,5,8,0,13,5,30,6,7,0,13,0,30,8,1,0,9,1,-15,3,1
2,4,19,0,30,6,7,0,13,1,30,6,2,0,8,0,30,5,8,0,13,5,30,6,7,0,13,0,30,8,1,0,9,1,-15,3,1
2,3,23,1,30,4,9,0,13,4,30,6,0,0,6,7,30,11,2,0,13,0,30,3,10,0,13,1,30,6,0,0,6,1,-15,3,1
2,3,31,1,30,2,10,0,12,8,30,8,0,0,8,3,30,4,8,0,12,3,30,10,2,0,12,6,30,6,0,0,6,1,-15,3,1
2,4,31,1,30,2,10,0,12,8,30,8,0,0,8,3,30,4,8,0,12,3,30,10,2,0,12,6,30,6,0,0,6,1,-15,3,1
2,0,38,3,30,1,9,0,10,8,30,6,0,0,6,0,30,1,9,0,10,0,30,5,5,0,10,4,30,6,0,0,6,1,-15,3,1
2,3,38,3,30,1,9,0,10,8,30,6,0,0,6,0,30,1,9,0,10,0,30,5,5,0,10,4,30,6,0,0,6,1,-15,3,1
2,4,47,3,30,4,10,0,14,10,30,4,0,0,4,0,30,3,11,0,14,0,30,4,10,0,14,3,30,6,1,0,7,1,-15,3,1
2,3,7,0,30,2,2,0,4,2,30,2,0,0,2,0,30,2,2,0,4,0,30,1,3,0,4,1,30,2,0,0,2,0,-27,3,0
2,3,8,1,30,7,0,0,7,4,30,2,0,0,2,3,30,2,5,0,7,1,30,2,5,0,7,3,30,3,0,0,3,0,-27,3,0
2,4,8,1,30,7,0,0,7,4,30,2,0,0,2,3,30,2,5,0,7,1,30,2,5,0,7,3,30,3,0,0,3,0,-27,3,0
2,1,13,1,30,5,2,0,7,0,30,4,0,0,4,3,30,6,1,0,7,13,30,7,0,0,7,4,30,4,0,0,4,1,-15,3,1
2,0,27,1,30,2,13,0,15,5,30,1,1,0,2,0,30,5,10,0,15,1,30,4,11,0,15,4,30,6,0,0,6,1,-15,3,1
2,2,27,1,30,2,13,0,15,5,30,1,1,0,2,0,30,5,10,0,15,1,30,4,11,0,15,4,30,6,0,0,6,1,-15,3,1
2,4,27,1,30,2,13,0,15,5,30,1,1,0,2,0,30,5,10,0,15,1,30,4,11,0,15,4,30,6,0,0,6,1,-15,3,1
2,3,31,2,30,8,4,0,12,5,30,8,0,0,8,3,30,8,4,0,12,0,30,5,7,0,12,1,30,6,0,0,6,1,-15,3,1
2,4,31,2,30,8,4,0,12,5,30,8,0,0,8,3,30,8,4,0,12,0,30,5,7,0,12,1,30,6,0,0,6,1,-15,3,1
2,3,39,0,30,1,10,0,11,6,30,6,0,0,6,0,30,4,7,0,11,1,30,3,8,0,11,8,30,5,0,0,5,1,-15,3,1
2,2,8,2,30,7,0,0,7,4,30,2,0,0,2,3,30,2,5,0,7,0,30,5,2,0,7,1,30,3,0,0,3,0,-27,3,0
2,3,8,2,30,7,0,0,7,4,30,2,0,0,2,3,30,2,5,0,7,0,30,5,2,0,7,1,30,3,0,0,3,0,-27,3,0
2,2,13,3,30,6,1,0,7,0,30,4,0,0,4,3,30,7,0,0,7,6,30,6,1,0,7,0,30,4,0,0,4,1,-15,3,1
2,3,13,3,30,6,1,0,7,0,30,4,0,0,4,3,30,7,0,0,7,6,30,6,1,0,7,0,30,4,0,0,4,1,-15,3,1
2,2,17,3,30,9,5,0,14,2,30,6,0,0,6,0,30,7,7,0,14,1,30,6,8,0,14,2,30,4,0,0,4,1,-15,3,1
2,3,17,3,30,9,5,0,14,2,30,6,0,0,6,0,30,7,7,0,14,1,30,6,8,0,14,2,30,4,0,0,4,1,-15,3,1
2,3,22,1,30,7,1,0,8,3,30,2,0,0,2,0,30,3,5,0,8,1,30,4,4,0,8,3,30,4,0,0,4,1,-15,3,1
2,4,22,1,30,7,1,0,8,3,30,2,0,0,2,0,30,3,5,0,8,1,30,4,4,0,8,3,30,4,0,0,4,1,-15,3,1
2,0,25,1,30,6,8,0,14,6,30,6,0,0,6,0,30,3,11,0,14,1,30,9,5,0,14,9,30,6,0,0,6,1,-15,3,1
2,1,25,1,30,6,8,0,14,6,30,6,0,0,6,0,30,3,11,0,14,1,30,9,5,0,14,9,30,6,0,0,6,1,-15,3,1
2,3,29,0,30,8,6,0,14,5,30,12,0,0,12,0,30,9,5,0,14,0,30,1,13,0,14,0,30,8,1,0,9,1,-15,3,1
2,4,29,0,30,8,6,0,14,5,30,12,0,0,12,0,30,9,5,0,14,0,30,1,13,0,14,0,30,8,1,0,9,1,-15,3,1
2,3,33,1,30,3,8,0,11,6,30,4,0,0,4,0,30,6,5,0,11,3,30,8,3,0,11,10,30,4,0,0,4,1,-15,3,1
2,0,5,0,30,2,3,0,5,3,30,2,2,0,4,0,30,0,5,0,5,0,30,2,3,0,5,0,30,0,2,0,2,0,-27,3,0
2,1,5,0,30,2,3,0,5,3,30,2,2,0,4,0,30,0,5,0,5,0,30,2,3,0,5,0,30,0,2,0,2,0,-27,3,0
2,2,5,0,30,2,3,0,5,3,30,2,2,0,4,0,30,0,5,0,5,0,30,2,3,0,5,0,30,0,2,0,2,0,-27,3,0
2,4,5,0,30,2,3,0,5,3,30,2,2,0,4,0,30,0,5,0,5,0,30,2,3,0,5,0,30,0,2,0,2,0,-27,3,0
2,1,13,0,30,2,1,0,3,0,30,2,0,0,2,1,30,3,0,0,3,8,30,2,1,0,3,4,30,2,0,0,2,1,-15,3,1
2,4,13,1,30,5,2,0,7,0,30,4,0,0,4,2,30,7,0,0,7,10,30,6,1,0,7,0,30,4,0,0,4,1,-15,3,1
2,2,19,0,30,3,10,0,13,0,30,8,0,0,8,0,30,7,6,0,13,5,30,4,9,0,13,1,30,8,1,0,9,1,-15,3,1
2,3,25,2,30,6,8,0,14,0,30,6,0,0,6,0,30,12,2,0,14,1,30,4,10,0,14,3,30,5,1,0,6,1,-15,3,1
2,4,25,2,30,6,8,0,14,0,30,6,0,0,6,0,30,12,2,0,14,1,30,4,10,0,14,3,30,5,1,0,6,1,-15,3,1
2,2,27,1,30,3,12,0,15,3,30,2,0,0,2,0,30,9,6,0,15,4,30,4,11,0,15,3,30,6,0,0,6,1,-15,3,1
2,2,35,0,30,7,6,0,13,5,30,2,0,0,2,1,30,4,9,0,13,0,30,1,12,0,13,7,30,8,0,0,8,1,-15,3,1
2,0,4,2,30,6,2,0,8,4,30,3,1,0,4,0,30,1,7,0,8,0,30,6,2,0,8,4,30,4,0,0,4,0,-27,3,0
2,3,6,0,30,4,5,0,9,4,30,2,0,0,2,0,30,2,7,0,9,0,30,4,5,0,9,0,30,5,0,0,5,0,-27,3,0
2,4,8,1,30,7,0,0,7,3,30,2,0,0,2,2,30,3,4,0,7,5,30,7,0,0,7,1,30,3,0,0,3,0,-27,3,0
2,1,13,3,30,7,0,0,7,0,30,4,0,0,4,2,30,6,1,0,7,7,30,6,1,0,7,5,30,4,0,0,4,1,-15,3,1
2,4,15,1,30,4,9,0,13,0,30,6,0,0,6,0,30,5,8,0,13,1,30,4,9,0,13,2,30,9,0,0,9,1,-15,3,1
2,0,17,4,30,9,5,0,14,3,30,6,0,0,6,0,30,3,11,0,14,5,30,6,8,0,14,4,30,4,0,0,4,1,-15,3,1
2,4,17,4,30,9,5,0,14,3,30,6,0,0,6,0,30,3,11,0,14,5,30,6,8,0,14,2,30,4,0,0,4,1,-15,3,1
2,0,19,0,30,8,5,0,13,2,30,6,2,0,8,4,30,4,9,0,13,0,30,6,7,0,13,0,30,7,2,0,9,1,-15,3,1
2,2,19,0,30,8,5,0,13,2,30,6,2,0,8,4,30,4,9,0,13,0,30,6,7,0,13,0,30,7,2,0,9,1,-15,3,1
2,3,19,0,30,8,5,0,13,2,30,6,2,0,8,4,30,4,9,0,13,0,30,6,7,0,13,0,30,7,2,0,9,1,-15,3,1
2,1,25,1,30,9,5,0,14,2,30,6,0,0,6,0,30,8,6,0,14,1,30,5,9,0,14,6,30,5,1,0,6,1,-15,3,1
2,1,29,3,30,7,7,0,14,5,30,12,0,0,12,0,30,3,11,0,14,0,30,1,13,0,14,0,30,6,3,0,9,1,-15,3,1
2,2,29,3,30,7,7,0,14,5,30,12,0,0,12,0,30,3,11,0,14,0,30,1,13,0,14,0,30,6,3,0,9,1,-15,3,1
2,3,29,3,30,7,7,0,14,5,30,12,0,0,12,0,30,3,11,0,14,0,30,1,13,0,14,0,30,6,3,0,9,1,-15,3,1
2,1,31,5,30,8,4,0,12,3,30,8,0,0,8,4,30,11,1,0,12,0,30,3,9,0,12,0,30,1,5,0,6,1,-15,3,1
2,3,35,0,30,6,7,0,13,4,30,2,0,0,2,1,30,6,7,0,13,0,30,5,8,0,13,7,30,8,0,0,8,1,-15,3,1
2,2,41,0,30,7,5,0,12,6,30,8,0,0,8,0,30,7,5,0,12,2,30,4,8,0,12,6,30,7,0,0,7,1,-15,3,1
2,4,41,0,30,7,5,0,12,6,30,8,0,0,8,0,30,7,5,0,12,2,30,4,8,0,12,6,30,7,0,0,7,1,-15,3,1
2,2,5,0,30,2,3,0,5,3,30,1,3,0,4,1,30,1,4,0,5,0,30,1,4,0,5,0,30,0,2,0,2,0,-27,3,0
2,3,5,0,30,2,3,0,5,3,30,1,3,0,4,1,30,1,4,0,5,0,30,1,4,0,5,0,30,0,2,0,2,0,-27,3,0
2,4,5,0,30,2,3,0,5,3,30,1,3,0,4,1,30,1,4,0,5,0,30,1,4,0,5,0,30,0,2,0,2,0,-27,3,0
2,3,6,2,30,9,0,0,9,4,30,2,0,0,2,0,30,2,7,0,9,0,30,4,5,0,9,1,30,3,2,0,5,0,-27,3,0
2,4,6,2,30,9,0,0,9,4,30,2,0,0,2,0,30,2,7,0,9,0,30,4,5,0,9,1,30,3,2,0,5,0,-27,3,0
2,3,8,0,30,6,1,0,7,4,30,2,0,0,2,4,30,1,6,0,7,0,30,4,3,0,7,2,30,3,0,0,3,0,-27,3,0
2,1,13,5,30,7,0,0,7,2,30,4,0,0,4,3,30,6,1,0,7,2,30,7,0,0,7,3,30,4,0,0,4,1,-15,3,1
2,4,15,0,30,5,8,0,13,0,30,6,0,0,6,1,30,7,6,0,13,1,30,5,8,0,13,2,30,9,0,0,9,1,-15,3,1
2,4,23,0,30,4,9,0,13,3,30,6,0,0,6,3,30,9,4,0,13,2,30,5,8,0,13,2,30,6,0,0,6,1,-15,3,1
2,4,25,0,30,8,6,0,14,3,30,5,1,0,6,0,30,7,7,0,14,1,30,4,10,0,14,5,30,5,1,0,6,1,-15,3,1
2,0,29,0,30,6,8,0,14,5,30,9,3,0,12,4,30,5,9,0,14,0,30,4,10,0,14,1,30,9,0,0,9,1,-15,3,1
2,4,29,0,30,6,8,0,14,5,30,9,3,0,12,4,30,5,9,0,14,0,30,4,10,0,14,1,30,9,0,0,9,1,-15,3,1
2,4,31,1,30,7,5,0,12,3,30,8,0,0,8,5,30,11,1,0,12,0,30,3,9,0,12,1,30,2,4,0,6,1,-15,3,1
2,3,47,0,30,0,14,0,14,9,30,4,0,0,4,0,30,3,11,0,14,2,30,7,7,0,14,5,30,7,0,0,7,1,-15,3,1
2,3,6,1,30,6,3,0,9,4,30,2,0,0,2,0,30,2,7,0,9,0,30,4,5,0,9,1,30,4,1,0,5,0,-27,3,0
2,4,6,1,30,6,3,0,9,4,30,2,0,0,2,0,30,2,7,0,9,0,30,4,5,0,9,1,30,4,1,0,5,0,-27,3,0
2,1,17,3,30,5,9,0,14,3,30,6,0,0,6,0,30,6,8,0,14,5,30,8,6,0,14,5,30,4,0,0,4,1,-15,3,1
2,4,17,3,30,5,9,0,14,3,30,6,0,0,6,0,30,6,8,0,14,5,30,8,6,0,14,5,30,4,0,0,4,1,-15,3,1
2,1,19,1,30,5,8,0,13,2,30,4,4,0,8,0,30,4,9,0,13,1,30,4,9,0,13,1,30,9,0,0,9,1,-15,3,1
2,4,19,1,30,5,8,0,13,2,30,4,4,0,8,0,30,4,9,0,13,0,30,4,9,0,13,1,30,9,0,0,9,1,-15,3,1
2,3,21,3,30,8,2,0,10,4,30,6,0,0,6,1,30,3,7,0,10,2,30,5,5,0,10,1,30,3,1,0,4,1,-15,3,1
2,2,27,1,30,4,11,0,15,4,30,2,0,0,2,0,30,3,12,0,15,0,30,6,9,0,15,6,30,6,0,0,6,1,-15,3,1
2,3,27,1,30,4,11,0,15,4,30,2,0,0,2,0,30,3,12,0,15,0,30,6,9,0,15,6,30,6,0,0,6,1,-15,3,1
2,4,27,1,30,4,11,0,15,4,30,2,0,0,2,0,30,3,12,0,15,0,30,6,9,0,15,6,30,6,0,0,6,1,-15,3,1
2,0,29,0,30,7,7,0,14,5,30,7,5,0,12,0,30,3,11,0,14,0,30,5,9,0,14,4,30,9,0,0,9,1,-15,3,1
2,3,33,0,30,4,7,0,11,5,30,4,0,0,4,0,30,9,2,0,11,1,30,8,3,0,11,9,30,4,0,0,4,1,-15,3,1
2,3,35,0,30,7,6,0,13,4,30,2,0,0,2,1,30,5,8,0,13,3,30,4,9,0,13,5,30,8,0,0,8,1,-15,3,1
2,4,35,0,30,7,6,0,13,4,30,2,0,0,2,1,30,5,8,0,13,3,30,4,9,0,13,5,30,8,0,0,8,1,-15,3,1
2,4,7,0,30,0,4,0,4,2,30,2,0,0,2,0,30,1,3,0,4,0,30,1,3,0,4,2,30,1,1,0,2,0,-27,3,0
2,0,11,3,30,4,8,0,12,1,30,4,0,0,4,0,30,8,4,0,12,7,30,6,6,0,12,3,30,4,0,0,4,1,-15,3,1
2,1,11,3,30,4,8,0,12,1,30,4,0,0,4,0,30,8,4,0,12,7,30,6,6,0,12,3,30,4,0,0,4,1,-15,3,1
2,2,11,3,30,4,8,0,12,1,30,4,0,0,4,0,30,8,4,0,12,7,30,6,6,0,12,3,30,4,0,0,4,1,-15,3,1
2,2,13,2,30,6,1,0,7,0,30,4,0,0,4,5,30,7,0,0,7,7,30,3,4,0,7,0,30,4,0,0,4,1,-15,3,1
2,4,13,2,30,6,1,0,7,0,30,4,0,0,4,5,30,7,0,0,7,7,30,3,4,0,7,0,30,4,0,0,4,1,-15,3,1
2,3,17,3,30,8,6,0,14,3,30,6,0,0,6,0,30,7,7,0,14,5,30,7,7,0,14,6,30,4,0,0,4,1,-15,3,1
2,4,17,3,30,8,6,0,14,3,30,6,0,0,6,0,30,7,7,0,14,5,30,7,7,0,14,6,30,4,0,0,4,1,-15,3,1
2,3,19,0,30,4,9,0,13,2,30,7,1,0,8,0,30,4,9,0,13,3,30,4,9,0,13,2,30,9,0,0,9,1,-15,3,1
2,2,21,2,30,6,4,0,10,4,30,6,0,0,6,1,30,3,7,0,10,2,30,5,5,0,10,1,30,4,0,0,4,1,-15,3,1
2,4,23,1,30,7,6,0,13,1,30,6,0,0,6,4,30,13,0,0,13,0,30,5,8,0,13,1,30,5,1,0,6,1,-15,3,1
2,2,25,0,30,8,6,0,14,2,30,6,0,0,6,0,30,9,5,0,14,1,30,5,9,0,14,5,30,5,1,0,6,1,-15,3,1
2,3,27,1,30,3,12,0,15,5,30,2,0,0,2,0,30,5,10,0,15,2,30,3,12,0,15,1,30,5,1,0,6,1,-15,3,1
2,4,29,0,30,6,8,0,14,5,30,11,1,0,12,0,30,5,9,0,14,0,30,1,13,0,14,0,30,8,1,0,9,1,-15,3,1
2,4,31,0,30,8,4,0,12,4,30,8,0,0,8,4,30,9,3,0,12,0,30,3,9,0,12,0,30,6,0,0,6,1,-15,3,1
2,2,32,0,30,3,6,0,9,4,30,2,0,0,2,0,30,8,1,0,9,1,30,3,6,0,9,2,30,2,0,0,2,1,-15,3,1
2,3,5,0,30,0,5,0,5,2,30,4,0,0,4,0,30,0,5,0,5,1,30,2,3,0,5,4,30,2,0,0,2,0,-27,3,0
2,2,13,5,30,5,2,0,7,0,30,4,0,0,4,0,30,6,1,0,7,7,30,5,2,0,7,5,30,4,0,0,4,1,-15,3,1
2,4,13,5,30,5,2,0,7,0,30,4,0,0,4,0,30,6,1,0,7,7,30,5,2,0,7,5,30,4,0,0,4,1,-15,3,1
2,4,19,0,30,5,8,0,13,2,30,8,0,0,8,0,30,6,7,0,13,6,30,5,8,0,13,0,30,8,1,0,9,1,-15,3,1
2,3,23,2,30,7,6,0,13,3,30,6,0,0,6,5,30,12,1,0,13,0,30,5,8,0,13,2,30,5,1,0,6,1,-15,3,1
2,4,23,2,30,7,6,0,13,3,30,6,0,0,6,5,30,12,1,0,13,0,30,5,8,0,13,2,30,5,1,0,6,1,-15,3,1
2,3,25,1,30,6,8,0,14,4,30,6,0,0,6,0,30,4,10,0,14,1,30,7,7,0,14,5,30,5,1,0,6,1,-15,3,1
2,4,31,4,30,8,4,0,12,4,30,8,0,0,8,4,30,11,1,0,12,0,30,3,9,0,12,0,30,3,3,0,6,1,-15,3,1
2,1,33,1,30,2,9,0,11,4,30,4,0,0,4,1,30,9,2,0,11,2,30,6,5,0,11,3,30,4,0,0,4,1,-15,3,1
2,2,5,0,30,2,3,0,5,3,30,4,0,0,4,0,30,0,5,0,5,0,30,3,2,0,5,4,30,2,0,0,2,0,-27,3,0
2,2,13,1,30,7,0,0,7,0,30,4,0,0,4,2,30,5,2,0,7,4,30,6,1,0,7,6,30,4,0,0,4,1,-15,3,1
2,4,13,1,30,7,0,0,7,0,30,4,0,0,4,2,30,5,2,0,7,4,30,6,1,0,7,6,30,4,0,0,4,1,-15,3,1
2,2,17,6,30,9,5,0,14,2,30,6,0,0,6,0,30,9,5,0,14,1,30,6,8,0,14,0,30,4,0,0,4,1,-15,3,1
2,4,25,0,30,5,9,0,14,5,30,6,0,0,6,0,30,7,7,0,14,3,30,7,7,0,14,6,30,6,0,0,6,1,-15,3,1
2,0,27,2,30,5,10,0,15,4,30,2,0,0,2,0,30,3,12,0,15,0,30,4,11,0,15,3,30,6,0,0,6,1,-15,3,1
2,2,27,2,30,5,10,0,15,4,30,2,0,0,2,0,30,3,12,0,15,0,30,4,11,0,15,3,30,6,0,0,6,1,-15,3,1
2,3,27,2,30,5,10,0,15,4,30,2,0,0,2,0,30,3,12,0,15,0,30,4,11,0,15,3,30,6,0,0,6,1,-15,3,1
2,0,29,0,30,7,7,0,14,6,30,11,1,0,12,0,30,6,8,0,14,0,30,1,13,0,14,1,30,9,0,0,9,1,-15,3,1
2,4,39,0,30,4,7,0,11,6,30,6,0,0,6,0,30,4,7,0,11,0,30,2,9,0,11,3,30,4,1,0,5,1,-15,3,1
2,3,47,0,30,0,14,0,14,6,30,4,0,0,4,0,30,3,11,0,14,1,30,3,11,0,14,9,30,7,0,0,7,1,-15,3,1
2,2,13,3,30,7,0,0,7,1,30,4,0,0,4,0,30,6,1,0,7,7,30,5,2,0,7,3,30,4,0,0,4,1,-15,3,1
2,4,19,0,30,3,10,0,13,2,30,4,4,0,8,0,30,4,9,0,13,3,30,4,9,0,13,2,30,9,0,0,9,1,-15,3,1
2,3,25,1,30,5,9,0,14,3,30,6,0,0,6,0,30,11,3,0,14,1,30,5,9,0,14,5,30,6,0,0,6,1,-15,3,1
2,4,25,1,30,5,9,0,14,3,30,6,0,0,6,0,30,11,3,0,14,1,30,5,9,0,14,5,30,6,0,0,6,1,-15,3,1
2,1,27,1,30,3,12,0,15,3,30,2,0,0,2,0,30,1,14,0,15,3,30,4,11,0,15,6,30,6,0,0,6,1,-15,3,1
2,2,27,1,30,3,12,0,15,3,30,2,0,0,2,0,30,1,14,0,15,3,30,4,11,0,15,6,30,6,0,0,6,1,-15,3,1
2,3,27,1,30,3,12,0,15,3,30,2,0,0,2,0,30,1,14,0,15,3,30,4,11,0,15,6,30,6,0,0,6,1,-15,3,1
2,4,27,1,30,3,12,0,15,3,30,2,0,0,2,0,30,1,14,0,15,3,30,4,11,0,15,6,30,6,0,0,6,1,-15,3,1
2,2,29,0,30,7,7,0,14,5,30,10,2,0,12,0,30,3,11,0,14,0,30,1,13,0,14,3,30,9,0,0,9,1,-15,3,1
2,0,4,6,30,8,0,0,8,4,30,4,0,0,4,0,30,3,5,0,8,0,30,2,6,0,8,2,30,4,0,0,4,0,-27,3,0
2,3,5,0,30,2,3,0,5,3,30,1,3,0,4,0,30,0,5,0,5,0,30,3,2,0,5,0,30,0,2,0,2,0,-27,3,0
2,4,5,0,30,2,3,0,5,3,30,1,3,0,4,0,30,0,5,0,5,0,30,3,2,0,5,0,30,0,2,0,2,0,-27,3,0
2,3,8,0,30,6,1,0,7,3,30,2,0,0,2,0,30,4,3,0,7,0,30,5,2,0,7,3,30,3,0,0,3,0,-27,3,0
2,4,8,0,30,6,1,0,7,3,30,2,0,0,2,0,30,4,3,0,7,0,30,5,2,0,7,3,30,3,0,0,3,0,-27,3,0
2,3,21,0,30,8,2,0,10,3,30,5,1,0,6,1,30,4,6,0,10,5,30,4,6,0,10,3,30,4,0,0,4,1,-15,3,1
2,4,23,2,30,5,8,0,13,2,30,6,0,0,6,3,30,11,2,0,13,0,30,4,9,0,13,2,30,6,0,0,6,1,-15,3,1
2,0,25,1,30,6,8,0,14,5,30,6,0,0,6,0,30,7,7,0,14,1,30,5,9,0,14,4,30,6,0,0,6,1,-15,3,1
2,4,25,1,30,6,8,0,14,5,30,6,0,0,6,0,30,7,7,0,14,1,30,5,9,0,14,4,30,6,0,0,6,1,-15,3,1
2,2,26,0,30,7,2,0,9,5,30,4,0,0,4,2,30,0,9,0,9,0,30,4,5,0,9,7,30,3,0,0,3,1,-15,3,1
2,0,27,1,30,4,11,0,15,4,30,2,0,0,2,0,30,3,12,0,15,0,30,6,9,0,15,3,30,6,0,0,6,1,-15,3,1
2,2,27,1,30,4,11,0,15,4,30,2,0,0,2,0,30,3,12,0,15,0,30,6,9,0,15,3,30,6,0,0,6,1,-15,3,1
2,4,27,1,30,4,11,0,15,4,30,2,0,0,2,0,30,3,12,0,15,0,30,6,9,0,15,3,30,6,0,0,6,1,-15,3,1
2,4,35,0,30,7,6,0,13,2,30,2,0,0,2,0,30,10,3,0,13,3,30,2,11,0,13,4,30,8,0,0,8,1,-15,3,1
2,2,39,3,30,5,6,0,11,8,30,6,0,0,6,0,30,4,7,0,11,0,30,4,7,0,11,2,30,5,0,0,5,1,-15,3,1
2,4,39,3,30,5,6,0,11,8,30,6,0,0,6,0,30,4,7,0,11,0,30,4,7,0,11,2,30,5,0,0,5,1,-15,3,1
2,2,5,0,30,2,3,0,5,3,30,1,3,0,4,0,30,0,5,0,5,0,30,1,4,0,5,3,30,2,0,0,2,0,-27,3,0
2,3,5,0,30,2,3,0,5,3,30,1,3,0,4,0,30,0,5,0,5,0,30,1,4,0,5,3,30,2,0,0,2,0,-27,3,0
2,2,13,2,30,5,2,0,7,0,30,4,0,0,4,2,30,5,2,0,7,5,30,7,0,0,7,6,30,4,0,0,4,1,-15,3,1
2,3,13,2,30,5,2,0,7,0,30,4,0,0,4,2,30,5,2,0,7,5,30,7,0,0,7,6,30,4,0,0,4,1,-15,3,1
2,4,13,2,30,5,2,0,7,0,30,4,0,0,4,2,30,5,2,0,7,5,30,7,0,0,7,6,30,4,0,0,4,1,-15,3,1
2,3,17,4,30,8,6,0,14,2,30,6,0,0,6,0,30,9,5,0,14,1,30,5,9,0,14,6,30,4,0,0,4,1,-15,3,1
2,4,17,4,30,8,6,0,14,2,30,6,0,0,6,0,30,9,5,0,14,1,30,5,9,0,14,6,30,4,0,0,4,1,-15,3,1
2,4,19,0,30,3,10,0,13,2,30,3,5,0,8,0,30,7,6,0,13,3,30,2,11,0,13,0,30,9,0,0,9,1,-15,3,1
2,2,25,1,30,5,9,0,14,3,30,6,0,0,6,0,30,6,8,0,14,3,30,7,7,0,14,5,30,5,1,0,6,1,-15,3,1
2,2,27,1,30,4,11,0,15,5,30,2,0,0,2,0,30,5,10,0,15,0,30,3,12,0,15,6,30,4,2,0,6,1,-15,3,1
2,3,27,1,30,4,11,0,15,5,30,2,0,0,2,0,30,5,10,0,15,0,30,3,12,0,15,6,30,4,2,0,6,1,-15,3,1
2,4,27,1,30,4,11,0,15,5,30,2,0,0,2,0,30,5,10,0,15,0,30,3,12,0,15,6,30,4,2,0,6,1,-15,3,1
2,4,31,3,30,3,9,0,12,5,30,8,0,0,8,3,30,9,3,0,12,0,30,7,5,0,12,2,30,5,1,0,6,1,-15,3,1
2,3,45,0,30,5,8,0,13,8,30,10,0,0,10,0,30,2,11,0,13,0,30,4,9,0,13,8,30,5,0,0,5,1,-15,3,1
2,2,13,8,30,7,0,0,7,2,30,4,0,0,4,2,30,6,1,0,7,5,30,6,1,0,7,0,30,3,1,0,4,1,-15,3,1
2,3,13,8,30,7,0,0,7,2,30,4,0,0,4,2,30,6,1,0,7,5,30,6,1,0,7,0,30,3,1,0,4,1,-15,3,1
2,4,13,8,30,7,0,0,7,2,30,4,0,0,4,2,30,6,1,0,7,5,30,6,1,0,7,0,30,3,1,0,4,1,-15,3,1
2,2,19,0,30,3,10,0,13,2,30,5,3,0,8,0,30,8,5,0,13,3,30,6,7,0,13,2,30,8,1,0,9,1,-15,3,1
2,4,23,3,30,7,6,0,13,1,30,6,0,0,6,2,30,13,0,0,13,0,30,6,7,0,13,1,30,6,0,0,6,1,-15,3,1
2,2,25,3,30,7,7,0,14,4,30,6,0,0,6,0,30,8,6,0,14,1,30,5,9,0,14,3,30,5,1,0,6,1,-15,3,1
2,4,25,3,30,7,7,0,14,4,30,6,0,0,6,0,30,8,6,0,14,1,30,5,9,0,14,3,30,5,1,0,6,1,-15,3,1
2,4,27,0,30,5,10,0,15,3,30,2,0,0,2,0,30,3,12,0,15,1,30,7,8,0,15,3,30,6,0,0,6,1,-15,3,1
2,3,29,0,30,9,5,0,14,4,30,11,1,0,12,0,30,4,10,0,14,0,30,1,13,0,14,0,30,9,0,0,9,1,-15,3,1
2,4,29,0,30,9,5,0,14,4,30,11,1,0,12,0,30,4,10,0,14,0,30,1,13,0,14,0,30,9,0,0,9,1,-15,3,1
2,1,31,3,30,10,2,0,12,5,30,8,0,0,8,3,30,6,6,0,12,0,30,3,9,0,12,0,30,2,4,0,6,1,-15,3,1
2,4,35,2,30,9,4,0,13,4,30,2,0,0,2,0,30,6,7,0,13,0,30,1,12,0,13,3,30,8,0,0,8,1,-15,3,1
2,3,39,0,30,3,8,0,11,6,30,6,0,0,6,0,30,7,4,0,11,2,30,2,9,0,11,4,30,5,0,0,5,1,-15,3,1
2,0,47,0,30,3,11,0,14,7,30,4,0,0,4,0,30,6,8,0,14,0,30,2,12,0,14,8,30,7,0,0,7,1,-15,3,1
2,0,4,4,30,6,2,0,8,4,30,3,1,0,4,0,30,2,6,0,8,0,30,5,3,0,8,4,30,4,0,0,4,0,-27,3,0
2,4,4,4,30,6,2,0,8,4,30,3,1,0,4,0,30,2,6,0,8,0,30,5,3,0,8,4,30,4,0,0,4,0,-27,3,0
2,2,13,3,30,7,0,0,7,2,30,4,0,0,4,2,30,6,1,0,7,3,30,6,1,0,7,4,30,4,0,0,4,1,-15,3,1
2,4,13,3,30,7,0,0,7,2,30,4,0,0,4,2,30,6,1,0,7,3,30,6,1,0,7,4,30,4,0,0,4,1,-15,3,1
2,4,19,0,30,9,4,0,13,1,30,5,3,0,8,0,30,6,7,0,13,0,30,3,10,0,13,1,30,7,2,0,9,1,-15,3,1
2,3,25,0,30,6,8,0,14,4,30,6,0,0,6,4,30,11,3,0,14,1,30,7,7,0,14,3,30,5,1,0,6,1,-15,3,1
2,4,25,0,30,6,8,0,14,4,30,6,0,0,6,4,30,11,3,0,14,1,30,7,7,0,14,3,30,5,1,0,6,1,-15,3,1
2,4,27,0,30,5,10,0,15,4,30,1,1,0,2,0,30,7,8,0,15,1,30,4,11,0,15,3,30,6,0,0,6,1,-15,3,1
2,4,29,0,30,8,6,0,14,5,30,9,3,0,12,0,30,4,10,0,14,0,30,0,14,0,14,5,30,9,0,0,9,1,-15,3,1
2,4,8,1,30,7,0,0,7,3,30,2,0,0,2,3,30,4,3,0,7,2,30,6,1,0,7,0,30,3,0,0,3,0,-27,3,0
2,4,9,0,30,1,3,0,4,2,30,2,0,0,2,0,30,0,4,0,4,0,30,1,3,0,4,0,30,0,1,0,1,0,-27,3,0
2,2,17,3,30,8,6,0,14,3,30,6,0,0,6,0,30,7,7,0,14,4,30,6,8,0,14,0,30,4,0,0,4,1,-15,3,1
2,4,17,3,30,8,6,0,14,3,30,6,0,0,6,0,30,7,7,0,14,4,30,6,8,0,14,0,30,4,0,0,4,1,-15,3,1
2,4,23,2,30,4,9,0,13,4,30,6,0,0,6,7,30,11,2,0,13,0,30,4,9,0,13,3,30,6,0,0,6,1,-15,3,1
2,2,25,2,30,6,8,0,14,4,30,6,0,0,6,0,30,6,8,0,14,1,30,9,5,0,14,3,30,6,0,0,6,1,-15,3,1
2,4,25,2,30,6,8,0,14,4,30,6,0,0,6,0,30,6,8,0,14,0,30,9,5,0,14,3,30,6,0,0,6,1,-15,3,1
2,3,29,0,30,7,7,0,14,6,30,10,2,0,12,0,30,3,11,0,14,0,30,1,13,0,14,4,30,9,0,0,9,1,-15,3,1
2,2,35,0,30,5,8,0,13,5,30,2,0,0,2,1,30,6,7,0,13,0,30,2,11,0,13,4,30,8,0,0,8,1,-15,3,1
2,2,37,1,30,6,5,0,11,7,30,8,0,0,8,0,30,4,7,0,11,2,30,3,8,0,11,6,30,6,0,0,6,1,-15,3,1
2,3,37,1,30,6,5,0,11,7,30,8,0,0,8,0,30,4,7,0,11,2,30,3,8,0,11,6,30,6,0,0,6,1,-15,3,1
2,4,37,1,30,6,5,0,11,7,30,8,0,0,8,0,30,4,7,0,11,2,30,3,8,0,11,6,30,6,0,0,6,1,-15,3,1
2,0,41,0,30,6,6,0,12,7,30,8,0,0,8,0,30,3,9,0,12,2,30,3,9,0,12,5,30,7,0,0,7,1,-15,3,1
2,2,41,0,30,6,6,0,12,7,30,8,0,0,8,0,30,3,9,0,12,2,30,3,9,0,12,5,30,7,0,0,7,1,-15,3,1
2,3,41,0,30,6,6,0,12,7,30,8,0,0,8,0,30,3,9,0,12,2,30,3,9,0,12,5,30,7,0,0,7,1,-15,3,1
2,0,47,0,30,2,12,0,14,6,30,4,0,0,4,0,30,7,7,0,14,1,30,6,8,0,14,9,30,7,0,0,7,1,-15,3,1
2,2,4,2,30,5,3,0,8,4,30,4,0,0,4,1,30,4,4,0,8,1,30,8,0,0,8,2,30,4,0,0,4,0,-27,3,0
2,1,5,0,30,2,3,0,5,2,30,3,1,0,4,1,30,1,4,0,5,0,30,1,4,0,5,0,30,0,2,0,2,0,-27,3,0
2,3,5,0,30,2,3,0,5,2,30,3,1,0,4,1,30,1,4,0,5,0,30,1,4,0,5,0,30,0,2,0,2,0,-27,3,0
2,4,5,0,30,2,3,0,5,2,30,3,1,0,4,1,30,1,4,0,5,0,30,1,4,0,5,0,30,0,2,0,2,0,-27,3,0
2,4,11,0,30,1,3,0,4,0,30,0,0,0,0,1,30,3,1,0,4,3,30,1,3,0,4,1,30,1,0,0,1,1,-15,3,1
2,1,11,0,30,4,8,0,12,0,30,4,0,0,4,0,30,7,5,0,12,6,30,6,6,0,12,5,30,4,0,0,4,1,-15,3,1
2,1,13,1,30,7,0,0,7,0,30,4,0,0,4,3,30,5,2,0,7,7,30,6,1,0,7,7,30,4,0,0,4,1,-15,3,1
2,4,15,1,30,4,9,0,13,1,30,6,0,0,6,0,30,3,10,0,13,1,30,4,9,0,13,3,30,9,0,0,9,1,-15,3,1
2,2,17,3,30,9,5,0,14,3,30,6,0,0,6,0,30,7,7,0,14,2,30,5,9,0,14,0,30,4,0,0,4,1,-15,3,1
2,1,19,0,30,4,9,0,13,2,30,7,1,0,8,0,30,4,9,0,13,0,30,7,6,0,13,1,30,9,0,0,9,1,-15,3,1
2,4,19,0,30,4,9,0,13,2,30,7,1,0,8,0,30,4,9,0,13,0,30,7,6,0,13,1,30,9,0,0,9,1,-15,3,1
2,1,21,3,30,8,2,0,10,4,30,6,0,0,6,1,30,3,7,0,10,4,30,5,5,0,10,0,30,4,0,0,4,1,-15,3,1
2,2,21,3,30,8,2,0,10,4,30,6,0,0,6,1,30,3,7,0,10,4,30,5,5,0,10,0,30,4,0,0,4,1,-15,3,1
2,0,27,1,30,4,11,0,15,3,30,1,1,0,2,0,30,6,9,0,15,1,30,9,6,0,15,6,30,6,0,0,6,1,-15,3,1
2,3,33,3,30,6,5,0,11,5,30,4,0,0,4,4,30,11,0,0,11,0,30,3,8,0,11,0,30,4,0,0,4,1,-15,3,1
2,0,4,3,30,4,4,0,8,4,30,2,2,0,4,0,30,3,5,0,8,1,30,8,0,0,8,3,30,4,0,0,4,0,-27,3,0
2,2,4,0,30,4,4,0,8,4,30,2,2,0,4,0,30,3,5,0,8,1,30,8,0,0,8,3,30,4,0,0,4,0,-27,3,0
2,4,4,0,30,4,4,0,8,4,30,2,2,0,4,0,30,3,5,0,8,1,30,8,0,0,8,3,30,4,0,0,4,0,-27,3,0
2,1,5,0,30,2,3,0,5,3,30,3,1,0,4,0,30,0,5,0,5,0,30,1,4,0,5,3,30,2,0,0,2,0,-27,3,0
2,2,5,0,30,2,3,0,5,3,30,3,1,0,4,0,30,0,5,0,5,0,30,1,4,0,5,3,30,2,0,0,2,0,-27,3,0
2,3,11,1,30,4,0,0,4,0,30,0,0,0,0,0,30,2,2,0,4,4,30,2,2,0,4,3,30,1,0,0,1,1,-15,3,1
2,3,15,0,30,7,6,0,13,0,30,3,3,0,6,0,30,7,6,0,13,1,30,3,10,0,13,3,30,4,5,0,9,1,-15,3,1
2,1,19,0,30,3,10,0,13,2,30,4,4,0,8,0,30,7,6,0,13,11,30,6,7,0,13,1,30,9,0,0,9,1,-15,3,1
2,3,23,2,30,8,5,0,13,3,30,6,0,0,6,3,30,10,3,0,13,0,30,6,7,0,13,1,30,6,0,0,6,1,-15,3,1
2,1,27,1,30,4,11,0,15,2,30,2,0,0,2,0,30,5,10,0,15,2,30,5,10,0,15,3,30,6,0,0,6,1,-15,3,1
2,2,27,1,30,4,11,0,15,2,30,2,0,0,2,0,30,5,10,0,15,2,30,5,10,0,15,3,30,6,0,0,6,1,-15,3,1
2,2,39,0,30,10,1,0,11,6,30,6,0,0,6,0,30,5,6,0,11,0,30,3,8,0,11,5,30,5,0,0,5,1,-15,3,1
2,4,3,1,30,4,0,0,4,3,30,4,0,0,4,0,30,0,4,0,4,3,30,0,4,0,4,2,30,2,1,0,3,0,-27,3,0
2,2,4,2,30,8,0,0,8,4,30,4,0,0,4,0,30,4,4,0,8,0,30,4,4,0,8,0,30,4,0,0,4,0,-27,3,0
2,2,15,1,30,5,8,0,13,2,30,6,0,0,6,0,30,3,10,0,13,1,30,9,4,0,13,2,30,6,3,0,9,1,-15,3,1
2,2,17,5,30,10,4,0,14,4,30,6,0,0,6,0,30,4,10,0,14,1,30,6,8,0,14,4,30,4,0,0,4,1,-15,3,1
2,3,19,0,30,9,4,0,13,0,30,7,1,0,8,0,30,10,3,0,13,0,30,3,10,0,13,1,30,6,3,0,9,1,-15,3,1
2,4,19,0,30,9,4,0,13,0,30,7,1,0,8,0,30,10,3,0,13,0,30,3,10,0,13,1,30,6,3,0,9,1,-15,3,1
2,2,27,1,30,5,10,0,15,4,30,2,0,0,2,0,30,2,13,0,15,5,30,4,11,0,15,3,30,6,0,0,6,1,-15,3,1
2,3,31,5,30,6,6,0,12,4,30,8,0,0,8,4,30,12,0,0,12,0,30,3,9,0,12,0,30,3,3,0,6,1,-15,3,1
2,4,31,5,30,6,6,0,12,4,30,8,0,0,8,4,30,12,0,0,12,0,30,3,9,0,12,0,30,3,3,0,6,1,-15,3,1
2,3,1,0,30,7,3,0,10,5,30,2,0,0,2,0,30,3,7,0,10,2,30,8,2,0,10,5,30,6,0,0,6,0,-27,3,0
2,4,1,0,30,7,3,0,10,5,30,2,0,0,2,0,30,3,7,0,10,2,30,8,2,0,10,5,30,6,0,0,6,0,-27,3,0
2,4,4,2,30,7,1,0,8,4,30,4,0,0,4,0,30,1,7,0,8,0,30,1,7,0,8,1,30,4,0,0,4,0,-27,3,0
2,2,6,2,30,6,3,0,9,3,30,2,0,0,2,0,30,6,3,0,9,0,30,5,4,0,9,0,30,4,1,0,5,0,-27,3,0
2,3,8,3,30,7,0,0,7,4,30,2,0,0,2,3,30,4,3,0,7,0,30,6,1,0,7,3,30,3,0,0,3,0,-27,3,0
2,3,9,2,30,3,1,0,4,3,30,2,0,0,2,0,30,0,4,0,4,0,30,1,3,0,4,1,30,1,0,0,1,0,-27,3,0
2,3,17,0,30,8,6,0,14,2,30,6,0,0,6,0,30,6,8,0,14,4,30,6,8,0,14,4,30,4,0,0,4,1,-15,3,1
2,1,19,1,30,5,8,0,13,2,30,7,1,0,8,0,30,5,8,0,13,3,30,8,5,0,13,0,30,7,2,0,9,1,-15,3,1
2,2,19,1,30,5,8,0,13,2,30,7,1,0,8,0,30,5,8,0,13,3,30,8,5,0,13,0,30,7,2,0,9,1,-15,3,1
2,3,19,1,30,5,8,0,13,2,30,7,1,0,8,0,30,5,8,0,13,3,30,8,5,0,13,0,30,7,2,0,9,1,-15,3,1
2,4,19,1,30,5,8,0,13,2,30,7,1,0,8,0,30,5,8,0,13,3,30,8,5,0,13,0,30,7,2,0,9,1,-15,3,1
2,4,25,1,30,9,5,0,14,1,30,6,0,0,6,0,30,9,5,0,14,1,30,5,9,0,14,2,30,4,2,0,6,1,-15,3,1
2,1,27,1,30,5,10,0,15,0,30,2,0,0,2,0,30,7,8,0,15,2,30,7,8,0,15,4,30,6,0,0,6,1,-15,3,1
2,0,29,0,30,9,5,0,14,6,30,10,2,0,12,0,30,3,11,0,14,0,30,1,13,0,14,4,30,9,0,0,9,1,-15,3,1
2,2,29,0,30,9,5,0,14,6,30,10,2,0,12,0,30,3,11,0,14,0,30,1,13,0,14,4,30,9,0,0,9,1,-15,3,1
2,3,29,0,30,9,5,0,14,6,30,10,2,0,12,0,30,3,11,0,14,0,30,1,13,0,14,4,30,9,0,0,9,1,-15,3,1
2,4,35,0,30,3,10,0,13,2,30,2,0,0,2,1,30,12,1,0,13,0,30,1,12,0,13,2,30,8,0,0,8,1,-15,3,1
2,3,3,2,30,1,3,0,4,3,30,4,0,0,4,0,30,2,2,0,4,4,30,2,2,0,4,0,30,1,2,0,3,0,-27,3,0
2,2,6,1,30,5,4,0,9,4,30,2,0,0,2,0,30,2,7,0,9,0,30,4,5,0,9,1,30,5,0,0,5,0,-27,3,0
2,3,11,0,30,6,6,0,12,1,30,4,0,0,4,0,30,5,7,0,12,4,30,6,6,0,12,6,30,4,0,0,4,1,-15,3,1
2,4,11,0,30,6,6,0,12,1,30,4,0,0,4,0,30,5,7,0,12,4,30,6,6,0,12,6,30,4,0,0,4,1,-15,3,1
2,0,19,1,30,3,10,0,13,3,30,7,1,0,8,0,30,5,8,0,13,5,30,8,5,0,13,2,30,9,0,0,9,1,-15,3,1
2,1,19,1,30,3,10,0,13,3,30,7,1,0,8,0,30,5,8,0,13,5,30,8,5,0,13,2,30,9,0,0,9,1,-15,3,1
2,3,19,1,30,3,10,0,13,3,30,7,1,0,8,0,30,5,8,0,13,5,30,8,5,0,13,2,30,9,0,0,9,1,-15,3,1
2,4,19,1,30,3,10,0,13,3,30,7,1,0,8,0,30,5,8,0,13,5,30,8,5,0,13,2,30,9,0,0,9,1,-15,3,1
2,4,35,0,30,8,5,0,13,6,30,0,2,0,2,0,30,2,11,0,13,6,30,5,8,0,13,6,30,8,0,0,8,1,-15,3,1
2,2,39,0,30,4,7,0,11,6,30,6,0,0,6,4,30,8,3,0,11,0,30,3,8,0,11,3,30,5,0,0,5,1,-15,3,1
2,4,39,0,30,4,7,0,11,6,30,6,0,0,6,4,30,8,3,0,11,0,30,3,8,0,11,3,30,5,0,0,5,1,-15,3,1
2,3,1,0,30,7,3,0,10,4,30,2,0,0,2,0,30,4,6,0,10,3,30,5,5,0,10,6,30,6,0,0,6,0,-27,3,0
2,4,4,0,30,7,1,0,8,4,30,4,0,0,4,0,30,1,7,0,8,0,30,2,6,0,8,2,30,4,0,0,4,0,-27,3,0
2,4,6,0,30,7,2,0,9,3,30,2,0,0,2,0,30,5,4,0,9,0,30,4,5,0,9,0,30,4,1,0,5,0,-27,3,0
2,4,15,0,30,3,10,0,13,0,30,6,0,0,6,0,30,6,7,0,13,1,30,5,8,0,13,2,30,6,3,0,9,1,-15,3,1
2,1,17,3,30,9,5,0,14,2,30,6,0,0,6,0,30,4,10,0,14,4,30,6,8,0,14,2,30,4,0,0,4,1,-15,3,1
2,4,19,0,30,4,9,0,13,2,30,5,3,0,8,0,30,6,7,0,13,7,30,4,9,0,13,0,30,9,0,0,9,1,-15,3,1
2,1,27,1,30,6,9,0,15,2,30,1,1,0,2,0,30,6,9,0,15,2,30,6,9,0,15,4,30,6,0,0,6,1,-15,3,1
2,2,27,1,30,6,9,0,15,2,30,1,1,0,2,0,30,6,9,0,15,2,30,6,9,0,15,4,30,6,0,0,6,1,-15,3,1
2,4,29,0,30,5,9,0,14,6,30,12,0,0,12,0,30,5,9,0,14,0,30,0,14,0,14,1,30,9,0,0,9,1,-15,3,1
2,2,31,2,30,6,6,0,12,4,30,8,0,0,8,5,30,10,2,0,12,0,30,3,9,0,12,0,30,3,3,0,6,1,-15,3,1
2,3,31,2,30,6,6,0,12,4,30,8,0,0,8,5,30,10,2,0,12,0,30,3,9,0,12,0,30,3,3,0,6,1,-15,3,1
2,4,31,2,30,6,6,0,12,4,30,8,0,0,8,5,30,10,2,0,12,0,30,3,9,0,12,0,30,3,3,0,6,1,-15,3,1
2,3,33,1,30,2,9,0,11,4,30,4,0,0,4,1,30,9,2,0,11,0,30,3,8,0,11,5,30,4,0,0,4,1,-15,3,1
2,2,35,0,30,5,8,0,13,4,30,2,0,0,2,1,30,9,4,0,13,2,30,4,9,0,13,7,30,8,0,0,8,1,-15,3,1
2,3,6,0,30,8,1,0,9,3,30,2,0,0,2,0,30,5,4,0,9,0,30,3,6,0,9,0,30,5,0,0,5,0,-27,3,0
2,1,13,3,30,4,3,0,7,0,30,4,0,0,4,1,30,6,1,0,7,6,30,6,1,0,7,5,30,4,0,0,4,1,-15,3,1
2,4,13,3,30,4,3,0,7,0,30,4,0,0,4,1,30,6,1,0,7,6,30,6,1,0,7,5,30,4,0,0,4,1,-15,3,1
2,0,17,4,30,11,3,0,14,3,30,6,0,0,6,0,30,6,8,0,14,2,30,6,8,0,14,3,30,4,0,0,4,1,-15,3,1
2,2,17,4,30,11,3,0,14,3,30,6,0,0,6,0,30,6,8,0,14,2,30,6,8,0,14,3,30,4,0,0,4,1,-15,3,1
2,1,19,0,30,4,9,0,13,2,30,6,2,0,8,0,30,5,8,0,13,4,30,4,9,0,13,0,30,9,0,0,9,1,-15,3,1
2,3,19,0,30,4,9,0,13,2,30,6,2,0,8,0,30,5,8,0,13,4,30,4,9,0,13,0,30,9,0,0,9,1,-15,3,1
2,4,19,0,30,4,9,0,13,2,30,6,2,0,8,0,30,5,8,0,13,4,30,4,9,0,13,0,30,9,0,0,9,1,-15,3,1
2,2,21,2,30,7,3,0,10,4,30,6,0,0,6,1,30,3,7,0,10,2,30,5,5,0,10,1,30,4,0,0,4,1,-15,3,1
2,2,23,2,30,6,7,0,13,3,30,6,0,0,6,5,30,10,3,0,13,0,30,6,7,0,13,2,30,6,0,0,6,1,-15,3,1
2,3,23,2,30,6,7,0,13,3,30,6,0,0,6,5,30,10,3,0,13,0,30,6,7,0,13,2,30,6,0,0,6,1,-15,3,1
2,4,23,2,30,6,7,0,13,3,30,6,0,0,6,5,30,10,3,0,13,0,30,6,7,0,13,2,30,6,0,0,6,1,-15,3,1
2,2,25,1,30,2,12,0,14,2,30,6,0,0,6,0,30,10,4,0,14,1,30,5,9,0,14,4,30,6,0,0,6,1,-15,3,1
2,1,27,1,30,5,10,0,15,4,30,1,1,0,2,0,30,5,10,0,15,1,30,3,12,0,15,5,30,6,0,0,6,1,-15,3,1
2,2,29,0,30,3,11,0,14,6,30,11,1,0,12,0,30,7,7,0,14,0,30,1,13,0,14,5,30,9,0,0,9,1,-15,3,1
2,2,31,1,30,4,8,0,12,7,30,8,0,0,8,3,30,4,8,0,12,0,30,9,3,0,12,4,30,6,0,0,6,1,-15,3,1
2,3,31,1,30,4,8,0,12,7,30,8,0,0,8,3,30,4,8,0,12,0,30,9,3,0,12,4,30,6,0,0,6,1,-15,3,1
2,3,35,6,30,7,6,0,13,2,30,1,1,0,2,0,30,6,7,0,13,0,30,1,12,0,13,0,30,7,1,0,8,1,-15,3,1
2,1,17,2,30,8,6,0,14,3,30,6,0,0,6,0,30,4,10,0,14,3,30,5,9,0,14,6,30,4,0,0,4,1,-15,3,1
2,3,17,2,30,8,6,0,14,3,30,6,0,0,6,0,30,4,10,0,14,3,30,5,9,0,14,6,30,4,0,0,4,1,-15,3,1
2,4,17,2,30,8,6,0,14,3,30,6,0,0,6,0,30,4,10,0,14,3,30,5,9,0,14,6,30,4,0,0,4,1,-15,3,1
2,1,19,0,30,3,10,0,13,2,30,6,2,0,8,0,30,4,9,0,13,3,30,6,7,0,13,2,30,8,1,0,9,1,-15,3,1
2,2,19,0,30,3,10,0,13,2,30,6,2,0,8,0,30,4,9,0,13,3,30,6,7,0,13,2,30,8,1,0,9,1,-15,3,1
2,4,19,0,30,3,10,0,13,2,30,6,2,0,8,0,30,4,9,0,13,3,30,6,7,0,13,2,30,8,1,0,9,1,-15,3,1
2,3,23,2,30,8,5,0,13,1,30,6,0,0,6,4,30,11,2,0,13,0,30,6,7,0,13,4,30,6,0,0,6,1,-15,3,1
2,1,25,1,30,6,8,0,14,4,30,6,0,0,6,0,30,7,7,0,14,1,30,6,8,0,14,3,30,5,1,0,6,1,-15,3,1
2,3,25,1,30,6,8,0,14,4,30,6,0,0,6,0,30,7,7,0,14,1,30,6,8,0,14,3,30,5,1,0,6,1,-15,3,1
2,2,26,0,30,9,0,0,9,5,30,4,0,0,4,2,30,0,9,0,9,0,30,2,7,0,9,6,30,3,0,0,3,1,-15,3,1
2,3,26,0,30,9,0,0,9,5,30,4,0,0,4,2,30,0,9,0,9,0,30,2,7,0,9,6,30,3,0,0,3,1,-15,3,1
2,2,41,0,30,3,9,0,12,6,30,8,0,0,8,0,30,4,8,0,12,3,30,5,7,0,12,7,30,7,0,0,7,1,-15,3,1
2,1,5,0,30,2,3,0,5,3,30,0,4,0,4,2,30,1,4,0,5,0,30,1,4,0,5,0,30,0,2,0,2,0,-27,3,0
2,2,5,0,30,2,3,0,5,3,30,0,4,0,4,2,30,1,4,0,5,0,30,1,4,0,5,0,30,0,2,0,2,0,-27,3,0
2,4,5,0,30,2,3,0,5,3,30,0,4,0,4,2,30,1,4,0,5,0,30,1,4,0,5,0,30,0,2,0,2,0,-27,3,0
2,4,7,1,30,5,4,0,9,2,30,4,0,0,4,0,30,6,3,0,9,5,30,3,6,0,9,1,30,5,1,0,6,0,-27,3,0
2,2,13,3,30,4,3,0,7,1,30,4,0,0,4,0,30,5,2,0,7,6,30,7,0,0,7,5,30,4,0,0,4,1,-15,3,1
2,3,13,3,30,4,3,0,7,1,30,4,0,0,4,0,30,5,2,0,7,6,30,7,0,0,7,5,30,4,0,0,4,1,-15,3,1
2,3,15,0,30,4,9,0,13,1,30,5,1,0,6,0,30,5,8,0,13,1,30,7,6,0,13,2,30,9,0,0,9,1,-15,3,1
2,2,17,7,30,11,3,0,14,4,30,6,0,0,6,0,30,4,10,0,14,0,30,7,7,0,14,3,30,4,0,0,4,1,-15,3,1
2,3,17,7,30,11,3,0,14,4,30,6,0,0,6,0,30,4,10,0,14,0,30,7,7,0,14,3,30,4,0,0,4,1,-15,3,1
2,4,17,7,30,11,3,0,14,4,30,6,0,0,6,0,30,4,10,0,14,0,30,7,7,0,14,3,30,4,0,0,4,1,-15,3,1
2,1,19,0,30,6,7,0,13,2,30,8,0,0,8,4,30,6,7,0,13,0,30,4,9,0,13,0,30,7,2,0,9,1,-15,3,1
2,3,19,0,30,6,7,0,13,2,30,8,0,0,8,4,30,6,7,0,13,0,30,4,9,0,13,0,30,7,2,0,9,1,-15,3,1
2,4,19,0,30,6,7,0,13,2,30,8,0,0,8,4,30,6,7,0,13,0,30,4,9,0,13,0,30,7,2,0,9,1,-15,3,1
2,0,25,1,30,4,10,0,14,6,30,6,0,0,6,0,30,3,11,0,14,3,30,8,6,0,14,8,30,6,0,0,6,1,-15,3,1
2,1,25,1,30,4,10,0,14,6,30,6,0,0,6,0,30,3,11,0,14,3,30,8,6,0,14,8,30,6,0,0,6,1,-15,3,1
2,2,25,1,30,4,10,0,14,6,30,6,0,0,6,0,30,3,11,0,14,3,30,8,6,0,14,8,30,6,0,0,6,1,-15,3,1
2,0,27,1,30,6,9,0,15,4,30,2,0,0,2,0,30,3,12,0,15,2,30,4,11,0,15,6,30,6,0,0,6,1,-15,3,1
2,2,27,1,30,6,9,0,15,4,30,2,0,0,2,0,30,3,12,0,15,2,30,4,11,0,15,6,30,6,0,0,6,1,-15,3,1
2,3,1,0,30,7,3,0,10,4,30,2,0,0,2,1,30,4,6,0,10,6,30,6,4,0,10,6,30,6,0,0,6,0,-27,3,0
2,4,8,1,30,7,0,0,7,4,30,2,0,0,2,0,30,3,4,0,7,2,30,6,1,0,7,0,30,3,0,0,3,0,-27,3,0
2,2,13,2,30,5,2,0,7,0,30,4,0,0,4,2,30,6,1,0,7,4,30,6,1,0,7,5,30,4,0,0,4,1,-15,3,1
2,3,13,2,30,5,2,0,7,0,30,4,0,0,4,2,30,6,1,0,7,4,30,6,1,0,7,5,30,4,0,0,4,1,-15,3,1
2,4,13,2,30,5,2,0,7,0,30,4,0,0,4,2,30,6,1,0,7,4,30,6,1,0,7,5,30,4,0,0,4,1,-15,3,1
2,4,15,0,30,2,11,0,13,1,30,6,0,0,6,1,30,5,8,0,13,1,30,4,9,0,13,2,30,9,0,0,9,1,-15,3,1
2,1,19,0,30,7,6,0,13,2,30,4,4,0,8,0,30,4,9,0,13,0,30,9,4,0,13,2,30,8,1,0,9,1,-15,3,1
2,2,19,0,30,7,6,0,13,2,30,4,4,0,8,0,30,4,9,0,13,0,30,9,4,0,13,2,30,8,1,0,9,1,-15,3,1
2,4,19,0,30,7,6,0,13,2,30,4,4,0,8,0,30,4,9,0,13,0,30,9,4,0,13,2,30,8,1,0,9,1,-15,3,1
2,4,23,1,30,6,7,0,13,3,30,6,0,0,6,3,30,7,6,0,13,0,30,6,7,0,13,0,30,4,2,0,6,1,-15,3,1
2,3,25,0,30,4,10,0,14,5,30,6,0,0,6,0,30,10,4,0,14,1,30,7,7,0,14,4,30,5,1,0,6,1,-15,3,1
2,4,25,0,30,4,10,0,14,5,30,6,0,0,6,0,30,10,4,0,14,1,30,7,7,0,14,4,30,5,1,0,6,1,-15,3,1
2,0,47,0,30,1,13,0,14,9,30,4,0,0,4,0,30,3,11,0,14,0,30,9,5,0,14,10,30,7,0,0,7,1,-15,3,1
2,3,47,0,30,1,13,0,14,9,30,4,0,0,4,0,30,3,11,0,14,0,30,9,5,0,14,10,30,7,0,0,7,1,-15,3,1
2,3,5,0,30,2,3,0,5,2,30,4,0,0,4,0,30,0,5,0,5,0,30,1,4,0,5,4,30,0,2,0,2,0,-27,3,0
2,4,5,0,30,2,3,0,5,2,30,4,0,0,4,0,30,0,5,0,5,0,30,1,4,0,5,4,30,0,2,0,2,0,-27,3,0
2,3,13,2,30,7,0,0,7,0,30,4,0,0,4,2,30,6,1,0,7,6,30,6,1,0,7,2,30,4,0,0,4,1,-15,3,1
2,4,13,2,30,7,0,0,7,0,30,4,0,0,4,2,30,6,1,0,7,6,30,6,1,0,7,2,30,4,0,0,4,1,-15,3,1
2,2,17,3,30,9,5,0,14,2,30,6,0,0,6,0,30,5,9,0,14,1,30,5,9,0,14,4,30,4,0,0,4,1,-15,3,1
2,3,17,3,30,9,5,0,14,2,30,6,0,0,6,0,30,5,9,0,14,1,30,5,9,0,14,4,30,4,0,0,4,1,-15,3,1
2,4,17,3,30,9,5,0,14,2,30,6,0,0,6,0,30,5,9,0,14,1,30,5,9,0,14,4,30,4,0,0,4,1,-15,3,1
2,4,19,0,30,5,8,0,13,2,30,5,3,0,8,0,30,5,8,0,13,7,30,4,9,0,13,0,30,9,0,0,9,1,-15,3,1
2,0,21,1,30,8,2,0,10,3,30,5,1,0,6,1,30,3,7,0,10,4,30,4,6,0,10,3,30,4,0,0,4,1,-15,3,1
2,3,23,2,30,5,8,0,13,3,30,6,0,0,6,7,30,11,2,0,13,0,30,4,9,0,13,3,30,6,0,0,6,1,-15,3,1
2,1,27,1,30,9,6,0,15,4,30,2,0,0,2,0,30,4,11,0,15,4,30,4,11,0,15,3,30,6,0,0,6,1,-15,3,1
2,2,29,0,30,7,7,0,14,5,30,11,1,0,12,0,30,4,10,0,14,1,30,1,13,0,14,0,30,9,0,0,9,1,-15,3,1
2,1,31,3,30,5,7,0,12,4,30,8,0,0,8,6,30,9,3,0,12,3,30,3,9,0,12,0,30,2,4,0,6,1,-15,3,1
2,3,31,3,30,5,7,0,12,4,30,8,0,0,8,6,30,9,3,0,12,3,30,3,9,0,12,0,30,2,4,0,6,1,-15,3,1
2,3,35,1,30,10,3,0,13,2,30,2,0,0,2,3,30,8,5,0,13,0,30,1,12,0,13,2,30,8,0,0,8,1,-15,3,1
2,0,39,0,30,2,9,0,11,6,30,6,0,0,6,3,30,9,2,0,11,0,30,4,7,0,11,5,30,5,0,0,5,1,-15,3,1
2,1,39,0,30,2,9,0,11,6,30,6,0,0,6,3,30,9,2,0,11,0,30,4,7,0,11,5,30,5,0,0,5,1,-15,3,1
2,4,39,0,30,2,9,0,11,6,30,6,0,0,6,3,30,9,2,0,11,0,30,4,7,0,11,1,30,5,0,0,5,1,-15,3,1
2,3,47,0,30,0,14,0,14,6,30,4,0,0,4,0,30,4,10,0,14,6,30,3,11,0,14,10,30,7,0,0,7,1,-15,3,1
2,4,9,0,30,1,3,0,4,2,30,2,0,0,2,0,30,0,4,0,4,0,30,1,3,0,4,3,30,1,0,0,1,0,-27,3,0
2,1,13,4,30,7,0,0,7,0,30,4,0,0,4,2,30,6,1,0,7,5,30,6,1,0,7,5,30,4,0,0,4,1,-15,3,1
2,2,13,4,30,7,0,0,7,0,30,4,0,0,4,2,30,6,1,0,7,5,30,6,1,0,7,5,30,4,0,0,4,1,-15,3,1
2,4,13,4,30,7,0,0,7,0,30,4,0,0,4,2,30,6,1,0,7,5,30,6,1,0,7,5,30,4,0,0,4,1,-15,3,1
2,1,17,1,30,9,5,0,14,3,30,6,0,0,6,0,30,5,9,0,14,4,30,7,7,0,14,1,30,4,0,0,4,1,-15,3,1
2,4,17,1,30,9,5,0,14,3,30,6,0,0,6,0,30,5,9,0,14,4,30,7,7,0,14,1,30,4,0,0,4,1,-15,3,1
2,3,19,0,30,2,11,0,13,2,30,6,2,0,8,0,30,5,8,0,13,2,30,5,8,0,13,0,30,8,1,0,9,1,-15,3,1
2,4,19,0,30,2,11,0,13,2,30,6,2,0,8,0,30,5,8,0,13,2,30,5,8,0,13,0,30,8,1,0,9,1,-15,3,1
2,2,23,1,30,5,8,0,13,3,30,6,0,0,6,0,30,10,3,0,13,2,30,10,3,0,13,3,30,6,0,0,6,1,-15,3,1
2,4,23,1,30,5,8,0,13,3,30,6,0,0,6,0,30,10,3,0,13,2,30,10,3,0,13,3,30,6,0,0,6,1,-15,3,1
2,1,25,1,30,7,7,0,14,4,30,6,0,0,6,0,30,5,9,0,14,2,30,8,6,0,14,3,30,5,1,0,6,1,-15,3,1
2,1,27,1,30,7,8,0,15,3,30,2,0,0,2,0,30,2,13,0,15,4,30,6,9,0,15,2,30,6,0,0,6,1,-15,3,1
2,3,27,1,30,7,8,0,15,3,30,2,0,0,2,0,30,2,13,0,15,4,30,6,9,0,15,2,30,6,0,0,6,1,-15,3,1
2,4,29,0,30,6,8,0,14,4,30,12,0,0,12,0,30,6,8,0,14,0,30,1,13,0,14,0,30,4,5,0,9,1,-15,3,1
2,3,32,0,30,9,0,0,9,4,30,2,0,0,2,0,30,7,2,0,9,1,30,3,6,0,9,7,30,2,0,0,2,1,-15,3,1
2,2,5,0,30,0,5,0,5,2,30,1,3,0,4,1,30,2,3,0,5,0,30,1,4,0,5,0,30,0,2,0,2,0,-27,3,0
2,4,5,0,30,0,5,0,5,2,30,1,3,0,4,1,30,2,3,0,5,0,30,1,4,0,5,0,30,0,2,0,2,0,-27,3,0
2,4,13,7,30,5,2,0,7,0,30,4,0,0,4,2,30,5,2,0,7,10,30,4,3,0,7,0,30,3,1,0,4,1,-15,3,1
2,2,17,5,30,12,2,0,14,2,30,6,0,0,6,0,30,7,7,0,14,1,30,5,9,0,14,2,30,4,0,0,4,1,-15,3,1
2,4,17,5,30,12,2,0,14,2,30,6,0,0,6,0,30,7,7,0,14,1,30,5,9,0,14,2,30,4,0,0,4,1,-15,3,1
2,4,19,0,30,4,9,0,13,2,30,6,2,0,8,0,30,4,9,0,13,7,30,4,9,0,13,0,30,8,1,0,9,1,-15,3,1
2,0,25,2,30,4,10,0,14,4,30,6,0,0,6,0,30,12,2,0,14,1,30,5,9,0,14,3,30,6,0,0,6,1,-15,3,1
2,2,27,1,30,4,11,0,15,4,30,2,0,0,2,0,30,2,13,0,15,1,30,5,10,0,15,7,30,5,1,0,6,1,-15,3,1
2,3,27,1,30,4,11,0,15,4,30,2,0,0,2,0,30,2,13,0,15,1,30,5,10,0,15,7,30,5,1,0,6,1,-15,3,1
2,1,17,4,30,10,4,0,14,2,30,6,0,0,6,0,30,6,8,0,14,1,30,5,9,0,14,3,30,4,0,0,4,1,-15,3,1
2,2,17,4,30,10,4,0,14,2,30,6,0,0,6,0,30,6,8,0,14,1,30,5,9,0,14,3,30,4,0,0,4,1,-15,3,1
2,2,19,0,30,4,9,0,13,2,30,8,0,0,8,0,30,4,9,0,13,3,30,4,9,0,13,0,30,7,2,0,9,1,-15,3,1
2,1,27,2,30,5,10,0,15,3,30,2,0,0,2,0,30,6,9,0,15,0,30,6,9,0,15,2,30,6,0,0,6,1,-15,3,1
2,3,27,2,30,5,10,0,15,3,30,2,0,0,2,0,30,6,9,0,15,0,30,6,9,0,15,2,30,6,0,0,6,1,-15,3,1
2,2,29,0,30,6,8,0,14,5,30,12,0,0,12,0,30,9,5,0,14,0,30,1,13,0,14,0,30,9,0,0,9,1,-15,3,1
2,2,33,1,30,2,9,0,11,5,30,4,0,0,4,2,30,10,1,0,11,2,30,3,8,0,11,5,30,4,0,0,4,1,-15,3,1
2,3,33,1,30,2,9,0,11,5,30,4,0,0,4,2,30,10,1,0,11,2,30,3,8,0,11,5,30,4,0,0,4,1,-15,3,1
2,0,4,3,30,7,1,0,8,4,30,4,0,0,4,0,30,2,6,0,8,2,30,5,3,0,8,2,30,4,0,0,4,0,-27,3,0
2,4,8,0,30,7,0,0,7,3,30,2,0,0,2,0,30,4,3,0,7,1,30,5,2,0,7,3,30,3,0,0,3,0,-27,3,0
2,4,13,2,30,5,2,0,7,0,30,4,0,0,4,2,30,7,0,0,7,7,30,7,0,0,7,0,30,4,0,0,4,1,-15,3,1
2,3,17,4,30,9,5,0,14,3,30,6,0,0,6,0,30,5,9,0,14,2,30,5,9,0,14,7,30,4,0,0,4,1,-15,3,1
2,2,19,0,30,3,10,0,13,2,30,6,2,0,8,0,30,7,6,0,13,1,30,3,10,0,13,2,30,9,0,0,9,1,-15,3,1
2,0,25,1,30,5,9,0,14,3,30,6,0,0,6,0,30,7,7,0,14,7,30,6,8,0,14,4,30,5,1,0,6,1,-15,3,1
2,2,25,1,30,5,9,0,14,3,30,6,0,0,6,0,30,7,7,0,14,7,30,6,8,0,14,4,30,5,1,0,6,1,-15,3,1
2,2,27,2,30,6,9,0,15,5,30,2,0,0,2,0,30,2,13,0,15,4,30,6,9,0,15,0,30,6,0,0,6,1,-15,3,1
2,4,27,2,30,6,9,0,15,5,30,2,0,0,2,0,30,2,13,0,15,4,30,6,9,0,15,0,30,6,0,0,6,1,-15,3,1
2,2,31,4,30,7,5,0,12,4,30,8,0,0,8,3,30,9,3,0,12,0,30,3,9,0,12,1,30,3,3,0,6,1,-15,3,1
2,3,31,4,30,7,5,0,12,4,30,8,0,0,8,3,30,9,3,0,12,0,30,3,9,0,12,1,30,3,3,0,6,1,-15,3,1
2,3,33,1,30,2,9,0,11,4,30,4,0,0,4,1,30,9,2,0,11,0,30,4,7,0,11,5,30,4,0,0,4,1,-15,3,1
2,3,8,11,30,7,0,0,7,4,30,2,0,0,2,0,30,7,0,0,7,0,30,4,3,0,7,2,30,3,0,0,3,0,-27,3,0
2,0,9,5,30,4,0,0,4,4,30,2,0,0,2,3,30,1,3,0,4,0,30,0,4,0,4,1,30,1,0,0,1,0,-27,3,0
2,3,9,5,30,4,0,0,4,4,30,2,0,0,2,3,30,1,3,0,4,0,30,0,4,0,4,1,30,1,0,0,1,0,-27,3,0
2,4,9,5,30,4,0,0,4,4,30,2,0,0,2,3,30,1,3,0,4,0,30,0,4,0,4,1,30,1,0,0,1,0,-27,3,0
2,2,17,4,30,10,4,0,14,3,30,6,0,0,6,0,30,5,9,0,14,2,30,8,6,0,14,3,30,3,1,0,4,1,-15,3,1
2,3,17,4,30,10,4,0,14,3,30,6,0,0,6,0,30,5,9,0,14,2,30,8,6,0,14,3,30,3,1,0,4,1,-15,3,1
2,4,17,4,30,10,4,0,14,3,30,6,0,0,6,0,30,5,9,0,14,2,30,8,6,0,14,3,30,3,1,0,4,1,-15,3,1
2,3,19,0,30,6,7,0,13,1,30,6,2,0,8,0,30,7,6,0,13,5,30,5,8,0,13,1,30,8,1,0,9,1,-15,3,1
2,4,19,0,30,6,7,0,13,1,30,6,2,0,8,0,30,7,6,0,13,5,30,5,8,0,13,1,30,8,1,0,9,1,-15,3,1
2,4,23,2,30,7,6,0,13,0,30,6,0,0,6,5,30,13,0,0,13,0,30,5,8,0,13,2,30,6,0,0,6,1,-15,3,1
2,2,26,0,30,7,2,0,9,4,30,4,0,0,4,3,30,3,6,0,9,0,30,2,7,0,9,5,30,2,1,0,3,1,-15,3,1
2,4,26,0,30,7,2,0,9,4,30,4,0,0,4,3,30,3,6,0,9,0,30,2,7,0,9,5,30,2,1,0,3,1,-15,3,1
2,1,27,1,30,4,11,0,15,2,30,2,0,0,2,0,30,8,7,0,15,4,30,4,11,0,15,3,30,6,0,0,6,1,-15,3,1
2,2,31,2,30,6,6,0,12,4,30,8,0,0,8,4,30,12,0,0,12,0,30,3,9,0,12,2,30,3,3,0,6,1,-15,3,1
2,3,31,2,30,6,6,0,12,4,30,8,0,0,8,4,30,12,0,0,12,0,30,3,9,0,12,2,30,3,3,0,6,1,-15,3,1
2,4,31,2,30,6,6,0,12,4,30,8,0,0,8,4,30,12,0,0,12,0,30,3,9,0,12,2,30,3,3,0,6,1,-15,3,1
2,4,43,0,30,7,7,0,14,10,30,6,0,0,6,0,30,4,10,0,14,1,30,8,6,0,14,4,30,5,0,0,5,1,-15,3,1
2,2,13,2,30,5,2,0,7,1,30,4,0,0,4,4,30,7,0,0,7,6,30,3,4,0,7,1,30,4,0,0,4,1,-15,3,1
2,0,17,2,30,9,5,0,14,4,30,6,0,0,6,0,30,4,10,0,14,2,30,10,4,0,14,4,30,4,0,0,4,1,-15,3,1
2,2,17,2,30,9,5,0,14,4,30,6,0,0,6,0,30,4,10,0,14,0,30,10,4,0,14,4,30,4,0,0,4,1,-15,3,1
2,3,17,2,30,9,5,0,14,4,30,6,0,0,6,0,30,4,10,0,14,0,30,10,4,0,14,4,30,4,0,0,4,1,-15,3,1
2,4,17,2,30,9,5,0,14,4,30,6,0,0,6,0,30,4,10,0,14,0,30,10,4,0,14,4,30,4,0,0,4,1,-15,3,1
2,4,23,1,30,5,8,0,13,2,30,6,0,0,6,3,30,10,3,0,13,0,30,5,8,0,13,3,30,6,0,0,6,1,-15,3,1
2,1,27,1,30,4,11,0,15,4,30,2,0,0,2,0,30,7,8,0,15,2,30,6,9,0,15,2,30,6,0,0,6,1,-15,3,1
2,3,27,1,30,4,11,0,15,0,30,2,0,0,2,0,30,7,8,0,15,2,30,6,9,0,15,2,30,6,0,0,6,1,-15,3,1
2,3,29,0,30,6,8,0,14,5,30,11,1,0,12,0,30,6,8,0,14,0,30,1,13,0,14,3,30,9,0,0,9,1,-15,3,1
2,3,7,0,30,2,2,0,4,2,30,2,0,0,2,0,30,1,3,0,4,0,30,1,3,0,4,3,30,1,1,0,2,0,-27,3,0
2,4,8,2,30,7,0,0,7,3,30,2,0,0,2,2,30,5,2,0,7,1,30,7,0,0,7,1,30,3,0,0,3,0,-27,3,0
2,4,11,1,30,5,7,0,12,1,30,4,0,0,4,0,30,5,7,0,12,4,30,6,6,0,12,6,30,4,0,0,4,1,-15,3,1
2,0,17,5,30,11,3,0,14,4,30,6,0,0,6,0,30,3,11,0,14,5,30,4,10,0,14,1,30,3,1,0,4,1,-15,3,1
2,2,17,5,30,11,3,0,14,4,30,6,0,0,6,0,30,3,11,0,14,5,30,4,10,0,14,1,30,3,1,0,4,1,-15,3,1
2,3,17,5,30,11,3,0,14,4,30,6,0,0,6,0,30,3,11,0,14,5,30,4,10,0,14,1,30,3,1,0,4,1,-15,3,1
2,0,19,0,30,4,9,0,13,3,30,7,1,0,8,4,30,4,9,0,13,5,30,7,6,0,13,0,30,7,2,0,9,1,-15,3,1
2,3,19,0,30,4,9,0,13,3,30,7,1,0,8,0,30,4,9,0,13,5,30,7,6,0,13,0,30,7,2,0,9,1,-15,3,1
2,4,19,0,30,4,9,0,13,3,30,7,1,0,8,0,30,4,9,0,13,5,30,7,6,0,13,0,30,7,2,0,9,1,-15,3,1
2,2,21,3,30,10,0,0,10,4,30,6,0,0,6,1,30,3,7,0,10,2,30,5,5,0,10,0,30,3,1,0,4,1,-15,3,1
2,3,21,3,30,10,0,0,10,4,30,6,0,0,6,1,30,3,7,0,10,2,30,5,5,0,10,0,30,3,1,0,4,1,-15,3,1
2,3,22,3,30,8,0,0,8,3,30,2,0,0,2,0,30,4,4,0,8,1,30,3,5,0,8,1,30,1,3,0,4,1,-15,3,1
2,4,22,3,30,8,0,0,8,3,30,2,0,0,2,0,30,4,4,0,8,1,30,3,5,0,8,1,30,1,3,0,4,1,-15,3,1
2,1,27,4,30,9,6,0,15,2,30,1,1,0,2,0,30,5,10,0,15,0,30,6,9,0,15,1,30,4,2,0,6,1,-15,3,1
2,3,27,4,30,9,6,0,15,2,30,1,1,0,2,0,30,5,10,0,15,0,30,6,9,0,15,1,30,4,2,0,6,1,-15,3,1
2,4,29,0,30,6,8,0,14,6,30,12,0,0,12,0,30,4,10,0,14,0,30,0,14,0,14,0,30,9,0,0,9,1,-15,3,1
2,3,47,0,30,2,12,0,14,7,30,4,0,0,4,0,30,3,11,0,14,0,30,2,12,0,14,0,30,7,0,0,7,1,-15,3,1
2,3,5,0,30,3,2,0,5,3,30,2,2,0,4,0,30,0,5,0,5,0,30,2,3,0,5,0,30,0,2,0,2,0,-27,3,0
2,3,8,1,30,7,0,0,7,4,30,2,0,0,2,4,30,4,3,0,7,1,30,7,0,0,7,2,30,3,0,0,3,0,-27,3,0
2,4,8,1,30,7,0,0,7,4,30,2,0,0,2,4,30,4,3,0,7,1,30,7,0,0,7,2,30,3,0,0,3,0,-27,3,0
2,1,13,2,30,5,2,0,7,0,30,4,0,0,4,1,30,6,1,0,7,6,30,7,0,0,7,3,30,4,0,0,4,1,-15,3,1
2,3,13,2,30,5,2,0,7,0,30,4,0,0,4,1,30,6,1,0,7,6,30,7,0,0,7,3,30,4,0,0,4,1,-15,3,1
2,4,13,2,30,5,2,0,7,0,30,4,0,0,4,1,30,6,1,0,7,6,30,7,0,0,7,3,30,4,0,0,4,1,-15,3,1
2,2,17,5,30,10,4,0,14,4,30,6,0,0,6,0,30,4,10,0,14,2,30,5,9,0,14,2,30,4,0,0,4,1,-15,3,1
2,2,19,0,30,8,5,0,13,1,30,5,3,0,8,0,30,7,6,0,13,3,30,3,10,0,13,2,30,9,0,0,9,1,-15,3,1
2,3,19,0,30,8,5,0,13,1,30,5,3,0,8,0,30,7,6,0,13,3,30,3,10,0,13,2,30,9,0,0,9,1,-15,3,1
2,0,27,1,30,6,9,0,15,5,30,1,1,0,2,2,30,6,9,0,15,0,30,7,8,0,15,1,30,5,1,0,6,1,-15,3,1
2,1,27,1,30,6,9,0,15,5,30,1,1,0,2,2,30,6,9,0,15,0,30,7,8,0,15,1,30,5,1,0,6,1,-15,3,1
2,3,27,1,30,6,9,0,15,3,30,1,1,0,2,2,30,6,9,0,15,0,30,7,8,0,15,1,30,5,1,0,6,1,-15,3,1
2,2,29,1,30,4,10,0,14,6,30,12,0,0,12,0,30,6,8,0,14,0,30,0,14,0,14,4,30,9,0,0,9,1,-15,3,1
2,3,29,1,30,4,10,0,14,6,30,12,0,0,12,0,30,6,8,0,14,0,30,0,14,0,14,4,30,9,0,0,9,1,-15,3,1
2,3,31,5,30,4,8,0,12,4,30,8,0,0,8,3,30,12,0,0,12,0,30,3,9,0,12,2,30,3,3,0,6,1,-15,3,1
2,3,37,7,30,7,4,0,11,7,30,7,1,0,8,0,30,2,9,0,11,1,30,2,9,0,11,6,30,6,0,0,6,1,-15,3,1
2,4,38,0,30,6,4,0,10,7,30,6,0,0,6,0,30,1,9,0,10,0,30,1,9,0,10,4,30,6,0,0,6,1,-15,3,1
2,3,43,0,30,10,4,0,14,5,30,6,0,0,6,0,30,12,2,0,14,1,30,1,13,0,14,2,30,5,0,0,5,1,-15,3,1
2,2,4,4,30,7,1,0,8,4,30,2,2,0,4,0,30,1,7,0,8,0,30,4,4,0,8,4,30,4,0,0,4,0,-27,3,0
2,0,19,1,30,7,6,0,13,2,30,6,2,0,8,6,30,4,9,0,13,0,30,3,10,0,13,0,30,8,1,0,9,1,-15,3,1
2,1,19,1,30,7,6,0,13,2,30,6,2,0,8,6,30,4,9,0,13,0,30,3,10,0,13,0,30,8,1,0,9,1,-15,3,1
2,2,19,1,30,7,6,0,13,2,30,6,2,0,8,6,30,4,9,0,13,0,30,3,10,0,13,0,30,8,1,0,9,1,-15,3,1
2,3,23,1,30,8,5,0,13,0,30,6,0,0,6,2,30,13,0,0,13,0,30,6,7,0,13,4,30,6,0,0,6,1,-15,3,1
2,2,27,2,30,7,8,0,15,2,30,2,0,0,2,0,30,9,6,0,15,0,30,4,11,0,15,1,30,4,2,0,6,1,-15,3,1
2,3,29,0,30,5,9,0,14,6,30,11,1,0,12,0,30,4,10,0,14,0,30,1,13,0,14,4,30,9,0,0,9,1,-15,3,1
2,4,31,3,30,5,7,0,12,5,30,8,0,0,8,5,30,10,2,0,12,0,30,3,9,0,12,0,30,5,1,0,6,1,-15,3,1
2,3,43,0,30,9,5,0,14,8,30,6,0,0,6,0,30,4,10,0,14,2,30,1,13,0,14,4,30,5,0,0,5,1,-15,3,1
2,4,1,0,30,8,2,0,10,4,30,2,0,0,2,1,30,3,7,0,10,0,30,6,4,0,10,5,30,6,0,0,6,0,-27,3,0
2,3,13,4,30,7,0,0,7,2,30,4,0,0,4,1,30,6,1,0,7,0,30,6,1,0,7,2,30,4,0,0,4,1,-15,3,1
2,4,23,3,30,7,6,0,13,0,30,6,0,0,6,4,30,13,0,0,13,0,30,5,8,0,13,2,30,5,1,0,6,1,-15,3,1
2,3,25,2,30,7,7,0,14,3,30,6,0,0,6,0,30,12,2,0,14,1,30,4,10,0,14,5,30,6,0,0,6,1,-15,3,1
2,4,25,2,30,7,7,0,14,3,30,6,0,0,6,0,30,12,2,0,14,1,30,4,10,0,14,5,30,6,0,0,6,1,-15,3,1
2,3,27,1,30,3,12,0,15,3,30,2,0,0,2,0,30,5,10,0,15,0,30,2,13,0,15,3,30,5,1,0,6,1,-15,3,1
2,3,33,4,30,7,4,0,11,4,30,4,0,0,4,0,30,9,2,0,11,6,30,3,8,0,11,3,30,4,0,0,4,1,-15,3,1
2,4,33,4,30,7,4,0,11,4,30,4,0,0,4,0,30,9,2,0,11,6,30,3,8,0,11,3,30,4,0,0,4,1,-15,3,1
2,2,13,1,30,3,0,0,3,1,30,2,0,0,2,2,30,3,0,0,3,5,30,2,1,0,3,2,30,2,0,0,2,1,-15,3,1
2,2,13,2,30,6,1,0,7,0,30,4,0,0,4,3,30,7,0,0,7,7,30,6,1,0,7,1,30,4,0,0,4,1,-15,3,1
2,1,19,0,30,7,6,0,13,2,30,8,0,0,8,3,30,5,8,0,13,0,30,4,9,0,13,0,30,7,2,0,9,1,-15,3,1
2,2,19,0,30,7,6,0,13,2,30,8,0,0,8,3,30,5,8,0,13,0,30,4,9,0,13,0,30,7,2,0,9,1,-15,3,1
2,3,19,0,30,7,6,0,13,2,30,8,0,0,8,3,30,5,8,0,13,0,30,4,9,0,13,0,30,7,2,0,9,1,-15,3,1
2,2,23,3,30,6,7,0,13,3,30,6,0,0,6,6,30,13,0,0,13,0,30,5,8,0,13,4,30,6,0,0,6,1,-15,3,1
2,3,23,3,30,6,7,0,13,3,30,6,0,0,6,6,30,13,0,0,13,0,30,5,8,0,13,4,30,6,0,0,6,1,-15,3,1
2,4,23,3,30,6,7,0,13,3,30,6,0,0,6,6,30,13,0,0,13,0,30,5,8,0,13,4,30,6,0,0,6,1,-15,3,1
2,0,25,1,30,5,9,0,14,5,30,6,0,0,6,0,30,5,9,0,14,1,30,8,6,0,14,5,30,5,1,0,6,1,-15,3,1
2,3,25,1,30,5,9,0,14,5,30,6,0,0,6,0,30,5,9,0,14,1,30,8,6,0,14,5,30,5,1,0,6,1,-15,3,1
2,4,25,1,30,5,9,0,14,5,30,6,0,0,6,0,30,5,9,0,14,1,30,8,6,0,14,5,30,5,1,0,6,1,-15,3,1
2,3,27,2,30,8,7,0,15,2,30,2,0,0,2,0,30,3,12,0,15,0,30,4,11,0,15,1,30,4,2,0,6,1,-15,3,1
2,4,27,2,30,8,7,0,15,2,30,2,0,0,2,0,30,3,12,0,15,0,30,4,11,0,15,1,30,4,2,0,6,1,-15,3,1
2,2,29,0,30,8,6,0,14,5,30,10,2,0,12,0,30,3,11,0,14,0,30,2,12,0,14,0,30,7,2,0,9,1,-15,3,1
2,3,29,0,30,8,6,0,14,5,30,10,2,0,12,0,30,3,11,0,14,0,30,2,12,0,14,0,30,7,2,0,9,1,-15,3,1
2,4,8,0,30,7,0,0,7,5,30,2,0,0,2,0,30,1,6,0,7,0,30,5,2,0,7,5,30,3,0,0,3,0,-27,3,0
2,3,13,2,30,3,0,0,3,1,30,2,0,0,2,0,30,2,1,0,3,4,30,3,0,0,3,3,30,2,0,0,2,1,-15,3,1
2,2,13,2,30,7,0,0,7,0,30,4,0,0,4,2,30,5,2,0,7,5,30,7,0,0,7,5,30,4,0,0,4,1,-15,3,1
2,2,19,0,30,3,10,0,13,3,30,5,3,0,8,0,30,4,9,0,13,7,30,4,9,0,13,5,30,8,1,0,9,1,-15,3,1
2,4,19,0,30,3,10,0,13,3,30,5,3,0,8,0,30,4,9,0,13,7,30,4,9,0,13,5,30,8,1,0,9,1,-15,3,1
2,0,21,3,30,9,1,0,10,3,30,6,0,0,6,1,30,6,4,0,10,2,30,5,5,0,10,2,30,4,0,0,4,1,-15,3,1
2,2,21,3,30,9,1,0,10,3,30,6,0,0,6,1,30,6,4,0,10,2,30,5,5,0,10,2,30,4,0,0,4,1,-15,3,1
2,4,22,1,30,7,1,0,8,2,30,2,0,0,2,0,30,4,4,0,8,0,30,1,7,0,8,1,30,4,0,0,4,1,-15,3,1
2,2,23,1,30,5,8,0,13,2,30,6,0,0,6,5,30,10,3,0,13,3,30,6,7,0,13,1,30,6,0,0,6,1,-15,3,1
2,3,23,1,30,5,8,0,13,2,30,6,0,0,6,5,30,10,3,0,13,3,30,6,7,0,13,1,30,6,0,0,6,1,-15,3,1
2,4,23,1,30,5,8,0,13,2,30,6,0,0,6,5,30,10,3,0,13,3,30,6,7,0,13,1,30,6,0,0,6,1,-15,3,1
2,3,25,1,30,10,4,0,14,4,30,6,0,0,6,0,30,6,8,0,14,1,30,5,9,0,14,4,30,5,1,0,6,1,-15,3,1
2,0,27,1,30,6,9,0,15,4,30,1,1,0,2,0,30,6,9,0,15,0,30,3,12,0,15,1,30,4,2,0,6,1,-15,3,1
2,4,27,1,30,6,9,0,15,4,30,1,1,0,2,0,30,6,9,0,15,0,30,3,12,0,15,0,30,4,2,0,6,1,-15,3,1
2,2,31,4,30,4,8,0,12,4,30,8,0,0,8,3,30,12,0,0,12,0,30,3,9,0,12,1,30,4,2,0,6,1,-15,3,1
2,2,1,0,30,7,3,0,10,4,30,2,0,0,2,1,30,4,6,0,10,2,30,6,4,0,10,8,30,6,0,0,6,0,-27,3,0
2,2,5,0,30,5,0,0,5,3,30,4,0,0,4,0,30,0,5,0,5,0,30,1,4,0,5,0,30,0,2,0,2,0,-27,3,0
2,3,5,0,30,5,0,0,5,3,30,4,0,0,4,0,30,0,5,0,5,0,30,1,4,0,5,0,30,0,2,0,2,0,-27,3,0
2,4,5,0,30,5,0,0,5,3,30,4,0,0,4,0,30,0,5,0,5,0,30,1,4,0,5,0,30,0,2,0,2,0,-27,3,0
2,4,8,0,30,7,0,0,7,4,30,2,0,0,2,3,30,3,4,0,7,2,30,4,3,0,7,0,30,3,0,0,3,0,-27,3,0
2,4,11,2,30,4,8,0,12,3,30,4,0,0,4,0,30,2,10,0,12,5,30,5,7,0,12,3,30,4,0,0,4,1,-15,3,1
2,3,13,2,30,7,0,0,7,1,30,4,0,0,4,2,30,7,0,0,7,3,30,6,1,0,7,5,30,4,0,0,4,1,-15,3,1
2,4,15,0,30,5,8,0,13,0,30,5,1,0,6,0,30,5,8,0,13,1,30,7,6,0,13,2,30,8,1,0,9,1,-15,3,1
2,3,27,1,30,6,9,0,15,1,30,2,0,0,2,0,30,8,7,0,15,0,30,3,12,0,15,2,30,6,0,0,6,1,-15,3,1
2,3,9,0,30,1,3,0,4,2,30,2,0,0,2,0,30,0,4,0,4,0,30,1,3,0,4,0,30,1,0,0,1,0,-27,3,0
2,3,11,3,30,5,7,0,12,3,30,4,0,0,4,0,30,2,10,0,12,2,30,7,5,0,12,4,30,4,0,0,4,1,-15,3,1
2,2,13,0,30,7,0,0,7,0,30,4,0,0,4,2,30,6,1,0,7,11,30,5,2,0,7,2,30,4,0,0,4,1,-15,3,1
2,0,17,3,30,9,5,0,14,2,30,6,0,0,6,0,30,7,7,0,14,4,30,6,8,0,14,6,30,4,0,0,4,1,-15,3,1
2,1,17,3,30,9,5,0,14,2,30,6,0,0,6,0,30,7,7,0,14,4,30,6,8,0,14,6,30,4,0,0,4,1,-15,3,1
2,2,19,0,30,4,9,0,13,2,30,5,3,0,8,0,30,4,9,0,13,0,30,5,8,0,13,1,30,9,0,0,9,1,-15,3,1
2,1,21,4,30,9,1,0,10,4,30,6,0,0,6,1,30,3,7,0,10,1,30,4,6,0,10,0,30,4,0,0,4,1,-15,3,1
2,2,21,4,30,9,1,0,10,4,30,6,0,0,6,1,30,3,7,0,10,1,30,4,6,0,10,0,30,4,0,0,4,1,-15,3,1
2,4,25,0,30,5,9,0,14,4,30,6,0,0,6,0,30,10,4,0,14,1,30,7,7,0,14,2,30,5,1,0,6,1,-15,3,1
2,0,26,0,30,5,4,0,9,4,30,4,0,0,4,4,30,2,7,0,9,1,30,2,7,0,9,5,30,3,0,0,3,1,-15,3,1
2,0,38,0,30,4,6,0,10,7,30,6,0,0,6,0,30,3,7,0,10,0,30,4,6,0,10,8,30,6,0,0,6,1,-15,3,1
2,2,38,0,30,4,6,0,10,7,30,6,0,0,6,0,30,3,7,0,10,0,30,4,6,0,10,8,30,6,0,0,6,1,-15,3,1
2,4,7,0,30,0,4,0,4,2,30,2,0,0,2,0,30,1,3,0,4,0,30,1,3,0,4,2,30,2,0,0,2,0,-27,3,0
2,2,13,1,30,5,2,0,7,0,30,4,0,0,4,2,30,7,0,0,7,5,30,5,2,0,7,4,30,4,0,0,4,1,-15,3,1
2,3,13,1,30,5,2,0,7,0,30,4,0,0,4,2,30,7,0,0,7,5,30,5,2,0,7,4,30,4,0,0,4,1,-15,3,1
2,4,19,0,30,3,10,0,13,2,30,8,0,0,8,0,30,8,5,0,13,1,30,3,10,0,13,2,30,8,1,0,9,1,-15,3,1
2,2,23,1,30,5,8,0,13,2,30,6,0,0,6,6,30,13,0,0,13,0,30,5,8,0,13,4,30,6,0,0,6,1,-15,3,1
2,3,25,3,30,6,8,0,14,4,30,6,0,0,6,0,30,5,9,0,14,0,30,5,9,0,14,5,30,6,0,0,6,1,-15,3,1
2,4,25,3,30,6,8,0,14,4,30,6,0,0,6,0,30,5,9,0,14,0,30,5,9,0,14,5,30,6,0,0,6,1,-15,3,1
2,4,29,0,30,8,6,0,14,6,30,12,0,0,12,0,30,2,12,0,14,0,30,0,14,0,14,1,30,9,0,0,9,1,-15,3,1
2,1,31,5,30,6,6,0,12,4,30,8,0,0,8,4,30,11,1,0,12,0,30,3,9,0,12,0,30,2,4,0,6,1,-15,3,1
2,4,35,1,30,8,5,0,13,3,30,2,0,0,2,1,30,11,2,0,13,0,30,2,11,0,13,1,30,8,0,0,8,1,-15,3,1
2,3,6,0,30,8,1,0,9,4,30,2,0,0,2,0,30,2,7,0,9,0,30,4,5,0,9,4,30,5,0,0,5,0,-27,3,0
2,3,7,0,30,2,2,0,4,2,30,2,0,0,2,0,30,1,3,0,4,0,30,1,3,0,4,0,30,2,0,0,2,0,-27,3,0
2,4,13,1,30,4,3,0,7,0,30,4,0,0,4,0,30,6,1,0,7,5,30,5,2,0,7,6,30,4,0,0,4,1,-15,3,1
2,2,17,5,30,12,2,0,14,4,30,6,0,0,6,0,30,3,11,0,14,0,30,6,8,0,14,1,30,2,2,0,4,1,-15,3,1
2,3,23,1,30,5,8,0,13,0,30,6,0,0,6,0,30,12,1,0,13,0,30,7,6,0,13,3,30,6,0,0,6,1,-15,3,1
2,4,23,1,30,5,8,0,13,0,30,6,0,0,6,0,30,12,1,0,13,0,30,7,6,0,13,3,30,6,0,0,6,1,-15,3,1
2,3,25,1,30,5,9,0,14,4,30,6,0,0,6,0,30,4,10,0,14,3,30,6,8,0,14,3,30,6,0,0,6,1,-15,3,1
2,3,27,2,30,10,5,0,15,2,30,2,0,0,2,1,30,3,12,0,15,0,30,4,11,0,15,1,30,3,3,0,6,1,-15,3,1
2,4,29,0,30,5,9,0,14,5,30,12,0,0,12,0,30,6,8,0,14,0,30,2,12,0,14,0,30,7,2,0,9,1,-15,3,1
2,3,31,3,30,5,7,0,12,5,30,8,0,0,8,3,30,8,4,0,12,0,30,3,9,0,12,0,30,5,1,0,6,1,-15,3,1
2,2,33,1,30,2,9,0,11,3,30,4,0,0,4,0,30,10,1,0,11,1,30,4,7,0,11,6,30,4,0,0,4,1,-15,3,1
2,4,33,1,30,2,9,0,11,3,30,4,0,0,4,0,30,10,1,0,11,1,30,4,7,0,11,6,30,4,0,0,4,1,-15,3,1
2,3,35,0,30,8,5,0,13,4,30,2,0,0,2,6,30,4,9,0,13,0,30,3,10,0,13,5,30,7,1,0,8,1,-15,3,1
2,2,43,6,30,7,7,0,14,7,30,6,0,0,6,0,30,4,10,0,14,1,30,1,13,0,14,7,30,5,0,0,5,1,-15,3,1
2,3,43,6,30,7,7,0,14,7,30,6,0,0,6,0,30,4,10,0,14,1,30,1,13,0,14,7,30,5,0,0,5,1,-15,3,1
2,3,13,1,30,7,0,0,7,0,30,4,0,0,4,2,30,5,2,0,7,5,30,6,1,0,7,4,30,4,0,0,4,1,-15,3,1
2,1,17,3,30,12,2,0,14,2,30,6,0,0,6,0,30,5,9,0,14,1,30,7,7,0,14,3,30,4,0,0,4,1,-15,3,1
2,3,17,3,30,12,2,0,14,2,30,6,0,0,6,0,30,5,9,0,14,1,30,7,7,0,14,3,30,4,0,0,4,1,-15,3,1
2,1,19,0,30,6,7,0,13,2,30,6,2,0,8,0,30,6,7,0,13,7,30,4,9,0,13,0,30,8,1,0,9,1,-15,3,1
2,2,19,0,30,6,7,0,13,2,30,6,2,0,8,0,30,6,7,0,13,7,30,4,9,0,13,0,30,8,1,0,9,1,-15,3,1
2,4,19,0,30,6,7,0,13,2,30,6,2,0,8,0,30,6,7,0,13,7,30,4,9,0,13,0,30,8,1,0,9,1,-15,3,1
2,4,29,0,30,6,8,0,14,6,30,12,0,0,12,0,30,5,9,0,14,0,30,0,14,0,14,5,30,9,0,0,9,1,-15,3,1
2,2,47,0,30,2,12,0,14,5,30,4,0,0,4,0,30,8,6,0,14,0,30,2,12,0,14,3,30,7,0,0,7,1,-15,3,1
2,3,47,0,30,2,12,0,14,5,30,4,0,0,4,0,30,8,6,0,14,0,30,2,12,0,14,3,30,7,0,0,7,1,-15,3,1
2,4,47,0,30,2,12,0,14,5,30,4,0,0,4,0,30,8,6,0,14,0,30,2,12,0,14,3,30,7,0,0,7,1,-15,3,1
2,0,11,1,30,5,7,0,12,1,30,4,0,0,4,0,30,7,5,0,12,9,30,7,5,0,12,5,30,4,0,0,4,1,-15,3,1
2,2,13,1,30,3,0,0,3,1,30,2,0,0,2,0,30,3,0,0,3,5,30,1,2,0,3,2,30,2,0,0,2,1,-15,3,1
2,4,13,1,30,3,0,0,3,1,30,2,0,0,2,0,30,3,0,0,3,5,30,1,2,0,3,2,30,2,0,0,2,1,-15,3,1
2,1,13,4,30,6,1,0,7,0,30,4,0,0,4,1,30,6,1,0,7,5,30,5,2,0,7,2,30,4,0,0,4,1,-15,3,1
2,3,13,4,30,6,1,0,7,0,30,4,0,0,4,1,30,6,1,0,7,5,30,5,2,0,7,2,30,4,0,0,4,1,-15,3,1
2,2,19,0,30,3,10,0,13,2,30,8,0,0,8,0,30,6,7,0,13,0,30,7,6,0,13,0,30,7,2,0,9,1,-15,3,1
2,4,23,1,30,5,8,0,13,3,30,6,0,0,6,8,30,11,2,0,13,0,30,4,9,0,13,0,30,6,0,0,6,1,-15,3,1
2,3,25,1,30,2,12,0,14,5,30,6,0,0,6,0,30,7,7,0,14,1,30,9,5,0,14,4,30,6,0,0,6,1,-15,3,1
2,1,27,1,30,5,10,0,15,4,30,1,1,0,2,0,30,6,9,0,15,1,30,4,11,0,15,4,30,6,0,0,6,1,-15,3,1
2,3,31,3,30,7,5,0,12,4,30,8,0,0,8,0,30,11,1,0,12,0,30,3,9,0,12,0,30,4,2,0,6,1,-15,3,1
2,4,17,4,30,10,4,0,14,2,30,6,0,0,6,0,30,8,6,0,14,1,30,5,9,0,14,2,30,4,0,0,4,1,-15,3,1
2,2,19,0,30,3,10,0,13,1,30,5,3,0,8,0,30,9,4,0,13,4,30,5,8,0,13,1,30,7,2,0,9,1,-15,3,1
2,3,19,0,30,3,10,0,13,1,30,5,3,0,8,0,30,9,4,0,13,4,30,5,8,0,13,1,30,7,2,0,9,1,-15,3,1
2,4,19,0,30,3,10,0,13,1,30,5,3,0,8,0,30,9,4,0,13,4,30,5,8,0,13,1,30,7,2,0,9,1,-15,3,1
2,2,23,7,30,6,7,0,13,2,30,6,0,0,6,2,30,13,0,0,13,0,30,5,8,0,13,2,30,6,0,0,6,1,-15,3,1
2,4,23,7,30,6,7,0,13,2,30,6,0,0,6,2,30,13,0,0,13,0,30,5,8,0,13,2,30,6,0,0,6,1,-15,3,1
2,2,25,3,30,3,11,0,14,4,30,6,0,0,6,0,30,9,5,0,14,3,30,7,7,0,14,6,30,6,0,0,6,1,-15,3,1
2,3,25,3,30,3,11,0,14,4,30,6,0,0,6,0,30,9,5,0,14,3,30,7,7,0,14,6,30,6,0,0,6,1,-15,3,1
2,0,27,1,30,4,11,0,15,5,30,2,0,0,2,0,30,3,12,0,15,2,30,8,7,0,15,3,30,6,0,0,6,1,-15,3,1
2,1,27,1,30,4,11,0,15,5,30,2,0,0,2,0,30,3,12,0,15,2,30,8,7,0,15,3,30,6,0,0,6,1,-15,3,1
2,2,27,1,30,4,11,0,15,5,30,2,0,0,2,0,30,3,12,0,15,2,30,8,7,0,15,3,30,6,0,0,6,1,-15,3,1
2,4,27,1,30,4,11,0,15,5,30,2,0,0,2,0,30,3,12,0,15,2,30,8,7,0,15,3,30,6,0,0,6,1,-15,3,1
2,3,29,0,30,9,5,0,14,6,30,12,0,0,12,0,30,4,10,0,14,0,30,1,13,0,14,0,30,8,1,0,9,1,-15,3,1
2,4,29,0,30,9,5,0,14,6,30,12,0,0,12,0,30,4,10,0,14,0,30,1,13,0,14,0,30,8,1,0,9,1,-15,3,1
2,4,31,1,30,5,7,0,12,4,30,8,0,0,8,5,30,10,2,0,12,0,30,3,9,0,12,0,30,2,4,0,6,1,-15,3,1
2,4,7,1,30,4,5,0,9,2,30,4,0,0,4,0,30,6,3,0,9,5,30,1,8,0,9,1,30,4,2,0,6,0,-27,3,0
2,4,8,1,30,7,0,0,7,4,30,2,0,0,2,11,30,3,4,0,7,0,30,6,1,0,7,1,30,3,0,0,3,0,-27,3,0
2,4,11,0,30,3,9,0,12,1,30,4,0,0,4,0,30,6,6,0,12,0,30,6,6,0,12,3,30,4,0,0,4,1,-15,3,1
2,3,13,2,30,6,1,0,7,0,30,4,0,0,4,2,30,5,2,0,7,4,30,7,0,0,7,8,30,4,0,0,4,1,-15,3,1
2,3,25,1,30,8,6,0,14,3,30,6,0,0,6,0,30,11,3,0,14,1,30,5,9,0,14,3,30,5,1,0,6,1,-15,3,1
2,0,31,1,30,5,7,0,12,7,30,8,0,0,8,3,30,4,8,0,12,2,30,7,5,0,12,3,30,6,0,0,6,1,-15,3,1
2,3,31,1,30,5,7,0,12,7,30,8,0,0,8,3,30,4,8,0,12,0,30,7,5,0,12,3,30,6,0,0,6,1,-15,3,1
2,2,37,3,30,7,4,0,11,5,30,4,4,0,8,2,30,10,1,0,11,2,30,2,9,0,11,0,30,6,0,0,6,1,-15,3,1
2,4,37,3,30,7,4,0,11,5,30,4,4,0,8,2,30,10,1,0,11,2,30,2,9,0,11,0,30,6,0,0,6,1,-15,3,1
2,3,1,0,30,4,6,0,10,4,30,2,0,0,2,1,30,4,6,0,10,4,30,10,0,0,10,6,30,6,0,0,6,0,-27,3,0
2,4,3,0,30,0,4,0,4,2,30,4,0,0,4,1,30,2,2,0,4,4,30,0,4,0,4,0,30,2,1,0,3,0,-27,3,0
2,1,13,3,30,7,0,0,7,0,30,4,0,0,4,2,30,5,2,0,7,11,30,7,0,0,7,2,30,4,0,0,4,1,-15,3,1
2,2,13,3,30,7,0,0,7,0,30,4,0,0,4,2,30,5,2,0,7,11,30,7,0,0,7,2,30,4,0,0,4,1,-15,3,1
2,3,15,2,30,4,9,0,13,1,30,6,0,0,6,0,30,3,10,0,13,1,30,5,8,0,13,2,30,4,5,0,9,1,-15,3,1
2,3,17,0,30,10,4,0,14,2,30,6,0,0,6,0,30,6,8,0,14,1,30,5,9,0,14,1,30,4,0,0,4,1,-15,3,1
2,4,17,0,30,10,4,0,14,2,30,6,0,0,6,0,30,6,8,0,14,1,30,5,9,0,14,1,30,4,0,0,4,1,-15,3,1
2,1,19,0,30,3,10,0,13,1,30,5,3,0,8,0,30,9,4,0,13,4,30,8,5,0,13,2,30,8,1,0,9,1,-15,3,1
2,2,19,0,30,3,10,0,13,1,30,5,3,0,8,0,30,9,4,0,13,4,30,8,5,0,13,2,30,8,1,0,9,1,-15,3,1
2,3,19,0,30,3,10,0,13,1,30,5,3,0,8,0,30,9,4,0,13,4,30,8,5,0,13,2,30,8,1,0,9,1,-15,3,1
2,4,19,0,30,3,10,0,13,1,30,5,3,0,8,0,30,9,4,0,13,4,30,8,5,0,13,2,30,8,1,0,9,1,-15,3,1
2,0,21,3,30,7,3,0,10,4,30,5,1,0,6,1,30,3,7,0,10,2,30,4,6,0,10,3,30,4,0,0,4,1,-15,3,1
2,2,21,3,30,7,3,0,10,4,30,5,1,0,6,1,30,3,7,0,10,2,30,4,6,0,10,3,30,4,0,0,4,1,-15,3,1
2,3,31,1,30,7,5,0,12,5,30,8,0,0,8,4,30,9,3,0,12,0,30,3,9,0,12,2,30,5,1,0,6,1,-15,3,1
2,3,32,0,30,6,3,0,9,4,30,2,0,0,2,1,30,8,1,0,9,1,30,3,6,0,9,4,30,2,0,0,2,1,-15,3,1
2,2,4,2,30,6,2,0,8,5,30,4,0,0,4,0,30,2,6,0,8,0,30,8,0,0,8,2,30,4,0,0,4,0,-27,3,0
2,2,13,1,30,5,2,0,7,0,30,4,0,0,4,0,30,5,2,0,7,13,30,6,1,0,7,4,30,4,0,0,4,1,-15,3,1
2,2,15,0,30,4,9,0,13,0,30,6,0,0,6,2,30,9,4,0,13,1,30,7,6,0,13,0,30,4,5,0,9,1,-15,3,1
2,3,15,0,30,4,9,0,13,0,30,6,0,0,6,2,30,9,4,0,13,1,30,7,6,0,13,0,30,4,5,0,9,1,-15,3,1
2,4,15,0,30,4,9,0,13,0,30,6,0,0,6,2,30,9,4,0,13,1,30,7,6,0,13,0,30,4,5,0,9,1,-15,3,1
2,1,17,4,30,10,4,0,14,2,30,6,0,0,6,0,30,7,7,0,14,1,30,5,9,0,14,7,30,4,0,0,4,1,-15,3,1
2,3,17,4,30,10,4,0,14,2,30,6,0,0,6,0,30,7,7,0,14,0,30,5,9,0,14,7,30,4,0,0,4,1,-15,3,1
2,3,23,1,30,5,8,0,13,4,30,6,0,0,6,8,30,10,3,0,13,0,30,5,8,0,13,1,30,5,1,0,6,1,-15,3,1
2,4,23,1,30,5,8,0,13,4,30,6,0,0,6,8,30,10,3,0,13,0,30,5,8,0,13,1,30,5,1,0,6,1,-15,3,1
2,1,25,1,30,3,11,0,14,2,30,6,0,0,6,0,30,11,3,0,14,1,30,5,9,0,14,4,30,5,1,0,6,1,-15,3,1
2,2,25,1,30,3,11,0,14,2,30,6,0,0,6,0,30,11,3,0,14,1,30,5,9,0,14,4,30,5,1,0,6,1,-15,3,1
2,4,35,0,30,7,6,0,13,5,30,2,0,0,2,1,30,3,10,0,13,2,30,3,10,0,13,6,30,8,0,0,8,1,-15,3,1
2,3,8,3,30,7,0,0,7,4,30,2,0,0,2,4,30,4,3,0,7,0,30,5,2,0,7,1,30,3,0,0,3,0,-27,3,0
2,1,13,4,30,7,0,0,7,0,30,4,0,0,4,2,30,7,0,0,7,7,30,5,2,0,7,4,30,4,0,0,4,1,-15,3,1
2,2,13,4,30,7,0,0,7,0,30,4,0,0,4,2,30,7,0,0,7,7,30,5,2,0,7,4,30,4,0,0,4,1,-15,3,1
2,4,13,4,30,7,0,0,7,0,30,4,0,0,4,2,30,7,0,0,7,7,30,5,2,0,7,4,30,4,0,0,4,1,-15,3,1
2,2,17,3,30,8,6,0,14,3,30,6,0,0,6,0,30,5,9,0,14,3,30,6,8,0,14,3,30,4,0,0,4,1,-15,3,1
2,3,17,3,30,8,6,0,14,3,30,6,0,0,6,0,30,5,9,0,14,3,30,6,8,0,14,3,30,4,0,0,4,1,-15,3,1
2,4,17,3,30,8,6,0,14,3,30,6,0,0,6,0,30,5,9,0,14,3,30,6,8,0,14,3,30,4,0,0,4,1,-15,3,1
2,2,25,1,30,8,6,0,14,3,30,6,0,0,6,0,30,12,2,0,14,1,30,5,9,0,14,4,30,5,1,0,6,1,-15,3,1
2,3,25,1,30,8,6,0,14,3,30,6,0,0,6,0,30,12,2,0,14,1,30,5,9,0,14,4,30,5,1,0,6,1,-15,3,1
2,2,33,1,30,4,7,0,11,5,30,4,0,0,4,3,30,9,2,0,11,1,30,3,8,0,11,7,30,4,0,0,4,1,-15,3,1
2,3,38,0,30,5,5,0,10,8,30,6,0,0,6,0,30,1,9,0,10,0,30,4,6,0,10,7,30,6,0,0,6,1,-15,3,1
2,4,43,4,30,11,3,0,14,8,30,6,0,0,6,0,30,4,10,0,14,1,30,2,12,0,14,3,30,5,0,0,5,1,-15,3,1
2,0,4,0,30,6,2,0,8,4,30,4,0,0,4,2,30,1,7,0,8,1,30,5,3,0,8,2,30,4,0,0,4,0,-27,3,0
2,1,4,0,30,6,2,0,8,4,30,4,0,0,4,2,30,1,7,0,8,1,30,5,3,0,8,2,30,4,0,0,4,0,-27,3,0
2,2,4,0,30,6,2,0,8,4,30,4,0,0,4,2,30,1,7,0,8,1,30,5,3,0,8,2,30,4,0,0,4,0,-27,3,0
2,3,17,0,30,8,6,0,14,3,30,6,0,0,6,0,30,3,11,0,14,2,30,6,8,0,14,4,30,4,0,0,4,1,-15,3,1
2,1,25,1,30,4,10,0,14,5,30,6,0,0,6,0,30,9,5,0,14,1,30,5,9,0,14,4,30,6,0,0,6,1,-15,3,1
2,2,25,1,30,4,10,0,14,5,30,6,0,0,6,0,30,9,5,0,14,1,30,5,9,0,14,4,30,6,0,0,6,1,-15,3,1
2,4,25,1,30,4,10,0,14,5,30,6,0,0,6,0,30,9,5,0,14,1,30,5,9,0,14,4,30,6,0,0,6,1,-15,3,1
2,2,27,0,30,4,11,0,15,5,30,2,0,0,2,0,30,3,12,0,15,0,30,4,11,0,15,5,30,6,0,0,6,1,-15,3,1
2,3,27,0,30,4,11,0,15,5,30,2,0,0,2,0,30,3,12,0,15,0,30,4,11,0,15,5,30,6,0,0,6,1,-15,3,1
2,4,29,0,30,5,9,0,14,6,30,12,0,0,12,0,30,3,11,0,14,0,30,1,13,0,14,3,30,9,0,0,9,1,-15,3,1
2,4,6,3,30,9,0,0,9,4,30,2,0,0,2,0,30,2,7,0,9,0,30,3,6,0,9,0,30,4,1,0,5,0,-27,3,0
2,1,13,3,30,5,2,0,7,0,30,4,0,0,4,3,30,7,0,0,7,9,30,6,1,0,7,6,30,4,0,0,4,1,-15,3,1
2,2,13,3,30,5,2,0,7,0,30,4,0,0,4,3,30,7,0,0,7,9,30,6,1,0,7,6,30,4,0,0,4,1,-15,3,1
2,3,15,0,30,4,9,0,13,1,30,4,2,0,6,0,30,4,9,0,13,1,30,9,4,0,13,2,30,4,5,0,9,1,-15,3,1
2,4,19,0,30,5,8,0,13,1,30,8,0,0,8,0,30,8,5,0,13,0,30,3,10,0,13,1,30,7,2,0,9,1,-15,3,1
2,3,23,1,30,6,7,0,13,3,30,5,1,0,6,7,30,9,4,0,13,0,30,3,10,0,13,1,30,6,0,0,6,1,-15,3,1
2,3,25,1,30,10,4,0,14,4,30,6,0,0,6,0,30,7,7,0,14,1,30,5,9,0,14,5,30,4,2,0,6,1,-15,3,1
2,1,27,1,30,4,11,0,15,1,30,2,0,0,2,0,30,8,7,0,15,0,30,5,10,0,15,4,30,6,0,0,6,1,-15,3,1
2,3,5,0,30,0,5,0,5,2,30,3,1,0,4,0,30,0,5,0,5,0,30,1,4,0,5,0,30,2,0,0,2,0,-27,3,0
2,2,11,0,30,1,3,0,4,0,30,0,0,0,0,0,30,1,3,0,4,7,30,3,1,0,4,3,30,1,0,0,1,1,-15,3,1
2,2,17,3,30,5,9,0,14,2,30,6,0,0,6,0,30,7,7,0,14,0,30,6,8,0,14,4,30,4,0,0,4,1,-15,3,1
2,3,17,3,30,5,9,0,14,2,30,6,0,0,6,0,30,7,7,0,14,0,30,6,8,0,14,4,30,4,0,0,4,1,-15,3,1
2,1,19,0,30,2,11,0,13,2,30,5,3,0,8,0,30,4,9,0,13,3,30,4,9,0,13,1,30,9,0,0,9,1,-15,3,1
2,3,19,0,30,2,11,0,13,2,30,5,3,0,8,0,30,4,9,0,13,3,30,4,9,0,13,1,30,9,0,0,9,1,-15,3,1
2,4,22,1,30,8,0,0,8,3,30,2,0,0,2,1,30,5,3,0,8,0,30,4,4,0,8,3,30,2,2,0,4,1,-15,3,1
2,4,23,1,30,6,7,0,13,0,30,6,0,0,6,4,30,11,2,0,13,0,30,6,7,0,13,3,30,6,0,0,6,1,-15,3,1
2,3,27,6,30,5,10,0,15,4,30,1,1,0,2,0,30,7,8,0,15,0,30,4,11,0,15,3,30,6,0,0,6,1,-15,3,1
2,4,27,6,30,5,10,0,15,4,30,1,1,0,2,0,30,7,8,0,15,0,30,4,11,0,15,3,30,6,0,0,6,1,-15,3,1
2,1,29,0,30,6,8,0,14,5,30,10,2,0,12,0,30,3,11,0,14,7,30,6,8,0,14,0,30,9,0,0,9,1,-15,3,1
2,0,4,3,30,5,3,0,8,4,30,3,1,0,4,0,30,4,4,0,8,0,30,6,2,0,8,2,30,3,1,0,4,0,-27,3,0
2,2,4,3,30,5,3,0,8,4,30,3,1,0,4,0,30,4,4,0,8,0,30,6,2,0,8,2,30,3,1,0,4,0,-27,3,0
2,3,4,3,30,5,3,0,8,4,30,3,1,0,4,0,30,4,4,0,8,0,30,6,2,0,8,2,30,3,1,0,4,0,-27,3,0
2,4,8,0,30,7,0,0,7,2,30,2,0,0,2,0,30,6,1,0,7,1,30,7,0,0,7,3,30,3,0,0,3,0,-27,3,0
2,3,13,1,30,7,0,0,7,1,30,4,0,0,4,2,30,5,2,0,7,3,30,7,0,0,7,5,30,4,0,0,4,1,-15,3,1
2,4,13,1,30,7,0,0,7,1,30,4,0,0,4,2,30,5,2,0,7,3,30,7,0,0,7,5,30,4,0,0,4,1,-15,3,1
2,4,15,1,30,4,9,0,13,1,30,6,0,0,6,0,30,3,10,0,13,1,30,3,10,0,13,3,30,9,0,0,9,1,-15,3,1
2,4,17,2,30,9,5,0,14,3,30,6,0,0,6,0,30,6,8,0,14,1,30,6,8,0,14,1,30,4,0,0,4,1,-15,3,1
2,3,19,0,30,4,9,0,13,2,30,6,2,0,8,0,30,5,8,0,13,3,30,6,7,0,13,2,30,8,1,0,9,1,-15,3,1
2,3,23,1,30,6,7,0,13,1,30,6,0,0,6,6,30,11,2,0,13,0,30,4,9,0,13,2,30,6,0,0,6,1,-15,3,1
2,4,25,0,30,8,6,0,14,1,30,6,0,0,6,0,30,9,5,0,14,1,30,7,7,0,14,3,30,5,1,0,6,1,-15,3,1
2,1,27,3,30,12,3,0,15,5,30,2,0,0,2,4,30,2,13,0,15,0,30,1,14,0,15,2,30,4,2,0,6,1,-15,3,1
2,3,29,1,30,9,5,0,14,5,30,10,2,0,12,0,30,2,12,0,14,0,30,1,13,0,14,0,30,8,1,0,9,1,-15,3,1
2,4,29,1,30,9,5,0,14,5,30,10,2,0,12,0,30,2,12,0,14,0,30,1,13,0,14,0,30,8,1,0,9,1,-15,3,1
2,4,35,0,30,7,6,0,13,3,30,2,0,0,2,1,30,5,8,0,13,0,30,2,11,0,13,3,30,8,0,0,8,1,-15,3,1
2,3,38,0,30,2,8,0,10,7,30,6,0,0,6,0,30,2,8,0,10,0,30,5,5,0,10,9,30,6,0,0,6,1,-15,3,1
2,0,41,1,30,10,2,0,12,8,30,8,0,0,8,0,30,3,9,0,12,1,30,4,8,0,12,1,30,5,2,0,7,1,-15,3,1
2,2,41,1,30,10,2,0,12,8,30,8,0,0,8,0,30,3,9,0,12,1,30,4,8,0,12,1,30,5,2,0,7,1,-15,3,1
2,3,41,1,30,10,2,0,12,8,30,8,0,0,8,0,30,3,9,0,12,1,30,4,8,0,12,1,30,5,2,0,7,1,-15,3,1
2,4,41,1,30,10,2,0,12,8,30,8,0,0,8,0,30,3,9,0,12,1,30,4,8,0,12,1,30,5,2,0,7,1,-15,3,1
2,0,45,3,30,8,5,0,13,10,30,10,0,0,10,0,30,2,11,0,13,0,30,4,9,0,13,9,30,5,0,0,5,1,-15,3,1
2,3,6,2,30,7,2,0,9,4,30,2,0,0,2,0,30,2,7,0,9,0,30,4,5,0,9,0,30,3,2,0,5,0,-27,3,0
2,4,6,2,30,7,2,0,9,4,30,2,0,0,2,0,30,2,7,0,9,0,30,4,5,0,9,0,30,3,2,0,5,0,-27,3,0
2,1,11,3,30,5,7,0,12,2,30,4,0,0,4,0,30,5,7,0,12,1,30,7,5,0,12,4,30,4,0,0,4,1,-15,3,1
2,4,13,5,30,7,0,0,7,3,30,4,0,0,4,5,30,5,2,0,7,0,30,6,1,0,7,0,30,4,0,0,4,1,-15,3,1
2,0,19,0,30,2,11,0,13,1,30,8,0,0,8,0,30,7,6,0,13,4,30,5,8,0,13,0,30,7,2,0,9,1,-15,3,1
2,1,19,0,30,2,11,0,13,1,30,8,0,0,8,0,30,7,6,0,13,4,30,5,8,0,13,0,30,7,2,0,9,1,-15,3,1
2,2,19,0,30,2,11,0,13,1,30,8,0,0,8,0,30,7,6,0,13,4,30,5,8,0,13,0,30,7,2,0,9,1,-15,3,1
2,4,19,0,30,2,11,0,13,1,30,8,0,0,8,0,30,7,6,0,13,4,30,5,8,0,13,0,30,7,2,0,9,1,-15,3,1
2,2,25,2,30,6,8,0,14,5,30,6,0,0,6,0,30,6,8,0,14,1,30,7,7,0,14,4,30,5,1,0,6,1,-15,3,1
2,4,27,0,30,3,12,0,15,4,30,2,0,0,2,0,30,4,11,0,15,0,30,4,11,0,15,3,30,6,0,0,6,1,-15,3,1
2,2,29,0,30,9,5,0,14,6,30,11,1,0,12,0,30,3,11,0,14,0,30,1,13,0,14,0,30,9,0,0,9,1,-15,3,1
2,4,1,0,30,4,6,0,10,3,30,2,0,0,2,1,30,4,6,0,10,4,30,4,6,0,10,6,30,6,0,0,6,0,-27,3,0
2,1,5,0,30,1,4,0,5,3,30,1,3,0,4,0,30,1,4,0,5,0,30,2,3,0,5,0,30,2,0,0,2,0,-27,3,0
2,2,5,0,30,1,4,0,5,3,30,1,3,0,4,0,30,1,4,0,5,0,30,2,3,0,5,0,30,2,0,0,2,0,-27,3,0
2,1,13,3,30,7,0,0,7,1,30,4,0,0,4,3,30,5,2,0,7,3,30,7,0,0,7,2,30,4,0,0,4,1,-15,3,1
2,4,17,0,30,8,6,0,14,2,30,6,0,0,6,0,30,6,8,0,14,1,30,6,8,0,14,4,30,4,0,0,4,1,-15,3,1
2,2,19,0,30,3,10,0,13,2,30,6,2,0,8,0,30,9,4,0,13,5,30,3,10,0,13,2,30,9,0,0,9,1,-15,3,1
2,4,19,0,30,3,10,0,13,2,30,6,2,0,8,0,30,9,4,0,13,5,30,3,10,0,13,2,30,9,0,0,9,1,-15,3,1
2,2,25,1,30,7,7,0,14,4,30,6,0,0,6,0,30,8,6,0,14,1,30,4,10,0,14,3,30,5,1,0,6,1,-15,3,1
2,4,25,1,30,7,7,0,14,4,30,6,0,0,6,0,30,8,6,0,14,0,30,4,10,0,14,3,30,5,1,0,6,1,-15,3,1
2,4,31,1,30,4,8,0,12,5,30,8,0,0,8,8,30,9,3,0,12,0,30,3,9,0,12,1,30,3,3,0,6,1,-15,3,1
2,1,4,2,30,8,0,0,8,5,30,4,0,0,4,0,30,1,7,0,8,2,30,6,2,0,8,1,30,4,0,0,4,0,-27,3,0
2,2,4,2,30,8,0,0,8,5,30,4,0,0,4,0,30,1,7,0,8,2,30,6,2,0,8,1,30,4,0,0,4,0,-27,3,0
2,3,4,2,30,8,0,0,8,5,30,4,0,0,4,0,30,1,7,0,8,2,30,6,2,0,8,1,30,4,0,0,4,0,-27,3,0
2,4,4,2,30,8,0,0,8,5,30,4,0,0,4,0,30,1,7,0,8,2,30,6,2,0,8,1,30,4,0,0,4,0,-27,3,0
2,1,9,0,30,8,3,0,11,2,30,6,0,0,6,1,30,9,2,0,11,5,30,4,7,0,11,3,30,2,2,0,4,0,-27,3,0
2,4,9,0,30,8,3,0,11,2,30,6,0,0,6,1,30,9,2,0,11,5,30,4,7,0,11,3,30,2,2,0,4,0,-27,3,0
2,2,12,0,30,6,1,0,7,1,30,2,4,0,6,0,30,4,3,0,7,6,30,4,3,0,7,5,30,2,1,0,3,1,-15,3,1
2,3,12,0,30,6,1,0,7,1,30,2,4,0,6,0,30,4,3,0,7,6,30,4,3,0,7,5,30,2,1,0,3,1,-15,3,1
2,1,19,0,30,2,11,0,13,2,30,3,5,0,8,0,30,6,7,0,13,5,30,6,7,0,13,0,30,9,0,0,9,1,-15,3,1
2,2,19,0,30,2,11,0,13,2,30,3,5,0,8,0,30,6,7,0,13,5,30,6,7,0,13,0,30,9,0,0,9,1,-15,3,1
2,3,21,8,30,10,0,0,10,4,30,6,0,0,6,1,30,3,7,0,10,1,30,3,7,0,10,0,30,3,1,0,4,1,-15,3,1
2,4,21,8,30,10,0,0,10,4,30,6,0,0,6,1,30,3,7,0,10,1,30,3,7,0,10,0,30,3,1,0,4,1,-15,3,1
2,0,27,1,30,3,12,0,15,3,30,1,1,0,2,0,30,6,9,0,15,1,30,7,8,0,15,5,30,6,0,0,6,1,-15,3,1
2,1,27,1,30,3,12,0,15,3,30,1,1,0,2,0,30,6,9,0,15,1,30,7,8,0,15,5,30,6,0,0,6,1,-15,3,1
2,2,27,1,30,3,12,0,15,3,30,1,1,0,2,0,30,6,9,0,15,1,30,7,8,0,15,5,30,6,0,0,6,1,-15,3,1
2,3,29,1,30,6,8,0,14,6,30,10,2,0,12,0,30,3,11,0,14,0,30,0,14,0,14,4,30,9,0,0,9,1,-15,3,1
2,2,5,0,30,1,4,0,5,2,30,2,2,0,4,0,30,2,3,0,5,0,30,1,4,0,5,0,30,0,2,0,2,0,-27,3,0
2,3,5,0,30,1,4,0,5,2,30,2,2,0,4,0,30,2,3,0,5,0,30,1,4,0,5,0,30,0,2,0,2,0,-27,3,0
2,1,13,3,30,6,1,0,7,1,30,4,0,0,4,0,30,6,1,0,7,3,30,5,2,0,7,4,30,4,0,0,4,1,-15,3,1
2,3,17,0,30,10,4,0,14,0,30,6,0,0,6,0,30,7,7,0,14,1,30,5,9,0,14,2,30,4,0,0,4,1,-15,3,1
2,2,19,0,30,6,7,0,13,2,30,7,1,0,8,4,30,4,9,0,13,3,30,6,7,0,13,0,30,7,2,0,9,1,-15,3,1
2,3,22,1,30,7,1,0,8,2,30,2,0,0,2,0,30,4,4,0,8,1,30,3,5,0,8,0,30,2,2,0,4,1,-15,3,1
2,4,31,2,30,6,6,0,12,4,30,8,0,0,8,4,30,10,2,0,12,0,30,3,9,0,12,1,30,4,2,0,6,1,-15,3,1
2,3,33,1,30,2,9,0,11,4,30,4,0,0,4,3,30,9,2,0,11,0,30,3,8,0,11,5,30,4,0,0,4,1,-15,3,1
2,1,13,1,30,6,1,0,7,0,30,4,0,0,4,3,30,7,0,0,7,13,30,5,2,0,7,3,30,4,0,0,4,1,-15,3,1
2,2,17,4,30,11,3,0,14,4,30,6,0,0,6,0,30,2,12,0,14,1,30,4,10,0,14,3,30,4,0,0,4,1,-15,3,1
2,3,17,4,30,11,3,0,14,4,30,6,0,0,6,0,30,2,12,0,14,1,30,4,10,0,14,3,30,4,0,0,4,1,-15,3,1
2,4,17,4,30,11,3,0,14,4,30,6,0,0,6,0,30,2,12,0,14,1,30,4,10,0,14,3,30,4,0,0,4,1,-15,3,1
2,1,19,0,30,3,10,0,13,2,30,6,2,0,8,0,30,4,9,0,13,8,30,6,7,0,13,0,30,8,1,0,9,1,-15,3,1
2,2,21,3,30,8,2,0,10,4,30,6,0,0,6,1,30,3,7,0,10,1,30,4,6,0,10,1,30,4,0,0,4,1,-15,3,1
2,4,21,3,30,8,2,0,10,4,30,6,0,0,6,1,30,3,7,0,10,1,30,4,6,0,10,1,30,4,0,0,4,1,-15,3,1
2,3,23,2,30,6,7,0,13,1,30,6,0,0,6,5,30,11,2,0,13,0,30,5,8,0,13,2,30,6,0,0,6,1,-15,3,1
2,3,25,1,30,4,10,0,14,1,30,6,0,0,6,0,30,8,6,0,14,1,30,5,9,0,14,3,30,5,1,0,6,1,-15,3,1
2,0,27,1,30,4,11,0,15,4,30,1,1,0,2,0,30,6,9,0,15,1,30,4,11,0,15,3,30,6,0,0,6,1,-15,3,1
2,3,29,0,30,5,9,0,14,6,30,12,0,0,12,0,30,3,11,0,14,0,30,0,14,0,14,0,30,9,0,0,9,1,-15,3,1
2,0,31,1,30,5,7,0,12,4,30,8,0,0,8,3,30,12,0,0,12,0,30,3,9,0,12,5,30,2,4,0,6,1,-15,3,1
2,0,38,0,30,1,9,0,10,7,30,6,0,0,6,0,30,1,9,0,10,0,30,5,5,0,10,9,30,6,0,0,6,1,-15,3,1
2,4,39,0,30,3,8,0,11,6,30,6,0,0,6,0,30,4,7,0,11,1,30,2,9,0,11,5,30,5,0,0,5,1,-15,3,1
2,3,11,1,30,5,7,0,12,2,30,4,0,0,4,0,30,6,6,0,12,3,30,7,5,0,12,0,30,4,0,0,4,1,-15,3,1
2,4,11,1,30,5,7,0,12,2,30,4,0,0,4,0,30,6,6,0,12,3,30,7,5,0,12,0,30,4,0,0,4,1,-15,3,1
2,3,17,5,30,11,3,0,14,4,30,6,0,0,6,0,30,3,11,0,14,1,30,4,10,0,14,2,30,4,0,0,4,1,-15,3,1
2,4,17,5,30,11,3,0,14,4,30,6,0,0,6,0,30,3,11,0,14,1,30,4,10,0,14,2,30,4,0,0,4,1,-15,3,1
2,3,23,1,30,4,9,0,13,4,30,6,0,0,6,7,30,12,1,0,13,0,30,4,9,0,13,3,30,6,0,0,6,1,-15,3,1
2,4,23,1,30,4,9,0,13,4,30,6,0,0,6,7,30,12,1,0,13,0,30,4,9,0,13,3,30,6,0,0,6,1,-15,3,1
2,2,11,0,30,1,3,0,4,0,30,0,0,0,0,0,30,3,1,0,4,7,30,4,0,0,4,0,30,1,0,0,1,1,-15,3,1
2,4,11,0,30,1,3,0,4,0,30,0,0,0,0,0,30,3,1,0,4,7,30,4,0,0,4,0,30,1,0,0,1,1,-15,3,1
2,2,17,1,30,10,4,0,14,0,30,6,0,0,6,0,30,5,9,0,14,0,30,5,9,0,14,4,30,4,0,0,4,1,-15,3,1
2,1,19,0,30,4,9,0,13,2,30,5,3,0,8,0,30,4,9,0,13,7,30,4,9,0,13,2,30,9,0,0,9,1,-15,3,1
2,2,19,0,30,4,9,0,13,2,30,5,3,0,8,0,30,4,9,0,13,7,30,4,9,0,13,2,30,9,0,0,9,1,-15,3,1
2,1,21,3,30,9,1,0,10,4,30,6,0,0,6,1,30,3,7,0,10,2,30,5,5,0,10,1,30,4,0,0,4,1,-15,3,1
2,3,25,1,30,7,7,0,14,4,30,6,0,0,6,0,30,10,4,0,14,0,30,5,9,0,14,3,30,5,1,0,6,1,-15,3,1
2,4,25,1,30,7,7,0,14,4,30,6,0,0,6,0,30,10,4,0,14,0,30,5,9,0,14,3,30,5,1,0,6,1,-15,3,1
2,2,29,0,30,11,3,0,14,4,30,7,5,0,12,0,30,3,11,0,14,0,30,3,11,0,14,1,30,9,0,0,9,1,-15,3,1
2,4,29,0,30,11,3,0,14,4,30,7,5,0,12,0,30,3,11,0,14,0,30,3,11,0,14,1,30,9,0,0,9,1,-15,3,1
2,3,2,0,30,7,3,0,10,3,30,2,2,0,4,0,30,3,7,0,10,0,30,4,6,0,10,1,30,8,0,0,8,0,-27,3,0
2,4,2,0,30,7,3,0,10,3,30,2,2,0,4,0,30,3,7,0,10,0,30,4,6,0,10,1,30,8,0,0,8,0,-27,3,0
2,2,6,0,30,6,3,0,9,4,30,2,0,0,2,0,30,2,7,0,9,0,30,4,5,0,9,3,30,5,0,0,5,0,-27,3,0
2,3,8,2,30,7,0,0,7,4,30,2,0,0,2,0,30,2,5,0,7,1,30,7,0,0,7,1,30,3,0,0,3,0,-27,3,0
2,4,8,2,30,7,0,0,7,4,30,2,0,0,2,0,30,2,5,0,7,1,30,7,0,0,7,1,30,3,0,0,3,0,-27,3,0
2,4,13,1,30,5,2,0,7,0,30,4,0,0,4,2,30,6,1,0,7,16,30,7,0,0,7,0,30,4,0,0,4,1,-15,3,1
2,4,23,2,30,5,8,0,13,0,30,6,0,0,6,2,30,13,0,0,13,0,30,5,8,0,13,2,30,6,0,0,6,1,-15,3,1
2,2,25,1,30,6,8,0,14,5,30,6,0,0,6,0,30,8,6,0,14,1,30,6,8,0,14,4,30,6,0,0,6,1,-15,3,1
2,0,27,1,30,4,11,0,15,3,30,2,0,0,2,0,30,10,5,0,15,2,30,5,10,0,15,2,30,6,0,0,6,1,-15,3,1
2,2,27,1,30,4,11,0,15,3,30,2,0,0,2,0,30,10,5,0,15,2,30,5,10,0,15,2,30,6,0,0,6,1,-15,3,1
2,3,27,1,30,4,11,0,15,3,30,2,0,0,2,0,30,10,5,0,15,2,30,5,10,0,15,2,30,6,0,0,6,1,-15,3,1
2,3,29,0,30,5,9,0,14,6,30,11,1,0,12,0,30,2,12,0,14,0,30,1,13,0,14,0,30,9,0,0,9,1,-15,3,1
2,4,29,0,30,5,9,0,14,6,30,11,1,0,12,0,30,2,12,0,14,0,30,1,13,0,14,0,30,9,0,0,9,1,-15,3,1
2,2,31,9,30,7,5,0,12,8,30,8,0,0,8,3,30,4,8,0,12,0,30,3,9,0,12,0,30,6,0,0,6,1,-15,3,1
2,4,31,9,30,7,5,0,12,8,30,8,0,0,8,0,30,4,8,0,12,0,30,3,9,0,12,0,30,6,0,0,6,1,-15,3,1
2,3,33,3,30,4,7,0,11,5,30,4,0,0,4,5,30,9,2,0,11,0,30,3,8,0,11,6,30,4,0,0,4,1,-15,3,1
2,3,4,0,30,7,1,0,8,4,30,4,0,0,4,2,30,1,7,0,8,0,30,4,4,0,8,4,30,4,0,0,4,0,-27,3,0
2,4,4,0,30,7,1,0,8,4,30,4,0,0,4,2,30,1,7,0,8,0,30,4,4,0,8,4,30,4,0,0,4,0,-27,3,0
2,0,5,0,30,2,3,0,5,3,30,3,1,0,4,2,30,1,4,0,5,0,30,1,4,0,5,0,30,2,0,0,2,0,-27,3,0
2,1,5,0,30,2,3,0,5,3,30,3,1,0,4,2,30,1,4,0,5,0,30,1,4,0,5,0,30,2,0,0,2,0,-27,3,0
2,2,23,2,30,6,7,0,13,3,30,6,0,0,6,6,30,9,4,0,13,1,30,7,6,0,13,1,30,6,0,0,6,1,-15,3,1
2,4,23,2,30,6,7,0,13,3,30,6,0,0,6,6,30,9,4,0,13,1,30,7,6,0,13,1,30,6,0,0,6,1,-15,3,1
2,1,27,2,30,5,10,0,15,4,30,1,1,0,2,0,30,9,6,0,15,1,30,4,11,0,15,0,30,6,0,0,6,1,-15,3,1
2,1,29,0,30,3,11,0,14,4,30,12,0,0,12,0,30,5,9,0,14,0,30,1,13,0,14,4,30,9,0,0,9,1,-15,3,1
2,2,29,0,30,3,11,0,14,4,30,12,0,0,12,0,30,5,9,0,14,0,30,1,13,0,14,4,30,9,0,0,9,1,-15,3,1
2,0,31,2,30,8,4,0,12,5,30,8,0,0,8,6,30,9,3,0,12,0,30,3,9,0,12,1,30,5,1,0,6,1,-15,3,1
2,1,31,2,30,8,4,0,12,5,30,8,0,0,8,6,30,9,3,0,12,0,30,3,9,0,12,1,30,5,1,0,6,1,-15,3,1
2,3,35,0,30,5,8,0,13,5,30,2,0,0,2,1,30,6,7,0,13,0,30,4,9,0,13,5,30,8,0,0,8,1,-15,3,1
2,4,7,1,30,4,5,0,9,3,30,4,0,0,4,0,30,6,3,0,9,5,30,3,6,0,9,2,30,6,0,0,6,0,-27,3,0
2,4,8,3,30,7,0,0,7,4,30,2,0,0,2,5,30,4,3,0,7,0,30,5,2,0,7,4,30,3,0,0,3,0,-27,3,0
2,2,9,0,30,2,2,0,4,2,30,2,0,0,2,0,30,0,4,0,4,0,30,1,3,0,4,3,30,1,0,0,1,0,-27,3,0
2,1,13,1,30,5,2,0,7,0,30,4,0,0,4,2,30,6,1,0,7,9,30,6,1,0,7,5,30,4,0,0,4,1,-15,3,1
2,4,13,1,30,5,2,0,7,0,30,4,0,0,4,2,30,6,1,0,7,9,30,6,1,0,7,0,30,4,0,0,4,1,-15,3,1
2,1,17,4,30,10,4,0,14,2,30,6,0,0,6,0,30,6,8,0,14,1,30,7,7,0,14,5,30,4,0,0,4,1,-15,3,1
2,4,17,4,30,10,4,0,14,2,30,6,0,0,6,0,30,6,8,0,14,1,30,7,7,0,14,3,30,4,0,0,4,1,-15,3,1
2,4,22,1,30,7,1,0,8,2,30,2,0,0,2,2,30,5,3,0,8,1,30,5,3,0,8,2,30,1,3,0,4,1,-15,3,1
2,4,23,1,30,6,7,0,13,3,30,6,0,0,6,6,30,12,1,0,13,0,30,5,8,0,13,3,30,6,0,0,6,1,-15,3,1
2,0,25,1,30,5,9,0,14,5,30,6,0,0,6,0,30,5,9,0,14,2,30,8,6,0,14,5,30,6,0,0,6,1,-15,3,1
2,1,25,1,30,5,9,0,14,5,30,6,0,0,6,0,30,5,9,0,14,2,30,8,6,0,14,5,30,6,0,0,6,1,-15,3,1
2,3,25,1,30,5,9,0,14,5,30,6,0,0,6,0,30,5,9,0,14,2,30,8,6,0,14,5,30,6,0,0,6,1,-15,3,1
2,4,25,1,30,5,9,0,14,5,30,6,0,0,6,0,30,5,9,0,14,2,30,8,6,0,14,5,30,6,0,0,6,1,-15,3,1
2,4,1,0,30,7,3,0,10,4,30,2,0,0,2,1,30,4,6,0,10,3,30,5,5,0,10,1,30,6,0,0,6,0,-27,3,0
2,0,5,0,30,2,3,0,5,3,30,0,4,0,4,0,30,0,5,0,5,3,30,1,4,0,5,0,30,1,1,0,2,0,-27,3,0
2,1,5,0,30,2,3,0,5,3,30,0,4,0,4,0,30,0,5,0,5,3,30,1,4,0,5,0,30,1,1,0,2,0,-27,3,0
2,4,13,1,30,3,0,0,3,0,30,2,0,0,2,1,30,3,0,0,3,8,30,2,1,0,3,4,30,2,0,0,2,1,-15,3,1
2,1,13,2,30,6,1,0,7,0,30,4,0,0,4,5,30,7,0,0,7,10,30,6,1,0,7,3,30,4,0,0,4,1,-15,3,1
2,2,13,2,30,6,1,0,7,0,30,4,0,0,4,5,30,7,0,0,7,10,30,6,1,0,7,3,30,4,0,0,4,1,-15,3,1
2,3,27,2,30,7,8,0,15,0,30,1,1,0,2,0,30,12,3,0,15,3,30,5,10,0,15,2,30,6,0,0,6,1,-15,3,1
2,2,45,0,30,7,6,0,13,11,30,10,0,0,10,0,30,0,13,0,13,0,30,6,7,0,13,10,30,5,0,0,5,1,-15,3,1
2,4,8,0,30,7,0,0,7,4,30,2,0,0,2,0,30,4,3,0,7,4,30,6,1,0,7,1,30,3,0,0,3,0,-27,3,0
2,1,13,2,30,6,1,0,7,1,30,4,0,0,4,2,30,5,2,0,7,7,30,4,3,0,7,5,30,4,0,0,4,1,-15,3,1
2,1,17,5,30,8,6,0,14,3,30,6,0,0,6,0,30,5,9,0,14,4,30,5,9,0,14,2,30,4,0,0,4,1,-15,3,1
2,3,17,5,30,8,6,0,14,3,30,6,0,0,6,0,30,5,9,0,14,4,30,5,9,0,14,2,30,4,0,0,4,1,-15,3,1
2,3,19,0,30,3,10,0,13,2,30,6,2,0,8,0,30,4,9,0,13,3,30,4,9,0,13,0,30,9,0,0,9,1,-15,3,1
2,4,21,2,30,8,2,0,10,4,30,6,0,0,6,1,30,3,7,0,10,3,30,4,6,0,10,2,30,4,0,0,4,1,-15,3,1
2,3,25,2,30,7,7,0,14,4,30,6,0,0,6,0,30,5,9,0,14,1,30,5,9,0,14,5,30,5,1,0,6,1,-15,3,1
2,2,31,3,30,8,4,0,12,5,30,8,0,0,8,5,30,8,4,0,12,0,30,3,9,0,12,0,30,3,3,0,6,1,-15,3,1
2,4,32,0,30,7,2,0,9,5,30,2,0,0,2,0,30,4,5,0,9,1,30,2,7,0,9,2,30,2,0,0,2,1,-15,3,1
2,4,35,0,30,8,5,0,13,3,30,2,0,0,2,1,30,10,3,0,13,2,30,3,10,0,13,6,30,8,0,0,8,1,-15,3,1
2,1,4,2,30,7,1,0,8,4,30,4,0,0,4,0,30,3,5,0,8,0,30,4,4,0,8,1,30,4,0,0,4,0,-27,3,0
2,4,8,2,30,7,0,0,7,4,30,2,0,0,2,3,30,2,5,0,7,0,30,7,0,0,7,2,30,3,0,0,3,0,-27,3,0
2,4,15,0,30,4,9,0,13,1,30,5,1,0,6,0,30,3,10,0,13,0,30,7,6,0,13,4,30,9,0,0,9,1,-15,3,1
2,4,17,3,30,10,4,0,14,3,30,6,0,0,6,0,30,5,9,0,14,0,30,8,6,0,14,1,30,4,0,0,4,1,-15,3,1
2,4,19,0,30,4,9,0,13,2,30,3,5,0,8,0,30,7,6,0,13,7,30,3,10,0,13,2,30,9,0,0,9,1,-15,3,1
2,2,25,1,30,9,5,0,14,2,30,6,0,0,6,0,30,9,5,0,14,1,30,5,9,0,14,3,30,5,1,0,6,1,-15,3,1
2,3,25,1,30,9,5,0,14,2,30,6,0,0,6,0,30,9,5,0,14,1,30,5,9,0,14,3,30,5,1,0,6,1,-15,3,1
2,0,27,1,30,4,11,0,15,1,30,1,1,0,2,0,30,6,9,0,15,1,30,6,9,0,15,3,30,6,0,0,6,1,-15,3,1
2,4,27,1,30,4,11,0,15,1,30,1,1,0,2,0,30,6,9,0,15,1,30,6,9,0,15,3,30,6,0,0,6,1,-15,3,1
2,2,1,0,30,4,6,0,10,4,30,2,0,0,2,1,30,4,6,0,10,10,30,7,3,0,10,6,30,6,0,0,6,0,-27,3,0
2,1,4,2,30,8,0,0,8,4,30,4,0,0,4,0,30,3,5,0,8,0,30,4,4,0,8,3,30,4,0,0,4,0,-27,3,0
2,2,4,2,30,8,0,0,8,4,30,4,0,0,4,0,30,3,5,0,8,0,30,4,4,0,8,3,30,4,0,0,4,0,-27,3,0
2,1,13,1,30,5,2,0,7,0,30,4,0,0,4,2,30,6,1,0,7,15,30,5,2,0,7,3,30,4,0,0,4,1,-15,3,1
2,2,13,1,30,5,2,0,7,0,30,4,0,0,4,2,30,6,1,0,7,15,30,5,2,0,7,3,30,4,0,0,4,1,-15,3,1
2,2,17,4,30,10,4,0,14,4,30,6,0,0,6,0,30,3,11,0,14,1,30,8,6,0,14,0,30,4,0,0,4,1,-15,3,1
2,3,23,1,30,5,8,0,13,3,30,6,0,0,6,5,30,12,1,0,13,0,30,6,7,0,13,0,30,6,0,0,6,1,-15,3,1
2,2,39,0,30,6,5,0,11,6,30,6,0,0,6,0,30,5,6,0,11,2,30,3,8,0,11,4,30,5,0,0,5,1,-15,3,1
2,3,39,0,30,6,5,0,11,6,30,6,0,0,6,0,30,5,6,0,11,2,30,3,8,0,11,4,30,5,0,0,5,1,-15,3,1
2,4,39,0,30,6,5,0,11,6,30,6,0,0,6,0,30,5,6,0,11,2,30,3,8,0,11,4,30,5,0,0,5,1,-15,3,1
2,3,2,0,30,5,5,0,10,3,30,4,0,0,4,2,30,5,5,0,10,3,30,6,4,0,10,1,30,8,0,0,8,0,-27,3,0
2,0,19,4,30,10,3,0,13,2,30,6,2,0,8,1,30,4,9,0,13,0,30,6,7,0,13,0,30,6,3,0,9,1,-15,3,1
2,3,19,4,30,10,3,0,13,2,30,6,2,0,8,1,30,4,9,0,13,0,30,6,7,0,13,0,30,6,3,0,9,1,-15,3,1
2,4,19,4,30,10,3,0,13,2,30,6,2,0,8,1,30,4,9,0,13,0,30,6,7,0,13,0,30,6,3,0,9,1,-15,3,1
2,0,4,1,30,6,2,0,8,5,30,4,0,0,4,0,30,2,6,0,8,2,30,8,0,0,8,2,30,4,0,0,4,0,-27,3,0
2,1,4,1,30,6,2,0,8,5,30,4,0,0,4,0,30,2,6,0,8,2,30,8,0,0,8,2,30,4,0,0,4,0,-27,3,0
2,3,4,1,30,6,2,0,8,5,30,4,0,0,4,0,30,2,6,0,8,2,30,8,0,0,8,2,30,4,0,0,4,0,-27,3,0
2,3,5,0,30,2,3,0,5,1,30,3,1,0,4,0,30,0,5,0,5,0,30,1,4,0,5,0,30,0,2,0,2,0,-27,3,0
2,4,8,0,30,7,0,0,7,3,30,2,0,0,2,0,30,4,3,0,7,0,30,2,5,0,7,4,30,3,0,0,3,0,-27,3,0
2,1,13,1,30,5,2,0,7,0,30,4,0,0,4,2,30,5,2,0,7,9,30,6,1,0,7,2,30,4,0,0,4,1,-15,3,1
2,2,13,1,30,5,2,0,7,0,30,4,0,0,4,2,30,5,2,0,7,9,30,6,1,0,7,2,30,4,0,0,4,1,-15,3,1
2,1,17,4,30,11,3,0,14,3,30,6,0,0,6,0,30,5,9,0,14,1,30,7,7,0,14,1,30,3,1,0,4,1,-15,3,1
2,4,17,4,30,11,3,0,14,3,30,6,0,0,6,0,30,5,9,0,14,1,30,7,7,0,14,0,30,3,1,0,4,1,-15,3,1
2,2,19,0,30,6,7,0,13,1,30,8,0,0,8,1,30,7,6,0,13,0,30,3,10,0,13,0,30,6,3,0,9,1,-15,3,1
2,4,19,0,30,6,7,0,13,1,30,8,0,0,8,1,30,7,6,0,13,0,30,3,10,0,13,0,30,6,3,0,9,1,-15,3,1
2,4,23,1,30,5,8,0,13,3,30,6,0,0,6,5,30,12,1,0,13,0,30,5,8,0,13,3,30,6,0,0,6,1,-15,3,1
2,4,25,1,30,5,9,0,14,5,30,6,0,0,6,0,30,4,10,0,14,1,30,9,5,0,14,6,30,6,0,0,6,1,-15,3,1
2,1,31,1,30,6,6,0,12,5,30,8,0,0,8,4,30,9,3,0,12,0,30,3,9,0,12,2,30,6,0,0,6,1,-15,3,1
2,2,31,1,30,6,6,0,12,5,30,8,0,0,8,4,30,9,3,0,12,0,30,3,9,0,12,2,30,6,0,0,6,1,-15,3,1
2,4,31,1,30,6,6,0,12,5,30,8,0,0,8,4,30,9,3,0,12,0,30,3,9,0,12,2,30,6,0,0,6,1,-15,3,1
2,4,8,2,30,7,0,0,7,4,30,2,0,0,2,3,30,2,5,0,7,0,30,3,4,0,7,3,30,3,0,0,3,0,-27,3,0
2,1,15,0,30,3,10,0,13,0,30,6,0,0,6,0,30,5,8,0,13,1,30,6,7,0,13,2,30,4,5,0,9,1,-15,3,1
2,2,15,0,30,3,10,0,13,0,30,6,0,0,6,0,30,5,8,0,13,1,30,6,7,0,13,2,30,4,5,0,9,1,-15,3,1
2,3,15,0,30,3,10,0,13,0,30,6,0,0,6,0,30,5,8,0,13,1,30,6,7,0,13,2,30,4,5,0,9,1,-15,3,1
2,1,17,4,30,9,5,0,14,3,30,6,0,0,6,0,30,4,10,0,14,2,30,5,9,0,14,3,30,4,0,0,4,1,-15,3,1
2,2,17,4,30,9,5,0,14,3,30,6,0,0,6,0,30,4,10,0,14,2,30,5,9,0,14,3,30,4,0,0,4,1,-15,3,1
2,1,19,0,30,4,9,0,13,2,30,6,2,0,8,1,30,9,4,0,13,2,30,5,8,0,13,1,30,9,0,0,9,1,-15,3,1
2,4,19,0,30,4,9,0,13,2,30,6,2,0,8,1,30,9,4,0,13,2,30,5,8,0,13,1,30,9,0,0,9,1,-15,3,1
2,2,23,1,30,5,8,0,13,1,30,6,0,0,6,0,30,13,0,0,13,0,30,6,7,0,13,3,30,6,0,0,6,1,-15,3,1
2,3,23,1,30,5,8,0,13,1,30,6,0,0,6,0,30,13,0,0,13,0,30,6,7,0,13,3,30,6,0,0,6,1,-15,3,1
2,3,11,0,30,5,7,0,12,0,30,4,0,0,4,0,30,6,6,0,12,5,30,6,6,0,12,6,30,4,0,0,4,1,-15,3,1
2,2,13,6,30,7,0,0,7,0,30,4,0,0,4,2,30,7,0,0,7,3,30,5,2,0,7,6,30,4,0,0,4,1,-15,3,1
2,4,13,6,30,7,0,0,7,0,30,4,0,0,4,1,30,7,0,0,7,3,30,5,2,0,7,6,30,4,0,0,4,1,-15,3,1
2,4,15,0,30,3,10,0,13,1,30,6,0,0,6,0,30,3,10,0,13,1,30,3,10,0,13,1,30,8,1,0,9,1,-15,3,1
2,0,19,0,30,3,10,0,13,2,30,8,0,0,8,2,30,5,8,0,13,1,30,6,7,0,13,1,30,6,3,0,9,1,-15,3,1
2,2,19,0,30,3,10,0,13,2,30,8,0,0,8,2,30,5,8,0,13,1,30,6,7,0,13,1,30,6,3,0,9,1,-15,3,1
2,4,19,0,30,3,10,0,13,2,30,8,0,0,8,1,30,5,8,0,13,1,30,6,7,0,13,1,30,6,3,0,9,1,-15,3,1
2,2,25,3,30,5,9,0,14,4,30,6,0,0,6,0,30,7,7,0,14,1,30,7,7,0,14,5,30,5,1,0,6,1,-15,3,1
2,0,27,1,30,5,10,0,15,2,30,2,0,0,2,0,30,3,12,0,15,2,30,4,11,0,15,5,30,6,0,0,6,1,-15,3,1
2,2,27,0,30,5,10,0,15,2,30,2,0,0,2,0,30,3,12,0,15,2,30,4,11,0,15,5,30,6,0,0,6,1,-15,3,1
2,3,27,0,30,5,10,0,15,2,30,2,0,0,2,0,30,3,12,0,15,2,30,4,11,0,15,5,30,6,0,0,6,1,-15,3,1
2,4,27,0,30,5,10,0,15,2,30,2,0,0,2,0,30,3,12,0,15,2,30,4,11,0,15,5,30,6,0,0,6,1,-15,3,1
2,2,33,5,30,5,6,0,11,5,30,4,0,0,4,5,30,10,1,0,11,0,30,3,8,0,11,6,30,4,0,0,4,1,-15,3,1
2,4,33,5,30,5,6,0,11,5,30,4,0,0,4,0,30,10,1,0,11,0,30,3,8,0,11,6,30,4,0,0,4,1,-15,3,1
2,0,35,0,30,8,5,0,13,6,30,2,0,0,2,1,30,2,11,0,13,1,30,9,4,0,13,5,30,8,0,0,8,1,-15,3,1
2,2,35,0,30,8,5,0,13,6,30,2,0,0,2,1,30,2,11,0,13,1,30,9,4,0,13,5,30,8,0,0,8,1,-15,3,1
2,3,35,0,30,8,5,0,13,6,30,2,0,0,2,1,30,2,11,0,13,1,30,9,4,0,13,5,30,8,0,0,8,1,-15,3,1
2,4,35,0,30,8,5,0,13,6,30,2,0,0,2,1,30,2,11,0,13,1,30,9,4,0,13,5,30,8,0,0,8,1,-15,3,1
2,1,13,3,30,5,2,0,7,1,30,4,0,0,4,2,30,6,1,0,7,5,30,5,2,0,7,3,30,4,0,0,4,1,-15,3,1
2,2,13,3,30,5,2,0,7,1,30,4,0,0,4,2,30,6,1,0,7,5,30,5,2,0,7,3,30,4,0,0,4,1,-15,3,1
2,1,17,3,30,9,5,0,14,3,30,6,0,0,6,0,30,4,10,0,14,2,30,6,8,0,14,5,30,4,0,0,4,1,-15,3,1
2,1,19,0,30,2,11,0,13,1,30,8,0,0,8,0,30,7,6,0,13,1,30,7,6,0,13,1,30,6,3,0,9,1,-15,3,1
2,2,19,0,30,2,11,0,13,1,30,8,0,0,8,0,30,7,6,0,13,1,30,7,6,0,13,1,30,6,3,0,9,1,-15,3,1
2,3,19,0,30,2,11,0,13,1,30,8,0,0,8,0,30,7,6,0,13,1,30,7,6,0,13,1,30,6,3,0,9,1,-15,3,1
2,4,19,0,30,2,11,0,13,1,30,8,0,0,8,0,30,7,6,0,13,1,30,7,6,0,13,1,30,6,3,0,9,1,-15,3,1
2,2,27,0,30,8,7,0,15,2,30,2,0,0,2,0,30,5,10,0,15,0,30,5,10,0,15,0,30,6,0,0,6,1,-15,3,1
2,3,27,0,30,8,7,0,15,2,30,2,0,0,2,0,30,5,10,0,15,0,30,5,10,0,15,0,30,6,0,0,6,1,-15,3,1
2,4,37,0,30,6,5,0,11,5,30,5,3,0,8,4,30,7,4,0,11,0,30,2,9,0,11,0,30,6,0,0,6,1,-15,3,1
2,2,38,0,30,1,9,0,10,6,30,6,0,0,6,0,30,5,5,0,10,0,30,6,4,0,10,6,30,5,1,0,6,1,-15,3,1
2,4,38,0,30,1,9,0,10,6,30,6,0,0,6,0,30,5,5,0,10,0,30,6,4,0,10,6,30,5,1,0,6,1,-15,3,1
2,3,47,1,30,11,3,0,14,6,30,4,0,0,4,0,30,3,11,0,14,0,30,2,12,0,14,3,30,4,3,0,7,1,-15,3,1
2,2,8,1,30,7,0,0,7,5,30,2,0,0,2,4,30,2,5,0,7,4,30,7,0,0,7,4,30,3,0,0,3,0,-27,3,0
2,2,9,0,30,3,1,0,4,2,30,2,0,0,2,0,30,0,4,0,4,0,30,1,3,0,4,3,30,1,0,0,1,0,-27,3,0
2,2,11,2,30,6,6,0,12,1,30,4,0,0,4,0,30,6,6,0,12,3,30,3,9,0,12,2,30,4,0,0,4,1,-15,3,1
2,3,11,2,30,6,6,0,12,1,30,4,0,0,4,0,30,6,6,0,12,3,30,3,9,0,12,2,30,4,0,0,4,1,-15,3,1
2,4,11,2,30,6,6,0,12,1,30,4,0,0,4,0,30,6,6,0,12,3,30,3,9,0,12,2,30,4,0,0,4,1,-15,3,1
2,1,13,2,30,7,0,0,7,1,30,4,0,0,4,2,30,6,1,0,7,6,30,5,2,0,7,3,30,4,0,0,4,1,-15,3,1
2,2,13,2,30,7,0,0,7,1,30,4,0,0,4,2,30,6,1,0,7,6,30,5,2,0,7,3,30,4,0,0,4,1,-15,3,1
2,1,17,3,30,11,3,0,14,4,30,6,0,0,6,0,30,3,11,0,14,2,30,6,8,0,14,3,30,4,0,0,4,1,-15,3,1
2,2,19,0,30,4,9,0,13,1,30,8,0,0,8,0,30,5,8,0,13,0,30,6,7,0,13,1,30,6,3,0,9,1,-15,3,1
2,3,19,0,30,4,9,0,13,1,30,8,0,0,8,0,30,5,8,0,13,0,30,6,7,0,13,1,30,6,3,0,9,1,-15,3,1
2,1,27,1,30,4,11,0,15,5,30,2,0,0,2,0,30,5,10,0,15,4,30,5,10,0,15,4,30,6,0,0,6,1,-15,3,1
2,2,27,1,30,4,11,0,15,5,30,2,0,0,2,0,30,5,10,0,15,4,30,5,10,0,15,4,30,6,0,0,6,1,-15,3,1
2,3,27,1,30,4,11,0,15,5,30,2,0,0,2,0,30,5,10,0,15,4,30,5,10,0,15,4,30,6,0,0,6,1,-15,3,1
2,2,29,0,30,4,10,0,14,6,30,12,0,0,12,0,30,4,10,0,14,0,30,1,13,0,14,2,30,9,0,0,9,1,-15,3,1
2,3,29,0,30,4,10,0,14,6,30,12,0,0,12,0,30,4,10,0,14,0,30,1,13,0,14,2,30,9,0,0,9,1,-15,3,1
2,4,29,0,30,4,10,0,14,6,30,12,0,0,12,0,30,4,10,0,14,0,30,1,13,0,14,2,30,9,0,0,9,1,-15,3,1
2,3,35,1,30,6,7,0,13,5,30,2,0,0,2,1,30,2,11,0,13,4,30,3,10,0,13,11,30,8,0,0,8,1,-15,3,1
2,4,39,0,30,4,7,0,11,6,30,6,0,0,6,0,30,6,5,0,11,0,30,4,7,0,11,3,30,5,0,0,5,1,-15,3,1
2,4,15,0,30,6,7,0,13,1,30,5,1,0,6,0,30,4,9,0,13,0,30,8,5,0,13,2,30,5,4,0,9,1,-15,3,1
2,1,19,0,30,6,7,0,13,2,30,5,3,0,8,0,30,7,6,0,13,8,30,4,9,0,13,0,30,7,2,0,9,1,-15,3,1
2,2,19,0,30,6,7,0,13,2,30,5,3,0,8,0,30,7,6,0,13,8,30,4,9,0,13,0,30,7,2,0,9,1,-15,3,1
2,3,23,1,30,5,8,0,13,3,30,6,0,0,6,4,30,11,2,0,13,0,30,6,7,0,13,2,30,5,1,0,6,1,-15,3,1
2,3,25,3,30,10,4,0,14,2,30,6,0,0,6,0,30,8,6,0,14,1,30,5,9,0,14,3,30,5,1,0,6,1,-15,3,1
2,0,26,0,30,7,2,0,9,4,30,4,0,0,4,5,30,3,6,0,9,2,30,3,6,0,9,5,30,2,1,0,3,1,-15,3,1
2,4,26,0,30,7,2,0,9,4,30,4,0,0,4,5,30,3,6,0,9,2,30,3,6,0,9,5,30,2,1,0,3,1,-15,3,1
2,1,27,1,30,5,10,0,15,2,30,1,1,0,2,0,30,6,9,0,15,1,30,7,8,0,15,1,30,6,0,0,6,1,-15,3,1
2,2,29,0,30,8,6,0,14,5,30,10,2,0,12,0,30,3,11,0,14,0,30,0,14,0,14,2,30,9,0,0,9,1,-15,3,1
2,4,2,0,30,8,2,0,10,3,30,3,1,0,4,10,30,4,6,0,10,0,30,8,2,0,10,1,30,2,6,0,8,0,-27,3,0
2,4,6,0,30,4,5,0,9,4,30,2,0,0,2,0,30,2,7,0,9,0,30,4,5,0,9,1,30,5,0,0,5,0,-27,3,0
2,3,8,0,30,7,0,0,7,4,30,2,0,0,2,3,30,4,3,0,7,4,30,5,2,0,7,2,30,3,0,0,3,0,-27,3,0
2,4,17,4,30,10,4,0,14,3,30,6,0,0,6,0,30,6,8,0,14,1,30,6,8,0,14,3,30,4,0,0,4,1,-15,3,1
2,3,27,1,30,13,2,0,15,4,30,2,0,0,2,0,30,3,12,0,15,0,30,4,11,0,15,1,30,2,4,0,6,1,-15,3,1
2,3,29,0,30,6,8,0,14,5,30,11,1,0,12,0,30,7,7,0,14,0,30,1,13,0,14,0,30,9,0,0,9,1,-15,3,1
2,4,29,0,30,6,8,0,14,5,30,11,1,0,12,0,30,7,7,0,14,0,30,1,13,0,14,0,30,9,0,0,9,1,-15,3,1
2,2,39,0,30,6,5,0,11,6,30,6,0,0,6,0,30,4,7,0,11,0,30,2,9,0,11,6,30,5,0,0,5,1,-15,3,1
2,4,39,0,30,6,5,0,11,6,30,6,0,0,6,0,30,4,7,0,11,0,30,2,9,0,11,6,30,5,0,0,5,1,-15,3,1
2,3,13,1,30,7,0,0,7,1,30,4,0,0,4,2,30,5,2,0,7,4,30,7,0,0,7,4,30,4,0,0,4,1,-15,3,1
2,4,13,1,30,7,0,0,7,1,30,4,0,0,4,2,30,5,2,0,7,4,30,7,0,0,7,4,30,4,0,0,4,1,-15,3,1
2,2,15,0,30,6,7,0,13,0,30,6,0,0,6,0,30,3,10,0,13,1,30,4,9,0,13,2,30,7,2,0,9,1,-15,3,1
2,4,17,2,30,9,5,0,14,3,30,6,0,0,6,0,30,6,8,0,14,2,30,7,7,0,14,0,30,4,0,0,4,1,-15,3,1
2,2,23,1,30,4,9,0,13,3,30,6,0,0,6,3,30,11,2,0,13,0,30,5,8,0,13,4,30,6,0,0,6,1,-15,3,1
2,3,23,1,30,4,9,0,13,3,30,6,0,0,6,3,30,11,2,0,13,0,30,5,8,0,13,4,30,6,0,0,6,1,-15,3,1
2,0,25,1,30,4,10,0,14,5,30,6,0,0,6,0,30,5,9,0,14,3,30,11,3,0,14,7,30,6,0,0,6,1,-15,3,1
2,2,25,1,30,4,10,0,14,5,30,6,0,0,6,0,30,5,9,0,14,3,30,11,3,0,14,7,30,6,0,0,6,1,-15,3,1
2,0,27,1,30,6,9,0,15,4,30,2,0,0,2,0,30,3,12,0,15,0,30,6,9,0,15,3,30,6,0,0,6,1,-15,3,1
2,2,27,1,30,6,9,0,15,4,30,2,0,0,2,0,30,3,12,0,15,0,30,6,9,0,15,3,30,6,0,0,6,1,-15,3,1
2,3,27,1,30,6,9,0,15,4,30,2,0,0,2,0,30,3,12,0,15,0,30,6,9,0,15,3,30,6,0,0,6,1,-15,3,1
2,1,4,2,30,7,1,0,8,5,30,2,2,0,4,0,30,2,6,0,8,0,30,6,2,0,8,2,30,3,1,0,4,0,-27,3,0
2,2,13,1,30,5,2,0,7,1,30,4,0,0,4,2,30,5,2,0,7,6,30,6,1,0,7,3,30,4,0,0,4,1,-15,3,1
2,3,13,1,30,5,2,0,7,1,30,4,0,0,4,2,30,5,2,0,7,6,30,6,1,0,7,3,30,4,0,0,4,1,-15,3,1
2,3,23,2,30,4,9,0,13,4,30,6,0,0,6,5,30,13,0,0,13,0,30,5,8,0,13,4,30,6,0,0,6,1,-15,3,1
2,1,25,1,30,5,9,0,14,5,30,6,0,0,6,0,30,4,10,0,14,3,30,10,4,0,14,0,30,6,0,0,6,1,-15,3,1
2,2,25,1,30,5,9,0,14,5,30,6,0,0,6,0,30,4,10,0,14,3,30,10,4,0,14,0,30,6,0,0,6,1,-15,3,1
2,3,26,0,30,8,1,0,9,5,30,2,2,0,4,1,30,0,9,0,9,0,30,4,5,0,9,4,30,1,2,0,3,1,-15,3,1
2,4,27,5,30,7,8,0,15,2,30,1,1,0,2,0,30,6,9,0,15,0,30,6,9,0,15,0,30,5,1,0,6,1,-15,3,1
2,3,30,3,30,5,0,0,5,5,30,2,0,0,2,3,30,2,3,0,5,3,30,2,3,0,5,0,30,2,1,0,3,1,-15,3,1
2,4,30,3,30,5,0,0,5,5,30,2,0,0,2,3,30,2,3,0,5,3,30,2,3,0,5,0,30,2,1,0,3,1,-15,3,1
2,3,31,0,30,7,5,0,12,4,30,8,0,0,8,3,30,9,3,0,12,0,30,3,9,0,12,1,30,2,4,0,6,1,-15,3,1
2,3,33,1,30,2,9,0,11,5,30,4,0,0,4,2,30,9,2,0,11,0,30,3,8,0,11,7,30,4,0,0,4,1,-15,3,1
2,4,1,0,30,5,5,0,10,4,30,2,0,0,2,0,30,4,6,0,10,3,30,7,3,0,10,6,30,6,0,0,6,0,-27,3,0
2,3,11,4,30,5,7,0,12,1,30,4,0,0,4,0,30,5,7,0,12,3,30,4,8,0,12,4,30,4,0,0,4,1,-15,3,1
2,3,13,2,30,5,2,0,7,1,30,4,0,0,4,2,30,5,2,0,7,4,30,7,0,0,7,3,30,4,0,0,4,1,-15,3,1
2,4,13,2,30,5,2,0,7,1,30,4,0,0,4,2,30,5,2,0,7,4,30,7,0,0,7,3,30,4,0,0,4,1,-15,3,1
2,4,19,0,30,2,11,0,13,2,30,8,0,0,8,0,30,8,5,0,13,4,30,5,8,0,13,2,30,8,1,0,9,1,-15,3,1
2,4,22,1,30,6,2,0,8,3,30,2,0,0,2,0,30,4,4,0,8,3,30,6,2,0,8,2,30,3,1,0,4,1,-15,3,1
2,4,25,1,30,7,7,0,14,5,30,6,0,0,6,0,30,6,8,0,14,1,30,8,6,0,14,2,30,6,0,0,6,1,-15,3,1
2,3,27,1,30,5,10,0,15,4,30,2,0,0,2,0,30,5,10,0,15,2,30,4,11,0,15,0,30,6,0,0,6,1,-15,3,1
2,0,37,1,30,8,3,0,11,7,30,8,0,0,8,0,30,3,8,0,11,4,30,3,8,0,11,7,30,6,0,0,6,1,-15,3,1
2,3,37,1,30,8,3,0,11,7,30,8,0,0,8,0,30,3,8,0,11,4,30,3,8,0,11,7,30,6,0,0,6,1,-15,3,1
2,0,6,1,30,9,0,0,9,4,30,2,0,0,2,0,30,3,6,0,9,0,30,4,5,0,9,1,30,3,2,0,5,0,-27,3,0
2,1,6,1,30,9,0,0,9,4,30,2,0,0,2,0,30,3,6,0,9,0,30,4,5,0,9,1,30,3,2,0,5,0,-27,3,0
2,4,6,1,30,9,0,0,9,4,30,2,0,0,2,0,30,3,6,0,9,0,30,4,5,0,9,1,30,3,2,0,5,0,-27,3,0
2,3,8,3,30,7,0,0,7,4,30,2,0,0,2,0,30,3,4,0,7,0,30,6,1,0,7,0,30,3,0,0,3,0,-27,3,0
2,2,13,5,30,7,0,0,7,0,30,4,0,0,4,2,30,5,2,0,7,7,30,6,1,0,7,5,30,4,0,0,4,1,-15,3,1
2,4,13,5,30,7,0,0,7,0,30,4,0,0,4,2,30,5,2,0,7,7,30,6,1,0,7,5,30,4,0,0,4,1,-15,3,1
2,3,17,4,30,9,5,0,14,0,30,6,0,0,6,0,30,10,4,0,14,1,30,5,9,0,14,0,30,2,2,0,4,1,-15,3,1
2,3,19,0,30,7,6,0,13,2,30,5,3,0,8,0,30,4,9,0,13,3,30,5,8,0,13,0,30,6,3,0,9,1,-15,3,1
2,1,21,1,30,6,4,0,10,3,30,6,0,0,6,1,30,4,6,0,10,4,30,4,6,0,10,3,30,4,0,0,4,1,-15,3,1
2,3,21,1,30,6,4,0,10,3,30,6,0,0,6,1,30,4,6,0,10,3,30,4,6,0,10,3,30,4,0,0,4,1,-15,3,1
2,4,23,1,30,12,1,0,13,2,30,6,0,0,6,0,30,10,3,0,13,0,30,6,7,0,13,0,30,6,0,0,6,1,-15,3,1
2,2,25,3,30,4,10,0,14,4,30,6,0,0,6,0,30,12,2,0,14,1,30,5,9,0,14,0,30,5,1,0,6,1,-15,3,1
2,4,25,3,30,4,10,0,14,4,30,6,0,0,6,0,30,12,2,0,14,1,30,5,9,0,14,0,30,5,1,0,6,1,-15,3,1
2,1,27,1,30,5,10,0,15,4,30,2,0,0,2,0,30,5,10,0,15,0,30,3,12,0,15,2,30,5,1,0,6,1,-15,3,1
2,2,27,1,30,5,10,0,15,4,30,2,0,0,2,0,30,5,10,0,15,0,30,3,12,0,15,2,30,5,1,0,6,1,-15,3,1
2,3,27,1,30,5,10,0,15,4,30,2,0,0,2,0,30,5,10,0,15,0,30,3,12,0,15,2,30,5,1,0,6,1,-15,3,1
2,4,29,0,30,6,8,0,14,6,30,12,0,0,12,0,30,4,10,0,14,0,30,1,13,0,14,2,30,9,0,0,9,1,-15,3,1
2,4,31,1,30,6,6,0,12,4,30,8,0,0,8,3,30,10,2,0,12,0,30,3,9,0,12,0,30,5,1,0,6,1,-15,3,1
2,4,32,0,30,5,4,0,9,4,30,2,0,0,2,2,30,8,1,0,9,1,30,3,6,0,9,3,30,2,0,0,2,1,-15,3,1
2,1,4,2,30,4,4,0,8,4,30,4,0,0,4,2,30,2,6,0,8,0,30,7,1,0,8,3,30,4,0,0,4,0,-27,3,0
2,4,8,0,30,7,0,0,7,3,30,2,0,0,2,4,30,3,4,0,7,1,30,4,3,0,7,3,30,3,0,0,3,0,-27,3,0
2,1,19,1,30,5,8,0,13,2,30,2,6,0,8,0,30,6,7,0,13,5,30,7,6,0,13,3,30,9,0,0,9,1,-15,3,1
2,2,19,1,30,5,8,0,13,2,30,2,6,0,8,0,30,6,7,0,13,5,30,7,6,0,13,3,30,9,0,0,9,1,-15,3,1
2,3,19,1,30,5,8,0,13,2,30,2,6,0,8,0,30,6,7,0,13,5,30,7,6,0,13,3,30,9,0,0,9,1,-15,3,1
2,4,19,1,30,5,8,0,13,2,30,2,6,0,8,0,30,6,7,0,13,5,30,7,6,0,13,3,30,9,0,0,9,1,-15,3,1
2,4,27,1,30,9,6,0,15,0,30,2,0,0,2,0,30,8,7,0,15,0,30,4,11,0,15,1,30,5,1,0,6,1,-15,3,1
2,3,6,0,30,6,3,0,9,3,30,2,0,0,2,2,30,3,6,0,9,0,30,3,6,0,9,2,30,4,1,0,5,0,-27,3,0
2,4,6,0,30,6,3,0,9,3,30,2,0,0,2,2,30,3,6,0,9,0,30,3,6,0,9,2,30,4,1,0,5,0,-27,3,0
2,3,8,0,30,6,1,0,7,3,30,2,0,0,2,3,30,2,5,0,7,3,30,5,2,0,7,6,30,3,0,0,3,0,-27,3,0
2,2,13,4,30,7,0,0,7,0,30,4,0,0,4,2,30,6,1,0,7,6,30,4,3,0,7,3,30,4,0,0,4,1,-15,3,1
2,3,13,4,30,7,0,0,7,0,30,4,0,0,4,2,30,6,1,0,7,6,30,4,3,0,7,3,30,4,0,0,4,1,-15,3,1
2,4,13,4,30,7,0,0,7,0,30,4,0,0,4,2,30,6,1,0,7,6,30,4,3,0,7,3,30,4,0,0,4,1,-15,3,1
2,4,17,2,30,10,4,0,14,1,30,6,0,0,6,0,30,8,6,0,14,1,30,6,8,0,14,4,30,4,0,0,4,1,-15,3,1
2,0,27,1,30,3,12,0,15,3,30,2,0,0,2,0,30,10,5,0,15,3,30,7,8,0,15,4,30,6,0,0,6,1,-15,3,1
2,4,27,1,30,3,12,0,15,3,30,2,0,0,2,0,30,10,5,0,15,3,30,7,8,0,15,4,30,6,0,0,6,1,-15,3,1
2,4,3,0,30,1,3,0,4,2,30,4,0,0,4,0,30,0,4,0,4,5,30,2,2,0,4,0,30,1,2,0,3,0,-27,3,0
2,0,5,0,30,4,1,0,5,3,30,0,4,0,4,0,30,0,5,0,5,0,30,1,4,0,5,0,30,0,2,0,2,0,-27,3,0
2,1,5,0,30,4,1,0,5,3,30,0,4,0,4,0,30,0,5,0,5,0,30,1,4,0,5,0,30,0,2,0,2,0,-27,3,0
2,4,5,0,30,4,1,0,5,3,30,0,4,0,4,0,30,0,5,0,5,0,30,1,4,0,5,0,30,0,2,0,2,0,-27,3,0
2,1,13,4,30,7,0,0,7,1,30,4,0,0,4,2,30,5,2,0,7,9,30,6,1,0,7,2,30,4,0,0,4,1,-15,3,1
2,2,13,4,30,7,0,0,7,1,30,4,0,0,4,2,30,5,2,0,7,9,30,6,1,0,7,2,30,4,0,0,4,1,-15,3,1
2,2,27,1,30,10,5,0,15,2,30,2,0,0,2,1,30,5,10,0,15,0,30,3,12,0,15,1,30,3,3,0,6,1,-15,3,1
2,3,27,1,30,10,5,0,15,2,30,2,0,0,2,1,30,5,10,0,15,0,30,3,12,0,15,1,30,3,3,0,6,1,-15,3,1
2,4,27,1,30,10,5,0,15,2,30,2,0,0,2,1,30,5,10,0,15,0,30,3,12,0,15,1,30,3,3,0,6,1,-15,3,1
2,4,23,1,30,6,7,0,13,3,30,6,0,0,6,5,30,10,3,0,13,0,30,4,9,0,13,1,30,5,1,0,6,1,-15,3,1
2,4,25,2,30,7,7,0,14,2,30,6,0,0,6,0,30,13,1,0,14,1,30,5,9,0,14,3,30,5,1,0,6,1,-15,3,1
2,0,27,1,30,4,11,0,15,2,30,1,1,0,2,0,30,4,11,0,15,3,30,5,10,0,15,5,30,6,0,0,6,1,-15,3,1
2,1,27,1,30,4,11,0,15,2,30,1,1,0,2,0,30,4,11,0,15,3,30,5,10,0,15,5,30,6,0,0,6,1,-15,3,1
2,3,27,1,30,4,11,0,15,2,30,1,1,0,2,0,30,4,11,0,15,3,30,5,10,0,15,5,30,6,0,0,6,1,-15,3,1
2,4,27,1,30,4,11,0,15,2,30,1,1,0,2,0,30,4,11,0,15,3,30,5,10,0,15,5,30,6,0,0,6,1,-15,3,1
2,1,29,0,30,3,11,0,14,5,30,11,1,0,12,0,30,3,11,0,14,0,30,0,14,0,14,0,30,7,2,0,9,1,-15,3,1
2,2,35,0,30,6,7,0,13,4,30,2,0,0,2,5,30,3,10,0,13,2,30,1,12,0,13,4,30,8,0,0,8,1,-15,3,1
2,4,35,0,30,6,7,0,13,4,30,2,0,0,2,5,30,3,10,0,13,2,30,1,12,0,13,3,30,8,0,0,8,1,-15,3,1
2,2,5,3,30,2,3,0,5,3,30,2,2,0,4,0,30,0,5,0,5,0,30,1,4,0,5,0,30,0,2,0,2,0,-27,3,0
2,4,7,0,30,4,0,0,4,2,30,2,0,0,2,0,30,1,3,0,4,0,30,1,3,0,4,2,30,2,0,0,2,0,-27,3,0
2,4,8,2,30,7,0,0,7,4,30,2,0,0,2,2,30,5,2,0,7,0,30,5,2,0,7,0,30,3,0,0,3,0,-27,3,0
2,4,11,0,30,1,3,0,4,0,30,0,0,0,0,0,30,0,4,0,4,3,30,3,1,0,4,1,30,1,0,0,1,1,-15,3,1
2,0,19,0,30,5,8,0,13,2,30,3,5,0,8,0,30,6,7,0,13,3,30,4,9,0,13,2,30,8,1,0,9,1,-15,3,1
2,3,23,1,30,3,10,0,13,0,30,6,0,0,6,3,30,13,0,0,13,3,30,4,9,0,13,1,30,6,0,0,6,1,-15,3,1
2,1,27,1,30,8,7,0,15,3,30,1,1,0,2,0,30,3,12,0,15,4,30,6,9,0,15,4,30,6,0,0,6,1,-15,3,1
2,2,30,2,30,5,0,0,5,5,30,2,0,0,2,3,30,2,3,0,5,3,30,1,4,0,5,0,30,2,1,0,3,1,-15,3,1
2,3,30,2,30,5,0,0,5,5,30,2,0,0,2,3,30,2,3,0,5,3,30,1,4,0,5,0,30,2,1,0,3,1,-15,3,1
2,4,30,2,30,5,0,0,5,5,30,2,0,0,2,3,30,2,3,0,5,3,30,1,4,0,5,0,30,2,1,0,3,1,-15,3,1
2,2,5,0,30,0,5,0,5,2,30,2,2,0,4,0,30,1,4,0,5,0,30,1,4,0,5,1,30,0,2,0,2,0,-27,3,0
2,4,5,0,30,0,5,0,5,2,30,2,2,0,4,0,30,1,4,0,5,0,30,1,4,0,5,1,30,0,2,0,2,0,-27,3,0
2,4,6,0,30,7,2,0,9,4,30,2,0,0,2,0,30,3,6,0,9,0,30,4,5,0,9,0,30,4,1,0,5,0,-27,3,0
2,4,8,1,30,7,0,0,7,5,30,2,0,0,2,0,30,1,6,0,7,1,30,7,0,0,7,4,30,3,0,0,3,0,-27,3,0
2,2,13,2,30,7,0,0,7,0,30,4,0,0,4,2,30,7,0,0,7,9,30,5,2,0,7,4,30,4,0,0,4,1,-15,3,1
2,3,15,0,30,4,9,0,13,1,30,6,0,0,6,0,30,4,9,0,13,1,30,6,7,0,13,3,30,8,1,0,9,1,-15,3,1
2,1,25,4,30,7,7,0,14,5,30,6,0,0,6,0,30,8,6,0,14,1,30,5,9,0,14,4,30,6,0,0,6,1,-15,3,1
2,4,25,4,30,7,7,0,14,5,30,6,0,0,6,0,30,8,6,0,14,1,30,5,9,0,14,4,30,6,0,0,6,1,-15,3,1
2,1,26,0,30,8,1,0,9,5,30,4,0,0,4,2,30,0,9,0,9,0,30,2,7,0,9,4,30,3,0,0,3,1,-15,3,1
2,3,26,0,30,8,1,0,9,5,30,4,0,0,4,2,30,0,9,0,9,0,30,2,7,0,9,1,30,3,0,0,3,1,-15,3,1
2,3,27,0,30,5,10,0,15,3,30,2,0,0,2,0,30,5,10,0,15,0,30,4,11,0,15,2,30,3,3,0,6,1,-15,3,1
2,3,32,0,30,7,2,0,9,4,30,2,0,0,2,0,30,7,2,0,9,1,30,2,7,0,9,6,30,2,0,0,2,1,-15,3,1
2,4,32,0,30,7,2,0,9,4,30,2,0,0,2,0,30,7,2,0,9,1,30,2,7,0,9,6,30,2,0,0,2,1,-15,3,1
2,2,43,5,30,9,5,0,14,9,30,6,0,0,6,0,30,5,9,0,14,0,30,1,13,0,14,1,30,5,0,0,5,1,-15,3,1
2,3,43,5,30,9,5,0,14,9,30,6,0,0,6,0,30,5,9,0,14,0,30,1,13,0,14,1,30,5,0,0,5,1,-15,3,1
2,4,43,5,30,9,5,0,14,9,30,6,0,0,6,0,30,5,9,0,14,0,30,1,13,0,14,1,30,5,0,0,5,1,-15,3,1
2,3,4,2,30,8,0,0,8,3,30,4,0,0,4,0,30,6,2,0,8,1,30,5,3,0,8,0,30,4,0,0,4,0,-27,3,0
2,3,8,0,30,7,0,0,7,3,30,2,0,0,2,4,30,3,4,0,7,1,30,7,0,0,7,4,30,3,0,0,3,0,-27,3,0
2,2,19,1,30,4,9,0,13,2,30,8,0,0,8,0,30,6,7,0,13,0,30,4,9,0,13,2,30,7,2,0,9,1,-15,3,1
2,2,23,1,30,4,9,0,13,3,30,6,0,0,6,4,30,13,0,0,13,0,30,10,3,0,13,2,30,6,0,0,6,1,-15,3,1
2,4,23,1,30,4,9,0,13,3,30,6,0,0,6,2,30,13,0,0,13,0,30,10,3,0,13,2,30,6,0,0,6,1,-15,3,1
2,2,25,3,30,8,6,0,14,5,30,6,0,0,6,0,30,4,10,0,14,1,30,5,9,0,14,3,30,5,1,0,6,1,-15,3,1
2,3,25,3,30,8,6,0,14,5,30,6,0,0,6,0,30,4,10,0,14,1,30,5,9,0,14,3,30,5,1,0,6,1,-15,3,1
2,4,25,3,30,8,6,0,14,5,30,6,0,0,6,0,30,4,10,0,14,1,30,5,9,0,14,3,30,5,1,0,6,1,-15,3,1
2,1,27,1,30,10,5,0,15,3,30,1,1,0,2,0,30,5,10,0,15,0,30,6,9,0,15,1,30,6,0,0,6,1,-15,3,1
2,2,27,1,30,10,5,0,15,3,30,1,1,0,2,0,30,5,10,0,15,0,30,6,9,0,15,1,30,6,0,0,6,1,-15,3,1
2,3,27,1,30,10,5,0,15,3,30,1,1,0,2,0,30,5,10,0,15,0,30,6,9,0,15,1,30,6,0,0,6,1,-15,3,1
2,1,31,1,30,4,8,0,12,5,30,8,0,0,8,6,30,9,3,0,12,1,30,5,7,0,12,3,30,3,3,0,6,1,-15,3,1
2,2,31,1,30,4,8,0,12,5,30,8,0,0,8,6,30,9,3,0,12,1,30,5,7,0,12,3,30,3,3,0,6,1,-15,3,1
2,4,31,1,30,4,8,0,12,5,30,8,0,0,8,6,30,9,3,0,12,0,30,5,7,0,12,3,30,3,3,0,6,1,-15,3,1
2,4,32,0,30,6,3,0,9,3,30,2,0,0,2,1,30,9,0,0,9,2,30,3,6,0,9,4,30,2,0,0,2,1,-15,3,1
2,3,38,0,30,2,8,0,10,6,30,6,0,0,6,0,30,3,7,0,10,0,30,4,6,0,10,7,30,6,0,0,6,1,-15,3,1
2,3,43,0,30,8,6,0,14,7,30,6,0,0,6,0,30,7,7,0,14,1,30,1,13,0,14,6,30,5,0,0,5,1,-15,3,1
2,4,43,0,30,8,6,0,14,7,30,6,0,0,6,0,30,7,7,0,14,1,30,1,13,0,14,6,30,5,0,0,5,1,-15,3,1
2,2,5,0,30,2,3,0,5,3,30,3,1,0,4,0,30,0,5,0,5,0,30,2,3,0,5,0,30,0,2,0,2,0,-27,3,0
2,4,5,0,30,2,3,0,5,3,30,3,1,0,4,0,30,0,5,0,5,0,30,2,3,0,5,0,30,0,2,0,2,0,-27,3,0
2,2,13,7,30,7,0,0,7,1,30,4,0,0,4,2,30,6,1,0,7,1,30,4,3,0,7,2,30,4,0,0,4,1,-15,3,1
2,3,13,7,30,7,0,0,7,1,30,4,0,0,4,2,30,6,1,0,7,1,30,4,3,0,7,2,30,4,0,0,4,1,-15,3,1
2,3,21,1,30,6,4,0,10,4,30,6,0,0,6,0,30,3,7,0,10,3,30,5,5,0,10,6,30,4,0,0,4,1,-15,3,1
2,4,21,1,30,6,4,0,10,4,30,6,0,0,6,0,30,3,7,0,10,3,30,5,5,0,10,6,30,4,0,0,4,1,-15,3,1
2,3,25,1,30,7,7,0,14,4,30,6,0,0,6,0,30,5,9,0,14,1,30,10,4,0,14,2,30,5,1,0,6,1,-15,3,1
2,4,27,3,30,6,9,0,15,2,30,1,1,0,2,0,30,9,6,0,15,0,30,4,11,0,15,0,30,4,2,0,6,1,-15,3,1
2,3,31,1,30,3,9,0,12,5,30,8,0,0,8,4,30,9,3,0,12,0,30,5,7,0,12,0,30,6,0,0,6,1,-15,3,1
2,1,4,12,30,8,0,0,8,3,30,1,3,0,4,0,30,1,7,0,8,0,30,0,8,0,8,2,30,4,0,0,4,0,-27,3,0
2,0,5,4,30,5,0,0,5,3,30,3,1,0,4,0,30,0,5,0,5,0,30,1,4,0,5,0,30,1,1,0,2,0,-27,3,0
2,2,5,4,30,5,0,0,5,3,30,3,1,0,4,0,30,0,5,0,5,0,30,1,4,0,5,0,30,1,1,0,2,0,-27,3,0
2,3,11,2,30,5,7,0,12,0,30,4,0,0,4,0,30,7,5,0,12,4,30,3,9,0,12,4,30,4,0,0,4,1,-15,3,1
2,4,11,2,30,5,7,0,12,0,30,4,0,0,4,0,30,7,5,0,12,4,30,3,9,0,12,4,30,4,0,0,4,1,-15,3,1
2,1,17,2,30,9,5,0,14,3,30,6,0,0,6,0,30,4,10,0,14,1,30,6,8,0,14,6,30,4,0,0,4,1,-15,3,1
2,4,17,0,30,9,5,0,14,2,30,6,0,0,6,0,30,4,10,0,14,1,30,6,8,0,14,6,30,4,0,0,4,1,-15,3,1
2,3,19,0,30,3,10,0,13,2,30,7,1,0,8,0,30,6,7,0,13,0,30,3,10,0,13,2,30,9,0,0,9,1,-15,3,1
2,4,19,0,30,3,10,0,13,2,30,7,1,0,8,0,30,6,7,0,13,0,30,3,10,0,13,2,30,9,0,0,9,1,-15,3,1
2,1,25,1,30,5,9,0,14,5,30,6,0,0,6,0,30,8,6,0,14,1,30,7,7,0,14,3,30,6,0,0,6,1,-15,3,1
2,1,26,0,30,9,0,0,9,5,30,4,0,0,4,2,30,1,8,0,9,0,30,2,7,0,9,6,30,3,0,0,3,1,-15,3,1
2,2,26,0,30,9,0,0,9,5,30,4,0,0,4,2,30,1,8,0,9,0,30,2,7,0,9,6,30,3,0,0,3,1,-15,3,1
2,3,26,0,30,9,0,0,9,5,30,4,0,0,4,2,30,1,8,0,9,0,30,2,7,0,9,6,30,3,0,0,3,1,-15,3,1
2,4,26,0,30,9,0,0,9,5,30,4,0,0,4,2,30,1,8,0,9,0,30,2,7,0,9,6,30,3,0,0,3,1,-15,3,1
2,0,27,1,30,6,9,0,15,3,30,2,0,0,2,0,30,3,12,0,15,1,30,5,10,0,15,1,30,6,0,0,6,1,-15,3,1
2,2,27,1,30,6,9,0,15,3,30,2,0,0,2,0,30,3,12,0,15,1,30,5,10,0,15,1,30,6,0,0,6,1,-15,3,1
2,3,27,1,30,6,9,0,15,3,30,2,0,0,2,0,30,3,12,0,15,1,30,5,10,0,15,1,30,6,0,0,6,1,-15,3,1
2,1,4,2,30,7,1,0,8,5,30,4,0,0,4,0,30,2,6,0,8,2,30,8,0,0,8,2,30,4,0,0,4,0,-27,3,0
2,2,4,2,30,7,1,0,8,5,30,4,0,0,4,0,30,2,6,0,8,2,30,8,0,0,8,2,30,4,0,0,4,0,-27,3,0
2,2,17,3,30,10,4,0,14,2,30,6,0,0,6,0,30,6,8,0,14,1,30,6,8,0,14,7,30,4,0,0,4,1,-15,3,1
2,0,19,0,30,3,10,0,13,2,30,4,4,0,8,0,30,5,8,0,13,9,30,3,10,0,13,4,30,9,0,0,9,1,-15,3,1
2,1,19,0,30,3,10,0,13,2,30,4,4,0,8,0,30,5,8,0,13,9,30,3,10,0,13,4,30,9,0,0,9,1,-15,3,1
2,4,19,0,30,3,10,0,13,2,30,4,4,0,8,0,30,5,8,0,13,9,30,3,10,0,13,4,30,9,0,0,9,1,-15,3,1
2,0,21,2,30,8,2,0,10,4,30,5,1,0,6,3,30,3,7,0,10,4,30,6,4,0,10,2,30,4,0,0,4,1,-15,3,1
2,4,23,2,30,9,4,0,13,3,30,6,0,0,6,7,30,10,3,0,13,0,30,5,8,0,13,1,30,5,1,0,6,1,-15,3,1
2,0,27,2,30,3,12,0,15,2,30,2,0,0,2,0,30,4,11,0,15,4,30,6,9,0,15,6,30,6,0,0,6,1,-15,3,1
2,1,27,2,30,3,12,0,15,2,30,2,0,0,2,0,30,4,11,0,15,4,30,6,9,0,15,6,30,6,0,0,6,1,-15,3,1
2,4,27,0,30,3,12,0,15,2,30,2,0,0,2,0,30,4,11,0,15,4,30,6,9,0,15,6,30,6,0,0,6,1,-15,3,1
2,3,29,0,30,9,5,0,14,6,30,9,3,0,12,0,30,3,11,0,14,0,30,1,13,0,14,5,30,9,0,0,9,1,-15,3,1
2,4,29,0,30,9,5,0,14,6,30,9,3,0,12,0,30,3,11,0,14,0,30,1,13,0,14,5,30,9,0,0,9,1,-15,3,1
2,3,33,2,30,4,7,0,11,5,30,4,0,0,4,5,30,9,2,0,11,0,30,3,8,0,11,4,30,4,0,0,4,1,-15,3,1
2,0,4,3,30,8,0,0,8,4,30,2,2,0,4,0,30,5,3,0,8,0,30,2,6,0,8,4,30,4,0,0,4,0,-27,3,0
2,1,4,3,30,8,0,0,8,4,30,2,2,0,4,0,30,5,3,0,8,0,30,2,6,0,8,4,30,4,0,0,4,0,-27,3,0
2,1,17,3,30,10,4,0,14,3,30,6,0,0,6,0,30,6,8,0,14,8,30,6,8,0,14,4,30,4,0,0,4,1,-15,3,1
2,4,21,2,30,8,2,0,10,4,30,6,0,0,6,1,30,3,7,0,10,5,30,6,4,0,10,1,30,4,0,0,4,1,-15,3,1
2,4,25,0,30,6,8,0,14,3,30,6,0,0,6,0,30,12,2,0,14,0,30,4,10,0,14,4,30,5,1,0,6,1,-15,3,1
2,2,27,1,30,3,12,0,15,3,30,2,0,0,2,0,30,5,10,0,15,2,30,4,11,0,15,5,30,6,0,0,6,1,-15,3,1
2,3,27,1,30,3,12,0,15,3,30,2,0,0,2,0,30,5,10,0,15,2,30,4,11,0,15,5,30,6,0,0,6,1,-15,3,1
2,4,29,0,30,5,9,0,14,5,30,10,2,0,12,0,30,3,11,0,14,0,30,2,12,0,14,0,30,8,1,0,9,1,-15,3,1
2,1,4,2,30,8,0,0,8,3,30,4,0,0,4,2,30,1,7,0,8,0,30,2,6,0,8,1,30,3,1,0,4,0,-27,3,0
2,2,4,2,30,8,0,0,8,3,30,4,0,0,4,2,30,1,7,0,8,0,30,2,6,0,8,1,30,3,1,0,4,0,-27,3,0
2,3,17,6,30,10,4,0,14,4,30,6,0,0,6,0,30,4,10,0,14,1,30,4,10,0,14,2,30,4,0,0,4,1,-15,3,1
2,0,26,0,30,6,3,0,9,4,30,3,1,0,4,5,30,0,9,0,9,0,30,1,8,0,9,4,30,3,0,0,3,1,-15,3,1
2,4,26,0,30,6,3,0,9,4,30,3,1,0,4,5,30,0,9,0,9,0,30,1,8,0,9,4,30,3,0,0,3,1,-15,3,1
2,2,27,4,30,5,10,0,15,2,30,1,1,0,2,0,30,6,9,0,15,2,30,4,11,0,15,6,30,4,2,0,6,1,-15,3,1
2,2,31,3,30,6,6,0,12,4,30,8,0,0,8,4,30,12,0,0,12,0,30,3,9,0,12,2,30,4,2,0,6,1,-15,3,1
2,3,11,0,30,3,1,0,4,0,30,0,0,0,0,0,30,0,4,0,4,4,30,2,2,0,4,2,30,1,0,0,1,1,-15,3,1
2,1,13,3,30,7,0,0,7,0,30,4,0,0,4,2,30,5,2,0,7,5,30,7,0,0,7,5,30,4,0,0,4,1,-15,3,1
2,2,13,3,30,7,0,0,7,0,30,4,0,0,4,2,30,5,2,0,7,5,30,7,0,0,7,5,30,4,0,0,4,1,-15,3,1
2,3,13,3,30,7,0,0,7,0,30,4,0,0,4,2,30,5,2,0,7,5,30,7,0,0,7,5,30,4,0,0,4,1,-15,3,1
2,4,17,3,30,10,4,0,14,2,30,6,0,0,6,0,30,5,9,0,14,0,30,5,9,0,14,5,30,4,0,0,4,1,-15,3,1
2,1,19,0,30,3,10,0,13,2,30,4,4,0,8,0,30,5,8,0,13,3,30,4,9,0,13,2,30,9,0,0,9,1,-15,3,1
2,2,19,0,30,3,10,0,13,2,30,4,4,0,8,0,30,5,8,0,13,3,30,4,9,0,13,2,30,9,0,0,9,1,-15,3,1
2,3,19,0,30,3,10,0,13,2,30,4,4,0,8,0,30,5,8,0,13,3,30,4,9,0,13,2,30,9,0,0,9,1,-15,3,1
2,4,19,0,30,3,10,0,13,2,30,4,4,0,8,0,30,5,8,0,13,3,30,4,9,0,13,2,30,9,0,0,9,1,-15,3,1
2,0,27,3,30,6,9,0,15,1,30,1,1,0,2,0,30,5,10,0,15,1,30,6,9,0,15,2,30,5,1,0,6,1,-15,3,1
2,3,27,3,30,6,9,0,15,1,30,1,1,0,2,0,30,5,10,0,15,1,30,6,9,0,15,2,30,5,1,0,6,1,-15,3,1
2,3,29,0,30,5,9,0,14,5,30,12,0,0,12,0,30,2,12,0,14,0,30,0,14,0,14,0,30,9,0,0,9,1,-15,3,1
2,4,29,0,30,5,9,0,14,5,30,12,0,0,12,0,30,2,12,0,14,0,30,0,14,0,14,0,30,9,0,0,9,1,-15,3,1
2,2,47,0,30,0,14,0,14,7,30,4,0,0,4,0,30,5,9,0,14,7,30,3,11,0,14,3,30,7,0,0,7,1,-15,3,1
2,4,47,0,30,0,14,0,14,7,30,4,0,0,4,0,30,5,9,0,14,7,30,3,11,0,14,3,30,7,0,0,7,1,-15,3,1
2,3,17,2,30,10,4,0,14,3,30,6,0,0,6,0,30,5,9,0,14,1,30,5,9,0,14,3,30,4,0,0,4,1,-15,3,1
2,4,17,2,30,10,4,0,14,3,30,6,0,0,6,0,30,5,9,0,14,1,30,5,9,0,14,3,30,4,0,0,4,1,-15,3,1
2,1,19,0,30,3,10,0,13,3,30,6,2,0,8,0,30,4,9,0,13,8,30,6,7,0,13,3,30,8,1,0,9,1,-15,3,1
2,4,19,0,30,3,10,0,13,3,30,6,2,0,8,0,30,4,9,0,13,8,30,6,7,0,13,3,30,8,1,0,9,1,-15,3,1
2,0,21,4,30,8,2,0,10,4,30,5,1,0,6,1,30,3,7,0,10,2,30,5,5,0,10,1,30,4,0,0,4,1,-15,3,1
2,1,21,4,30,8,2,0,10,4,30,5,1,0,6,1,30,3,7,0,10,2,30,5,5,0,10,1,30,4,0,0,4,1,-15,3,1
2,2,21,4,30,8,2,0,10,4,30,5,1,0,6,1,30,3,7,0,10,2,30,5,5,0,10,1,30,4,0,0,4,1,-15,3,1
2,3,23,1,30,4,9,0,13,3,30,6,0,0,6,9,30,13,0,0,13,0,30,5,8,0,13,2,30,6,0,0,6,1,-15,3,1
2,4,23,1,30,4,9,0,13,3,30,6,0,0,6,9,30,13,0,0,13,0,30,5,8,0,13,2,30,6,0,0,6,1,-15,3,1
2,2,25,2,30,5,9,0,14,3,30,6,0,0,6,0,30,11,3,0,14,1,30,9,5,0,14,4,30,5,1,0,6,1,-15,3,1
2,3,25,2,30,5,9,0,14,3,30,6,0,0,6,0,30,11,3,0,14,1,30,9,5,0,14,4,30,5,1,0,6,1,-15,3,1
2,3,31,1,30,8,4,0,12,3,30,8,0,0,8,6,30,12,0,0,12,0,30,3,9,0,12,0,30,2,4,0,6,1,-15,3,1
2,3,45,0,30,7,6,0,13,10,30,10,0,0,10,0,30,0,13,0,13,0,30,4,9,0,13,4,30,4,1,0,5,1,-15,3,1
2,3,47,0,30,0,14,0,14,5,30,4,0,0,4,0,30,5,9,0,14,0,30,2,12,0,14,1,30,7,0,0,7,1,-15,3,1
2,4,13,0,30,3,0,0,3,0,30,2,0,0,2,1,30,3,0,0,3,12,30,2,1,0,3,4,30,2,0,0,2,1,-15,3,1
2,4,13,1,30,5,2,0,7,0,30,4,0,0,4,0,30,7,0,0,7,9,30,6,1,0,7,4,30,4,0,0,4,1,-15,3,1
2,2,17,3,30,10,4,0,14,3,30,6,0,0,6,0,30,5,9,0,14,5,30,5,9,0,14,6,30,4,0,0,4,1,-15,3,1
2,3,23,2,30,4,9,0,13,3,30,6,0,0,6,7,30,9,4,0,13,0,30,4,9,0,13,0,30,5,1,0,6,1,-15,3,1
2,4,23,2,30,4,9,0,13,3,30,6,0,0,6,7,30,9,4,0,13,0,30,4,9,0,13,0,30,5,1,0,6,1,-15,3,1
2,4,1,0,30,4,6,0,10,4,30,2,0,0,2,0,30,4,6,0,10,7,30,10,0,0,10,6,30,6,0,0,6,0,-27,3,0
2,1,4,2,30,8,0,0,8,5,30,4,0,0,4,1,30,2,6,0,8,0,30,6,2,0,8,1,30,4,0,0,4,0,-27,3,0
2,1,5,0,30,3,2,0,5,2,30,0,4,0,4,0,30,0,5,0,5,0,30,1,4,0,5,0,30,0,2,0,2,0,-27,3,0
2,3,5,0,30,3,2,0,5,2,30,0,4,0,4,0,30,0,5,0,5,0,30,1,4,0,5,0,30,0,2,0,2,0,-27,3,0
2,3,8,0,30,5,2,0,7,3,30,2,0,0,2,0,30,4,3,0,7,1,30,4,3,0,7,2,30,3,0,0,3,0,-27,3,0
2,4,8,0,30,5,2,0,7,3,30,2,0,0,2,0,30,4,3,0,7,1,30,4,3,0,7,2,30,3,0,0,3,0,-27,3,0
2,1,11,1,30,3,9,0,12,0,30,4,0,0,4,0,30,9,3,0,12,9,30,5,7,0,12,4,30,4,0,0,4,1,-15,3,1
2,3,13,3,30,6,1,0,7,0,30,4,0,0,4,1,30,7,0,0,7,4,30,4,3,0,7,5,30,4,0,0,4,1,-15,3,1
2,4,13,3,30,6,1,0,7,0,30,4,0,0,4,1,30,7,0,0,7,4,30,4,3,0,7,5,30,4,0,0,4,1,-15,3,1
2,2,27,1,30,3,12,0,15,4,30,2,0,0,2,0,30,6,9,0,15,2,30,3,12,0,15,1,30,5,1,0,6,1,-15,3,1
2,3,7,0,30,1,3,0,4,2,30,2,0,0,2,0,30,1,3,0,4,0,30,1,3,0,4,0,30,2,0,0,2,0,-27,3,0
2,2,13,5,30,7,0,0,7,2,30,4,0,0,4,2,30,5,2,0,7,4,30,6,1,0,7,2,30,4,0,0,4,1,-15,3,1
2,4,13,5,30,7,0,0,7,2,30,4,0,0,4,2,30,5,2,0,7,4,30,6,1,0,7,2,30,4,0,0,4,1,-15,3,1
2,2,25,0,30,7,7,0,14,2,30,6,0,0,6,0,30,11,3,0,14,1,30,5,9,0,14,3,30,5,1,0,6,1,-15,3,1
2,0,27,1,30,5,10,0,15,5,30,1,1,0,2,0,30,3,12,0,15,1,30,6,9,0,15,7,30,6,0,0,6,1,-15,3,1
2,1,27,1,30,5,10,0,15,5,30,1,1,0,2,0,30,3,12,0,15,1,30,6,9,0,15,7,30,6,0,0,6,1,-15,3,1
2,3,27,1,30,5,10,0,15,5,30,1,1,0,2,0,30,3,12,0,15,1,30,6,9,0,15,7,30,6,0,0,6,1,-15,3,1
2,2,3,0,30,0,4,0,4,3,30,4,0,0,4,0,30,0,4,0,4,8,30,2,2,0,4,0,30,1,2,0,3,0,-27,3,0
2,4,3,0,30,0,4,0,4,3,30,4,0,0,4,0,30,0,4,0,4,8,30,2,2,0,4,0,30,1,2,0,3,0,-27,3,0
2,0,4,2,30,8,0,0,8,4,30,4,0,0,4,2,30,3,5,0,8,0,30,0,8,0,8,3,30,4,0,0,4,0,-27,3,0
2,4,5,0,30,0,5,0,5,3,30,0,4,0,4,0,30,0,5,0,5,0,30,1,4,0,5,3,30,2,0,0,2,0,-27,3,0
2,2,19,0,30,2,11,0,13,2,30,7,1,0,8,0,30,6,7,0,13,7,30,4,9,0,13,1,30,8,1,0,9,1,-15,3,1
2,4,19,0,30,2,11,0,13,2,30,7,1,0,8,0,30,6,7,0,13,7,30,4,9,0,13,1,30,8,1,0,9,1,-15,3,1
2,3,23,2,30,5,8,0,13,3,30,6,0,0,6,6,30,13,0,0,13,0,30,5,8,0,13,4,30,6,0,0,6,1,-15,3,1
2,2,25,1,30,4,10,0,14,4,30,6,0,0,6,0,30,5,9,0,14,1,30,8,6,0,14,4,30,6,0,0,6,1,-15,3,1
2,3,25,1,30,4,10,0,14,4,30,6,0,0,6,0,30,5,9,0,14,1,30,8,6,0,14,4,30,6,0,0,6,1,-15,3,1
2,4,25,1,30,4,10,0,14,4,30,6,0,0,6,0,30,5,9,0,14,1,30,8,6,0,14,4,30,6,0,0,6,1,-15,3,1
2,0,27,3,30,5,10,0,15,3,30,1,1,0,2,0,30,3,12,0,15,2,30,4,11,0,15,3,30,6,0,0,6,1,-15,3,1
2,4,27,3,30,5,10,0,15,3,30,1,1,0,2,0,30,3,12,0,15,2,30,4,11,0,15,3,30,6,0,0,6,1,-15,3,1
2,4,19,0,30,3,10,0,13,2,30,4,4,0,8,0,30,8,5,0,13,0,30,6,7,0,13,0,30,9,0,0,9,1,-15,3,1
2,2,25,3,30,7,7,0,14,4,30,6,0,0,6,0,30,6,8,0,14,1,30,5,9,0,14,3,30,5,1,0,6,1,-15,3,1
2,4,25,3,30,7,7,0,14,4,30,6,0,0,6,0,30,6,8,0,14,1,30,5,9,0,14,0,30,5,1,0,6,1,-15,3,1
2,1,27,1,30,4,11,0,15,0,30,1,1,0,2,0,30,8,7,0,15,0,30,5,10,0,15,1,30,4,2,0,6,1,-15,3,1
2,2,27,1,30,4,11,0,15,0,30,1,1,0,2,0,30,8,7,0,15,0,30,5,10,0,15,1,30,4,2,0,6,1,-15,3,1
2,4,27,1,30,4,11,0,15,0,30,1,1,0,2,0,30,8,7,0,15,0,30,5,10,0,15,1,30,4,2,0,6,1,-15,3,1
2,3,29,0,30,5,9,0,14,7,30,12,0,0,12,0,30,2,12,0,14,4,30,0,14,0,14,1,30,9,0,0,9,1,-15,3,1
2,4,29,0,30,5,9,0,14,7,30,12,0,0,12,0,30,2,12,0,14,4,30,0,14,0,14,1,30,9,0,0,9,1,-15,3,1
2,3,38,0,30,3,7,0,10,7,30,6,0,0,6,0,30,1,9,0,10,0,30,4,6,0,10,6,30,6,0,0,6,1,-15,3,1
2,0,39,0,30,6,5,0,11,6,30,6,0,0,6,0,30,6,5,0,11,0,30,2,9,0,11,4,30,5,0,0,5,1,-15,3,1
2,4,5,0,30,0,5,0,5,3,30,0,4,0,4,0,30,0,5,0,5,0,30,3,2,0,5,0,30,2,0,0,2,0,-27,3,0
2,4,13,0,30,4,3,0,7,0,30,4,0,0,4,6,30,5,2,0,7,12,30,7,0,0,7,6,30,4,0,0,4,1,-15,3,1
2,1,17,4,30,10,4,0,14,2,30,6,0,0,6,0,30,7,7,0,14,3,30,7,7,0,14,4,30,4,0,0,4,1,-15,3,1
2,3,19,0,30,4,9,0,13,0,30,7,1,0,8,0,30,6,7,0,13,4,30,4,9,0,13,0,30,6,3,0,9,1,-15,3,1
2,2,25,1,30,7,7,0,14,3,30,6,0,0,6,0,30,8,6,0,14,1,30,9,5,0,14,4,30,5,1,0,6,1,-15,3,1
2,2,27,1,30,5,10,0,15,3,30,2,0,0,2,0,30,6,9,0,15,0,30,4,11,0,15,5,30,4,2,0,6,1,-15,3,1
2,4,27,1,30,5,10,0,15,3,30,2,0,0,2,0,30,6,9,0,15,0,30,4,11,0,15,5,30,4,2,0,6,1,-15,3,1
2,4,31,0,30,5,7,0,12,7,30,8,0,0,8,3,30,4,8,0,12,0,30,8,4,0,12,3,30,6,0,0,6,1,-15,3,1
2,3,32,0,30,3,6,0,9,4,30,2,0,0,2,1,30,7,2,0,9,1,30,4,5,0,9,6,30,2,0,0,2,1,-15,3,1
2,2,6,0,30,6,3,0,9,4,30,2,0,0,2,0,30,3,6,0,9,0,30,4,5,0,9,2,30,5,0,0,5,0,-27,3,0
2,3,8,0,30,7,0,0,7,3,30,2,0,0,2,3,30,2,5,0,7,3,30,6,1,0,7,2,30,3,0,0,3,0,-27,3,0
2,2,19,0,30,6,7,0,13,2,30,3,5,0,8,0,30,5,8,0,13,7,30,4,9,0,13,3,30,9,0,0,9,1,-15,3,1
2,4,19,0,30,6,7,0,13,2,30,3,5,0,8,0,30,5,8,0,13,7,30,4,9,0,13,3,30,9,0,0,9,1,-15,3,1
2,1,23,3,30,7,6,0,13,2,30,6,0,0,6,7,30,12,1,0,13,0,30,6,7,0,13,1,30,6,0,0,6,1,-15,3,1
2,4,23,3,30,7,6,0,13,2,30,6,0,0,6,7,30,12,1,0,13,0,30,6,7,0,13,1,30,6,0,0,6,1,-15,3,1
2,0,25,1,30,7,7,0,14,4,30,6,0,0,6,0,30,7,7,0,14,1,30,5,9,0,14,5,30,5,1,0,6,1,-15,3,1
2,2,25,1,30,7,7,0,14,4,30,6,0,0,6,0,30,7,7,0,14,1,30,5,9,0,14,5,30,5,1,0,6,1,-15,3,1
2,4,25,1,30,7,7,0,14,4,30,6,0,0,6,0,30,7,7,0,14,1,30,5,9,0,14,3,30,5,1,0,6,1,-15,3,1
2,0,27,1,30,4,11,0,15,5,30,2,0,0,2,0,30,6,9,0,15,1,30,5,10,0,15,1,30,6,0,0,6,1,-15,3,1
2,4,27,1,30,4,11,0,15,5,30,2,0,0,2,0,30,6,9,0,15,1,30,5,10,0,15,1,30,6,0,0,6,1,-15,3,1
2,1,13,3,30,7,0,0,7,1,30,4,0,0,4,3,30,5,2,0,7,7,30,7,0,0,7,3,30,4,0,0,4,1,-15,3,1
2,2,13,3,30,7,0,0,7,1,30,4,0,0,4,3,30,5,2,0,7,7,30,7,0,0,7,3,30,4,0,0,4,1,-15,3,1
2,3,17,2,30,9,5,0,14,2,30,6,0,0,6,0,30,7,7,0,14,3,30,5,9,0,14,7,30,4,0,0,4,1,-15,3,1
2,1,19,0,30,4,9,0,13,2,30,5,3,0,8,0,30,4,9,0,13,3,30,7,6,0,13,3,30,9,0,0,9,1,-15,3,1
2,2,19,0,30,4,9,0,13,2,30,5,3,0,8,0,30,4,9,0,13,3,30,7,6,0,13,3,30,9,0,0,9,1,-15,3,1
2,4,19,0,30,4,9,0,13,2,30,5,3,0,8,0,30,4,9,0,13,3,30,7,6,0,13,3,30,9,0,0,9,1,-15,3,1
2,3,23,2,30,6,7,0,13,1,30,6,0,0,6,5,30,11,2,0,13,0,30,5,8,0,13,3,30,5,1,0,6,1,-15,3,1
2,2,25,1,30,5,9,0,14,4,30,5,1,0,6,0,30,10,4,0,14,1,30,7,7,0,14,0,30,5,1,0,6,1,-15,3,1
2,1,27,1,30,4,11,0,15,5,30,2,0,0,2,0,30,2,13,0,15,0,30,5,10,0,15,7,30,6,0,0,6,1,-15,3,1
2,2,27,1,30,4,11,0,15,5,30,2,0,0,2,0,30,2,13,0,15,0,30,5,10,0,15,7,30,6,0,0,6,1,-15,3,1
2,2,29,0,30,7,7,0,14,5,30,10,2,0,12,0,30,3,11,0,14,0,30,3,11,0,14,0,30,7,2,0,9,1,-15,3,1
2,4,29,0,30,7,7,0,14,5,30,10,2,0,12,0,30,3,11,0,14,0,30,3,11,0,14,0,30,7,2,0,9,1,-15,3,1
2,2,39,0,30,4,7,0,11,5,30,6,0,0,6,0,30,8,3,0,11,0,30,4,7,0,11,5,30,5,0,0,5,1,-15,3,1
2,3,39,0,30,4,7,0,11,5,30,6,0,0,6,0,30,8,3,0,11,0,30,4,7,0,11,5,30,5,0,0,5,1,-15,3,1
2,1,4,2,30,6,2,0,8,5,30,3,1,0,4,0,30,1,7,0,8,0,30,5,3,0,8,1,30,3,1,0,4,0,-27,3,0
2,3,13,0,30,7,0,0,7,0,30,4,0,0,4,3,30,7,0,0,7,5,30,5,2,0,7,5,30,4,0,0,4,1,-15,3,1
2,4,13,0,30,7,0,0,7,0,30,4,0,0,4,3,30,7,0,0,7,5,30,5,2,0,7,5,30,4,0,0,4,1,-15,3,1
2,1,17,2,30,9,5,0,14,2,30,6,0,0,6,0,30,5,9,0,14,1,30,5,9,0,14,6,30,4,0,0,4,1,-15,3,1
2,3,17,2,30,9,5,0,14,2,30,6,0,0,6,0,30,5,9,0,14,1,30,5,9,0,14,6,30,4,0,0,4,1,-15,3,1
2,4,17,2,30,9,5,0,14,2,30,6,0,0,6,0,30,5,9,0,14,1,30,5,9,0,14,6,30,4,0,0,4,1,-15,3,1
2,4,22,1,30,6,2,0,8,3,30,2,0,0,2,4,30,4,4,0,8,0,30,6,2,0,8,5,30,1,3,0,4,1,-15,3,1
2,0,25,1,30,8,6,0,14,5,30,6,0,0,6,0,30,4,10,0,14,7,30,6,8,0,14,5,30,5,1,0,6,1,-15,3,1
2,2,31,3,30,7,5,0,12,4,30,8,0,0,8,3,30,10,2,0,12,0,30,3,9,0,12,1,30,3,3,0,6,1,-15,3,1
2,3,33,1,30,2,9,0,11,5,30,4,0,0,4,0,30,10,1,0,11,0,30,3,8,0,11,3,30,4,0,0,4,1,-15,3,1
2,3,7,0,30,2,2,0,4,2,30,2,0,0,2,0,30,1,3,0,4,1,30,2,2,0,4,2,30,2,0,0,2,0,-27,3,0
2,4,7,0,30,2,2,0,4,2,30,2,0,0,2,0,30,1,3,0,4,1,30,2,2,0,4,2,30,2,0,0,2,0,-27,3,0
2,3,13,1,30,7,0,0,7,0,30,4,0,0,4,5,30,6,1,0,7,4,30,7,0,0,7,2,30,4,0,0,4,1,-15,3,1
2,3,17,3,30,9,5,0,14,3,30,6,0,0,6,0,30,5,9,0,14,1,30,5,9,0,14,3,30,4,0,0,4,1,-15,3,1
2,4,17,3,30,9,5,0,14,3,30,6,0,0,6,0,30,5,9,0,14,1,30,5,9,0,14,3,30,4,0,0,4,1,-15,3,1
2,2,19,0,30,6,7,0,13,2,30,8,0,0,8,5,30,4,9,0,13,0,30,3,10,0,13,0,30,6,3,0,9,1,-15,3,1
2,3,19,0,30,6,7,0,13,2,30,8,0,0,8,5,30,4,9,0,13,0,30,3,10,0,13,0,30,6,3,0,9,1,-15,3,1
2,3,23,3,30,5,8,0,13,2,30,6,0,0,6,1,30,12,1,0,13,1,30,6,7,0,13,5,30,6,0,0,6,1,-15,3,1
2,4,23,3,30,5,8,0,13,2,30,6,0,0,6,1,30,12,1,0,13,1,30,6,7,0,13,5,30,6,0,0,6,1,-15,3,1
2,2,25,1,30,9,5,0,14,4,30,6,0,0,6,0,30,7,7,0,14,1,30,5,9,0,14,3,30,6,0,0,6,1,-15,3,1
2,0,29,0,30,4,10,0,14,4,30,10,2,0,12,0,30,8,6,0,14,0,30,1,13,0,14,1,30,9,0,0,9,1,-15,3,1
2,2,29,0,30,4,10,0,14,4,30,10,2,0,12,0,30,8,6,0,14,0,30,1,13,0,14,1,30,9,0,0,9,1,-15,3,1
2,1,33,1,30,2,9,0,11,5,30,4,0,0,4,1,30,10,1,0,11,0,30,3,8,0,11,6,30,4,0,0,4,1,-15,3,1
2,2,33,1,30,2,9,0,11,5,30,4,0,0,4,1,30,10,1,0,11,0,30,3,8,0,11,6,30,4,0,0,4,1,-15,3,1
2,2,4,2,30,8,0,0,8,3,30,4,0,0,4,0,30,6,2,0,8,0,30,4,4,0,8,1,30,3,1,0,4,0,-27,3,0
2,4,8,1,30,7,0,0,7,3,30,2,0,0,2,3,30,3,4,0,7,3,30,7,0,0,7,2,30,3,0,0,3,0,-27,3,0
2,1,19,2,30,5,8,0,13,2,30,7,1,0,8,0,30,7,6,0,13,4,30,8,5,0,13,1,30,6,3,0,9,1,-15,3,1
2,2,19,2,30,5,8,0,13,2,30,7,1,0,8,0,30,7,6,0,13,4,30,8,5,0,13,1,30,6,3,0,9,1,-15,3,1
2,2,25,0,30,8,6,0,14,1,30,6,0,0,6,0,30,14,0,0,14,1,30,5,9,0,14,4,30,5,1,0,6,1,-15,3,1
2,1,27,2,30,3,12,0,15,1,30,1,1,0,2,0,30,5,10,0,15,0,30,6,9,0,15,5,30,6,0,0,6,1,-15,3,1
2,2,27,2,30,3,12,0,15,1,30,1,1,0,2,0,30,5,10,0,15,0,30,6,9,0,15,5,30,6,0,0,6,1,-15,3,1
2,3,39,2,30,4,7,0,11,8,30,6,0,0,6,0,30,5,6,0,11,1,30,5,6,0,11,1,30,5,0,0,5,1,-15,3,1
2,4,39,2,30,4,7,0,11,8,30,6,0,0,6,0,30,5,6,0,11,1,30,5,6,0,11,1,30,5,0,0,5,1,-15,3,1
2,0,4,2,30,7,1,0,8,4,30,3,1,0,4,0,30,2,6,0,8,0,30,5,3,0,8,4,30,4,0,0,4,0,-27,3,0
2,3,4,2,30,7,1,0,8,4,30,3,1,0,4,0,30,2,6,0,8,0,30,5,3,0,8,4,30,4,0,0,4,0,-27,3,0
2,4,25,1,30,7,7,0,14,4,30,6,0,0,6,0,30,7,7,0,14,0,30,5,9,0,14,4,30,5,1,0,6,1,-15,3,1
2,0,26,0,30,6,3,0,9,5,30,4,0,0,4,7,30,3,6,0,9,0,30,3,6,0,9,6,30,3,0,0,3,1,-15,3,1
2,3,26,0,30,6,3,0,9,5,30,4,0,0,4,7,30,3,6,0,9,0,30,3,6,0,9,6,30,3,0,0,3,1,-15,3,1
2,2,33,3,30,5,6,0,11,5,30,4,0,0,4,2,30,10,1,0,11,0,30,3,8,0,11,6,30,4,0,0,4,1,-15,3,1
2,2,1,0,30,5,5,0,10,3,30,2,0,0,2,1,30,4,6,0,10,4,30,6,4,0,10,6,30,6,0,0,6,0,-27,3,0
2,4,3,0,30,0,4,0,4,2,30,4,0,0,4,1,30,1,3,0,4,2,30,2,2,0,4,0,30,3,0,0,3,0,-27,3,0
2,3,11,2,30,4,8,0,12,0,30,4,0,0,4,0,30,7,5,0,12,6,30,3,9,0,12,5,30,4,0,0,4,1,-15,3,1
2,4,17,3,30,10,4,0,14,2,30,6,0,0,6,0,30,7,7,0,14,0,30,5,9,0,14,2,30,4,0,0,4,1,-15,3,1
2,4,19,0,30,3,10,0,13,2,30,7,1,0,8,0,30,4,9,0,13,0,30,5,8,0,13,0,30,8,1,0,9,1,-15,3,1
2,3,25,1,30,3,11,0,14,4,30,6,0,0,6,0,30,7,7,0,14,1,30,4,10,0,14,4,30,5,1,0,6,1,-15,3,1
2,0,27,2,30,5,10,0,15,4,30,2,0,0,2,0,30,6,9,0,15,2,30,6,9,0,15,1,30,6,0,0,6,1,-15,3,1
2,2,27,2,30,5,10,0,15,4,30,2,0,0,2,0,30,6,9,0,15,2,30,6,9,0,15,1,30,6,0,0,6,1,-15,3,1
2,3,27,2,30,5,10,0,15,4,30,2,0,0,2,0,30,6,9,0,15,2,30,6,9,0,15,1,30,6,0,0,6,1,-15,3,1
2,2,29,0,30,7,7,0,14,6,30,12,0,0,12,0,30,3,11,0,14,0,30,1,13,0,14,1,30,9,0,0,9,1,-15,3,1
2,3,32,0,30,7,2,0,9,4,30,2,0,0,2,3,30,9,0,0,9,1,30,3,6,0,9,2,30,1,1,0,2,1,-15,3,1
2,3,33,1,30,2,9,0,11,4,30,4,0,0,4,2,30,11,0,0,11,0,30,3,8,0,11,6,30,4,0,0,4,1,-15,3,1
2,4,9,0,30,2,2,0,4,2,30,2,0,0,2,0,30,2,2,0,4,0,30,1,3,0,4,0,30,0,1,0,1,0,-27,3,0
2,4,13,11,30,7,0,0,7,1,30,4,0,0,4,0,30,5,2,0,7,5,30,3,4,0,7,0,30,4,0,0,4,1,-15,3,1
2,0,21,3,30,8,2,0,10,4,30,6,0,0,6,1,30,3,7,0,10,5,30,5,5,0,10,0,30,4,0,0,4,1,-15,3,1
2,1,21,3,30,8,2,0,10,4,30,6,0,0,6,1,30,3,7,0,10,5,30,5,5,0,10,0,30,4,0,0,4,1,-15,3,1
2,3,21,3,30,8,2,0,10,4,30,6,0,0,6,1,30,3,7,0,10,5,30,5,5,0,10,0,30,4,0,0,4,1,-15,3,1
2,3,27,1,30,3,12,0,15,4,30,1,1,0,2,0,30,4,11,0,15,2,30,10,5,0,15,2,30,6,0,0,6,1,-15,3,1
2,3,17,3,30,8,6,0,14,2,30,6,0,0,6,0,30,7,7,0,14,0,30,3,11,0,14,3,30,4,0,0,4,1,-15,3,1
2,4,17,3,30,8,6,0,14,2,30,6,0,0,6,0,30,7,7,0,14,0,30,3,11,0,14,3,30,4,0,0,4,1,-15,3,1
2,0,19,0,30,1,12,0,13,2,30,7,1,0,8,0,30,10,3,0,13,5,30,4,9,0,13,2,30,8,1,0,9,1,-15,3,1
2,1,19,0,30,1,12,0,13,2,30,7,1,0,8,0,30,10,3,0,13,5,30,4,9,0,13,2,30,8,1,0,9,1,-15,3,1
2,2,19,0,30,1,12,0,13,2,30,7,1,0,8,0,30,10,3,0,13,5,30,4,9,0,13,2,30,8,1,0,9,1,-15,3,1
2,1,21,2,30,6,4,0,10,3,30,4,2,0,6,0,30,3,7,0,10,5,30,5,5,0,10,4,30,4,0,0,4,1,-15,3,1
2,2,21,2,30,6,4,0,10,3,30,4,2,0,6,0,30,3,7,0,10,5,30,5,5,0,10,4,30,4,0,0,4,1,-15,3,1
2,3,21,2,30,6,4,0,10,3,30,4,2,0,6,0,30,3,7,0,10,5,30,5,5,0,10,4,30,4,0,0,4,1,-15,3,1
2,2,23,4,30,5,8,0,13,3,30,6,0,0,6,2,30,10,3,0,13,2,30,7,6,0,13,0,30,6,0,0,6,1,-15,3,1
2,4,23,4,30,5,8,0,13,3,30,6,0,0,6,2,30,10,3,0,13,0,30,7,6,0,13,0,30,6,0,0,6,1,-15,3,1
2,4,25,1,30,9,5,0,14,5,30,6,0,0,6,1,30,5,9,0,14,1,30,5,9,0,14,3,30,5,1,0,6,1,-15,3,1
2,1,27,1,30,4,11,0,15,5,30,2,0,0,2,0,30,5,10,0,15,2,30,3,12,0,15,5,30,6,0,0,6,1,-15,3,1
2,2,27,1,30,4,11,0,15,5,30,2,0,0,2,0,30,5,10,0,15,2,30,3,12,0,15,5,30,6,0,0,6,1,-15,3,1
2,3,27,1,30,4,11,0,15,5,30,2,0,0,2,0,30,5,10,0,15,2,30,3,12,0,15,5,30,6,0,0,6,1,-15,3,1
2,4,27,1,30,4,11,0,15,5,30,2,0,0,2,0,30,5,10,0,15,2,30,3,12,0,15,5,30,6,0,0,6,1,-15,3,1
2,2,39,2,30,3,8,0,11,6,30,6,0,0,6,0,30,7,4,0,11,0,30,2,9,0,11,2,30,4,1,0,5,1,-15,3,1
2,4,1,0,30,9,1,0,10,4,30,2,0,0,2,1,30,4,6,0,10,6,30,6,4,0,10,6,30,6,0,0,6,0,-27,3,0
2,4,17,2,30,7,7,0,14,0,30,6,0,0,6,0,30,7,7,0,14,2,30,5,9,0,14,2,30,4,0,0,4,1,-15,3,1
2,4,19,0,30,5,8,0,13,2,30,4,4,0,8,0,30,6,7,0,13,9,30,5,8,0,13,3,30,9,0,0,9,1,-15,3,1
2,0,27,2,30,5,10,0,15,2,30,1,1,0,2,0,30,9,6,0,15,0,30,6,9,0,15,3,30,6,0,0,6,1,-15,3,1
2,1,29,0,30,5,9,0,14,5,30,12,0,0,12,0,30,5,9,0,14,0,30,0,14,0,14,1,30,9,0,0,9,1,-15,3,1
2,3,29,0,30,5,9,0,14,5,30,12,0,0,12,0,30,5,9,0,14,0,30,0,14,0,14,1,30,9,0,0,9,1,-15,3,1
2,4,29,0,30,5,9,0,14,5,30,12,0,0,12,0,30,5,9,0,14,0,30,0,14,0,14,1,30,9,0,0,9,1,-15,3,1
2,4,31,1,30,5,7,0,12,4,30,8,0,0,8,6,30,9,3,0,12,0,30,4,8,0,12,2,30,2,4,0,6,1,-15,3,1
2,2,35,0,30,6,7,0,13,6,30,2,0,0,2,1,30,2,11,0,13,5,30,3,10,0,13,6,30,8,0,0,8,1,-15,3,1
2,3,35,0,30,6,7,0,13,6,30,2,0,0,2,1,30,2,11,0,13,5,30,3,10,0,13,6,30,8,0,0,8,1,-15,3,1
2,0,4,2,30,6,2,0,8,4,30,4,0,0,4,2,30,1,7,0,8,0,30,4,4,0,8,1,30,3,1,0,4,0,-27,3,0
2,2,4,2,30,6,2,0,8,4,30,4,0,0,4,0,30,1,7,0,8,0,30,4,4,0,8,1,30,3,1,0,4,0,-27,3,0
2,1,13,1,30,5,2,0,7,1,30,4,0,0,4,2,30,6,1,0,7,6,30,7,0,0,7,5,30,4,0,0,4,1,-15,3,1
2,3,13,1,30,5,2,0,7,1,30,4,0,0,4,2,30,6,1,0,7,6,30,7,0,0,7,5,30,4,0,0,4,1,-15,3,1
2,2,17,3,30,10,4,0,14,3,30,6,0,0,6,0,30,4,10,0,14,0,30,5,9,0,14,4,30,4,0,0,4,1,-15,3,1
2,3,19,0,30,2,11,0,13,2,30,6,2,0,8,0,30,5,8,0,13,2,30,6,7,0,13,2,30,9,0,0,9,1,-15,3,1
2,4,19,0,30,2,11,0,13,2,30,6,2,0,8,0,30,5,8,0,13,2,30,6,7,0,13,2,30,9,0,0,9,1,-15,3,1
2,3,23,1,30,4,9,0,13,4,30,6,0,0,6,5,30,11,2,0,13,0,30,6,7,0,13,3,30,5,1,0,6,1,-15,3,1
2,1,25,1,30,5,9,0,14,5,30,6,0,0,6,0,30,6,8,0,14,1,30,5,9,0,14,4,30,6,0,0,6,1,-15,3,1
2,3,25,1,30,5,9,0,14,5,30,6,0,0,6,0,30,6,8,0,14,1,30,5,9,0,14,4,30,6,0,0,6,1,-15,3,1
2,1,27,1,30,4,11,0,15,5,30,1,1,0,2,0,30,3,12,0,15,2,30,6,9,0,15,4,30,6,0,0,6,1,-15,3,1
2,2,27,1,30,4,11,0,15,5,30,1,1,0,2,0,30,3,12,0,15,2,30,6,9,0,15,4,30,6,0,0,6,1,-15,3,1
2,1,31,3,30,6,6,0,12,4,30,8,0,0,8,6,30,12,0,0,12,0,30,3,9,0,12,1,30,1,5,0,6,1,-15,3,1
2,2,31,3,30,6,6,0,12,4,30,8,0,0,8,6,30,12,0,0,12,0,30,3,9,0,12,1,30,1,5,0,6,1,-15,3,1
2,4,19,1,30,6,7,0,13,2,30,8,0,0,8,1,30,4,9,0,13,0,30,3,10,0,13,1,30,8,1,0,9,1,-15,3,1
2,3,23,1,30,4,9,0,13,5,30,6,0,0,6,0,30,6,7,0,13,3,30,6,7,0,13,8,30,5,1,0,6,1,-15,3,1
2,3,25,1,30,7,7,0,14,4,30,6,0,0,6,0,30,7,7,0,14,2,30,10,4,0,14,0,30,6,0,0,6,1,-15,3,1
2,1,27,3,30,6,9,0,15,2,30,2,0,0,2,0,30,7,8,0,15,0,30,3,12,0,15,1,30,3,3,0,6,1,-15,3,1
2,4,27,3,30,6,9,0,15,2,30,2,0,0,2,0,30,7,8,0,15,0,30,3,12,0,15,1,30,3,3,0,6,1,-15,3,1
2,2,29,0,30,4,10,0,14,6,30,12,0,0,12,0,30,7,7,0,14,0,30,1,13,0,14,4,30,9,0,0,9,1,-15,3,1
2,3,29,0,30,4,10,0,14,6,30,12,0,0,12,0,30,7,7,0,14,0,30,1,13,0,14,4,30,9,0,0,9,1,-15,3,1
2,4,29,0,30,4,10,0,14,6,30,12,0,0,12,0,30,7,7,0,14,0,30,1,13,0,14,4,30,9,0,0,9,1,-15,3,1
2,3,6,1,30,6,3,0,9,4,30,2,0,0,2,0,30,3,6,0,9,0,30,4,5,0,9,3,30,5,0,0,5,0,-27,3,0
2,4,6,1,30,6,3,0,9,4,30,2,0,0,2,0,30,3,6,0,9,0,30,4,5,0,9,3,30,5,0,0,5,0,-27,3,0
2,1,13,1,30,6,1,0,7,0,30,4,0,0,4,2,30,6,1,0,7,5,30,6,1,0,7,4,30,4,0,0,4,1,-15,3,1
2,3,13,1,30,6,1,0,7,0,30,4,0,0,4,2,30,6,1,0,7,5,30,6,1,0,7,4,30,4,0,0,4,1,-15,3,1
2,0,17,4,30,10,4,0,14,4,30,6,0,0,6,0,30,3,11,0,14,3,30,7,7,0,14,3,30,4,0,0,4,1,-15,3,1
2,1,17,4,30,10,4,0,14,4,30,6,0,0,6,0,30,3,11,0,14,3,30,7,7,0,14,3,30,4,0,0,4,1,-15,3,1
2,2,17,4,30,10,4,0,14,4,30,6,0,0,6,0,30,3,11,0,14,3,30,7,7,0,14,3,30,4,0,0,4,1,-15,3,1
2,3,19,0,30,4,9,0,13,3,30,6,2,0,8,9,30,4,9,0,13,0,30,5,8,0,13,0,30,7,2,0,9,1,-15,3,1
2,1,25,1,30,3,11,0,14,5,30,6,0,0,6,0,30,6,8,0,14,1,30,11,3,0,14,5,30,6,0,0,6,1,-15,3,1
2,2,25,1,30,3,11,0,14,5,30,6,0,0,6,0,30,6,8,0,14,1,30,11,3,0,14,5,30,6,0,0,6,1,-15,3,1
2,0,27,3,30,8,7,0,15,4,30,1,1,0,2,0,30,2,13,0,15,0,30,4,11,0,15,4,30,6,0,0,6,1,-15,3,1
2,2,27,3,30,8,7,0,15,4,30,1,1,0,2,0,30,2,13,0,15,0,30,4,11,0,15,4,30,6,0,0,6,1,-15,3,1
2,3,27,3,30,8,7,0,15,4,30,1,1,0,2,0,30,2,13,0,15,0,30,4,11,0,15,4,30,6,0,0,6,1,-15,3,1
2,4,27,3,30,8,7,0,15,4,30,1,1,0,2,0,30,2,13,0,15,0,30,4,11,0,15,4,30,6,0,0,6,1,-15,3,1
2,3,30,7,30,3,2,0,5,6,30,2,0,0,2,1,30,2,3,0,5,3,30,2,3,0,5,0,30,2,1,0,3,1,-15,3,1
2,2,31,2,30,8,4,0,12,4,30,8,0,0,8,3,30,8,4,0,12,0,30,3,9,0,12,1,30,2,4,0,6,1,-15,3,1
2,2,43,6,30,8,6,0,14,7,30,6,0,0,6,0,30,4,10,0,14,1,30,1,13,0,14,3,30,5,0,0,5,1,-15,3,1
2,0,47,0,30,2,12,0,14,8,30,4,0,0,4,0,30,3,11,0,14,0,30,5,9,0,14,7,30,7,0,0,7,1,-15,3,1
2,2,47,0,30,2,12,0,14,8,30,4,0,0,4,0,30,3,11,0,14,0,30,5,9,0,14,7,30,7,0,0,7,1,-15,3,1
2,2,4,4,30,8,0,0,8,4,30,4,0,0,4,1,30,4,4,0,8,0,30,5,3,0,8,1,30,3,1,0,4,0,-27,3,0
2,4,8,0,30,7,0,0,7,3,30,2,0,0,2,0,30,4,3,0,7,0,30,2,5,0,7,3,30,3,0,0,3,0,-27,3,0
2,3,17,3,30,9,5,0,14,2,30,6,0,0,6,0,30,6,8,0,14,0,30,6,8,0,14,1,30,3,1,0,4,1,-15,3,1
2,1,19,0,30,3,10,0,13,2,30,4,4,0,8,0,30,9,4,0,13,0,30,5,8,0,13,2,30,9,0,0,9,1,-15,3,1
2,2,19,0,30,3,10,0,13,2,30,4,4,0,8,0,30,9,4,0,13,0,30,5,8,0,13,2,30,9,0,0,9,1,-15,3,1
2,3,25,2,30,8,6,0,14,4,30,6,0,0,6,0,30,5,9,0,14,1,30,8,6,0,14,3,30,6,0,0,6,1,-15,3,1
2,4,25,2,30,8,6,0,14,4,30,6,0,0,6,0,30,5,9,0,14,1,30,8,6,0,14,3,30,6,0,0,6,1,-15,3,1
2,1,26,0,30,7,2,0,9,5,30,4,0,0,4,2,30,0,9,0,9,0,30,3,6,0,9,3,30,3,0,0,3,1,-15,3,1
2,3,26,0,30,7,2,0,9,5,30,4,0,0,4,2,30,0,9,0,9,0,30,3,6,0,9,3,30,3,0,0,3,1,-15,3,1
2,2,27,1,30,7,8,0,15,0,30,2,0,0,2,0,30,6,9,0,15,0,30,4,11,0,15,0,30,3,3,0,6,1,-15,3,1
2,3,27,1,30,7,8,0,15,0,30,2,0,0,2,0,30,6,9,0,15,0,30,4,11,0,15,0,30,3,3,0,6,1,-15,3,1
2,4,27,1,30,7,8,0,15,0,30,2,0,0,2,0,30,6,9,0,15,0,30,4,11,0,15,0,30,3,3,0,6,1,-15,3,1
2,0,33,2,30,4,7,0,11,4,30,4,0,0,4,7,30,8,3,0,11,5,30,3,8,0,11,4,30,4,0,0,4,1,-15,3,1
2,3,33,2,30,4,7,0,11,4,30,4,0,0,4,7,30,8,3,0,11,5,30,3,8,0,11,0,30,4,0,0,4,1,-15,3,1
2,3,39,2,30,1,10,0,11,6,30,6,0,0,6,0,30,6,5,0,11,0,30,2,9,0,11,4,30,5,0,0,5,1,-15,3,1
2,4,39,2,30,1,10,0,11,6,30,6,0,0,6,0,30,6,5,0,11,0,30,2,9,0,11,4,30,5,0,0,5,1,-15,3,1
2,2,13,4,30,7,0,0,7,0,30,4,0,0,4,2,30,6,1,0,7,8,30,5,2,0,7,2,30,4,0,0,4,1,-15,3,1
2,1,17,3,30,7,7,0,14,3,30,6,0,0,6,2,30,5,9,0,14,3,30,7,7,0,14,2,30,4,0,0,4,1,-15,3,1
2,3,17,2,30,7,7,0,14,3,30,6,0,0,6,2,30,5,9,0,14,3,30,7,7,0,14,2,30,4,0,0,4,1,-15,3,1
2,4,19,0,30,5,8,0,13,2,30,5,3,0,8,0,30,4,9,0,13,4,30,5,8,0,13,1,30,8,1,0,9,1,-15,3,1
2,4,23,1,30,6,7,0,13,2,30,6,0,0,6,4,30,12,1,0,13,0,30,6,7,0,13,2,30,5,1,0,6,1,-15,3,1
2,0,29,4,30,5,9,0,14,6,30,12,0,0,12,0,30,4,10,0,14,0,30,1,13,0,14,0,30,9,0,0,9,1,-15,3,1
2,2,29,4,30,5,9,0,14,6,30,12,0,0,12,0,30,4,10,0,14,0,30,1,13,0,14,0,30,9,0,0,9,1,-15,3,1
2,3,29,4,30,5,9,0,14,6,30,12,0,0,12,0,30,4,10,0,14,0,30,1,13,0,14,0,30,9,0,0,9,1,-15,3,1
2,4,29,4,30,5,9,0,14,6,30,12,0,0,12,0,30,4,10,0,14,0,30,1,13,0,14,0,30,9,0,0,9,1,-15,3,1
2,4,30,4,30,5,0,0,5,5,30,2,0,0,2,1,30,2,3,0,5,3,30,2,3,0,5,1,30,3,0,0,3,1,-15,3,1
2,4,13,2,30,3,0,0,3,0,30,2,0,0,2,0,30,3,0,0,3,8,30,2,1,0,3,6,30,2,0,0,2,1,-15,3,1
2,1,19,0,30,3,10,0,13,3,30,8,0,0,8,8,30,7,6,0,13,1,30,4,9,0,13,1,30,6,3,0,9,1,-15,3,1
2,3,19,0,30,3,10,0,13,3,30,8,0,0,8,8,30,7,6,0,13,1,30,4,9,0,13,1,30,6,3,0,9,1,-15,3,1
2,4,25,0,30,9,5,0,14,4,30,6,0,0,6,0,30,3,11,0,14,1,30,5,9,0,14,4,30,5,1,0,6,1,-15,3,1
2,1,26,0,30,5,4,0,9,5,30,4,0,0,4,5,30,0,9,0,9,0,30,4,5,0,9,6,30,3,0,0,3,1,-15,3,1
2,2,26,0,30,5,4,0,9,5,30,4,0,0,4,5,30,0,9,0,9,0,30,4,5,0,9,6,30,3,0,0,3,1,-15,3,1
2,3,26,0,30,5,4,0,9,5,30,4,0,0,4,5,30,0,9,0,9,0,30,4,5,0,9,6,30,3,0,0,3,1,-15,3,1
2,4,26,0,30,5,4,0,9,5,30,4,0,0,4,5,30,0,9,0,9,0,30,4,5,0,9,6,30,3,0,0,3,1,-15,3,1
2,1,27,1,30,4,11,0,15,4,30,1,1,0,2,0,30,9,6,0,15,2,30,4,11,0,15,2,30,6,0,0,6,1,-15,3,1
2,1,29,0,30,4,10,0,14,5,30,12,0,0,12,0,30,6,8,0,14,0,30,0,14,0,14,3,30,9,0,0,9,1,-15,3,1
2,3,31,1,30,10,2,0,12,4,30,8,0,0,8,3,30,8,4,0,12,0,30,3,9,0,12,1,30,4,2,0,6,1,-15,3,1
2,4,8,1,30,7,0,0,7,4,30,2,0,0,2,0,30,3,4,0,7,0,30,6,1,0,7,1,30,3,0,0,3,0,-27,3,0
2,2,13,2,30,7,0,0,7,0,30,4,0,0,4,2,30,6,1,0,7,8,30,6,1,0,7,3,30,4,0,0,4,1,-15,3,1
2,4,13,2,30,7,0,0,7,0,30,4,0,0,4,2,30,6,1,0,7,8,30,6,1,0,7,3,30,4,0,0,4,1,-15,3,1
2,1,17,4,30,10,4,0,14,4,30,6,0,0,6,0,30,4,10,0,14,3,30,6,8,0,14,4,30,4,0,0,4,1,-15,3,1
2,4,25,1,30,7,7,0,14,1,30,6,0,0,6,0,30,8,6,0,14,1,30,5,9,0,14,0,30,6,0,0,6,1,-15,3,1
2,1,29,0,30,6,8,0,14,5,30,12,0,0,12,0,30,5,9,0,14,0,30,1,13,0,14,1,30,9,0,0,9,1,-15,3,1
2,2,29,0,30,6,8,0,14,5,30,12,0,0,12,0,30,5,9,0,14,0,30,1,13,0,14,1,30,9,0,0,9,1,-15,3,1
2,3,29,0,30,6,8,0,14,5,30,12,0,0,12,0,30,5,9,0,14,0,30,1,13,0,14,1,30,9,0,0,9,1,-15,3,1
2,4,29,0,30,6,8,0,14,5,30,12,0,0,12,0,30,5,9,0,14,0,30,1,13,0,14,1,30,9,0,0,9,1,-15,3,1
2,4,32,0,30,6,3,0,9,4,30,2,0,0,2,2,30,9,0,0,9,1,30,3,6,0,9,4,30,2,0,0,2,1,-15,3,1
2,1,4,3,30,7,1,0,8,4,30,4,0,0,4,0,30,2,6,0,8,0,30,5,3,0,8,3,30,4,0,0,4,0,-27,3,0
2,4,8,3,30,7,0,0,7,3,30,2,0,0,2,1,30,2,5,0,7,0,30,4,3,0,7,0,30,3,0,0,3,0,-27,3,0
2,1,13,4,30,7,0,0,7,0,30,4,0,0,4,1,30,6,1,0,7,11,30,7,0,0,7,2,30,4,0,0,4,1,-15,3,1
2,0,27,2,30,4,11,0,15,4,30,1,1,0,2,0,30,6,9,0,15,3,30,5,10,0,15,2,30,6,0,0,6,1,-15,3,1
2,3,27,2,30,4,11,0,15,2,30,1,1,0,2,0,30,6,9,0,15,3,30,5,10,0,15,2,30,6,0,0,6,1,-15,3,1
2,4,27,2,30,4,11,0,15,2,30,1,1,0,2,0,30,6,9,0,15,3,30,5,10,0,15,2,30,6,0,0,6,1,-15,3,1
2,3,29,0,30,4,10,0,14,6,30,12,0,0,12,0,30,3,11,0,14,0,30,0,14,0,14,3,30,9,0,0,9,1,-15,3,1
2,3,31,7,30,8,4,0,12,4,30,8,0,0,8,3,30,10,2,0,12,0,30,3,9,0,12,0,30,2,4,0,6,1,-15,3,1
2,2,33,1,30,2,9,0,11,4,30,4,0,0,4,1,30,9,2,0,11,1,30,4,7,0,11,4,30,4,0,0,4,1,-15,3,1
2,3,33,1,30,2,9,0,11,4,30,4,0,0,4,1,30,9,2,0,11,1,30,4,7,0,11,4,30,4,0,0,4,1,-15,3,1
2,2,39,0,30,4,7,0,11,6,30,6,0,0,6,0,30,7,4,0,11,0,30,4,7,0,11,4,30,5,0,0,5,1,-15,3,1
2,3,45,0,30,3,10,0,13,9,30,10,0,0,10,0,30,0,13,0,13,0,30,4,9,0,13,8,30,5,0,0,5,1,-15,3,1
2,3,1,0,30,7,3,0,10,5,30,2,0,0,2,1,30,3,7,0,10,3,30,7,3,0,10,6,30,6,0,0,6,0,-27,3,0
2,4,13,2,30,5,2,0,7,0,30,4,0,0,4,2,30,6,1,0,7,10,30,6,1,0,7,4,30,4,0,0,4,1,-15,3,1
2,4,17,4,30,10,4,0,14,1,30,6,0,0,6,0,30,6,8,0,14,2,30,5,9,0,14,2,30,3,1,0,4,1,-15,3,1
2,3,21,0,30,5,5,0,10,3,30,6,0,0,6,0,30,3,7,0,10,2,30,4,6,0,10,3,30,4,0,0,4,1,-15,3,1
2,2,25,1,30,7,7,0,14,4,30,6,0,0,6,0,30,5,9,0,14,1,30,10,4,0,14,5,30,6,0,0,6,1,-15,3,1
2,4,25,1,30,7,7,0,14,4,30,6,0,0,6,0,30,5,9,0,14,1,30,10,4,0,14,5,30,6,0,0,6,1,-15,3,1
2,0,27,1,30,8,7,0,15,4,30,1,1,0,2,0,30,2,13,0,15,3,30,5,10,0,15,2,30,6,0,0,6,1,-15,3,1
2,1,27,1,30,8,7,0,15,4,30,1,1,0,2,0,30,2,13,0,15,3,30,5,10,0,15,2,30,6,0,0,6,1,-15,3,1
2,2,27,1,30,8,7,0,15,4,30,1,1,0,2,0,30,2,13,0,15,3,30,5,10,0,15,2,30,6,0,0,6,1,-15,3,1
2,3,3,6,30,9,2,0,11,3,30,7,1,0,8,4,30,2,9,0,11,2,30,2,9,0,11,1,30,2,5,0,7,0,-27,3,0
2,1,11,2,30,5,7,0,12,2,30,4,0,0,4,0,30,5,7,0,12,4,30,7,5,0,12,4,30,4,0,0,4,1,-15,3,1
2,2,11,2,30,5,7,0,12,2,30,4,0,0,4,0,30,5,7,0,12,4,30,7,5,0,12,4,30,4,0,0,4,1,-15,3,1
2,4,11,2,30,5,7,0,12,2,30,4,0,0,4,0,30,5,7,0,12,0,30,7,5,0,12,4,30,4,0,0,4,1,-15,3,1
2,3,17,4,30,13,1,0,14,2,30,6,0,0,6,0,30,7,7,0,14,1,30,2,12,0,14,1,30,4,0,0,4,1,-15,3,1
2,2,25,2,30,4,10,0,14,2,30,6,0,0,6,0,30,13,1,0,14,1,30,5,9,0,14,5,30,5,1,0,6,1,-15,3,1
2,1,27,1,30,5,10,0,15,1,30,1,1,0,2,0,30,7,8,0,15,0,30,6,9,0,15,2,30,6,0,0,6,1,-15,3,1
2,2,27,1,30,5,10,0,15,1,30,1,1,0,2,0,30,7,8,0,15,0,30,6,9,0,15,2,30,6,0,0,6,1,-15,3,1
2,3,29,0,30,8,6,0,14,5,30,7,5,0,12,0,30,3,11,0,14,0,30,3,11,0,14,5,30,9,0,0,9,1,-15,3,1
2,4,31,1,30,7,5,0,12,7,30,8,0,0,8,3,30,5,7,0,12,0,30,9,3,0,12,2,30,6,0,0,6,1,-15,3,1
2,0,47,0,30,0,14,0,14,7,30,4,0,0,4,0,30,7,7,0,14,6,30,5,9,0,14,7,30,7,0,0,7,1,-15,3,1
2,3,47,0,30,0,14,0,14,7,30,4,0,0,4,0,30,7,7,0,14,6,30,5,9,0,14,7,30,7,0,0,7,1,-15,3,1
2,1,5,0,30,2,3,0,5,3,30,1,3,0,4,0,30,0,5,0,5,0,30,2,3,0,5,0,30,0,2,0,2,0,-27,3,0
2,3,5,0,30,2,3,0,5,3,30,1,3,0,4,0,30,0,5,0,5,0,30,2,3,0,5,0,30,0,2,0,2,0,-27,3,0
2,4,11,2,30,4,8,0,12,2,30,4,0,0,4,3,30,4,8,0,12,5,30,2,10,0,12,0,30,3,1,0,4,1,-15,3,1
2,3,17,3,30,10,4,0,14,3,30,6,0,0,6,0,30,4,10,0,14,3,30,4,10,0,14,7,30,4,0,0,4,1,-15,3,1
2,1,19,0,30,3,10,0,13,2,30,7,1,0,8,0,30,4,9,0,13,0,30,3,10,0,13,1,30,9,0,0,9,1,-15,3,1
2,2,25,2,30,2,12,0,14,1,30,6,0,0,6,0,30,12,2,0,14,1,30,5,9,0,14,4,30,4,2,0,6,1,-15,3,1
2,3,25,2,30,2,12,0,14,1,30,6,0,0,6,0,30,12,2,0,14,1,30,5,9,0,14,4,30,4,2,0,6,1,-15,3,1
2,4,25,2,30,2,12,0,14,1,30,6,0,0,6,0,30,12,2,0,14,1,30,5,9,0,14,4,30,4,2,0,6,1,-15,3,1
2,2,27,1,30,4,11,0,15,4,30,1,1,0,2,0,30,6,9,0,15,0,30,3,12,0,15,4,30,6,0,0,6,1,-15,3,1
2,2,39,0,30,4,7,0,11,8,30,6,0,0,6,0,30,4,7,0,11,1,30,7,4,0,11,5,30,5,0,0,5,1,-15,3,1
2,2,45,0,30,8,5,0,13,11,30,10,0,0,10,0,30,0,13,0,13,0,30,4,9,0,13,8,30,5,0,0,5,1,-15,3,1
2,1,4,2,30,6,2,0,8,4,30,4,0,0,4,2,30,3,5,0,8,0,30,6,2,0,8,1,30,4,0,0,4,0,-27,3,0
2,1,13,2,30,5,2,0,7,0,30,4,0,0,4,5,30,7,0,0,7,5,30,5,2,0,7,5,30,4,0,0,4,1,-15,3,1
2,3,17,1,30,9,5,0,14,2,30,6,0,0,6,0,30,7,7,0,14,1,30,7,7,0,14,7,30,4,0,0,4,1,-15,3,1
2,2,19,0,30,5,8,0,13,1,30,5,3,0,8,0,30,6,7,0,13,1,30,2,11,0,13,1,30,9,0,0,9,1,-15,3,1
2,4,19,0,30,5,8,0,13,1,30,5,3,0,8,0,30,6,7,0,13,1,30,2,11,0,13,1,30,9,0,0,9,1,-15,3,1
2,3,21,2,30,9,1,0,10,4,30,5,1,0,6,1,30,3,7,0,10,3,30,6,4,0,10,1,30,4,0,0,4,1,-15,3,1
2,4,23,1,30,5,8,0,13,3,30,6,0,0,6,7,30,12,1,0,13,0,30,3,10,0,13,1,30,5,1,0,6,1,-15,3,1
2,4,27,1,30,6,9,0,15,0,30,1,1,0,2,0,30,11,4,0,15,2,30,4,11,0,15,3,30,6,0,0,6,1,-15,3,1
2,4,35,1,30,9,4,0,13,4,30,2,0,0,2,1,30,2,11,0,13,0,30,1,12,0,13,3,30,7,1,0,8,1,-15,3,1
2,0,39,0,30,1,10,0,11,7,30,6,0,0,6,0,30,4,7,0,11,4,30,4,7,0,11,4,30,5,0,0,5,1,-15,3,1
2,2,39,0,30,1,10,0,11,7,30,6,0,0,6,0,30,4,7,0,11,4,30,4,7,0,11,4,30,5,0,0,5,1,-15,3,1
2,3,39,0,30,1,10,0,11,7,30,6,0,0,6,0,30,4,7,0,11,4,30,4,7,0,11,4,30,5,0,0,5,1,-15,3,1
2,4,39,0,30,1,10,0,11,7,30,6,0,0,6,0,30,4,7,0,11,4,30,4,7,0,11,4,30,5,0,0,5,1,-15,3,1
2,3,43,0,30,11,3,0,14,8,30,6,0,0,6,0,30,4,10,0,14,1,30,3,11,0,14,4,30,5,0,0,5,1,-15,3,1
2,4,43,0,30,11,3,0,14,8,30,6,0,0,6,0,30,4,10,0,14,1,30,3,11,0,14,4,30,5,0,0,5,1,-15,3,1
2,0,5,1,30,2,3,0,5,3,30,1,3,0,4,0,30,0,5,0,5,0,30,1,4,0,5,0,30,2,0,0,2,0,-27,3,0
2,2,5,1,30,2,3,0,5,3,30,1,3,0,4,0,30,0,5,0,5,0,30,1,4,0,5,0,30,2,0,0,2,0,-27,3,0
2,3,5,1,30,2,3,0,5,3,30,1,3,0,4,0,30,0,5,0,5,0,30,1,4,0,5,0,30,2,0,0,2,0,-27,3,0
2,4,8,0,30,7,0,0,7,3,30,2,0,0,2,1,30,6,1,0,7,0,30,7,0,0,7,2,30,3,0,0,3,0,-27,3,0
2,0,13,1,30,7,0,0,7,1,30,4,0,0,4,2,30,5,2,0,7,7,30,6,1,0,7,4,30,4,0,0,4,1,-15,3,1
2,4,13,1,30,7,0,0,7,1,30,4,0,0,4,2,30,5,2,0,7,7,30,6,1,0,7,4,30,4,0,0,4,1,-15,3,1
2,1,23,1,30,3,10,0,13,2,30,6,0,0,6,7,30,11,2,0,13,0,30,7,6,0,13,4,30,6,0,0,6,1,-15,3,1
2,4,25,1,30,10,4,0,14,1,30,6,0,0,6,0,30,9,5,0,14,1,30,6,8,0,14,5,30,4,2,0,6,1,-15,3,1
2,4,37,1,30,4,7,0,11,6,30,8,0,0,8,2,30,10,1,0,11,4,30,5,6,0,11,5,30,6,0,0,6,1,-15,3,1
2,4,38,0,30,2,8,0,10,7,30,6,0,0,6,0,30,3,7,0,10,0,30,6,4,0,10,5,30,6,0,0,6,1,-15,3,1
2,0,4,2,30,7,1,0,8,5,30,4,0,0,4,2,30,1,7,0,8,3,30,8,0,0,8,2,30,2,2,0,4,0,-27,3,0
2,1,4,2,30,7,1,0,8,5,30,4,0,0,4,2,30,1,7,0,8,3,30,8,0,0,8,2,30,2,2,0,4,0,-27,3,0
2,2,4,2,30,7,1,0,8,5,30,4,0,0,4,2,30,1,7,0,8,3,30,8,0,0,8,2,30,2,2,0,4,0,-27,3,0
2,3,4,2,30,7,1,0,8,5,30,4,0,0,4,2,30,1,7,0,8,3,30,8,0,0,8,2,30,2,2,0,4,0,-27,3,0
2,4,4,2,30,7,1,0,8,5,30,4,0,0,4,2,30,1,7,0,8,3,30,8,0,0,8,2,30,2,2,0,4,0,-27,3,0
2,1,17,5,30,11,3,0,14,3,30,6,0,0,6,0,30,5,9,0,14,1,30,6,8,0,14,1,30,2,2,0,4,1,-15,3,1
2,2,17,5,30,11,3,0,14,3,30,6,0,0,6,0,30,5,9,0,14,1,30,6,8,0,14,1,30,2,2,0,4,1,-15,3,1
2,1,19,0,30,5,8,0,13,1,30,4,4,0,8,0,30,6,7,0,13,7,30,5,8,0,13,2,30,8,1,0,9,1,-15,3,1
2,2,19,0,30,5,8,0,13,1,30,4,4,0,8,0,30,6,7,0,13,7,30,5,8,0,13,2,30,8,1,0,9,1,-15,3,1
2,1,21,1,30,6,4,0,10,3,30,4,2,0,6,0,30,3,7,0,10,6,30,4,6,0,10,1,30,4,0,0,4,1,-15,3,1
2,2,21,1,30,6,4,0,10,3,30,4,2,0,6,0,30,3,7,0,10,6,30,4,6,0,10,1,30,4,0,0,4,1,-15,3,1
2,4,23,2,30,9,4,0,13,1,30,6,0,0,6,3,30,10,3,0,13,0,30,4,9,0,13,1,30,6,0,0,6,1,-15,3,1
2,2,25,3,30,5,9,0,14,5,30,6,0,0,6,0,30,9,5,0,14,1,30,5,9,0,14,3,30,5,1,0,6,1,-15,3,1
2,3,25,3,30,5,9,0,14,5,30,6,0,0,6,0,30,9,5,0,14,1,30,5,9,0,14,3,30,5,1,0,6,1,-15,3,1
2,4,25,3,30,5,9,0,14,5,30,6,0,0,6,0,30,9,5,0,14,1,30,5,9,0,14,3,30,5,1,0,6,1,-15,3,1
2,3,26,2,30,9,0,0,9,5,30,4,0,0,4,0,30,1,8,0,9,0,30,2,7,0,9,6,30,3,0,0,3,1,-15,3,1
2,4,26,2,30,9,0,0,9,5,30,4,0,0,4,0,30,1,8,0,9,0,30,2,7,0,9,6,30,3,0,0,3,1,-15,3,1
2,0,27,1,30,3,12,0,15,2,30,2,0,0,2,0,30,8,7,0,15,0,30,5,10,0,15,3,30,6,0,0,6,1,-15,3,1
2,2,27,1,30,3,12,0,15,2,30,2,0,0,2,0,30,8,7,0,15,0,30,5,10,0,15,3,30,6,0,0,6,1,-15,3,1
2,2,29,0,30,6,8,0,14,6,30,9,3,0,12,0,30,3,11,0,14,0,30,1,13,0,14,3,30,9,0,0,9,1,-15,3,1
2,3,29,0,30,6,8,0,14,6,30,9,3,0,12,0,30,3,11,0,14,0,30,1,13,0,14,3,30,9,0,0,9,1,-15,3,1
2,3,13,2,30,7,0,0,7,0,30,4,0,0,4,2,30,6,1,0,7,5,30,5,2,0,7,0,30,4,0,0,4,1,-15,3,1
2,4,13,2,30,7,0,0,7,0,30,4,0,0,4,2,30,6,1,0,7,5,30,5,2,0,7,0,30,4,0,0,4,1,-15,3,1
2,0,19,0,30,3,10,0,13,2,30,6,2,0,8,0,30,4,9,0,13,7,30,4,9,0,13,2,30,9,0,0,9,1,-15,3,1
2,0,27,1,30,4,11,0,15,2,30,2,0,0,2,0,30,6,9,0,15,1,30,5,10,0,15,5,30,6,0,0,6,1,-15,3,1
2,1,29,0,30,6,8,0,14,5,30,11,1,0,12,0,30,3,11,0,14,0,30,1,13,0,14,3,30,9,0,0,9,1,-15,3,1
2,4,29,0,30,6,8,0,14,5,30,11,1,0,12,0,30,3,11,0,14,0,30,1,13,0,14,3,30,9,0,0,9,1,-15,3,1
2,3,31,4,30,7,5,0,12,4,30,8,0,0,8,3,30,10,2,0,12,0,30,3,9,0,12,0,30,3,3,0,6,1,-15,3,1
2,4,8,2,30,7,0,0,7,4,30,2,0,0,2,0,30,3,4,0,7,0,30,6,1,0,7,0,30,3,0,0,3,0,-27,3,0
2,4,19,0,30,3,10,0,13,0,30,5,3,0,8,0,30,6,7,0,13,4,30,4,9,0,13,1,30,9,0,0,9,1,-15,3,1
2,1,21,1,30,8,2,0,10,3,30,6,0,0,6,1,30,3,7,0,10,6,30,4,6,0,10,3,30,4,0,0,4,1,-15,3,1
2,2,21,1,30,8,2,0,10,3,30,6,0,0,6,1,30,3,7,0,10,6,30,4,6,0,10,3,30,4,0,0,4,1,-15,3,1
2,3,21,1,30,8,2,0,10,3,30,6,0,0,6,1,30,3,7,0,10,6,30,4,6,0,10,3,30,4,0,0,4,1,-15,3,1
2,2,27,1,30,4,11,0,15,4,30,1,1,0,2,0,30,3,12,0,15,0,30,4,11,0,15,5,30,6,0,0,6,1,-15,3,1
2,0,29,0,30,4,10,0,14,6,30,10,2,0,12,0,30,4,10,0,14,0,30,2,12,0,14,2,30,9,0,0,9,1,-15,3,1
2,2,29,0,30,4,10,0,14,6,30,10,2,0,12,0,30,4,10,0,14,0,30,2,12,0,14,0,30,9,0,0,9,1,-15,3,1
2,3,29,0,30,4,10,0,14,6,30,10,2,0,12,0,30,4,10,0,14,0,30,2,12,0,14,0,30,9,0,0,9,1,-15,3,1
2,1,37,0,30,6,5,0,11,4,30,8,0,0,8,2,30,11,0,0,11,4,30,3,8,0,11,3,30,6,0,0,6,1,-15,3,1
2,2,37,0,30,6,5,0,11,4,30,8,0,0,8,2,30,11,0,0,11,4,30,3,8,0,11,3,30,6,0,0,6,1,-15,3,1
2,4,39,0,30,2,9,0,11,6,30,6,0,0,6,0,30,4,7,0,11,0,30,2,9,0,11,6,30,5,0,0,5,1,-15,3,1
2,3,43,0,30,7,7,0,14,7,30,6,0,0,6,0,30,4,10,0,14,1,30,1,13,0,14,5,30,5,0,0,5,1,-15,3,1
2,3,4,10,30,8,0,0,8,4,30,2,2,0,4,0,30,6,2,0,8,0,30,3,5,0,8,1,30,3,1,0,4,0,-27,3,0
2,0,5,3,30,5,0,0,5,3,30,3,1,0,4,0,30,0,5,0,5,0,30,1,4,0,5,0,30,0,2,0,2,0,-27,3,0
2,1,5,3,30,5,0,0,5,3,30,3,1,0,4,0,30,0,5,0,5,0,30,1,4,0,5,0,30,0,2,0,2,0,-27,3,0
2,2,5,3,30,5,0,0,5,3,30,3,1,0,4,0,30,0,5,0,5,0,30,1,4,0,5,0,30,0,2,0,2,0,-27,3,0
2,4,5,3,30,5,0,0,5,3,30,3,1,0,4,0,30,0,5,0,5,0,30,1,4,0,5,0,30,0,2,0,2,0,-27,3,0
2,4,13,0,30,7,0,0,7,1,30,4,0,0,4,2,30,6,1,0,7,2,30,6,1,0,7,0,30,4,0,0,4,1,-15,3,1
2,1,23,2,30,5,8,0,13,2,30,6,0,0,6,8,30,13,0,0,13,0,30,5,8,0,13,1,30,5,1,0,6,1,-15,3,1
2,0,27,1,30,8,7,0,15,2,30,2,0,0,2,0,30,3,12,0,15,1,30,6,9,0,15,5,30,6,0,0,6,1,-15,3,1
2,1,27,1,30,8,7,0,15,2,30,2,0,0,2,0,30,3,12,0,15,1,30,6,9,0,15,5,30,6,0,0,6,1,-15,3,1
2,2,27,1,30,8,7,0,15,2,30,2,0,0,2,0,30,3,12,0,15,1,30,6,9,0,15,5,30,6,0,0,6,1,-15,3,1
2,1,29,0,30,8,6,0,14,5,30,11,1,0,12,0,30,3,11,0,14,0,30,1,13,0,14,1,30,9,0,0,9,1,-15,3,1
2,2,29,0,30,8,6,0,14,5,30,11,1,0,12,0,30,3,11,0,14,0,30,1,13,0,14,1,30,9,0,0,9,1,-15,3,1
2,4,32,0,30,4,5,0,9,4,30,2,0,0,2,0,30,7,2,0,9,1,30,3,6,0,9,4,30,2,0,0,2,1,-15,3,1
2,1,33,1,30,2,9,0,11,5,30,4,0,0,4,3,30,9,2,0,11,0,30,3,8,0,11,7,30,4,0,0,4,1,-15,3,1
2,2,33,1,30,2,9,0,11,5,30,4,0,0,4,3,30,9,2,0,11,0,30,3,8,0,11,7,30,4,0,0,4,1,-15,3,1
2,3,33,1,30,2,9,0,11,5,30,4,0,0,4,3,30,9,2,0,11,0,30,3,8,0,11,7,30,4,0,0,4,1,-15,3,1
2,0,13,4,30,7,0,0,7,1,30,4,0,0,4,4,30,7,0,0,7,8,30,6,1,0,7,5,30,4,0,0,4,1,-15,3,1
2,2,13,0,30,7,0,0,7,1,30,4,0,0,4,4,30,7,0,0,7,8,30,6,1,0,7,5,30,4,0,0,4,1,-15,3,1
2,3,17,3,30,10,4,0,14,2,30,6,0,0,6,0,30,9,5,0,14,1,30,8,6,0,14,4,30,4,0,0,4,1,-15,3,1
2,4,17,3,30,10,4,0,14,2,30,6,0,0,6,0,30,9,5,0,14,1,30,8,6,0,14,4,30,4,0,0,4,1,-15,3,1
2,4,23,1,30,6,7,0,13,1,30,6,0,0,6,7,30,13,0,0,13,1,30,4,9,0,13,3,30,6,0,0,6,1,-15,3,1
2,2,27,1,30,5,10,0,15,4,30,2,0,0,2,0,30,3,12,0,15,5,30,7,8,0,15,4,30,6,0,0,6,1,-15,3,1
2,3,27,1,30,5,10,0,15,4,30,2,0,0,2,0,30,3,12,0,15,5,30,7,8,0,15,4,30,6,0,0,6,1,-15,3,1
2,2,29,0,30,8,6,0,14,6,30,12,0,0,12,0,30,3,11,0,14,0,30,1,13,0,14,2,30,9,0,0,9,1,-15,3,1
2,3,29,0,30,8,6,0,14,6,30,12,0,0,12,0,30,3,11,0,14,0,30,1,13,0,14,2,30,9,0,0,9,1,-15,3,1
2,4,29,0,30,8,6,0,14,6,30,12,0,0,12,0,30,3,11,0,14,0,30,1,13,0,14,2,30,9,0,0,9,1,-15,3,1
2,3,32,0,30,5,4,0,9,4,30,2,0,0,2,1,30,9,0,0,9,1,30,3,6,0,9,2,30,2,0,0,2,1,-15,3,1
2,3,6,0,30,7,2,0,9,4,30,2,0,0,2,0,30,2,7,0,9,0,30,5,4,0,9,4,30,5,0,0,5,0,-27,3,0
2,4,6,0,30,7,2,0,9,4,30,2,0,0,2,0,30,2,7,0,9,0,30,5,4,0,9,4,30,5,0,0,5,0,-27,3,0
2,4,11,1,30,4,8,0,12,0,30,4,0,0,4,0,30,9,3,0,12,6,30,5,7,0,12,0,30,4,0,0,4,1,-15,3,1
2,4,13,2,30,7,0,0,7,0,30,4,0,0,4,1,30,6,1,0,7,8,30,7,0,0,7,2,30,4,0,0,4,1,-15,3,1
2,3,22,1,30,8,0,0,8,2,30,2,0,0,2,0,30,5,3,0,8,0,30,4,4,0,8,2,30,2,2,0,4,1,-15,3,1
2,3,23,1,30,4,9,0,13,3,30,6,0,0,6,6,30,10,3,0,13,0,30,7,6,0,13,3,30,6,0,0,6,1,-15,3,1
2,4,25,1,30,7,7,0,14,5,30,6,0,0,6,0,30,5,9,0,14,1,30,5,9,0,14,5,30,5,1,0,6,1,-15,3,1
2,3,27,1,30,4,11,0,15,5,30,2,0,0,2,0,30,4,11,0,15,0,30,4,11,0,15,4,30,6,0,0,6,1,-15,3,1
2,3,47,0,30,1,13,0,14,8,30,4,0,0,4,0,30,3,11,0,14,0,30,6,8,0,14,6,30,7,0,0,7,1,-15,3,1
2,1,13,2,30,6,1,0,7,0,30,4,0,0,4,7,30,6,1,0,7,9,30,7,0,0,7,4,30,4,0,0,4,1,-15,3,1
2,3,19,0,30,2,11,0,13,2,30,5,3,0,8,0,30,5,8,0,13,0,30,5,8,0,13,0,30,7,2,0,9,1,-15,3,1
2,4,29,0,30,4,10,0,14,3,30,12,0,0,12,0,30,8,6,0,14,1,30,3,11,0,14,0,30,9,0,0,9,1,-15,3,1
2,2,35,0,30,9,4,0,13,6,30,2,0,0,2,5,30,2,11,0,13,0,30,1,12,0,13,5,30,7,1,0,8,1,-15,3,1
2,3,35,0,30,9,4,0,13,6,30,2,0,0,2,5,30,2,11,0,13,0,30,1,12,0,13,5,30,7,1,0,8,1,-15,3,1
2,1,37,0,30,5,6,0,11,5,30,8,0,0,8,1,30,11,0,0,11,6,30,3,8,0,11,4,30,6,0,0,6,1,-15,3,1
2,2,37,0,30,5,6,0,11,5,30,8,0,0,8,1,30,11,0,0,11,6,30,3,8,0,11,4,30,6,0,0,6,1,-15,3,1
2,3,37,0,30,5,6,0,11,5,30,8,0,0,8,1,30,11,0,0,11,6,30,3,8,0,11,4,30,6,0,0,6,1,-15,3,1
2,1,4,2,30,7,1,0,8,4,30,4,0,0,4,0,30,4,4,0,8,2,30,6,2,0,8,1,30,2,2,0,4,0,-27,3,0
2,2,4,2,30,7,1,0,8,4,30,4,0,0,4,0,30,4,4,0,8,2,30,6,2,0,8,1,30,2,2,0,4,0,-27,3,0
2,3,4,2,30,7,1,0,8,4,30,4,0,0,4,0,30,4,4,0,8,2,30,6,2,0,8,1,30,2,2,0,4,0,-27,3,0
2,2,6,0,30,8,1,0,9,4,30,2,0,0,2,0,30,2,7,0,9,1,30,4,5,0,9,0,30,4,1,0,5,0,-27,3,0
2,3,11,1,30,4,8,0,12,1,30,4,0,0,4,0,30,6,6,0,12,3,30,3,9,0,12,0,30,4,0,0,4,1,-15,3,1
2,4,11,1,30,4,8,0,12,1,30,4,0,0,4,0,30,6,6,0,12,3,30,3,9,0,12,0,30,4,0,0,4,1,-15,3,1
2,0,13,4,30,7,0,0,7,3,30,4,0,0,4,6,30,5,2,0,7,5,30,6,1,0,7,0,30,4,0,0,4,1,-15,3,1
2,1,13,4,30,7,0,0,7,3,30,4,0,0,4,6,30,5,2,0,7,5,30,6,1,0,7,0,30,4,0,0,4,1,-15,3,1
2,2,13,4,30,7,0,0,7,3,30,4,0,0,4,6,30,5,2,0,7,5,30,6,1,0,7,0,30,4,0,0,4,1,-15,3,1
2,4,13,4,30,7,0,0,7,3,30,4,0,0,4,6,30,5,2,0,7,5,30,6,1,0,7,0,30,4,0,0,4,1,-15,3,1
2,2,17,3,30,8,6,0,14,3,30,6,0,0,6,0,30,4,10,0,14,5,30,5,9,0,14,7,30,4,0,0,4,1,-15,3,1
2,3,17,3,30,8,6,0,14,3,30,6,0,0,6,0,30,4,10,0,14,5,30,5,9,0,14,7,30,4,0,0,4,1,-15,3,1
2,2,25,2,30,6,8,0,14,4,30,6,0,0,6,0,30,6,8,0,14,1,30,4,10,0,14,5,30,5,1,0,6,1,-15,3,1
2,0,27,1,30,4,11,0,15,3,30,2,0,0,2,0,30,6,9,0,15,0,30,3,12,0,15,4,30,6,0,0,6,1,-15,3,1
2,2,31,5,30,8,4,0,12,4,30,8,0,0,8,3,30,10,2,0,12,0,30,3,9,0,12,0,30,2,4,0,6,1,-15,3,1
2,4,39,0,30,0,11,0,11,5,30,6,0,0,6,0,30,6,5,0,11,2,30,2,9,0,11,6,30,5,0,0,5,1,-15,3,1
2,0,4,2,30,7,1,0,8,5,30,4,0,0,4,0,30,2,6,0,8,0,30,5,3,0,8,3,30,4,0,0,4,0,-27,3,0
2,3,4,2,30,7,1,0,8,5,30,4,0,0,4,0,30,2,6,0,8,0,30,5,3,0,8,3,30,4,0,0,4,0,-27,3,0
2,3,13,9,30,7,0,0,7,1,30,4,0,0,4,2,30,6,1,0,7,0,30,6,1,0,7,8,30,4,0,0,4,1,-15,3,1
2,0,21,3,30,9,1,0,10,4,30,6,0,0,6,1,30,3,7,0,10,5,30,4,6,0,10,3,30,4,0,0,4,1,-15,3,1
2,3,21,3,30,9,1,0,10,4,30,6,0,0,6,0,30,3,7,0,10,5,30,4,6,0,10,3,30,4,0,0,4,1,-15,3,1
2,4,21,3,30,9,1,0,10,4,30,6,0,0,6,0,30,3,7,0,10,5,30,4,6,0,10,3,30,4,0,0,4,1,-15,3,1
2,1,25,4,30,7,7,0,14,2,30,6,0,0,6,0,30,9,5,0,14,1,30,5,9,0,14,3,30,5,1,0,6,1,-15,3,1
2,3,36,0,30,3,6,0,9,5,30,2,0,0,2,5,30,6,3,0,9,1,30,5,4,0,9,9,30,3,0,0,3,1,-15,3,1
2,3,39,2,30,3,8,0,11,6,30,6,0,0,6,0,30,5,6,0,11,0,30,2,9,0,11,6,30,2,3,0,5,1,-15,3,1
2,2,11,0,30,1,3,0,4,0,30,0,0,0,0,0,30,2,2,0,4,3,30,2,2,0,4,1,30,1,0,0,1,1,-15,3,1
2,4,11,0,30,1,3,0,4,0,30,0,0,0,0,0,30,2,2,0,4,3,30,2,2,0,4,1,30,1,0,0,1,1,-15,3,1
2,2,13,1,30,3,0,0,3,0,30,2,0,0,2,0,30,2,1,0,3,9,30,3,0,0,3,6,30,2,0,0,2,1,-15,3,1
2,3,13,3,30,6,1,0,7,0,30,4,0,0,4,3,30,5,2,0,7,5,30,7,0,0,7,8,30,4,0,0,4,1,-15,3,1
2,1,17,4,30,9,5,0,14,3,30,6,0,0,6,0,30,6,8,0,14,0,30,8,6,0,14,5,30,4,0,0,4,1,-15,3,1
2,3,17,4,30,9,5,0,14,3,30,6,0,0,6,0,30,6,8,0,14,0,30,8,6,0,14,4,30,4,0,0,4,1,-15,3,1
2,3,19,0,30,3,10,0,13,2,30,6,2,0,8,0,30,7,6,0,13,0,30,3,10,0,13,1,30,7,2,0,9,1,-15,3,1
2,4,21,1,30,7,3,0,10,3,30,5,1,0,6,0,30,4,6,0,10,5,30,5,5,0,10,3,30,4,0,0,4,1,-15,3,1
2,0,27,1,30,5,10,0,15,3,30,2,0,0,2,0,30,9,6,0,15,2,30,4,11,0,15,0,30,6,0,0,6,1,-15,3,1
2,1,27,1,30,5,10,0,15,3,30,2,0,0,2,0,30,9,6,0,15,2,30,4,11,0,15,0,30,6,0,0,6,1,-15,3,1
2,2,27,1,30,5,10,0,15,3,30,2,0,0,2,0,30,9,6,0,15,2,30,4,11,0,15,0,30,6,0,0,6,1,-15,3,1
2,3,27,1,30,5,10,0,15,3,30,2,0,0,2,0,30,9,6,0,15,2,30,4,11,0,15,0,30,6,0,0,6,1,-15,3,1
2,2,31,5,30,6,6,0,12,4,30,8,0,0,8,4,30,12,0,0,12,0,30,3,9,0,12,1,30,2,4,0,6,1,-15,3,1
2,2,33,1,30,2,9,0,11,6,30,4,0,0,4,0,30,6,5,0,11,0,30,7,4,0,11,8,30,4,0,0,4,1,-15,3,1
2,2,38,0,30,4,6,0,10,8,30,6,0,0,6,0,30,1,9,0,10,0,30,5,5,0,10,7,30,6,0,0,6,1,-15,3,1
2,0,39,0,30,2,9,0,11,7,30,6,0,0,6,7,30,7,4,0,11,0,30,2,9,0,11,2,30,5,0,0,5,1,-15,3,1
2,3,39,0,30,2,9,0,11,7,30,6,0,0,6,7,30,7,4,0,11,0,30,2,9,0,11,2,30,5,0,0,5,1,-15,3,1
2,2,6,1,30,7,2,0,9,4,30,2,0,0,2,0,30,2,7,0,9,1,30,4,5,0,9,1,30,5,0,0,5,0,-27,3,0
2,3,8,0,30,7,0,0,7,4,30,2,0,0,2,1,30,3,4,0,7,1,30,7,0,0,7,1,30,3,0,0,3,0,-27,3,0
2,1,9,2,30,4,0,0,4,3,30,2,0,0,2,3,30,2,2,0,4,0,30,2,2,0,4,1,30,1,0,0,1,0,-27,3,0
2,2,9,2,30,4,0,0,4,3,30,2,0,0,2,3,30,2,2,0,4,0,30,2,2,0,4,1,30,1,0,0,1,0,-27,3,0
2,3,9,2,30,4,0,0,4,3,30,2,0,0,2,3,30,2,2,0,4,0,30,2,2,0,4,1,30,1,0,0,1,0,-27,3,0
2,4,13,1,30,6,1,0,7,0,30,4,0,0,4,5,30,7,0,0,7,8,30,4,3,0,7,3,30,4,0,0,4,1,-15,3,1
2,4,17,3,30,9,5,0,14,3,30,6,0,0,6,0,30,4,10,0,14,1,30,7,7,0,14,0,30,4,0,0,4,1,-15,3,1
2,4,19,0,30,3,10,0,13,0,30,8,0,0,8,0,30,10,3,0,13,1,30,4,9,0,13,0,30,7,2,0,9,1,-15,3,1
2,4,22,6,30,6,2,0,8,4,30,2,0,0,2,4,30,4,4,0,8,1,30,4,4,0,8,2,30,2,2,0,4,1,-15,3,1
2,2,25,1,30,3,11,0,14,3,30,6,0,0,6,0,30,12,2,0,14,1,30,6,8,0,14,5,30,4,2,0,6,1,-15,3,1
2,3,25,1,30,3,11,0,14,3,30,6,0,0,6,0,30,12,2,0,14,1,30,6,8,0,14,5,30,4,2,0,6,1,-15,3,1
2,4,25,1,30,3,11,0,14,3,30,6,0,0,6,0,30,12,2,0,14,1,30,6,8,0,14,5,30,4,2,0,6,1,-15,3,1
2,3,29,1,30,6,8,0,14,5,30,8,4,0,12,0,30,8,6,0,14,0,30,1,13,0,14,0,30,7,2,0,9,1,-15,3,1
2,4,29,1,30,6,8,0,14,5,30,8,4,0,12,0,30,8,6,0,14,0,30,1,13,0,14,0,30,7,2,0,9,1,-15,3,1
2,3,31,1,30,6,6,0,12,5,30,8,0,0,8,4,30,9,3,0,12,0,30,3,9,0,12,3,30,5,1,0,6,1,-15,3,1
2,2,47,0,30,1,13,0,14,7,30,4,0,0,4,0,30,8,6,0,14,0,30,5,9,0,14,9,30,7,0,0,7,1,-15,3,1
2,0,5,0,30,2,3,0,5,3,30,3,1,0,4,0,30,0,5,0,5,0,30,2,3,0,5,0,30,0,2,0,2,0,-27,3,0
2,1,13,2,30,7,0,0,7,0,30,4,0,0,4,2,30,7,0,0,7,6,30,6,1,0,7,6,30,4,0,0,4,1,-15,3,1
2,2,17,3,30,9,5,0,14,2,30,6,0,0,6,0,30,6,8,0,14,1,30,5,9,0,14,5,30,4,0,0,4,1,-15,3,1
2,3,17,3,30,9,5,0,14,2,30,6,0,0,6,0,30,6,8,0,14,1,30,5,9,0,14,5,30,4,0,0,4,1,-15,3,1
2,4,17,3,30,9,5,0,14,2,30,6,0,0,6,0,30,6,8,0,14,1,30,5,9,0,14,5,30,4,0,0,4,1,-15,3,1
2,1,25,3,30,4,10,0,14,6,30,6,0,0,6,0,30,7,7,0,14,1,30,5,9,0,14,5,30,5,1,0,6,1,-15,3,1
2,2,25,3,30,4,10,0,14,6,30,6,0,0,6,0,30,7,7,0,14,1,30,5,9,0,14,5,30,5,1,0,6,1,-15,3,1
2,3,25,3,30,4,10,0,14,6,30,6,0,0,6,0,30,7,7,0,14,1,30,5,9,0,14,5,30,5,1,0,6,1,-15,3,1
2,4,27,1,30,7,8,0,15,0,30,2,0,0,2,0,30,9,6,0,15,1,30,4,11,0,15,0,30,4,2,0,6,1,-15,3,1
2,2,29,3,30,7,7,0,14,5,30,8,4,0,12,0,30,5,9,0,14,0,30,1,13,0,14,1,30,9,0,0,9,1,-15,3,1
2,3,29,3,30,7,7,0,14,5,30,8,4,0,12,0,30,5,9,0,14,0,30,1,13,0,14,1,30,9,0,0,9,1,-15,3,1
2,4,29,3,30,7,7,0,14,5,30,8,4,0,12,0,30,5,9,0,14,0,30,1,13,0,14,1,30,9,0,0,9,1,-15,3,1
2,3,35,0,30,10,3,0,13,4,30,2,0,0,2,1,30,2,11,0,13,2,30,1,12,0,13,6,30,8,0,0,8,1,-15,3,1
2,1,7,0,30,1,3,0,4,2,30,2,0,0,2,0,30,1,3,0,4,3,30,1,3,0,4,2,30,1,1,0,2,0,-27,3,0
2,3,7,0,30,1,3,0,4,2,30,2,0,0,2,0,30,1,3,0,4,3,30,1,3,0,4,2,30,1,1,0,2,0,-27,3,0
2,2,13,5,30,5,2,0,7,0,30,4,0,0,4,2,30,6,1,0,7,10,30,6,1,0,7,4,30,4,0,0,4,1,-15,3,1
2,4,13,5,30,5,2,0,7,0,30,4,0,0,4,2,30,6,1,0,7,10,30,6,1,0,7,4,30,4,0,0,4,1,-15,3,1
2,4,17,4,30,10,4,0,14,2,30,6,0,0,6,0,30,5,9,0,14,0,30,5,9,0,14,0,30,4,0,0,4,1,-15,3,1
2,1,18,1,30,8,0,0,8,2,30,4,0,0,4,3,30,1,7,0,8,4,30,3,5,0,8,0,30,3,2,0,5,1,-15,3,1
2,2,19,0,30,2,11,0,13,2,30,6,2,0,8,0,30,9,4,0,13,0,30,5,8,0,13,1,30,8,1,0,9,1,-15,3,1
2,2,25,1,30,7,7,0,14,0,30,6,0,0,6,0,30,12,2,0,14,1,30,4,10,0,14,1,30,6,0,0,6,1,-15,3,1
2,4,25,1,30,7,7,0,14,0,30,6,0,0,6,0,30,12,2,0,14,1,30,4,10,0,14,1,30,6,0,0,6,1,-15,3,1
2,0,27,1,30,4,11,0,15,4,30,2,0,0,2,0,30,2,13,0,15,0,30,5,10,0,15,7,30,6,0,0,6,1,-15,3,1
2,1,27,1,30,4,11,0,15,4,30,2,0,0,2,0,30,2,13,0,15,0,30,5,10,0,15,7,30,6,0,0,6,1,-15,3,1
2,2,27,1,30,4,11,0,15,4,30,2,0,0,2,0,30,2,13,0,15,0,30,5,10,0,15,7,30,6,0,0,6,1,-15,3,1
2,0,29,1,30,5,9,0,14,4,30,11,1,0,12,0,30,7,7,0,14,0,30,1,13,0,14,3,30,9,0,0,9,1,-15,3,1
2,1,29,1,30,5,9,0,14,4,30,11,1,0,12,0,30,7,7,0,14,0,30,1,13,0,14,3,30,9,0,0,9,1,-15,3,1
2,2,29,1,30,5,9,0,14,4,30,11,1,0,12,0,30,7,7,0,14,0,30,1,13,0,14,3,30,9,0,0,9,1,-15,3,1
2,0,33,5,30,4,7,0,11,5,30,4,0,0,4,4,30,10,1,0,11,0,30,3,8,0,11,4,30,4,0,0,4,1,-15,3,1
2,1,33,5,30,4,7,0,11,5,30,4,0,0,4,4,30,10,1,0,11,0,30,3,8,0,11,4,30,4,0,0,4,1,-15,3,1
2,4,35,0,30,6,7,0,13,6,30,2,0,0,2,1,30,2,11,0,13,1,30,2,11,0,13,0,30,8,0,0,8,1,-15,3,1
2,3,39,0,30,6,5,0,11,6,30,6,0,0,6,0,30,6,5,0,11,0,30,4,7,0,11,3,30,5,0,0,5,1,-15,3,1
2,4,39,0,30,6,5,0,11,6,30,6,0,0,6,0,30,6,5,0,11,0,30,4,7,0,11,3,30,5,0,0,5,1,-15,3,1
2,3,11,3,30,5,7,0,12,2,30,4,0,0,4,0,30,4,8,0,12,6,30,6,6,0,12,5,30,4,0,0,4,1,-15,3,1
2,2,13,1,30,5,2,0,7,1,30,4,0,0,4,2,30,6,1,0,7,7,30,6,1,0,7,5,30,4,0,0,4,1,-15,3,1
2,3,15,1,30,5,8,0,13,1,30,6,0,0,6,0,30,4,9,0,13,1,30,7,6,0,13,2,30,8,1,0,9,1,-15,3,1
2,1,17,4,30,11,3,0,14,3,30,6,0,0,6,0,30,5,9,0,14,1,30,5,9,0,14,4,30,4,0,0,4,1,-15,3,1
2,2,17,4,30,11,3,0,14,3,30,6,0,0,6,0,30,5,9,0,14,1,30,5,9,0,14,4,30,4,0,0,4,1,-15,3,1
2,4,17,4,30,11,3,0,14,3,30,6,0,0,6,0,30,5,9,0,14,1,30,5,9,0,14,4,30,4,0,0,4,1,-15,3,1
2,2,19,0,30,3,10,0,13,2,30,6,2,0,8,0,30,7,6,0,13,5,30,4,9,0,13,3,30,9,0,0,9,1,-15,3,1
2,3,19,0,30,3,10,0,13,2,30,6,2,0,8,0,30,7,6,0,13,5,30,4,9,0,13,3,30,9,0,0,9,1,-15,3,1
2,4,19,0,30,3,10,0,13,2,30,6,2,0,8,0,30,7,6,0,13,5,30,4,9,0,13,3,30,9,0,0,9,1,-15,3,1
2,2,23,1,30,5,8,0,13,0,30,6,0,0,6,1,30,13,0,0,13,0,30,5,8,0,13,2,30,6,0,0,6,1,-15,3,1
2,2,25,1,30,6,8,0,14,6,30,6,0,0,6,0,30,3,11,0,14,4,30,7,7,0,14,4,30,6,0,0,6,1,-15,3,1
2,3,25,1,30,6,8,0,14,6,30,6,0,0,6,0,30,3,11,0,14,4,30,7,7,0,14,4,30,6,0,0,6,1,-15,3,1
2,1,27,1,30,9,6,0,15,2,30,2,0,0,2,0,30,12,3,0,15,0,30,3,12,0,15,1,30,2,4,0,6,1,-15,3,1
2,3,27,1,30,9,6,0,15,2,30,2,0,0,2,0,30,12,3,0,15,0,30,3,12,0,15,1,30,2,4,0,6,1,-15,3,1
2,4,27,1,30,9,6,0,15,2,30,2,0,0,2,0,30,12,3,0,15,0,30,3,12,0,15,1,30,2,4,0,6,1,-15,3,1
2,3,31,2,30,7,5,0,12,3,30,8,0,0,8,3,30,11,1,0,12,0,30,3,9,0,12,2,30,6,0,0,6,1,-15,3,1
2,3,35,0,30,7,6,0,13,5,30,2,0,0,2,1,30,5,8,0,13,1,30,4,9,0,13,7,30,8,0,0,8,1,-15,3,1
2,0,4,2,30,4,4,0,8,5,30,4,0,0,4,0,30,1,7,0,8,0,30,7,1,0,8,4,30,4,0,0,4,0,-27,3,0
2,2,4,2,30,4,4,0,8,5,30,4,0,0,4,0,30,1,7,0,8,0,30,7,1,0,8,4,30,4,0,0,4,0,-27,3,0
2,3,17,2,30,10,4,0,14,3,30,6,0,0,6,0,30,3,11,0,14,4,30,7,7,0,14,1,30,3,1,0,4,1,-15,3,1
2,4,17,2,30,10,4,0,14,3,30,6,0,0,6,0,30,3,11,0,14,4,30,7,7,0,14,1,30,3,1,0,4,1,-15,3,1
2,2,25,1,30,6,8,0,14,4,30,6,0,0,6,0,30,9,5,0,14,1,30,5,9,0,14,3,30,5,1,0,6,1,-15,3,1
2,0,26,1,30,6,3,0,9,6,30,4,0,0,4,5,30,0,9,0,9,0,30,2,7,0,9,4,30,2,1,0,3,1,-15,3,1
2,2,27,1,30,4,11,0,15,4,30,2,0,0,2,0,30,7,8,0,15,0,30,8,7,0,15,2,30,2,4,0,6,1,-15,3,1
2,2,31,2,30,9,3,0,12,6,30,8,0,0,8,3,30,4,8,0,12,0,30,3,9,0,12,2,30,4,2,0,6,1,-15,3,1
2,3,31,2,30,9,3,0,12,6,30,8,0,0,8,3,30,4,8,0,12,0,30,3,9,0,12,2,30,4,2,0,6,1,-15,3,1
2,3,7,0,30,1,3,0,4,2,30,2,0,0,2,0,30,1,3,0,4,0,30,1,3,0,4,2,30,2,0,0,2,0,-27,3,0
2,1,11,3,30,4,8,0,12,1,30,4,0,0,4,0,30,6,6,0,12,2,30,7,5,0,12,5,30,4,0,0,4,1,-15,3,1
2,3,11,3,30,4,8,0,12,1,30,4,0,0,4,0,30,6,6,0,12,2,30,7,5,0,12,5,30,4,0,0,4,1,-15,3,1
2,2,13,1,30,7,0,0,7,0,30,4,0,0,4,3,30,6,1,0,7,14,30,5,2,0,7,1,30,4,0,0,4,1,-15,3,1
2,4,13,1,30,7,0,0,7,0,30,4,0,0,4,3,30,6,1,0,7,14,30,5,2,0,7,1,30,4,0,0,4,1,-15,3,1
2,1,17,4,30,10,4,0,14,4,30,6,0,0,6,0,30,5,9,0,14,1,30,8,6,0,14,4,30,4,0,0,4,1,-15,3,1
2,3,17,4,30,10,4,0,14,4,30,6,0,0,6,0,30,5,9,0,14,1,30,8,6,0,14,4,30,4,0,0,4,1,-15,3,1
2,2,25,1,30,9,5,0,14,3,30,6,0,0,6,0,30,7,7,0,14,0,30,5,9,0,14,6,30,5,1,0,6,1,-15,3,1
2,3,25,1,30,9,5,0,14,3,30,6,0,0,6,0,30,7,7,0,14,0,30,5,9,0,14,6,30,5,1,0,6,1,-15,3,1
2,0,27,1,30,3,12,0,15,3,30,1,1,0,2,0,30,7,8,0,15,1,30,5,10,0,15,4,30,6,0,0,6,1,-15,3,1
2,2,27,1,30,3,12,0,15,3,30,1,1,0,2,0,30,7,8,0,15,1,30,5,10,0,15,4,30,6,0,0,6,1,-15,3,1
2,3,29,2,30,8,6,0,14,5,30,7,5,0,12,0,30,3,11,0,14,0,30,0,14,0,14,4,30,9,0,0,9,1,-15,3,1
2,2,35,4,30,7,6,0,13,3,30,2,0,0,2,1,30,6,7,0,13,2,30,2,11,0,13,6,30,8,0,0,8,1,-15,3,1
2,4,19,0,30,2,11,0,13,3,30,8,0,0,8,0,30,5,8,0,13,0,30,5,8,0,13,3,30,9,0,0,9,1,-15,3,1
2,3,23,1,30,6,7,0,13,3,30,6,0,0,6,9,30,12,1,0,13,2,30,6,7,0,13,1,30,6,0,0,6,1,-15,3,1
2,4,23,1,30,6,7,0,13,3,30,6,0,0,6,9,30,12,1,0,13,2,30,6,7,0,13,1,30,6,0,0,6,1,-15,3,1
2,2,25,1,30,9,5,0,14,4,30,6,0,0,6,0,30,6,8,0,14,1,30,5,9,0,14,4,30,5,1,0,6,1,-15,3,1
2,0,27,1,30,3,12,0,15,3,30,2,0,0,2,0,30,4,11,0,15,2,30,3,12,0,15,3,30,6,0,0,6,1,-15,3,1
2,1,27,1,30,3,12,0,15,3,30,2,0,0,2,0,30,4,11,0,15,2,30,3,12,0,15,3,30,6,0,0,6,1,-15,3,1
2,4,31,3,30,8,4,0,12,4,30,8,0,0,8,3,30,10,2,0,12,0,30,3,9,0,12,0,30,2,4,0,6,1,-15,3,1
2,0,4,2,30,8,0,0,8,5,30,4,0,0,4,0,30,2,6,0,8,1,30,8,0,0,8,3,30,4,0,0,4,0,-27,3,0
2,1,4,2,30,8,0,0,8,5,30,4,0,0,4,0,30,2,6,0,8,1,30,8,0,0,8,3,30,4,0,0,4,0,-27,3,0
2,2,4,2,30,8,0,0,8,5,30,4,0,0,4,0,30,2,6,0,8,1,30,8,0,0,8,3,30,4,0,0,4,0,-27,3,0
2,2,13,11,30,5,2,0,7,3,30,4,0,0,4,2,30,7,0,0,7,6,30,7,0,0,7,0,30,4,0,0,4,1,-15,3,1
2,3,13,11,30,5,2,0,7,3,30,4,0,0,4,2,30,7,0,0,7,6,30,7,0,0,7,0,30,4,0,0,4,1,-15,3,1
2,4,13,11,30,5,2,0,7,3,30,4,0,0,4,2,30,7,0,0,7,6,30,7,0,0,7,0,30,4,0,0,4,1,-15,3,1
2,3,17,3,30,9,5,0,14,3,30,6,0,0,6,0,30,5,9,0,14,2,30,5,9,0,14,4,30,4,0,0,4,1,-15,3,1
2,3,19,0,30,3,10,0,13,0,30,6,2,0,8,0,30,9,4,0,13,5,30,4,9,0,13,0,30,7,2,0,9,1,-15,3,1
2,3,23,2,30,7,6,0,13,0,30,6,0,0,6,3,30,13,0,0,13,1,30,6,7,0,13,3,30,6,0,0,6,1,-15,3,1
2,4,25,1,30,6,8,0,14,4,30,6,0,0,6,0,30,4,10,0,14,1,30,4,10,0,14,4,30,5,1,0,6,1,-15,3,1
2,3,27,2,30,4,11,0,15,3,30,2,0,0,2,0,30,6,9,0,15,2,30,4,11,0,15,2,30,6,0,0,6,1,-15,3,1
2,4,27,2,30,4,11,0,15,3,30,2,0,0,2,0,30,6,9,0,15,2,30,4,11,0,15,2,30,6,0,0,6,1,-15,3,1
2,2,29,0,30,8,6,0,14,5,30,11,1,0,12,0,30,3,11,0,14,0,30,1,13,0,14,0,30,9,0,0,9,1,-15,3,1
2,3,29,0,30,8,6,0,14,5,30,11,1,0,12,0,30,3,11,0,14,0,30,1,13,0,14,0,30,9,0,0,9,1,-15,3,1
2,0,38,0,30,7,3,0,10,7,30,6,0,0,6,0,30,1,9,0,10,0,30,2,8,0,10,7,30,6,0,0,6,1,-15,3,1
2,3,38,0,30,7,3,0,10,7,30,6,0,0,6,0,30,1,9,0,10,0,30,2,8,0,10,7,30,6,0,0,6,1,-15,3,1
2,4,2,0,30,6,4,0,10,3,30,3,1,0,4,2,30,5,5,0,10,5,30,7,3,0,10,1,30,7,1,0,8,0,-27,3,0
2,2,4,2,30,5,3,0,8,5,30,2,2,0,4,0,30,1,7,0,8,0,30,7,1,0,8,0,30,4,0,0,4,0,-27,3,0
2,2,13,1,30,6,1,0,7,1,30,4,0,0,4,2,30,5,2,0,7,8,30,7,0,0,7,6,30,4,0,0,4,1,-15,3,1
2,0,19,0,30,5,8,0,13,2,30,3,5,0,8,0,30,4,9,0,13,11,30,6,7,0,13,1,30,9,0,0,9,1,-15,3,1
2,2,19,0,30,5,8,0,13,2,30,3,5,0,8,0,30,4,9,0,13,11,30,6,7,0,13,1,30,9,0,0,9,1,-15,3,1
2,4,19,0,30,5,8,0,13,2,30,3,5,0,8,0,30,4,9,0,13,11,30,6,7,0,13,1,30,9,0,0,9,1,-15,3,1
2,4,29,0,30,10,4,0,14,5,30,11,1,0,12,0,30,3,11,0,14,0,30,1,13,0,14,2,30,9,0,0,9,1,-15,3,1
2,2,35,0,30,8,5,0,13,4,30,2,0,0,2,1,30,6,7,0,13,0,30,2,11,0,13,6,30,8,0,0,8,1,-15,3,1
2,4,13,1,30,6,1,0,7,0,30,4,0,0,4,0,30,6,1,0,7,11,30,6,1,0,7,2,30,3,1,0,4,1,-15,3,1
2,2,17,3,30,10,4,0,14,3,30,6,0,0,6,0,30,5,9,0,14,0,30,7,7,0,14,1,30,4,0,0,4,1,-15,3,1
2,3,17,3,30,10,4,0,14,3,30,6,0,0,6,0,30,5,9,0,14,0,30,7,7,0,14,1,30,4,0,0,4,1,-15,3,1
2,4,17,3,30,10,4,0,14,3,30,6,0,0,6,0,30,5,9,0,14,0,30,7,7,0,14,1,30,4,0,0,4,1,-15,3,1
2,3,19,0,30,2,11,0,13,2,30,8,0,0,8,0,30,9,4,0,13,3,30,6,7,0,13,3,30,7,2,0,9,1,-15,3,1
2,2,25,1,30,8,6,0,14,5,30,6,0,0,6,0,30,7,7,0,14,1,30,6,8,0,14,5,30,5,1,0,6,1,-15,3,1
2,0,27,1,30,4,11,0,15,4,30,1,1,0,2,0,30,3,12,0,15,0,30,4,11,0,15,3,30,6,0,0,6,1,-15,3,1
2,1,27,1,30,4,11,0,15,4,30,1,1,0,2,0,30,3,12,0,15,0,30,4,11,0,15,3,30,6,0,0,6,1,-15,3,1
2,3,27,1,30,4,11,0,15,4,30,1,1,0,2,0,30,3,12,0,15,0,30,4,11,0,15,3,30,6,0,0,6,1,-15,3,1
2,4,29,0,30,7,7,0,14,5,30,12,0,0,12,0,30,5,9,0,14,0,30,0,14,0,14,0,30,9,0,0,9,1,-15,3,1
2,4,31,3,30,9,3,0,12,4,30,8,0,0,8,3,30,8,4,0,12,0,30,3,9,0,12,0,30,3,3,0,6,1,-15,3,1
2,2,1,1,30,8,2,0,10,4,30,2,0,0,2,1,30,4,6,0,10,6,30,6,4,0,10,6,30,6,0,0,6,0,-27,3,0
2,4,1,1,30,8,2,0,10,4,30,2,0,0,2,1,30,4,6,0,10,6,30,6,4,0,10,6,30,6,0,0,6,0,-27,3,0
2,1,5,0,30,1,4,0,5,3,30,1,3,0,4,0,30,1,4,0,5,0,30,1,4,0,5,0,30,1,1,0,2,0,-27,3,0
2,3,5,0,30,1,4,0,5,3,30,1,3,0,4,0,30,1,4,0,5,0,30,1,4,0,5,0,30,1,1,0,2,0,-27,3,0
2,3,8,3,30,7,0,0,7,4,30,2,0,0,2,2,30,5,2,0,7,0,30,4,3,0,7,6,30,3,0,0,3,0,-27,3,0
2,4,8,3,30,7,0,0,7,4,30,2,0,0,2,2,30,5,2,0,7,0,30,4,3,0,7,6,30,3,0,0,3,0,-27,3,0
2,2,11,0,30,3,9,0,12,0,30,4,0,0,4,0,30,7,5,0,12,8,30,5,7,0,12,0,30,4,0,0,4,1,-15,3,1
2,4,11,0,30,3,9,0,12,0,30,4,0,0,4,0,30,7,5,0,12,8,30,5,7,0,12,0,30,4,0,0,4,1,-15,3,1
2,1,13,3,30,6,1,0,7,0,30,4,0,0,4,5,30,7,0,0,7,5,30,6,1,0,7,5,30,4,0,0,4,1,-15,3,1
2,2,13,3,30,6,1,0,7,0,30,4,0,0,4,5,30,7,0,0,7,5,30,6,1,0,7,5,30,4,0,0,4,1,-15,3,1
2,3,17,2,30,9,5,0,14,3,30,6,0,0,6,0,30,6,8,0,14,2,30,6,8,0,14,3,30,4,0,0,4,1,-15,3,1
2,4,27,2,30,4,11,0,15,0,30,2,0,0,2,0,30,14,1,0,15,3,30,3,12,0,15,1,30,5,1,0,6,1,-15,3,1
2,3,35,1,30,9,4,0,13,2,30,2,0,0,2,1,30,5,8,0,13,2,30,1,12,0,13,3,30,8,0,0,8,1,-15,3,1
2,1,37,1,30,8,3,0,11,5,30,5,3,0,8,0,30,8,3,0,11,5,30,3,8,0,11,5,30,6,0,0,6,1,-15,3,1
2,2,37,1,30,8,3,0,11,5,30,5,3,0,8,0,30,8,3,0,11,5,30,3,8,0,11,5,30,6,0,0,6,1,-15,3,1
2,3,37,1,30,8,3,0,11,5,30,5,3,0,8,0,30,8,3,0,11,5,30,3,8,0,11,5,30,6,0,0,6,1,-15,3,1
2,4,37,1,30,8,3,0,11,5,30,5,3,0,8,0,30,8,3,0,11,5,30,3,8,0,11,5,30,6,0,0,6,1,-15,3,1
2,1,5,0,30,2,3,0,5,3,30,3,1,0,4,0,30,0,5,0,5,0,30,2,3,0,5,0,30,2,0,0,2,0,-27,3,0
2,3,5,0,30,2,3,0,5,3,30,3,1,0,4,0,30,0,5,0,5,0,30,2,3,0,5,0,30,2,0,0,2,0,-27,3,0
2,3,6,0,30,6,3,0,9,3,30,2,0,0,2,0,30,5,4,0,9,0,30,4,5,0,9,0,30,4,1,0,5,0,-27,3,0
2,2,13,1,30,6,1,0,7,1,30,4,0,0,4,1,30,6,1,0,7,6,30,7,0,0,7,0,30,4,0,0,4,1,-15,3,1
2,4,13,1,30,6,1,0,7,1,30,4,0,0,4,1,30,6,1,0,7,6,30,7,0,0,7,0,30,4,0,0,4,1,-15,3,1
2,3,17,2,30,8,6,0,14,2,30,6,0,0,6,0,30,6,8,0,14,0,30,7,7,0,14,5,30,4,0,0,4,1,-15,3,1
2,3,23,3,30,7,6,0,13,3,30,6,0,0,6,5,30,11,2,0,13,0,30,6,7,0,13,0,30,6,0,0,6,1,-15,3,1
2,3,25,1,30,6,8,0,14,4,30,6,0,0,6,0,30,4,10,0,14,2,30,6,8,0,14,4,30,6,0,0,6,1,-15,3,1
2,4,25,1,30,6,8,0,14,4,30,6,0,0,6,0,30,4,10,0,14,2,30,6,8,0,14,4,30,6,0,0,6,1,-15,3,1
2,1,27,6,30,5,10,0,15,4,30,1,1,0,2,0,30,3,12,0,15,1,30,5,10,0,15,6,30,4,2,0,6,1,-15,3,1
2,2,27,6,30,5,10,0,15,4,30,1,1,0,2,0,30,3,12,0,15,1,30,5,10,0,15,6,30,4,2,0,6,1,-15,3,1
2,4,27,6,30,5,10,0,15,4,30,1,1,0,2,0,30,3,12,0,15,1,30,5,10,0,15,6,30,4,2,0,6,1,-15,3,1
2,3,29,0,30,4,10,0,14,5,30,9,3,0,12,0,30,6,8,0,14,0,30,2,12,0,14,0,30,9,0,0,9,1,-15,3,1
2,4,29,0,30,4,10,0,14,5,30,9,3,0,12,0,30,6,8,0,14,0,30,2,12,0,14,0,30,9,0,0,9,1,-15,3,1
2,3,35,0,30,8,5,0,13,5,30,2,0,0,2,1,30,3,10,0,13,0,30,2,11,0,13,7,30,8,0,0,8,1,-15,3,1
2,4,37,6,30,7,4,0,11,6,30,8,0,0,8,0,30,8,3,0,11,0,30,3,8,0,11,0,30,4,2,0,6,1,-15,3,1
2,0,41,0,30,6,6,0,12,6,30,8,0,0,8,0,30,4,8,0,12,0,30,3,9,0,12,1,30,4,3,0,7,1,-15,3,1
2,3,41,0,30,6,6,0,12,6,30,8,0,0,8,0,30,4,8,0,12,0,30,3,9,0,12,1,30,4,3,0,7,1,-15,3,1
2,3,6,1,30,9,0,0,9,3,30,2,0,0,2,0,30,3,6,0,9,0,30,4,5,0,9,2,30,1,4,0,5,0,-27,3,0
2,4,7,0,30,2,2,0,4,2,30,2,0,0,2,0,30,1,3,0,4,1,30,1,3,0,4,1,30,2,0,0,2,0,-27,3,0
2,2,19,0,30,3,10,0,13,1,30,8,0,0,8,0,30,7,6,0,13,3,30,4,9,0,13,0,30,8,1,0,9,1,-15,3,1
2,3,19,0,30,3,10,0,13,1,30,8,0,0,8,0,30,7,6,0,13,3,30,4,9,0,13,0,30,8,1,0,9,1,-15,3,1
2,3,25,1,30,7,7,0,14,0,30,6,0,0,6,0,30,12,2,0,14,0,30,5,9,0,14,2,30,5,1,0,6,1,-15,3,1
2,0,26,0,30,8,1,0,9,3,30,0,4,0,4,1,30,0,9,0,9,8,30,1,8,0,9,5,30,3,0,0,3,1,-15,3,1
2,4,26,0,30,8,1,0,9,3,30,0,4,0,4,1,30,0,9,0,9,8,30,1,8,0,9,5,30,3,0,0,3,1,-15,3,1
2,1,27,1,30,4,11,0,15,5,30,2,0,0,2,0,30,2,13,0,15,1,30,11,4,0,15,0,30,6,0,0,6,1,-15,3,1
2,3,27,1,30,4,11,0,15,5,30,2,0,0,2,0,30,2,13,0,15,1,30,11,4,0,15,0,30,6,0,0,6,1,-15,3,1
2,4,27,1,30,4,11,0,15,5,30,2,0,0,2,0,30,2,13,0,15,1,30,11,4,0,15,0,30,6,0,0,6,1,-15,3,1
2,3,31,1,30,6,6,0,12,4,30,8,0,0,8,4,30,10,2,0,12,0,30,9,3,0,12,1,30,2,4,0,6,1,-15,3,1
2,4,35,0,30,8,5,0,13,6,30,2,0,0,2,1,30,2,11,0,13,0,30,9,4,0,13,4,30,8,0,0,8,1,-15,3,1
2,0,4,2,30,6,2,0,8,4,30,2,2,0,4,0,30,2,6,0,8,0,30,7,1,0,8,3,30,4,0,0,4,0,-27,3,0
2,2,13,3,30,6,1,0,7,0,30,4,0,0,4,2,30,6,1,0,7,5,30,6,1,0,7,2,30,4,0,0,4,1,-15,3,1
2,3,13,3,30,6,1,0,7,0,30,4,0,0,4,2,30,6,1,0,7,5,30,6,1,0,7,2,30,4,0,0,4,1,-15,3,1
2,1,17,3,30,10,4,0,14,2,30,6,0,0,6,0,30,7,7,0,14,3,30,5,9,0,14,1,30,4,0,0,4,1,-15,3,1
2,2,17,3,30,10,4,0,14,2,30,6,0,0,6,0,30,7,7,0,14,3,30,5,9,0,14,1,30,4,0,0,4,1,-15,3,1
2,3,17,3,30,10,4,0,14,2,30,6,0,0,6,0,30,7,7,0,14,3,30,5,9,0,14,1,30,4,0,0,4,1,-15,3,1
2,4,19,0,30,2,11,0,13,2,30,8,0,0,8,0,30,5,8,0,13,0,30,4,9,0,13,0,30,9,0,0,9,1,-15,3,1
2,4,23,0,30,6,7,0,13,0,30,6,0,0,6,4,30,13,0,0,13,0,30,5,8,0,13,1,30,6,0,0,6,1,-15,3,1
2,2,31,3,30,4,8,0,12,7,30,8,0,0,8,3,30,4,8,0,12,0,30,9,3,0,12,1,30,4,2,0,6,1,-15,3,1
2,3,31,3,30,4,8,0,12,7,30,8,0,0,8,3,30,4,8,0,12,0,30,9,3,0,12,1,30,4,2,0,6,1,-15,3,1
2,4,31,3,30,4,8,0,12,7,30,8,0,0,8,3,30,4,8,0,12,0,30,9,3,0,12,1,30,4,2,0,6,1,-15,3,1
2,2,35,0,30,10,3,0,13,4,30,2,0,0,2,1,30,2,11,0,13,3,30,4,9,0,13,9,30,8,0,0,8,1,-15,3,1
2,3,35,0,30,10,3,0,13,4,30,2,0,0,2,1,30,2,11,0,13,3,30,4,9,0,13,9,30,8,0,0,8,1,-15,3,1
2,2,38,0,30,1,9,0,10,6,30,6,0,0,6,0,30,1,9,0,10,0,30,3,7,0,10,7,30,6,0,0,6,1,-15,3,1
2,0,13,1,30,6,1,0,7,1,30,4,0,0,4,2,30,5,2,0,7,6,30,5,2,0,7,5,30,4,0,0,4,1,-15,3,1
2,4,13,0,30,6,1,0,7,1,30,4,0,0,4,2,30,5,2,0,7,6,30,5,2,0,7,5,30,4,0,0,4,1,-15,3,1
2,3,17,4,30,10,4,0,14,3,30,6,0,0,6,0,30,5,9,0,14,1,30,6,8,0,14,2,30,2,2,0,4,1,-15,3,1
2,4,19,0,30,4,9,0,13,2,30,7,1,0,8,0,30,6,7,0,13,4,30,4,9,0,13,0,30,8,1,0,9,1,-15,3,1
2,1,21,2,30,7,3,0,10,3,30,6,0,0,6,3,30,6,4,0,10,1,30,4,6,0,10,1,30,4,0,0,4,1,-15,3,1
2,1,23,1,30,5,8,0,13,2,30,6,0,0,6,6,30,12,1,0,13,0,30,5,8,0,13,4,30,6,0,0,6,1,-15,3,1
2,2,23,1,30,5,8,0,13,2,30,6,0,0,6,6,30,12,1,0,13,0,30,5,8,0,13,4,30,6,0,0,6,1,-15,3,1
2,3,23,1,30,5,8,0,13,2,30,6,0,0,6,6,30,12,1,0,13,0,30,5,8,0,13,4,30,6,0,0,6,1,-15,3,1
2,0,25,1,30,2,12,0,14,6,30,6,0,0,6,0,30,5,9,0,14,2,30,6,8,0,14,7,30,5,1,0,6,1,-15,3,1
2,1,27,2,30,5,10,0,15,3,30,2,0,0,2,0,30,2,13,0,15,0,30,3,12,0,15,6,30,6,0,0,6,1,-15,3,1
2,3,27,2,30,5,10,0,15,3,30,2,0,0,2,0,30,2,13,0,15,0,30,3,12,0,15,6,30,6,0,0,6,1,-15,3,1
2,4,27,2,30,5,10,0,15,3,30,2,0,0,2,0,30,2,13,0,15,0,30,3,12,0,15,6,30,6,0,0,6,1,-15,3,1
2,2,39,0,30,2,9,0,11,6,30,6,0,0,6,0,30,4,7,0,11,0,30,2,9,0,11,2,30,5,0,0,5,1,-15,3,1
2,3,39,0,30,2,9,0,11,6,30,6,0,0,6,0,30,4,7,0,11,0,30,2,9,0,11,2,30,5,0,0,5,1,-15,3,1
2,4,17,3,30,8,6,0,14,2,30,6,0,0,6,0,30,7,7,0,14,1,30,6,8,0,14,0,30,4,0,0,4,1,-15,3,1
2,1,19,0,30,5,8,0,13,2,30,4,4,0,8,0,30,4,9,0,13,3,30,5,8,0,13,1,30,9,0,0,9,1,-15,3,1
2,2,19,0,30,5,8,0,13,2,30,4,4,0,8,0,30,4,9,0,13,3,30,5,8,0,13,1,30,9,0,0,9,1,-15,3,1
2,3,23,3,30,4,9,0,13,3,30,6,0,0,6,7,30,11,2,0,13,0,30,6,7,0,13,2,30,6,0,0,6,1,-15,3,1
2,2,25,1,30,6,8,0,14,4,30,6,0,0,6,0,30,6,8,0,14,1,30,7,7,0,14,4,30,6,0,0,6,1,-15,3,1
2,4,25,1,30,6,8,0,14,4,30,6,0,0,6,0,30,6,8,0,14,1,30,7,7,0,14,0,30,6,0,0,6,1,-15,3,1
2,1,27,1,30,5,10,0,15,4,30,2,0,0,2,0,30,4,11,0,15,1,30,8,7,0,15,1,30,6,0,0,6,1,-15,3,1
2,2,27,1,30,5,10,0,15,4,30,2,0,0,2,0,30,4,11,0,15,1,30,8,7,0,15,1,30,6,0,0,6,1,-15,3,1
2,4,27,1,30,5,10,0,15,4,30,2,0,0,2,0,30,4,11,0,15,0,30,8,7,0,15,1,30,6,0,0,6,1,-15,3,1
2,0,4,2,30,6,2,0,8,5,30,4,0,0,4,1,30,2,6,0,8,1,30,8,0,0,8,1,30,3,1,0,4,0,-27,3,0
2,3,4,2,30,6,2,0,8,5,30,4,0,0,4,1,30,2,6,0,8,1,30,8,0,0,8,1,30,3,1,0,4,0,-27,3,0
2,3,8,2,30,7,0,0,7,3,30,2,0,0,2,0,30,5,2,0,7,0,30,5,2,0,7,1,30,3,0,0,3,0,-27,3,0
2,0,11,1,30,4,8,0,12,0,30,4,0,0,4,0,30,8,4,0,12,8,30,6,6,0,12,4,30,4,0,0,4,1,-15,3,1
2,4,13,7,30,6,1,0,7,2,30,4,0,0,4,3,30,6,1,0,7,3,30,6,1,0,7,0,30,4,0,0,4,1,-15,3,1
2,2,17,3,30,9,5,0,14,2,30,6,0,0,6,0,30,9,5,0,14,3,30,6,8,0,14,3,30,4,0,0,4,1,-15,3,1
2,1,19,1,30,5,8,0,13,3,30,5,3,0,8,6,30,4,9,0,13,4,30,3,10,0,13,0,30,5,4,0,9,1,-15,3,1
2,2,19,1,30,5,8,0,13,3,30,5,3,0,8,6,30,4,9,0,13,4,30,3,10,0,13,0,30,5,4,0,9,1,-15,3,1
2,1,25,2,30,4,10,0,14,3,30,6,0,0,6,0,30,7,7,0,14,2,30,8,6,0,14,3,30,6,0,0,6,1,-15,3,1
2,2,25,2,30,4,10,0,14,3,30,6,0,0,6,0,30,7,7,0,14,2,30,8,6,0,14,3,30,6,0,0,6,1,-15,3,1
2,3,27,1,30,6,9,0,15,5,30,1,1,0,2,0,30,5,10,0,15,0,30,6,9,0,15,1,30,6,0,0,6,1,-15,3,1
2,2,29,0,30,6,8,0,14,3,30,12,0,0,12,0,30,6,8,0,14,0,30,0,14,0,14,0,30,8,1,0,9,1,-15,3,1
2,2,5,0,30,2,3,0,5,3,30,4,0,0,4,0,30,0,5,0,5,0,30,2,3,0,5,1,30,2,0,0,2,0,-27,3,0
2,3,5,0,30,2,3,0,5,3,30,4,0,0,4,0,30,0,5,0,5,0,30,2,3,0,5,1,30,2,0,0,2,0,-27,3,0
2,3,8,2,30,7,0,0,7,4,30,2,0,0,2,0,30,6,1,0,7,2,30,7,0,0,7,1,30,3,0,0,3,0,-27,3,0
2,1,13,1,30,4,3,0,7,0,30,4,0,0,4,2,30,5,2,0,7,4,30,7,0,0,7,7,30,4,0,0,4,1,-15,3,1
2,2,13,1,30,4,3,0,7,0,30,4,0,0,4,2,30,5,2,0,7,4,30,7,0,0,7,7,30,4,0,0,4,1,-15,3,1
2,2,17,5,30,10,4,0,14,2,30,6,0,0,6,0,30,7,7,0,14,2,30,4,10,0,14,4,30,4,0,0,4,1,-15,3,1
2,3,25,1,30,4,10,0,14,3,30,6,0,0,6,0,30,8,6,0,14,2,30,5,9,0,14,5,30,6,0,0,6,1,-15,3,1
2,4,25,1,30,4,10,0,14,3,30,6,0,0,6,0,30,8,6,0,14,2,30,5,9,0,14,5,30,6,0,0,6,1,-15,3,1
2,0,27,1,30,5,10,0,15,5,30,2,0,0,2,0,30,3,12,0,15,1,30,5,10,0,15,5,30,6,0,0,6,1,-15,3,1
2,0,33,6,30,6,5,0,11,5,30,4,0,0,4,5,30,9,2,0,11,0,30,3,8,0,11,4,30,4,0,0,4,1,-15,3,1
2,1,33,6,30,6,5,0,11,5,30,4,0,0,4,5,30,9,2,0,11,0,30,3,8,0,11,4,30,4,0,0,4,1,-15,3,1
2,2,33,6,30,6,5,0,11,5,30,4,0,0,4,5,30,9,2,0,11,0,30,3,8,0,11,4,30,4,0,0,4,1,-15,3,1
2,3,8,1,30,7,0,0,7,4,30,2,0,0,2,4,30,4,3,0,7,1,30,7,0,0,7,0,30,3,0,0,3,0,-27,3,0
2,1,13,1,30,4,3,0,7,0,30,4,0,0,4,2,30,6,1,0,7,10,30,6,1,0,7,2,30,4,0,0,4,1,-15,3,1
2,4,15,0,30,4,9,0,13,1,30,6,0,0,6,0,30,3,10,0,13,1,30,5,8,0,13,2,30,8,1,0,9,1,-15,3,1
2,0,17,4,30,9,5,0,14,3,30,6,0,0,6,0,30,5,9,0,14,1,30,7,7,0,14,5,30,4,0,0,4,1,-15,3,1
2,4,23,2,30,13,0,0,13,1,30,5,1,0,6,3,30,12,1,0,13,0,30,5,8,0,13,2,30,6,0,0,6,1,-15,3,1
2,3,25,2,30,7,7,0,14,5,30,6,0,0,6,0,30,6,8,0,14,1,30,7,7,0,14,0,30,5,1,0,6,1,-15,3,1
2,4,25,2,30,7,7,0,14,5,30,6,0,0,6,0,30,6,8,0,14,1,30,7,7,0,14,0,30,5,1,0,6,1,-15,3,1
2,0,27,1,30,4,11,0,15,4,30,2,0,0,2,0,30,6,9,0,15,4,30,4,11,0,15,3,30,6,0,0,6,1,-15,3,1
2,1,27,1,30,4,11,0,15,4,30,2,0,0,2,0,30,6,9,0,15,4,30,4,11,0,15,3,30,6,0,0,6,1,-15,3,1
2,2,27,1,30,4,11,0,15,4,30,2,0,0,2,0,30,6,9,0,15,4,30,4,11,0,15,3,30,6,0,0,6,1,-15,3,1
2,3,27,1,30,4,11,0,15,4,30,2,0,0,2,0,30,6,9,0,15,4,30,4,11,0,15,3,30,6,0,0,6,1,-15,3,1
2,3,29,0,30,6,8,0,14,6,30,11,1,0,12,0,30,3,11,0,14,0,30,1,13,0,14,1,30,9,0,0,9,1,-15,3,1
2,4,32,0,30,4,5,0,9,4,30,2,0,0,2,0,30,8,1,0,9,1,30,3,6,0,9,3,30,2,0,0,2,1,-15,3,1
2,4,38,0,30,3,7,0,10,6,30,6,0,0,6,1,30,4,6,0,10,0,30,2,8,0,10,5,30,6,0,0,6,1,-15,3,1
2,2,13,5,30,5,2,0,7,0,30,4,0,0,4,2,30,6,1,0,7,6,30,6,1,0,7,1,30,4,0,0,4,1,-15,3,1
2,1,17,3,30,9,5,0,14,3,30,6,0,0,6,0,30,5,9,0,14,2,30,8,6,0,14,5,30,4,0,0,4,1,-15,3,1
2,3,17,3,30,9,5,0,14,3,30,6,0,0,6,0,30,5,9,0,14,2,30,8,6,0,14,5,30,4,0,0,4,1,-15,3,1
2,3,19,0,30,4,9,0,13,0,30,8,0,0,8,0,30,5,8,0,13,4,30,3,10,0,13,1,30,8,1,0,9,1,-15,3,1
2,4,19,0,30,4,9,0,13,0,30,8,0,0,8,0,30,5,8,0,13,4,30,3,10,0,13,1,30,8,1,0,9,1,-15,3,1
2,4,22,10,30,5,3,0,8,2,30,2,0,0,2,0,30,5,3,0,8,4,30,2,6,0,8,1,30,1,3,0,4,1,-15,3,1
2,3,23,1,30,11,2,0,13,0,30,6,0,0,6,2,30,12,1,0,13,0,30,6,7,0,13,5,30,5,1,0,6,1,-15,3,1
2,4,25,0,30,5,9,0,14,4,30,6,0,0,6,0,30,6,8,0,14,1,30,6,8,0,14,3,30,6,0,0,6,1,-15,3,1
2,0,27,2,30,6,9,0,15,4,30,1,1,0,2,0,30,6,9,0,15,2,30,3,12,0,15,0,30,6,0,0,6,1,-15,3,1
2,4,27,2,30,6,9,0,15,1,30,1,1,0,2,0,30,6,9,0,15,2,30,3,12,0,15,0,30,6,0,0,6,1,-15,3,1
2,4,30,3,30,4,1,0,5,4,30,2,0,0,2,1,30,1,4,0,5,5,30,1,4,0,5,3,30,3,0,0,3,1,-15,3,1
2,1,6,2,30,9,0,0,9,3,30,2,0,0,2,0,30,5,4,0,9,0,30,3,6,0,9,0,30,3,2,0,5,0,-27,3,0
2,4,6,2,30,9,0,0,9,3,30,2,0,0,2,0,30,5,4,0,9,0,30,3,6,0,9,0,30,3,2,0,5,0,-27,3,0
2,1,13,2,30,6,1,0,7,0,30,4,0,0,4,2,30,5,2,0,7,6,30,4,3,0,7,3,30,4,0,0,4,1,-15,3,1
2,3,13,2,30,6,1,0,7,0,30,4,0,0,4,2,30,5,2,0,7,6,30,4,3,0,7,3,30,4,0,0,4,1,-15,3,1
2,4,13,2,30,6,1,0,7,0,30,4,0,0,4,2,30,5,2,0,7,6,30,4,3,0,7,3,30,4,0,0,4,1,-15,3,1
2,4,17,0,30,9,5,0,14,0,30,6,0,0,6,0,30,6,8,0,14,0,30,6,8,0,14,3,30,4,0,0,4,1,-15,3,1
2,3,22,1,30,7,1,0,8,3,30,2,0,0,2,4,30,4,4,0,8,0,30,4,4,0,8,2,30,4,0,0,4,1,-15,3,1
2,3,23,0,30,5,8,0,13,4,30,6,0,0,6,6,30,10,3,0,13,0,30,4,9,0,13,2,30,6,0,0,6,1,-15,3,1
2,4,23,0,30,5,8,0,13,4,30,6,0,0,6,6,30,10,3,0,13,0,30,4,9,0,13,2,30,6,0,0,6,1,-15,3,1
2,2,27,1,30,9,6,0,15,5,30,1,1,0,2,0,30,3,12,0,15,0,30,6,9,0,15,5,30,6,0,0,6,1,-15,3,1
2,3,27,1,30,9,6,0,15,5,30,1,1,0,2,0,30,3,12,0,15,0,30,6,9,0,15,5,30,6,0,0,6,1,-15,3,1
2,4,27,1,30,9,6,0,15,5,30,1,1,0,2,0,30,3,12,0,15,0,30,6,9,0,15,5,30,6,0,0,6,1,-15,3,1
2,1,29,0,30,4,10,0,14,5,30,12,0,0,12,0,30,7,7,0,14,2,30,1,13,0,14,0,30,7,2,0,9,1,-15,3,1
2,3,29,0,30,4,10,0,14,4,30,12,0,0,12,0,30,7,7,0,14,2,30,1,13,0,14,0,30,7,2,0,9,1,-15,3,1
2,3,39,0,30,3,8,0,11,6,30,6,0,0,6,0,30,4,7,0,11,1,30,3,8,0,11,5,30,5,0,0,5,1,-15,3,1
2,2,15,0,30,4,9,0,13,0,30,5,1,0,6,0,30,3,10,0,13,1,30,4,9,0,13,2,30,9,0,0,9,1,-15,3,1
2,2,19,0,30,3,10,0,13,0,30,7,1,0,8,0,30,8,5,0,13,8,30,5,8,0,13,0,30,7,2,0,9,1,-15,3,1
2,4,19,0,30,3,10,0,13,0,30,7,1,0,8,0,30,8,5,0,13,8,30,5,8,0,13,0,30,7,2,0,9,1,-15,3,1
2,1,27,2,30,11,4,0,15,2,30,2,0,0,2,1,30,10,5,0,15,0,30,2,13,0,15,0,30,1,5,0,6,1,-15,3,1
2,2,27,2,30,11,4,0,15,2,30,2,0,0,2,1,30,10,5,0,15,0,30,2,13,0,15,0,30,1,5,0,6,1,-15,3,1
2,4,31,3,30,5,7,0,12,5,30,8,0,0,8,4,30,12,0,0,12,0,30,3,9,0,12,1,30,6,0,0,6,1,-15,3,1
2,3,9,5,30,4,0,0,4,3,30,2,0,0,2,0,30,0,4,0,4,0,30,1,3,0,4,1,30,1,0,0,1,0,-27,3,0
2,3,9,3,30,11,0,0,11,4,30,6,0,0,6,0,30,5,6,0,11,1,30,3,8,0,11,4,30,3,1,0,4,0,-27,3,0
2,4,15,0,30,5,8,0,13,1,30,6,0,0,6,0,30,3,10,0,13,1,30,3,10,0,13,3,30,9,0,0,9,1,-15,3,1
2,3,19,0,30,4,9,0,13,2,30,5,3,0,8,0,30,6,7,0,13,3,30,6,7,0,13,0,30,8,1,0,9,1,-15,3,1
2,4,19,0,30,4,9,0,13,2,30,5,3,0,8,0,30,6,7,0,13,3,30,6,7,0,13,0,30,8,1,0,9,1,-15,3,1
2,2,25,1,30,5,9,0,14,3,30,6,0,0,6,0,30,8,6,0,14,2,30,7,7,0,14,2,30,5,1,0,6,1,-15,3,1
2,3,25,1,30,5,9,0,14,3,30,6,0,0,6,0,30,8,6,0,14,2,30,7,7,0,14,2,30,5,1,0,6,1,-15,3,1
2,1,27,1,30,5,10,0,15,4,30,2,0,0,2,0,30,6,9,0,15,2,30,4,11,0,15,0,30,5,1,0,6,1,-15,3,1
2,3,27,1,30,5,10,0,15,4,30,2,0,0,2,0,30,6,9,0,15,2,30,4,11,0,15,0,30,5,1,0,6,1,-15,3,1
2,3,29,1,30,7,7,0,14,6,30,11,1,0,12,0,30,3,11,0,14,0,30,1,13,0,14,1,30,9,0,0,9,1,-15,3,1
2,3,11,0,30,1,3,0,4,0,30,0,0,0,0,0,30,3,1,0,4,5,30,1,3,0,4,2,30,1,0,0,1,1,-15,3,1
2,4,11,0,30,1,3,0,4,0,30,0,0,0,0,0,30,3,1,0,4,5,30,1,3,0,4,2,30,1,0,0,1,1,-15,3,1
2,2,19,0,30,4,9,0,13,2,30,8,0,0,8,1,30,5,8,0,13,3,30,5,8,0,13,0,30,7,2,0,9,1,-15,3,1
2,3,19,0,30,4,9,0,13,2,30,8,0,0,8,1,30,5,8,0,13,3,30,5,8,0,13,0,30,7,2,0,9,1,-15,3,1
2,4,23,2,30,6,7,0,13,0,30,6,0,0,6,1,30,13,0,0,13,0,30,6,7,0,13,3,30,6,0,0,6,1,-15,3,1
2,1,25,1,30,7,7,0,14,3,30,6,0,0,6,0,30,6,8,0,14,1,30,6,8,0,14,7,30,6,0,0,6,1,-15,3,1
2,1,27,1,30,6,9,0,15,0,30,2,0,0,2,0,30,11,4,0,15,0,30,3,12,0,15,1,30,3,3,0,6,1,-15,3,1
2,3,27,1,30,6,9,0,15,0,30,2,0,0,2,0,30,11,4,0,15,0,30,3,12,0,15,1,30,3,3,0,6,1,-15,3,1
2,3,39,0,30,4,7,0,11,7,30,6,0,0,6,0,30,4,7,0,11,0,30,4,7,0,11,6,30,5,0,0,5,1,-15,3,1
2,1,4,2,30,8,0,0,8,4,30,4,0,0,4,1,30,2,6,0,8,0,30,5,3,0,8,1,30,3,1,0,4,0,-27,3,0
2,1,13,5,30,3,0,0,3,2,30,2,0,0,2,3,30,3,0,0,3,6,30,3,0,0,3,2,30,2,0,0,2,1,-15,3,1
2,3,13,5,30,3,0,0,3,2,30,2,0,0,2,3,30,3,0,0,3,6,30,3,0,0,3,2,30,2,0,0,2,1,-15,3,1
2,4,13,5,30,3,0,0,3,2,30,2,0,0,2,3,30,3,0,0,3,6,30,3,0,0,3,2,30,2,0,0,2,1,-15,3,1
2,1,13,5,30,7,0,0,7,0,30,4,0,0,4,4,30,7,0,0,7,3,30,7,0,0,7,2,30,4,0,0,4,1,-15,3,1
2,2,13,5,30,7,0,0,7,0,30,4,0,0,4,4,30,7,0,0,7,3,30,7,0,0,7,2,30,4,0,0,4,1,-15,3,1
2,2,21,3,30,9,1,0,10,3,30,5,1,0,6,1,30,4,6,0,10,1,30,3,7,0,10,2,30,4,0,0,4,1,-15,3,1
2,3,21,3,30,9,1,0,10,3,30,5,1,0,6,1,30,4,6,0,10,1,30,3,7,0,10,2,30,4,0,0,4,1,-15,3,1
2,2,31,1,30,3,9,0,12,8,30,8,0,0,8,3,30,4,8,0,12,6,30,9,3,0,12,3,30,6,0,0,6,1,-15,3,1
2,4,35,1,30,10,3,0,13,4,30,2,0,0,2,1,30,6,7,0,13,2,30,1,12,0,13,4,30,8,0,0,8,1,-15,3,1
2,4,6,0,30,6,3,0,9,4,30,2,0,0,2,1,30,2,7,0,9,0,30,4,5,0,9,0,30,3,2,0,5,0,-27,3,0
2,3,8,1,30,7,0,0,7,3,30,2,0,0,2,4,30,7,0,0,7,1,30,7,0,0,7,0,30,3,0,0,3,0,-27,3,0
2,3,13,2,30,7,0,0,7,1,30,4,0,0,4,0,30,6,1,0,7,4,30,4,3,0,7,4,30,4,0,0,4,1,-15,3,1
2,4,13,2,30,7,0,0,7,1,30,4,0,0,4,0,30,6,1,0,7,4,30,4,3,0,7,4,30,4,0,0,4,1,-15,3,1
2,0,17,3,30,9,5,0,14,4,30,6,0,0,6,0,30,3,11,0,14,3,30,5,9,0,14,2,30,4,0,0,4,1,-15,3,1
2,1,17,3,30,9,5,0,14,4,30,6,0,0,6,0,30,3,11,0,14,3,30,5,9,0,14,2,30,4,0,0,4,1,-15,3,1
2,2,17,3,30,9,5,0,14,4,30,6,0,0,6,0,30,3,11,0,14,3,30,5,9,0,14,2,30,4,0,0,4,1,-15,3,1
2,3,17,3,30,9,5,0,14,4,30,6,0,0,6,0,30,3,11,0,14,3,30,5,9,0,14,2,30,4,0,0,4,1,-15,3,1
2,4,17,3,30,9,5,0,14,4,30,6,0,0,6,0,30,3,11,0,14,3,30,5,9,0,14,2,30,4,0,0,4,1,-15,3,1
2,3,19,0,30,3,10,0,13,2,30,6,2,0,8,0,30,7,6,0,13,4,30,4,9,0,13,2,30,8,1,0,9,1,-15,3,1
2,4,23,1,30,5,8,0,13,1,30,6,0,0,6,2,30,13,0,0,13,0,30,6,7,0,13,2,30,6,0,0,6,1,-15,3,1
2,0,27,1,30,5,10,0,15,3,30,1,1,0,2,0,30,3,12,0,15,0,30,4,11,0,15,5,30,6,0,0,6,1,-15,3,1
2,3,27,0,30,5,10,0,15,3,30,1,1,0,2,0,30,3,12,0,15,0,30,4,11,0,15,5,30,6,0,0,6,1,-15,3,1
2,0,29,0,30,7,7,0,14,6,30,12,0,0,12,0,30,4,10,0,14,0,30,0,14,0,14,3,30,9,0,0,9,1,-15,3,1
2,1,29,0,30,7,7,0,14,6,30,12,0,0,12,0,30,4,10,0,14,0,30,0,14,0,14,3,30,9,0,0,9,1,-15,3,1
2,2,29,0,30,7,7,0,14,6,30,12,0,0,12,0,30,4,10,0,14,0,30,0,14,0,14,3,30,9,0,0,9,1,-15,3,1
2,3,29,0,30,7,7,0,14,6,30,12,0,0,12,0,30,4,10,0,14,0,30,0,14,0,14,3,30,9,0,0,9,1,-15,3,1
2,4,29,0,30,7,7,0,14,6,30,12,0,0,12,0,30,4,10,0,14,0,30,0,14,0,14,3,30,9,0,0,9,1,-15,3,1
2,2,37,0,30,6,5,0,11,6,30,8,0,0,8,0,30,3,8,0,11,4,30,5,6,0,11,9,30,6,0,0,6,1,-15,3,1
2,2,41,0,30,10,2,0,12,9,30,8,0,0,8,0,30,3,9,0,12,0,30,4,8,0,12,3,30,7,0,0,7,1,-15,3,1
2,0,4,2,30,7,1,0,8,5,30,4,0,0,4,0,30,2,6,0,8,2,30,8,0,0,8,2,30,2,2,0,4,0,-27,3,0
2,1,4,2,30,7,1,0,8,5,30,4,0,0,4,0,30,2,6,0,8,2,30,8,0,0,8,2,30,2,2,0,4,0,-27,3,0
2,2,4,2,30,7,1,0,8,5,30,4,0,0,4,0,30,2,6,0,8,2,30,8,0,0,8,2,30,2,2,0,4,0,-27,3,0
2,3,4,2,30,7,1,0,8,5,30,4,0,0,4,0,30,2,6,0,8,2,30,8,0,0,8,2,30,2,2,0,4,0,-27,3,0
2,4,9,0,30,2,2,0,4,2,30,2,0,0,2,0,30,4,0,0,4,1,30,1,3,0,4,0,30,1,0,0,1,0,-27,3,0
2,2,13,2,30,7,0,0,7,0,30,4,0,0,4,2,30,6,1,0,7,8,30,7,0,0,7,6,30,4,0,0,4,1,-15,3,1
2,4,19,0,30,4,9,0,13,2,30,8,0,0,8,0,30,4,9,0,13,3,30,4,9,0,13,0,30,9,0,0,9,1,-15,3,1
2,2,25,2,30,8,6,0,14,5,30,6,0,0,6,0,30,5,9,0,14,1,30,5,9,0,14,3,30,5,1,0,6,1,-15,3,1
2,2,26,0,30,6,3,0,9,5,30,4,0,0,4,5,30,1,8,0,9,0,30,1,8,0,9,4,30,3,0,0,3,1,-15,3,1
2,3,26,0,30,6,3,0,9,5,30,4,0,0,4,5,30,1,8,0,9,0,30,1,8,0,9,4,30,3,0,0,3,1,-15,3,1
2,1,27,1,30,6,9,0,15,3,30,2,0,0,2,0,30,6,9,0,15,0,30,4,11,0,15,1,30,6,0,0,6,1,-15,3,1
2,4,27,1,30,6,9,0,15,3,30,2,0,0,2,0,30,6,9,0,15,0,30,4,11,0,15,1,30,6,0,0,6,1,-15,3,1
2,3,29,0,30,5,9,0,14,6,30,12,0,0,12,0,30,5,9,0,14,0,30,1,13,0,14,0,30,9,0,0,9,1,-15,3,1
2,3,31,3,30,8,4,0,12,5,30,8,0,0,8,3,30,4,8,0,12,0,30,3,9,0,12,1,30,5,1,0,6,1,-15,3,1
2,4,31,3,30,8,4,0,12,5,30,8,0,0,8,3,30,4,8,0,12,0,30,3,9,0,12,1,30,5,1,0,6,1,-15,3,1
2,4,33,5,30,5,6,0,11,5,30,4,0,0,4,0,30,11,0,0,11,0,30,3,8,0,11,4,30,4,0,0,4,1,-15,3,1
2,4,35,0,30,8,5,0,13,3,30,2,0,0,2,3,30,6,7,0,13,0,30,1,12,0,13,2,30,8,0,0,8,1,-15,3,1
2,2,9,0,30,1,3,0,4,2,30,2,0,0,2,0,30,0,4,0,4,0,30,0,4,0,4,2,30,1,0,0,1,0,-27,3,0
2,3,9,0,30,1,3,0,4,2,30,2,0,0,2,0,30,0,4,0,4,0,30,0,4,0,4,2,30,1,0,0,1,0,-27,3,0
2,1,11,2,30,3,9,0,12,0,30,4,0,0,4,0,30,8,4,0,12,7,30,6,6,0,12,4,30,4,0,0,4,1,-15,3,1
2,2,11,2,30,3,9,0,12,0,30,4,0,0,4,0,30,8,4,0,12,7,30,6,6,0,12,4,30,4,0,0,4,1,-15,3,1
2,4,13,2,30,6,1,0,7,1,30,4,0,0,4,2,30,5,2,0,7,14,30,4,3,0,7,2,30,4,0,0,4,1,-15,3,1
2,2,19,0,30,4,9,0,13,1,30,5,3,0,8,1,30,10,3,0,13,4,30,4,9,0,13,2,30,9,0,0,9,1,-15,3,1
2,1,25,1,30,7,7,0,14,3,30,6,0,0,6,1,30,7,7,0,14,1,30,6,8,0,14,4,30,5,1,0,6,1,-15,3,1
2,3,27,1,30,5,10,0,15,4,30,1,1,0,2,0,30,3,12,0,15,4,30,4,11,0,15,2,30,6,0,0,6,1,-15,3,1
2,3,31,5,30,7,5,0,12,4,30,8,0,0,8,0,30,11,1,0,12,0,30,3,9,0,12,0,30,3,3,0,6,1,-15,3,1
2,4,35,0,30,6,7,0,13,4,30,2,0,0,2,1,30,6,7,0,13,2,30,1,12,0,13,3,30,8,0,0,8,1,-15,3,1
2,1,4,1,30,7,1,0,8,4,30,4,0,0,4,2,30,3,5,0,8,0,30,2,6,0,8,2,30,4,0,0,4,0,-27,3,0
2,2,4,1,30,7,1,0,8,4,30,4,0,0,4,2,30,3,5,0,8,0,30,2,6,0,8,2,30,4,0,0,4,0,-27,3,0
2,3,4,1,30,7,1,0,8,4,30,4,0,0,4,2,30,3,5,0,8,0,30,2,6,0,8,2,30,4,0,0,4,0,-27,3,0
2,3,6,0,30,6,3,0,9,3,30,2,0,0,2,0,30,4,5,0,9,3,30,4,5,0,9,2,30,5,0,0,5,0,-27,3,0
2,1,13,5,30,7,0,0,7,0,30,4,0,0,4,2,30,5,2,0,7,9,30,6,1,0,7,2,30,4,0,0,4,1,-15,3,1
2,3,17,3,30,8,6,0,14,2,30,6,0,0,6,0,30,6,8,0,14,1,30,5,9,0,14,3,30,4,0,0,4,1,-15,3,1
2,0,19,1,30,4,9,0,13,1,30,5,3,0,8,2,30,7,6,0,13,2,30,5,8,0,13,0,30,5,4,0,9,1,-15,3,1
2,1,19,1,30,4,9,0,13,1,30,5,3,0,8,2,30,7,6,0,13,2,30,5,8,0,13,0,30,5,4,0,9,1,-15,3,1
2,2,19,1,30,4,9,0,13,1,30,5,3,0,8,2,30,7,6,0,13,2,30,5,8,0,13,0,30,5,4,0,9,1,-15,3,1
2,4,22,1,30,7,1,0,8,2,30,2,0,0,2,1,30,3,5,0,8,0,30,2,6,0,8,2,30,3,1,0,4,1,-15,3,1
2,0,26,0,30,6,3,0,9,5,30,4,0,0,4,3,30,0,9,0,9,0,30,4,5,0,9,6,30,3,0,0,3,1,-15,3,1
2,3,29,0,30,7,7,0,14,5,30,10,2,0,12,0,30,7,7,0,14,0,30,1,13,0,14,2,30,9,0,0,9,1,-15,3,1
2,2,35,0,30,9,4,0,13,4,30,2,0,0,2,1,30,4,9,0,13,0,30,3,10,0,13,6,30,7,1,0,8,1,-15,3,1
2,3,35,0,30,9,4,0,13,4,30,2,0,0,2,1,30,4,9,0,13,0,30,3,10,0,13,6,30,7,1,0,8,1,-15,3,1
2,0,4,2,30,6,2,0,8,4,30,4,0,0,4,0,30,1,7,0,8,0,30,6,2,0,8,4,30,4,0,0,4,0,-27,3,0
2,1,13,1,30,6,1,0,7,0,30,4,0,0,4,2,30,7,0,0,7,3,30,7,0,0,7,5,30,4,0,0,4,1,-15,3,1
2,3,17,3,30,7,7,0,14,3,30,6,0,0,6,0,30,5,9,0,14,1,30,5,9,0,14,0,30,4,0,0,4,1,-15,3,1
2,4,17,3,30,7,7,0,14,3,30,6,0,0,6,0,30,5,9,0,14,1,30,5,9,0,14,0,30,4,0,0,4,1,-15,3,1
2,1,19,0,30,3,10,0,13,2,30,4,4,0,8,0,30,5,8,0,13,4,30,6,7,0,13,4,30,9,0,0,9,1,-15,3,1
2,2,19,0,30,3,10,0,13,2,30,4,4,0,8,0,30,5,8,0,13,4,30,6,7,0,13,4,30,9,0,0,9,1,-15,3,1
2,4,19,0,30,3,10,0,13,2,30,4,4,0,8,0,30,5,8,0,13,4,30,6,7,0,13,4,30,9,0,0,9,1,-15,3,1
2,1,27,3,30,7,8,0,15,3,30,1,1,0,2,0,30,8,7,0,15,0,30,6,9,0,15,2,30,6,0,0,6,1,-15,3,1
2,2,27,3,30,7,8,0,15,3,30,1,1,0,2,0,30,8,7,0,15,0,30,6,9,0,15,2,30,6,0,0,6,1,-15,3,1
2,4,27,3,30,7,8,0,15,3,30,1,1,0,2,0,30,8,7,0,15,0,30,6,9,0,15,2,30,6,0,0,6,1,-15,3,1
2,2,33,1,30,4,7,0,11,5,30,4,0,0,4,0,30,9,2,0,11,0,30,3,8,0,11,6,30,4,0,0,4,1,-15,3,1
2,3,35,2,30,8,5,0,13,2,30,2,0,0,2,1,30,4,9,0,13,4,30,1,12,0,13,2,30,8,0,0,8,1,-15,3,1
2,3,38,0,30,3,7,0,10,5,30,6,0,0,6,0,30,8,2,0,10,0,30,2,8,0,10,0,30,5,1,0,6,1,-15,3,1
2,4,38,0,30,3,7,0,10,5,30,6,0,0,6,0,30,8,2,0,10,0,30,2,8,0,10,0,30,5,1,0,6,1,-15,3,1
2,2,7,0,30,1,3,0,4,2,30,2,0,0,2,3,30,2,2,0,4,3,30,1,3,0,4,0,30,2,0,0,2,0,-27,3,0
2,4,7,0,30,1,3,0,4,2,30,2,0,0,2,3,30,2,2,0,4,3,30,1,3,0,4,0,30,2,0,0,2,0,-27,3,0
2,2,17,0,30,5,9,0,14,1,30,6,0,0,6,0,30,8,6,0,14,7,30,6,8,0,14,6,30,4,0,0,4,1,-15,3,1
2,3,19,0,30,4,9,0,13,2,30,2,6,0,8,0,30,7,6,0,13,3,30,7,6,0,13,1,30,8,1,0,9,1,-15,3,1
2,3,23,1,30,7,6,0,13,2,30,6,0,0,6,3,30,10,3,0,13,0,30,4,9,0,13,3,30,6,0,0,6,1,-15,3,1
2,4,23,1,30,7,6,0,13,2,30,6,0,0,6,3,30,10,3,0,13,0,30,4,9,0,13,3,30,6,0,0,6,1,-15,3,1
2,1,27,1,30,4,11,0,15,5,30,2,0,0,2,4,30,8,7,0,15,0,30,11,4,0,15,1,30,3,3,0,6,1,-15,3,1
2,3,27,1,30,4,11,0,15,5,30,2,0,0,2,0,30,8,7,0,15,0,30,11,4,0,15,1,30,3,3,0,6,1,-15,3,1
2,4,27,1,30,4,11,0,15,5,30,2,0,0,2,0,30,8,7,0,15,0,30,11,4,0,15,1,30,3,3,0,6,1,-15,3,1
2,2,29,1,30,10,4,0,14,5,30,7,5,0,12,0,30,4,10,0,14,0,30,1,13,0,14,3,30,9,0,0,9,1,-15,3,1
2,4,29,1,30,10,4,0,14,5,30,7,5,0,12,0,30,4,10,0,14,0,30,1,13,0,14,3,30,9,0,0,9,1,-15,3,1
2,3,31,1,30,4,8,0,12,7,30,8,0,0,8,3,30,4,8,0,12,0,30,9,3,0,12,2,30,6,0,0,6,1,-15,3,1
2,4,31,1,30,4,8,0,12,7,30,8,0,0,8,3,30,4,8,0,12,0,30,9,3,0,12,2,30,6,0,0,6,1,-15,3,1
2,1,33,2,30,6,5,0,11,5,30,4,0,0,4,4,30,10,1,0,11,2,30,5,6,0,11,8,30,4,0,0,4,1,-15,3,1
2,3,33,2,30,6,5,0,11,5,30,4,0,0,4,4,30,10,1,0,11,2,30,5,6,0,11,3,30,4,0,0,4,1,-15,3,1
2,3,38,0,30,2,8,0,10,7,30,6,0,0,6,0,30,2,8,0,10,0,30,4,6,0,10,8,30,6,0,0,6,1,-15,3,1
2,2,39,0,30,5,6,0,11,6,30,6,0,0,6,0,30,5,6,0,11,3,30,3,8,0,11,4,30,5,0,0,5,1,-15,3,1
2,0,9,5,30,3,1,0,4,3,30,2,0,0,2,2,30,4,0,0,4,0,30,0,4,0,4,0,30,0,1,0,1,0,-27,3,0
2,1,9,5,30,3,1,0,4,3,30,2,0,0,2,2,30,4,0,0,4,0,30,0,4,0,4,0,30,0,1,0,1,0,-27,3,0
2,4,9,5,30,3,1,0,4,3,30,2,0,0,2,2,30,4,0,0,4,0,30,0,4,0,4,0,30,0,1,0,1,0,-27,3,0
2,4,13,4,30,7,0,0,7,0,30,4,0,0,4,0,30,6,1,0,7,12,30,5,2,0,7,3,30,4,0,0,4,1,-15,3,1
2,4,19,0,30,9,4,0,13,1,30,5,3,0,8,2,30,6,7,0,13,0,30,6,7,0,13,0,30,8,1,0,9,1,-15,3,1
2,4,22,1,30,4,4,0,8,1,30,2,0,0,2,0,30,5,3,0,8,4,30,3,5,0,8,2,30,4,0,0,4,1,-15,3,1
2,2,27,1,30,4,11,0,15,5,30,2,0,0,2,0,30,5,10,0,15,0,30,4,11,0,15,6,30,6,0,0,6,1,-15,3,1
2,1,29,0,30,2,12,0,14,3,30,12,0,0,12,3,30,10,4,0,14,0,30,3,11,0,14,0,30,7,2,0,9,1,-15,3,1
2,2,29,0,30,2,12,0,14,3,30,12,0,0,12,3,30,10,4,0,14,0,30,3,11,0,14,0,30,7,2,0,9,1,-15,3,1
2,3,29,0,30,2,12,0,14,3,30,12,0,0,12,3,30,10,4,0,14,0,30,3,11,0,14,0,30,7,2,0,9,1,-15,3,1
2,4,29,0,30,2,12,0,14,3,30,12,0,0,12,3,30,10,4,0,14,0,30,3,11,0,14,0,30,7,2,0,9,1,-15,3,1
2,4,3,4,30,2,2,0,4,3,30,4,0,0,4,0,30,3,1,0,4,0,30,0,4,0,4,0,30,1,2,0,3,0,-27,3,0
2,0,4,2,30,7,1,0,8,4,30,4,0,0,4,0,30,2,6,0,8,0,30,4,4,0,8,3,30,4,0,0,4,0,-27,3,0
2,4,8,3,30,7,0,0,7,4,30,2,0,0,2,3,30,4,3,0,7,0,30,5,2,0,7,1,30,3,0,0,3,0,-27,3,0
2,3,17,3,30,9,5,0,14,2,30,6,0,0,6,0,30,5,9,0,14,0,30,5,9,0,14,6,30,4,0,0,4,1,-15,3,1
2,4,19,0,30,9,4,0,13,2,30,8,0,0,8,4,30,4,9,0,13,0,30,5,8,0,13,4,30,7,2,0,9,1,-15,3,1
2,0,25,1,30,5,9,0,14,5,30,6,0,0,6,0,30,7,7,0,14,2,30,10,4,0,14,5,30,6,0,0,6,1,-15,3,1
2,2,25,1,30,5,9,0,14,5,30,6,0,0,6,0,30,7,7,0,14,2,30,10,4,0,14,5,30,6,0,0,6,1,-15,3,1
2,3,25,1,30,5,9,0,14,5,30,6,0,0,6,0,30,7,7,0,14,2,30,10,4,0,14,5,30,6,0,0,6,1,-15,3,1
2,4,29,0,30,8,6,0,14,6,30,11,1,0,12,0,30,3,11,0,14,0,30,2,12,0,14,1,30,9,0,0,9,1,-15,3,1
2,4,3,1,30,4,7,0,11,3,30,8,0,0,8,0,30,5,6,0,11,12,30,4,7,0,11,1,30,2,5,0,7,0,-27,3,0
2,2,5,0,30,2,3,0,5,3,30,2,2,0,4,0,30,0,5,0,5,0,30,3,2,0,5,0,30,0,2,0,2,0,-27,3,0
2,3,5,0,30,2,3,0,5,3,30,2,2,0,4,0,30,0,5,0,5,0,30,3,2,0,5,0,30,0,2,0,2,0,-27,3,0
2,3,8,4,30,7,0,0,7,4,30,2,0,0,2,0,30,3,4,0,7,0,30,4,3,0,7,0,30,3,0,0,3,0,-27,3,0
2,4,8,4,30,7,0,0,7,4,30,2,0,0,2,0,30,3,4,0,7,0,30,4,3,0,7,0,30,3,0,0,3,0,-27,3,0
2,1,13,3,30,6,1,0,7,0,30,4,0,0,4,5,30,6,1,0,7,5,30,6,1,0,7,3,30,4,0,0,4,1,-15,3,1
2,2,11,0,30,4,8,0,12,1,30,4,0,0,4,6,30,5,7,0,12,3,30,6,6,0,12,4,30,4,0,0,4,1,-15,3,1
2,4,11,0,30,4,8,0,12,1,30,4,0,0,4,6,30,5,7,0,12,3,30,6,6,0,12,4,30,4,0,0,4,1,-15,3,1
2,2,13,2,30,5,2,0,7,0,30,4,0,0,4,1,30,6,1,0,7,5,30,6,1,0,7,2,30,4,0,0,4,1,-15,3,1
2,4,13,2,30,5,2,0,7,0,30,4,0,0,4,1,30,6,1,0,7,5,30,6,1,0,7,2,30,4,0,0,4,1,-15,3,1
2,3,15,1,30,7,6,0,13,1,30,6,0,0,6,0,30,3,10,0,13,1,30,3,10,0,13,1,30,6,3,0,9,1,-15,3,1
2,3,23,1,30,7,6,0,13,1,30,6,0,0,6,2,30,9,4,0,13,0,30,5,8,0,13,1,30,6,0,0,6,1,-15,3,1
2,3,25,2,30,7,7,0,14,5,30,6,0,0,6,0,30,8,6,0,14,1,30,5,9,0,14,3,30,5,1,0,6,1,-15,3,1
2,4,25,2,30,7,7,0,14,5,30,6,0,0,6,0,30,8,6,0,14,1,30,5,9,0,14,3,30,5,1,0,6,1,-15,3,1
2,0,26,0,30,8,1,0,9,4,30,4,0,0,4,4,30,1,8,0,9,0,30,2,7,0,9,6,30,3,0,0,3,1,-15,3,1
2,0,27,1,30,4,11,0,15,3,30,2,0,0,2,0,30,5,10,0,15,1,30,5,10,0,15,2,30,6,0,0,6,1,-15,3,1
2,2,27,1,30,4,11,0,15,3,30,2,0,0,2,0,30,5,10,0,15,1,30,5,10,0,15,2,30,6,0,0,6,1,-15,3,1
2,3,27,1,30,4,11,0,15,3,30,2,0,0,2,0,30,5,10,0,15,1,30,5,10,0,15,2,30,6,0,0,6,1,-15,3,1
2,2,4,3,30,7,1,0,8,4,30,4,0,0,4,0,30,2,6,0,8,0,30,5,3,0,8,4,30,4,0,0,4,0,-27,3,0
2,2,17,5,30,9,5,0,14,3,30,6,0,0,6,0,30,4,10,0,14,1,30,5,9,0,14,0,30,4,0,0,4,1,-15,3,1
2,4,19,0,30,4,9,0,13,2,30,2,6,0,8,0,30,8,5,0,13,8,30,2,11,0,13,0,30,9,0,0,9,1,-15,3,1
2,2,21,1,30,6,4,0,10,4,30,6,0,0,6,1,30,2,8,0,10,1,30,3,7,0,10,4,30,4,0,0,4,1,-15,3,1
2,3,21,1,30,6,4,0,10,4,30,6,0,0,6,1,30,2,8,0,10,1,30,3,7,0,10,4,30,4,0,0,4,1,-15,3,1
2,1,25,2,30,7,7,0,14,5,30,6,0,0,6,0,30,4,10,0,14,1,30,6,8,0,14,4,30,5,1,0,6,1,-15,3,1
2,2,25,2,30,7,7,0,14,5,30,6,0,0,6,0,30,4,10,0,14,1,30,6,8,0,14,4,30,5,1,0,6,1,-15,3,1
2,1,27,7,30,4,11,0,15,4,30,1,1,0,2,0,30,3,12,0,15,0,30,3,12,0,15,2,30,6,0,0,6,1,-15,3,1
2,2,27,7,30,4,11,0,15,4,30,1,1,0,2,0,30,3,12,0,15,0,30,3,12,0,15,2,30,6,0,0,6,1,-15,3,1
2,3,27,7,30,4,11,0,15,4,30,1,1,0,2,0,30,3,12,0,15,0,30,3,12,0,15,2,30,6,0,0,6,1,-15,3,1
2,2,19,0,30,3,10,0,13,2,30,6,2,0,8,0,30,5,8,0,13,6,30,5,8,0,13,2,30,7,2,0,9,1,-15,3,1
2,4,19,0,30,3,10,0,13,2,30,6,2,0,8,0,30,5,8,0,13,6,30,5,8,0,13,2,30,7,2,0,9,1,-15,3,1
2,2,27,0,30,4,11,0,15,2,30,2,0,0,2,0,30,6,9,0,15,0,30,10,5,0,15,1,30,3,3,0,6,1,-15,3,1
2,3,27,0,30,4,11,0,15,2,30,2,0,0,2,0,30,6,9,0,15,0,30,10,5,0,15,1,30,3,3,0,6,1,-15,3,1
2,4,27,0,30,4,11,0,15,2,30,2,0,0,2,0,30,6,9,0,15,0,30,10,5,0,15,1,30,3,3,0,6,1,-15,3,1
2,3,29,1,30,9,5,0,14,6,30,10,2,0,12,0,30,3,11,0,14,0,30,3,11,0,14,5,30,9,0,0,9,1,-15,3,1
2,4,29,1,30,9,5,0,14,6,30,10,2,0,12,0,30,3,11,0,14,0,30,3,11,0,14,5,30,9,0,0,9,1,-15,3,1
2,4,31,3,30,3,9,0,12,5,30,8,0,0,8,4,30,11,1,0,12,0,30,3,9,0,12,0,30,5,1,0,6,1,-15,3,1
2,3,35,0,30,6,7,0,13,6,30,2,0,0,2,1,30,2,11,0,13,0,30,3,10,0,13,6,30,8,0,0,8,1,-15,3,1
2,2,13,2,30,7,0,0,7,0,30,4,0,0,4,2,30,7,0,0,7,11,30,4,3,0,7,4,30,4,0,0,4,1,-15,3,1
2,4,13,2,30,7,0,0,7,0,30,4,0,0,4,2,30,7,0,0,7,11,30,4,3,0,7,4,30,4,0,0,4,1,-15,3,1
2,4,15,0,30,3,10,0,13,1,30,6,0,0,6,0,30,3,10,0,13,1,30,6,7,0,13,2,30,8,1,0,9,1,-15,3,1
2,1,17,4,30,9,5,0,14,4,30,6,0,0,6,0,30,5,9,0,14,4,30,7,7,0,14,2,30,4,0,0,4,1,-15,3,1
2,2,17,4,30,9,5,0,14,4,30,6,0,0,6,0,30,5,9,0,14,4,30,7,7,0,14,2,30,4,0,0,4,1,-15,3,1
2,4,17,4,30,9,5,0,14,4,30,6,0,0,6,0,30,5,9,0,14,4,30,7,7,0,14,2,30,4,0,0,4,1,-15,3,1
2,3,23,1,30,6,7,0,13,2,30,6,0,0,6,3,30,11,2,0,13,0,30,4,9,0,13,3,30,6,0,0,6,1,-15,3,1
2,4,23,1,30,6,7,0,13,2,30,6,0,0,6,3,30,11,2,0,13,0,30,4,9,0,13,3,30,6,0,0,6,1,-15,3,1
2,4,25,1,30,9,5,0,14,3,30,6,0,0,6,0,30,5,9,0,14,1,30,6,8,0,14,3,30,5,1,0,6,1,-15,3,1
2,3,27,3,30,5,10,0,15,5,30,1,1,0,2,0,30,6,9,0,15,2,30,4,11,0,15,1,30,6,0,0,6,1,-15,3,1
2,4,29,0,30,7,7,0,14,4,30,12,0,0,12,0,30,5,9,0,14,0,30,0,14,0,14,0,30,8,1,0,9,1,-15,3,1
2,1,31,3,30,5,7,0,12,4,30,8,0,0,8,3,30,10,2,0,12,0,30,4,8,0,12,0,30,5,1,0,6,1,-15,3,1
2,3,36,0,30,3,6,0,9,6,30,0,2,0,2,7,30,3,6,0,9,0,30,4,5,0,9,6,30,3,0,0,3,1,-15,3,1
2,4,36,0,30,3,6,0,9,6,30,0,2,0,2,7,30,3,6,0,9,0,30,4,5,0,9,6,30,3,0,0,3,1,-15,3,1
2,3,39,0,30,2,9,0,11,6,30,6,0,0,6,0,30,7,4,0,11,2,30,4,7,0,11,3,30,5,0,0,5,1,-15,3,1
2,0,5,0,30,2,3,0,5,3,30,2,2,0,4,0,30,1,4,0,5,2,30,2,3,0,5,2,30,2,0,0,2,0,-27,3,0
2,4,5,0,30,2,3,0,5,3,30,2,2,0,4,0,30,1,4,0,5,2,30,2,3,0,5,2,30,2,0,0,2,0,-27,3,0
2,1,11,0,30,4,8,0,12,0,30,4,0,0,4,0,30,5,7,0,12,9,30,6,6,0,12,8,30,4,0,0,4,1,-15,3,1
2,1,13,4,30,6,1,0,7,0,30,4,0,0,4,4,30,6,1,0,7,9,30,5,2,0,7,0,30,4,0,0,4,1,-15,3,1
2,3,19,0,30,5,8,0,13,1,30,4,4,0,8,0,30,7,6,0,13,0,30,3,10,0,13,0,30,9,0,0,9,1,-15,3,1
2,4,25,0,30,5,9,0,14,4,30,6,0,0,6,0,30,8,6,0,14,1,30,5,9,0,14,4,30,5,1,0,6,1,-15,3,1
2,0,27,1,30,5,10,0,15,4,30,2,0,0,2,0,30,5,10,0,15,2,30,8,7,0,15,4,30,6,0,0,6,1,-15,3,1
2,1,27,1,30,5,10,0,15,4,30,2,0,0,2,0,30,5,10,0,15,2,30,8,7,0,15,4,30,6,0,0,6,1,-15,3,1
2,0,29,0,30,9,5,0,14,6,30,9,3,0,12,0,30,5,9,0,14,0,30,1,13,0,14,4,30,9,0,0,9,1,-15,3,1
2,1,29,0,30,9,5,0,14,6,30,9,3,0,12,0,30,5,9,0,14,0,30,1,13,0,14,4,30,9,0,0,9,1,-15,3,1
2,2,29,0,30,9,5,0,14,6,30,9,3,0,12,0,30,5,9,0,14,0,30,1,13,0,14,4,30,9,0,0,9,1,-15,3,1
2,3,29,0,30,9,5,0,14,6,30,9,3,0,12,0,30,5,9,0,14,0,30,1,13,0,14,4,30,9,0,0,9,1,-15,3,1
2,3,35,1,30,8,5,0,13,4,30,2,0,0,2,1,30,2,11,0,13,1,30,2,11,0,13,0,30,7,1,0,8,1,-15,3,1
2,2,36,6,30,4,5,0,9,7,30,2,0,0,2,0,30,2,7,0,9,6,30,4,5,0,9,6,30,2,1,0,3,1,-15,3,1
2,3,36,6,30,4,5,0,9,7,30,2,0,0,2,0,30,2,7,0,9,6,30,4,5,0,9,6,30,2,1,0,3,1,-15,3,1
2,4,36,6,30,4,5,0,9,7,30,2,0,0,2,0,30,2,7,0,9,6,30,4,5,0,9,6,30,2,1,0,3,1,-15,3,1
2,1,41,0,30,9,3,0,12,6,30,6,2,0,8,0,30,7,5,0,12,0,30,3,9,0,12,5,30,5,2,0,7,1,-15,3,1
2,3,43,6,30,5,9,0,14,10,30,6,0,0,6,0,30,4,10,0,14,0,30,5,9,0,14,4,30,5,0,0,5,1,-15,3,1
2,4,43,6,30,5,9,0,14,10,30,6,0,0,6,0,30,4,10,0,14,0,30,5,9,0,14,4,30,5,0,0,5,1,-15,3,1
2,0,4,2,30,8,0,0,8,5,30,4,0,0,4,2,30,1,7,0,8,1,30,8,0,0,8,1,30,3,1,0,4,0,-27,3,0
2,2,4,0,30,8,0,0,8,5,30,4,0,0,4,2,30,1,7,0,8,1,30,8,0,0,8,1,30,3,1,0,4,0,-27,3,0
2,2,19,0,30,2,11,0,13,2,30,8,0,0,8,0,30,6,7,0,13,5,30,5,8,0,13,0,30,8,1,0,9,1,-15,3,1
2,3,19,0,30,2,11,0,13,2,30,8,0,0,8,0,30,6,7,0,13,5,30,5,8,0,13,0,30,8,1,0,9,1,-15,3,1
2,4,23,1,30,7,6,0,13,0,30,6,0,0,6,3,30,13,0,0,13,0,30,5,8,0,13,2,30,6,0,0,6,1,-15,3,1
2,2,25,2,30,6,8,0,14,5,30,6,0,0,6,0,30,6,8,0,14,3,30,4,10,0,14,5,30,5,1,0,6,1,-15,3,1
2,3,25,2,30,6,8,0,14,5,30,6,0,0,6,0,30,6,8,0,14,3,30,4,10,0,14,5,30,5,1,0,6,1,-15,3,1
2,4,25,2,30,6,8,0,14,5,30,6,0,0,6,0,30,6,8,0,14,3,30,4,10,0,14,5,30,5,1,0,6,1,-15,3,1
2,3,27,1,30,4,11,0,15,3,30,2,0,0,2,0,30,6,9,0,15,2,30,4,11,0,15,2,30,6,0,0,6,1,-15,3,1
2,4,27,1,30,4,11,0,15,3,30,2,0,0,2,0,30,6,9,0,15,2,30,4,11,0,15,2,30,6,0,0,6,1,-15,3,1
2,0,4,2,30,7,1,0,8,5,30,4,0,0,4,1,30,1,7,0,8,1,30,8,0,0,8,2,30,2,2,0,4,0,-27,3,0
2,1,4,2,30,7,1,0,8,5,30,4,0,0,4,1,30,1,7,0,8,1,30,8,0,0,8,2,30,2,2,0,4,0,-27,3,0
2,2,4,2,30,7,1,0,8,5,30,4,0,0,4,1,30,1,7,0,8,1,30,8,0,0,8,2,30,2,2,0,4,0,-27,3,0
2,3,4,2,30,7,1,0,8,5,30,4,0,0,4,1,30,1,7,0,8,1,30,8,0,0,8,2,30,2,2,0,4,0,-27,3,0
2,2,11,0,30,5,7,0,12,0,30,4,0,0,4,0,30,6,6,0,12,4,30,5,7,0,12,3,30,4,0,0,4,1,-15,3,1
2,3,11,0,30,5,7,0,12,0,30,4,0,0,4,0,30,6,6,0,12,4,30,5,7,0,12,3,30,4,0,0,4,1,-15,3,1
2,4,11,0,30,5,7,0,12,0,30,4,0,0,4,0,30,6,6,0,12,4,30,5,7,0,12,3,30,4,0,0,4,1,-15,3,1
2,2,13,2,30,7,0,0,7,0,30,4,0,0,4,2,30,6,1,0,7,5,30,6,1,0,7,5,30,4,0,0,4,1,-15,3,1
2,4,13,2,30,7,0,0,7,0,30,4,0,0,4,2,30,6,1,0,7,5,30,6,1,0,7,5,30,4,0,0,4,1,-15,3,1
2,4,15,2,30,4,9,0,13,1,30,6,0,0,6,0,30,4,9,0,13,1,30,3,10,0,13,3,30,9,0,0,9,1,-15,3,1
2,1,19,0,30,3,10,0,13,1,30,6,2,0,8,1,30,12,1,0,13,5,30,5,8,0,13,2,30,7,2,0,9,1,-15,3,1
2,2,19,0,30,3,10,0,13,1,30,6,2,0,8,1,30,12,1,0,13,5,30,5,8,0,13,2,30,7,2,0,9,1,-15,3,1
2,4,25,1,30,7,7,0,14,4,30,6,0,0,6,1,30,9,5,0,14,1,30,5,9,0,14,0,30,5,1,0,6,1,-15,3,1
2,3,27,1,30,11,4,0,15,1,30,2,0,0,2,0,30,6,9,0,15,0,30,4,11,0,15,0,30,5,1,0,6,1,-15,3,1
2,4,27,1,30,11,4,0,15,1,30,2,0,0,2,0,30,6,9,0,15,0,30,4,11,0,15,0,30,5,1,0,6,1,-15,3,1
2,0,29,0,30,8,6,0,14,5,30,9,3,0,12,0,30,6,8,0,14,0,30,1,13,0,14,4,30,9,0,0,9,1,-15,3,1
2,3,29,0,30,8,6,0,14,5,30,9,3,0,12,0,30,6,8,0,14,0,30,1,13,0,14,4,30,9,0,0,9,1,-15,3,1
2,0,31,1,30,2,10,0,12,7,30,8,0,0,8,3,30,4,8,0,12,0,30,10,2,0,12,4,30,6,0,0,6,1,-15,3,1
2,2,31,1,30,2,10,0,12,7,30,8,0,0,8,3,30,4,8,0,12,0,30,10,2,0,12,4,30,6,0,0,6,1,-15,3,1
2,3,35,1,30,10,3,0,13,6,30,2,0,0,2,0,30,4,9,0,13,0,30,9,4,0,13,8,30,8,0,0,8,1,-15,3,1
2,4,39,0,30,1,10,0,11,7,30,6,0,0,6,0,30,4,7,0,11,2,30,4,7,0,11,3,30,5,0,0,5,1,-15,3,1
2,0,4,3,30,8,0,0,8,5,30,4,0,0,4,0,30,1,7,0,8,0,30,5,3,0,8,2,30,4,0,0,4,0,-27,3,0
2,1,4,3,30,8,0,0,8,5,30,4,0,0,4,0,30,1,7,0,8,0,30,5,3,0,8,2,30,4,0,0,4,0,-27,3,0
2,2,4,3,30,8,0,0,8,5,30,4,0,0,4,0,30,1,7,0,8,0,30,5,3,0,8,2,30,4,0,0,4,0,-27,3,0
2,4,8,1,30,7,0,0,7,2,30,2,0,0,2,6,30,3,4,0,7,6,30,7,0,0,7,0,30,3,0,0,3,0,-27,3,0
2,2,11,2,30,6,6,0,12,1,30,4,0,0,4,0,30,7,5,0,12,3,30,3,9,0,12,0,30,4,0,0,4,1,-15,3,1
2,3,11,2,30,6,6,0,12,1,30,4,0,0,4,0,30,7,5,0,12,3,30,3,9,0,12,0,30,4,0,0,4,1,-15,3,1
2,4,15,1,30,4,9,0,13,1,30,6,0,0,6,0,30,4,9,0,13,1,30,6,7,0,13,2,30,6,3,0,9,1,-15,3,1
2,1,19,0,30,8,5,0,13,1,30,5,3,0,8,0,30,4,9,0,13,3,30,4,9,0,13,0,30,8,1,0,9,1,-15,3,1
2,2,19,0,30,8,5,0,13,1,30,5,3,0,8,0,30,4,9,0,13,3,30,4,9,0,13,0,30,8,1,0,9,1,-15,3,1
2,4,19,0,30,8,5,0,13,1,30,5,3,0,8,0,30,4,9,0,13,3,30,4,9,0,13,0,30,8,1,0,9,1,-15,3,1
2,0,21,5,30,6,4,0,10,4,30,5,1,0,6,1,30,4,6,0,10,2,30,5,5,0,10,2,30,4,0,0,4,1,-15,3,1
2,4,21,5,30,6,4,0,10,4,30,5,1,0,6,1,30,4,6,0,10,1,30,5,5,0,10,2,30,4,0,0,4,1,-15,3,1
2,3,22,2,30,8,0,0,8,3,30,2,0,0,2,0,30,5,3,0,8,0,30,5,3,0,8,3,30,4,0,0,4,1,-15,3,1
2,3,23,2,30,5,8,0,13,3,30,6,0,0,6,2,30,11,2,0,13,0,30,7,6,0,13,4,30,6,0,0,6,1,-15,3,1
2,2,25,1,30,6,8,0,14,4,30,6,0,0,6,0,30,5,9,0,14,1,30,9,5,0,14,3,30,6,0,0,6,1,-15,3,1
2,2,31,4,30,6,6,0,12,7,30,8,0,0,8,3,30,4,8,0,12,0,30,3,9,0,12,0,30,5,1,0,6,1,-15,3,1
2,2,5,0,30,1,4,0,5,3,30,1,3,0,4,0,30,0,5,0,5,0,30,2,3,0,5,3,30,2,0,0,2,0,-27,3,0
2,4,5,0,30,1,4,0,5,3,30,1,3,0,4,0,30,0,5,0,5,0,30,2,3,0,5,3,30,2,0,0,2,0,-27,3,0
2,3,6,1,30,5,4,0,9,4,30,2,0,0,2,0,30,2,7,0,9,0,30,5,4,0,9,2,30,5,0,0,5,0,-27,3,0
2,4,8,6,30,7,0,0,7,3,30,2,0,0,2,0,30,4,3,0,7,0,30,1,6,0,7,1,30,3,0,0,3,0,-27,3,0
2,2,19,0,30,3,10,0,13,0,30,5,3,0,8,0,30,4,9,0,13,0,30,5,8,0,13,0,30,8,1,0,9,1,-15,3,1
2,3,19,0,30,3,10,0,13,0,30,5,3,0,8,0,30,4,9,0,13,0,30,5,8,0,13,0,30,8,1,0,9,1,-15,3,1
2,4,29,0,30,5,9,0,14,6,30,12,0,0,12,0,30,5,9,0,14,0,30,0,14,0,14,0,30,9,0,0,9,1,-15,3,1
2,1,31,3,30,9,3,0,12,4,30,8,0,0,8,4,30,9,3,0,12,0,30,4,8,0,12,4,30,2,4,0,6,1,-15,3,1
2,4,31,3,30,9,3,0,12,4,30,8,0,0,8,4,30,9,3,0,12,0,30,4,8,0,12,4,30,2,4,0,6,1,-15,3,1
2,2,13,5,30,7,0,0,7,2,30,4,0,0,4,2,30,5,2,0,7,5,30,5,2,0,7,2,30,4,0,0,4,1,-15,3,1
2,3,13,5,30,7,0,0,7,2,30,4,0,0,4,2,30,5,2,0,7,5,30,5,2,0,7,2,30,4,0,0,4,1,-15,3,1
2,1,27,2,30,6,9,0,15,2,30,2,0,0,2,0,30,6,9,0,15,0,30,9,6,0,15,2,30,6,0,0,6,1,-15,3,1
2,3,31,2,30,7,5,0,12,4,30,8,0,0,8,3,30,9,3,0,12,2,30,4,8,0,12,0,30,3,3,0,6,1,-15,3,1
2,1,4,7,30,8,0,0,8,5,30,2,2,0,4,0,30,1,7,0,8,2,30,5,3,0,8,2,30,3,1,0,4,0,-27,3,0
2,3,4,7,30,8,0,0,8,5,30,2,2,0,4,0,30,1,7,0,8,2,30,5,3,0,8,2,30,3,1,0,4,0,-27,3,0
2,4,8,4,30,7,0,0,7,4,30,2,0,0,2,3,30,3,4,0,7,0,30,6,1,0,7,1,30,3,0,0,3,0,-27,3,0
2,3,17,3,30,9,5,0,14,2,30,6,0,0,6,0,30,8,6,0,14,4,30,6,8,0,14,6,30,4,0,0,4,1,-15,3,1
2,4,17,3,30,9,5,0,14,2,30,6,0,0,6,0,30,8,6,0,14,4,30,6,8,0,14,6,30,4,0,0,4,1,-15,3,1
2,2,19,1,30,2,11,0,13,2,30,5,3,0,8,0,30,6,7,0,13,1,30,5,8,0,13,2,30,9,0,0,9,1,-15,3,1
2,3,19,1,30,2,11,0,13,2,30,5,3,0,8,0,30,6,7,0,13,1,30,5,8,0,13,2,30,9,0,0,9,1,-15,3,1
2,2,25,1,30,7,7,0,14,5,30,6,0,0,6,0,30,4,10,0,14,1,30,5,9,0,14,7,30,6,0,0,6,1,-15,3,1
2,3,25,1,30,7,7,0,14,5,30,6,0,0,6,0,30,4,10,0,14,1,30,5,9,0,14,7,30,6,0,0,6,1,-15,3,1
2,4,29,0,30,5,9,0,14,5,30,12,0,0,12,0,30,7,7,0,14,0,30,1,13,0,14,0,30,7,2,0,9,1,-15,3,1
2,1,31,3,30,5,7,0,12,5,30,8,0,0,8,6,30,11,1,0,12,0,30,3,9,0,12,2,30,4,2,0,6,1,-15,3,1
2,4,31,3,30,5,7,0,12,5,30,8,0,0,8,6,30,11,1,0,12,0,30,3,9,0,12,2,30,4,2,0,6,1,-15,3,1
2,0,5,0,30,4,1,0,5,3,30,2,2,0,4,2,30,2,3,0,5,0,30,1,4,0,5,1,30,0,2,0,2,0,-27,3,0
2,1,5,0,30,4,1,0,5,3,30,2,2,0,4,2,30,2,3,0,5,0,30,1,4,0,5,1,30,0,2,0,2,0,-27,3,0
2,3,5,0,30,4,1,0,5,3,30,2,2,0,4,2,30,2,3,0,5,0,30,1,4,0,5,1,30,0,2,0,2,0,-27,3,0
2,4,5,0,30,4,1,0,5,3,30,2,2,0,4,2,30,2,3,0,5,0,30,1,4,0,5,1,30,0,2,0,2,0,-27,3,0
2,4,15,0,30,6,7,0,13,0,30,6,0,0,6,0,30,4,9,0,13,1,30,3,10,0,13,2,30,7,2,0,9,1,-15,3,1
2,1,17,3,30,10,4,0,14,2,30,6,0,0,6,0,30,6,8,0,14,3,30,5,9,0,14,2,30,4,0,0,4,1,-15,3,1
2,0,19,0,30,3,10,0,13,1,30,8,0,0,8,4,30,5,8,0,13,6,30,4,9,0,13,1,30,6,3,0,9,1,-15,3,1
2,1,19,0,30,3,10,0,13,1,30,8,0,0,8,4,30,5,8,0,13,6,30,4,9,0,13,1,30,6,3,0,9,1,-15,3,1
2,3,19,0,30,3,10,0,13,1,30,8,0,0,8,4,30,5,8,0,13,6,30,4,9,0,13,1,30,6,3,0,9,1,-15,3,1
2,4,19,0,30,3,10,0,13,1,30,8,0,0,8,4,30,5,8,0,13,6,30,4,9,0,13,1,30,6,3,0,9,1,-15,3,1
2,4,23,1,30,5,8,0,13,4,30,6,0,0,6,7,30,11,2,0,13,0,30,4,9,0,13,2,30,6,0,0,6,1,-15,3,1
2,3,25,2,30,3,11,0,14,4,30,6,0,0,6,1,30,12,2,0,14,0,30,6,8,0,14,4,30,5,1,0,6,1,-15,3,1
2,3,35,0,30,7,6,0,13,3,30,2,0,0,2,3,30,11,2,0,13,0,30,1,12,0,13,2,30,7,1,0,8,1,-15,3,1
2,2,4,3,30,7,1,0,8,5,30,4,0,0,4,0,30,2,6,0,8,0,30,6,2,0,8,1,30,4,0,0,4,0,-27,3,0
2,0,5,0,30,3,2,0,5,3,30,0,4,0,4,0,30,0,5,0,5,5,30,1,4,0,5,0,30,0,2,0,2,0,-27,3,0
2,1,5,0,30,3,2,0,5,3,30,0,4,0,4,0,30,0,5,0,5,5,30,1,4,0,5,0,30,0,2,0,2,0,-27,3,0
2,4,5,0,30,3,2,0,5,3,30,0,4,0,4,0,30,0,5,0,5,5,30,1,4,0,5,0,30,0,2,0,2,0,-27,3,0
2,2,11,2,30,7,5,0,12,1,30,4,0,0,4,0,30,7,5,0,12,7,30,3,9,0,12,5,30,4,0,0,4,1,-15,3,1
2,4,11,2,30,7,5,0,12,1,30,4,0,0,4,0,30,7,5,0,12,7,30,3,9,0,12,5,30,4,0,0,4,1,-15,3,1
2,4,13,1,30,6,1,0,7,0,30,4,0,0,4,2,30,5,2,0,7,11,30,7,0,0,7,2,30,4,0,0,4,1,-15,3,1
2,0,21,3,30,8,2,0,10,4,30,6,0,0,6,1,30,3,7,0,10,3,30,5,5,0,10,0,30,4,0,0,4,1,-15,3,1
2,3,23,3,30,10,3,0,13,1,30,6,0,0,6,4,30,11,2,0,13,0,30,6,7,0,13,1,30,6,0,0,6,1,-15,3,1
2,2,25,2,30,5,9,0,14,4,30,6,0,0,6,0,30,8,6,0,14,1,30,5,9,0,14,4,30,5,1,0,6,1,-15,3,1
2,3,25,2,30,5,9,0,14,4,30,6,0,0,6,0,30,8,6,0,14,1,30,5,9,0,14,4,30,5,1,0,6,1,-15,3,1
2,4,25,2,30,5,9,0,14,4,30,6,0,0,6,0,30,8,6,0,14,1,30,5,9,0,14,4,30,5,1,0,6,1,-15,3,1
2,0,27,1,30,4,11,0,15,2,30,2,0,0,2,0,30,5,10,0,15,2,30,4,11,0,15,4,30,6,0,0,6,1,-15,3,1
2,2,27,1,30,4,11,0,15,2,30,2,0,0,2,0,30,5,10,0,15,2,30,4,11,0,15,4,30,6,0,0,6,1,-15,3,1
2,0,41,0,30,8,4,0,12,6,30,8,0,0,8,0,30,3,9,0,12,1,30,4,8,0,12,6,30,7,0,0,7,1,-15,3,1
2,4,3,0,30,1,3,0,4,2,30,4,0,0,4,0,30,1,3,0,4,0,30,1,3,0,4,0,30,1,2,0,3,0,-27,3,0
2,2,13,2,30,6,1,0,7,0,30,4,0,0,4,2,30,7,0,0,7,7,30,5,2,0,7,4,30,3,1,0,4,1,-15,3,1
2,4,17,2,30,9,5,0,14,3,30,6,0,0,6,0,30,6,8,0,14,4,30,7,7,0,14,5,30,4,0,0,4,1,-15,3,1
2,2,19,0,30,5,8,0,13,2,30,8,0,0,8,0,30,4,9,0,13,3,30,4,9,0,13,3,30,9,0,0,9,1,-15,3,1
2,3,19,0,30,5,8,0,13,2,30,8,0,0,8,0,30,4,9,0,13,3,30,4,9,0,13,3,30,9,0,0,9,1,-15,3,1
2,4,23,3,30,6,7,0,13,3,30,6,0,0,6,7,30,12,1,0,13,0,30,6,7,0,13,2,30,5,1,0,6,1,-15,3,1
2,2,25,1,30,5,9,0,14,5,30,6,0,0,6,0,30,7,7,0,14,1,30,5,9,0,14,4,30,5,1,0,6,1,-15,3,1
2,2,27,1,30,3,12,0,15,3,30,2,0,0,2,0,30,5,10,0,15,2,30,4,11,0,15,4,30,6,0,0,6,1,-15,3,1
2,3,27,1,30,3,12,0,15,3,30,2,0,0,2,0,30,5,10,0,15,2,30,4,11,0,15,4,30,6,0,0,6,1,-15,3,1
2,3,32,0,30,5,4,0,9,4,30,2,0,0,2,1,30,9,0,0,9,1,30,2,7,0,9,2,30,2,0,0,2,1,-15,3,1
2,4,32,0,30,5,4,0,9,4,30,2,0,0,2,1,30,9,0,0,9,1,30,2,7,0,9,2,30,2,0,0,2,1,-15,3,1
2,3,35,0,30,5,8,0,13,4,30,2,0,0,2,1,30,7,6,0,13,1,30,6,7,0,13,7,30,8,0,0,8,1,-15,3,1
2,3,4,2,30,5,3,0,8,4,30,4,0,0,4,0,30,3,5,0,8,0,30,5,3,0,8,3,30,3,1,0,4,0,-27,3,0
2,3,15,1,30,5,8,0,13,0,30,6,0,0,6,0,30,4,9,0,13,1,30,3,10,0,13,2,30,5,4,0,9,1,-15,3,1
2,1,19,0,30,4,9,0,13,2,30,4,4,0,8,0,30,8,5,0,13,2,30,4,9,0,13,2,30,8,1,0,9,1,-15,3,1
2,4,19,0,30,4,9,0,13,2,30,4,4,0,8,0,30,8,5,0,13,2,30,4,9,0,13,2,30,8,1,0,9,1,-15,3,1
2,0,21,1,30,6,4,0,10,3,30,6,0,0,6,1,30,3,7,0,10,6,30,4,6,0,10,6,30,4,0,0,4,1,-15,3,1
2,2,21,1,30,6,4,0,10,3,30,6,0,0,6,1,30,3,7,0,10,6,30,4,6,0,10,6,30,4,0,0,4,1,-15,3,1
2,3,21,1,30,6,4,0,10,3,30,6,0,0,6,1,30,3,7,0,10,6,30,4,6,0,10,6,30,4,0,0,4,1,-15,3,1
2,2,23,2,30,5,8,0,13,3,30,6,0,0,6,2,30,11,2,0,13,4,30,6,7,0,13,5,30,6,0,0,6,1,-15,3,1
2,3,23,2,30,5,8,0,13,3,30,6,0,0,6,2,30,11,2,0,13,4,30,6,7,0,13,5,30,6,0,0,6,1,-15,3,1
2,0,25,1,30,9,5,0,14,5,30,6,0,0,6,0,30,6,8,0,14,1,30,7,7,0,14,4,30,6,0,0,6,1,-15,3,1
2,1,25,1,30,9,5,0,14,5,30,6,0,0,6,0,30,6,8,0,14,1,30,7,7,0,14,4,30,6,0,0,6,1,-15,3,1
2,0,27,1,30,8,7,0,15,3,30,2,0,0,2,0,30,2,13,0,15,1,30,4,11,0,15,3,30,6,0,0,6,1,-15,3,1
2,0,38,0,30,1,9,0,10,7,30,6,0,0,6,1,30,1,9,0,10,0,30,5,5,0,10,8,30,6,0,0,6,1,-15,3,1
2,3,38,0,30,1,9,0,10,7,30,6,0,0,6,1,30,1,9,0,10,0,30,5,5,0,10,8,30,6,0,0,6,1,-15,3,1
2,3,5,0,30,2,3,0,5,3,30,2,2,0,4,0,30,0,5,0,5,0,30,2,3,0,5,0,30,0,2,0,2,0,-27,3,0
2,3,6,2,30,9,0,0,9,4,30,2,0,0,2,0,30,2,7,0,9,0,30,4,5,0,9,0,30,1,4,0,5,0,-27,3,0
2,4,6,2,30,9,0,0,9,4,30,2,0,0,2,0,30,2,7,0,9,0,30,4,5,0,9,0,30,1,4,0,5,0,-27,3,0
2,4,8,3,30,7,0,0,7,4,30,2,0,0,2,0,30,2,5,0,7,0,30,7,0,0,7,1,30,3,0,0,3,0,-27,3,0
2,4,19,0,30,3,10,0,13,0,30,6,2,0,8,0,30,11,2,0,13,3,30,4,9,0,13,1,30,8,1,0,9,1,-15,3,1
2,0,25,0,30,3,11,0,14,5,30,6,0,0,6,0,30,4,10,0,14,2,30,11,3,0,14,6,30,6,0,0,6,1,-15,3,1
2,3,25,0,30,3,11,0,14,5,30,6,0,0,6,0,30,4,10,0,14,2,30,11,3,0,14,6,30,6,0,0,6,1,-15,3,1
2,4,25,0,30,3,11,0,14,5,30,6,0,0,6,0,30,4,10,0,14,2,30,11,3,0,14,6,30,6,0,0,6,1,-15,3,1
2,3,27,2,30,6,9,0,15,5,30,2,0,0,2,0,30,3,12,0,15,4,30,6,9,0,15,4,30,6,0,0,6,1,-15,3,1
2,1,11,1,30,5,7,0,12,0,30,4,0,0,4,0,30,6,6,0,12,7,30,3,9,0,12,5,30,4,0,0,4,1,-15,3,1
2,4,11,1,30,5,7,0,12,0,30,4,0,0,4,0,30,6,6,0,12,7,30,3,9,0,12,5,30,4,0,0,4,1,-15,3,1
2,2,13,2,30,6,1,0,7,1,30,4,0,0,4,2,30,6,1,0,7,11,30,7,0,0,7,5,30,4,0,0,4,1,-15,3,1
2,2,25,3,30,7,7,0,14,5,30,6,0,0,6,0,30,6,8,0,14,1,30,5,9,0,14,3,30,5,1,0,6,1,-15,3,1
2,4,25,3,30,7,7,0,14,5,30,6,0,0,6,0,30,6,8,0,14,1,30,5,9,0,14,3,30,5,1,0,6,1,-15,3,1
2,2,27,1,30,4,11,0,15,4,30,2,0,0,2,0,30,6,9,0,15,2,30,6,9,0,15,1,30,6,0,0,6,1,-15,3,1
2,3,27,1,30,4,11,0,15,4,30,2,0,0,2,0,30,6,9,0,15,2,30,6,9,0,15,1,30,6,0,0,6,1,-15,3,1
2,3,8,2,30,7,0,0,7,3,30,2,0,0,2,0,30,4,3,0,7,0,30,5,2,0,7,1,30,3,0,0,3,0,-27,3,0
2,4,13,1,30,6,1,0,7,0,30,4,0,0,4,2,30,6,1,0,7,10,30,6,1,0,7,6,30,4,0,0,4,1,-15,3,1
2,2,17,2,30,11,3,0,14,2,30,6,0,0,6,0,30,7,7,0,14,3,30,6,8,0,14,5,30,4,0,0,4,1,-15,3,1
2,4,17,2,30,11,3,0,14,2,30,6,0,0,6,0,30,7,7,0,14,3,30,6,8,0,14,5,30,4,0,0,4,1,-15,3,1
2,4,23,1,30,6,7,0,13,2,30,6,0,0,6,7,30,12,1,0,13,0,30,5,8,0,13,1,30,5,1,0,6,1,-15,3,1
2,3,25,3,30,6,8,0,14,4,30,6,0,0,6,0,30,10,4,0,14,0,30,5,9,0,14,3,30,5,1,0,6,1,-15,3,1
2,3,29,0,30,4,10,0,14,5,30,11,1,0,12,0,30,10,4,0,14,0,30,0,14,0,14,2,30,9,0,0,9,1,-15,3,1
2,4,5,0,30,3,2,0,5,3,30,3,1,0,4,0,30,0,5,0,5,0,30,1,4,0,5,0,30,2,0,0,2,0,-27,3,0
2,4,9,1,30,3,1,0,4,2,30,2,0,0,2,0,30,2,2,0,4,0,30,1,3,0,4,0,30,0,1,0,1,0,-27,3,0
2,4,13,3,30,6,1,0,7,0,30,4,0,0,4,2,30,6,1,0,7,11,30,5,2,0,7,3,30,4,0,0,4,1,-15,3,1
2,3,17,4,30,9,5,0,14,3,30,6,0,0,6,0,30,6,8,0,14,1,30,5,9,0,14,1,30,4,0,0,4,1,-15,3,1
2,2,19,0,30,4,9,0,13,2,30,5,3,0,8,0,30,8,5,0,13,2,30,6,7,0,13,2,30,8,1,0,9,1,-15,3,1
2,1,21,1,30,5,5,0,10,3,30,4,2,0,6,0,30,5,5,0,10,2,30,5,5,0,10,5,30,4,0,0,4,1,-15,3,1
2,2,21,1,30,5,5,0,10,3,30,4,2,0,6,0,30,5,5,0,10,2,30,5,5,0,10,5,30,4,0,0,4,1,-15,3,1
2,1,27,1,30,10,5,0,15,3,30,2,0,0,2,0,30,6,9,0,15,0,30,4,11,0,15,0,30,3,3,0,6,1,-15,3,1
2,3,27,1,30,10,5,0,15,3,30,2,0,0,2,0,30,6,9,0,15,0,30,4,11,0,15,0,30,3,3,0,6,1,-15,3,1
2,4,27,1,30,10,5,0,15,3,30,2,0,0,2,0,30,6,9,0,15,0,30,4,11,0,15,0,30,3,3,0,6,1,-15,3,1
2,4,29,0,30,6,8,0,14,5,30,12,0,0,12,0,30,7,7,0,14,0,30,1,13,0,14,1,30,9,0,0,9,1,-15,3,1
2,4,31,2,30,7,5,0,12,5,30,8,0,0,8,3,30,7,5,0,12,0,30,5,7,0,12,2,30,2,4,0,6,1,-15,3,1
2,2,38,0,30,3,7,0,10,8,30,6,0,0,6,0,30,1,9,0,10,0,30,6,4,0,10,8,30,6,0,0,6,1,-15,3,1
2,3,38,0,30,3,7,0,10,8,30,6,0,0,6,0,30,1,9,0,10,0,30,6,4,0,10,8,30,6,0,0,6,1,-15,3,1
2,1,9,0,30,2,2,0,4,2,30,2,0,0,2,2,30,2,2,0,4,3,30,1,3,0,4,0,30,1,0,0,1,0,-27,3,0
2,3,9,0,30,2,2,0,4,2,30,2,0,0,2,2,30,2,2,0,4,3,30,1,3,0,4,0,30,1,0,0,1,0,-27,3,0
2,1,17,3,30,9,5,0,14,3,30,6,0,0,6,0,30,4,10,0,14,2,30,5,9,0,14,9,30,4,0,0,4,1,-15,3,1
2,3,23,1,30,7,6,0,13,2,30,6,0,0,6,1,30,13,0,0,13,2,30,5,8,0,13,4,30,6,0,0,6,1,-15,3,1
2,2,25,2,30,9,5,0,14,5,30,6,0,0,6,0,30,6,8,0,14,1,30,7,7,0,14,3,30,5,1,0,6,1,-15,3,1
2,3,25,2,30,9,5,0,14,5,30,6,0,0,6,0,30,6,8,0,14,1,30,7,7,0,14,3,30,5,1,0,6,1,-15,3,1
2,2,31,1,30,8,4,0,12,5,30,8,0,0,8,3,30,8,4,0,12,0,30,3,9,0,12,1,30,4,2,0,6,1,-15,3,1
2,3,31,1,30,8,4,0,12,5,30,8,0,0,8,3,30,8,4,0,12,0,30,3,9,0,12,1,30,4,2,0,6,1,-15,3,1
2,4,31,1,30,8,4,0,12,5,30,8,0,0,8,3,30,8,4,0,12,0,30,3,9,0,12,1,30,4,2,0,6,1,-15,3,1
2,3,6,0,30,8,1,0,9,4,30,2,0,0,2,0,30,2,7,0,9,0,30,4,5,0,9,1,30,3,2,0,5,0,-27,3,0
2,1,13,1,30,6,1,0,7,0,30,4,0,0,4,8,30,7,0,0,7,9,30,6,1,0,7,0,30,4,0,0,4,1,-15,3,1
2,4,13,1,30,6,1,0,7,0,30,4,0,0,4,8,30,7,0,0,7,9,30,6,1,0,7,0,30,4,0,0,4,1,-15,3,1
2,4,15,0,30,5,8,0,13,0,30,6,0,0,6,0,30,3,10,0,13,1,30,2,11,0,13,2,30,8,1,0,9,1,-15,3,1
2,0,27,3,30,4,11,0,15,3,30,2,0,0,2,0,30,10,5,0,15,0,30,4,11,0,15,4,30,5,1,0,6,1,-15,3,1
2,1,27,3,30,4,11,0,15,3,30,2,0,0,2,0,30,10,5,0,15,0,30,4,11,0,15,4,30,5,1,0,6,1,-15,3,1
2,2,27,3,30,4,11,0,15,3,30,2,0,0,2,0,30,10,5,0,15,0,30,4,11,0,15,4,30,5,1,0,6,1,-15,3,1
2,3,27,3,30,4,11,0,15,3,30,2,0,0,2,0,30,10,5,0,15,0,30,4,11,0,15,4,30,5,1,0,6,1,-15,3,1
2,3,33,2,30,6,5,0,11,3,30,4,0,0,4,0,30,11,0,0,11,0,30,3,8,0,11,0,30,4,0,0,4,1,-15,3,1
2,0,5,2,30,4,1,0,5,3,30,0,4,0,4,0,30,0,5,0,5,0,30,1,4,0,5,0,30,0,2,0,2,0,-27,3,0
2,4,5,2,30,4,1,0,5,3,30,0,4,0,4,0,30,0,5,0,5,0,30,1,4,0,5,0,30,0,2,0,2,0,-27,3,0
2,3,19,0,30,2,11,0,13,2,30,5,3,0,8,0,30,10,3,0,13,2,30,5,8,0,13,3,30,9,0,0,9,1,-15,3,1
2,4,19,0,30,2,11,0,13,2,30,5,3,0,8,0,30,10,3,0,13,2,30,5,8,0,13,3,30,9,0,0,9,1,-15,3,1
2,0,27,1,30,4,11,0,15,3,30,2,0,0,2,0,30,3,12,0,15,5,30,5,10,0,15,5,30,6,0,0,6,1,-15,3,1
2,3,27,0,30,4,11,0,15,3,30,2,0,0,2,0,30,3,12,0,15,5,30,5,10,0,15,5,30,6,0,0,6,1,-15,3,1
2,4,27,0,30,4,11,0,15,3,30,2,0,0,2,0,30,3,12,0,15,5,30,5,10,0,15,5,30,6,0,0,6,1,-15,3,1
2,3,31,1,30,7,5,0,12,3,30,8,0,0,8,0,30,9,3,0,12,0,30,3,9,0,12,0,30,2,4,0,6,1,-15,3,1
2,3,45,0,30,3,10,0,13,7,30,10,0,0,10,0,30,2,11,0,13,0,30,4,9,0,13,7,30,5,0,0,5,1,-15,3,1
2,3,4,10,30,8,0,0,8,3,30,4,0,0,4,0,30,1,7,0,8,0,30,0,8,0,8,1,30,3,1,0,4,0,-27,3,0
2,1,5,2,30,5,0,0,5,3,30,2,2,0,4,0,30,0,5,0,5,0,30,1,4,0,5,0,30,0,2,0,2,0,-27,3,0
2,4,5,0,30,5,0,0,5,3,30,2,2,0,4,0,30,0,5,0,5,0,30,1,4,0,5,0,30,0,2,0,2,0,-27,3,0
2,3,11,3,30,5,7,0,12,1,30,4,0,0,4,0,30,6,6,0,12,5,30,4,8,0,12,4,30,4,0,0,4,1,-15,3,1
2,1,13,2,30,7,0,0,7,1,30,4,0,0,4,2,30,5,2,0,7,11,30,6,1,0,7,2,30,4,0,0,4,1,-15,3,1
2,4,13,2,30,7,0,0,7,1,30,4,0,0,4,0,30,5,2,0,7,11,30,6,1,0,7,2,30,4,0,0,4,1,-15,3,1
2,3,17,3,30,9,5,0,14,3,30,6,0,0,6,0,30,4,10,0,14,1,30,6,8,0,14,2,30,4,0,0,4,1,-15,3,1
2,4,19,0,30,2,11,0,13,2,30,8,0,0,8,0,30,5,8,0,13,0,30,6,7,0,13,2,30,9,0,0,9,1,-15,3,1
2,3,25,1,30,1,13,0,14,5,30,6,0,0,6,0,30,9,5,0,14,2,30,8,6,0,14,4,30,6,0,0,6,1,-15,3,1
2,3,27,0,30,5,10,0,15,3,30,1,1,0,2,0,30,3,12,0,15,0,30,2,13,0,15,2,30,6,0,0,6,1,-15,3,1
2,4,27,0,30,5,10,0,15,3,30,1,1,0,2,0,30,3,12,0,15,0,30,2,13,0,15,2,30,6,0,0,6,1,-15,3,1
2,2,35,2,30,9,4,0,13,3,30,1,1,0,2,1,30,12,1,0,13,1,30,2,11,0,13,5,30,8,0,0,8,1,-15,3,1
2,3,35,2,30,9,4,0,13,3,30,1,1,0,2,1,30,12,1,0,13,1,30,2,11,0,13,5,30,8,0,0,8,1,-15,3,1
2,4,8,0,30,7,0,0,7,4,30,2,0,0,2,0,30,4,3,0,7,0,30,3,4,0,7,5,30,3,0,0,3,0,-27,3,0
2,4,23,1,30,7,6,0,13,1,30,6,0,0,6,7,30,10,3,0,13,0,30,5,8,0,13,1,30,6,0,0,6,1,-15,3,1
2,0,25,1,30,3,11,0,14,5,30,6,0,0,6,0,30,10,4,0,14,1,30,7,7,0,14,5,30,6,0,0,6,1,-15,3,1
2,1,25,1,30,3,11,0,14,5,30,6,0,0,6,0,30,10,4,0,14,1,30,7,7,0,14,5,30,6,0,0,6,1,-15,3,1
2,0,26,0,30,7,2,0,9,4,30,4,0,0,4,7,30,0,9,0,9,0,30,1,8,0,9,4,30,2,1,0,3,1,-15,3,1
2,1,26,0,30,7,2,0,9,4,30,4,0,0,4,7,30,0,9,0,9,0,30,1,8,0,9,4,30,2,1,0,3,1,-15,3,1
2,4,26,0,30,7,2,0,9,4,30,4,0,0,4,7,30,0,9,0,9,0,30,1,8,0,9,4,30,2,1,0,3,1,-15,3,1
2,2,27,1,30,7,8,0,15,2,30,2,0,0,2,0,30,6,9,0,15,1,30,5,10,0,15,2,30,6,0,0,6,1,-15,3,1
2,4,27,1,30,7,8,0,15,2,30,2,0,0,2,0,30,6,9,0,15,1,30,5,10,0,15,2,30,6,0,0,6,1,-15,3,1
2,4,7,1,30,6,3,0,9,1,30,3,1,0,4,0,30,6,3,0,9,8,30,2,7,0,9,1,30,3,3,0,6,0,-27,3,0
2,4,19,0,30,4,9,0,13,2,30,4,4,0,8,0,30,6,7,0,13,0,30,6,7,0,13,2,30,8,1,0,9,1,-15,3,1
2,0,21,3,30,6,4,0,10,4,30,5,1,0,6,1,30,3,7,0,10,2,30,5,5,0,10,3,30,4,0,0,4,1,-15,3,1
2,3,21,3,30,6,4,0,10,4,30,5,1,0,6,1,30,3,7,0,10,2,30,5,5,0,10,3,30,4,0,0,4,1,-15,3,1
2,4,23,2,30,5,8,0,13,4,30,6,0,0,6,5,30,10,3,0,13,0,30,5,8,0,13,1,30,6,0,0,6,1,-15,3,1
2,2,25,2,30,7,7,0,14,5,30,6,0,0,6,0,30,7,7,0,14,1,30,7,7,0,14,3,30,5,1,0,6,1,-15,3,1
2,3,25,2,30,7,7,0,14,5,30,6,0,0,6,0,30,7,7,0,14,1,30,7,7,0,14,3,30,5,1,0,6,1,-15,3,1
2,1,27,1,30,5,10,0,15,1,30,2,0,0,2,0,30,4,11,0,15,4,30,7,8,0,15,3,30,6,0,0,6,1,-15,3,1
2,2,29,1,30,6,8,0,14,6,30,12,0,0,12,0,30,5,9,0,14,0,30,1,13,0,14,1,30,9,0,0,9,1,-15,3,1
2,2,32,0,30,4,5,0,9,4,30,2,0,0,2,1,30,9,0,0,9,6,30,4,5,0,9,3,30,2,0,0,2,1,-15,3,1
2,3,32,0,30,4,5,0,9,4,30,2,0,0,2,1,30,9,0,0,9,6,30,4,5,0,9,3,30,2,0,0,2,1,-15,3,1
2,4,32,0,30,4,5,0,9,4,30,2,0,0,2,1,30,9,0,0,9,6,30,4,5,0,9,3,30,2,0,0,2,1,-15,3,1
2,1,13,3,30,5,2,0,7,0,30,4,0,0,4,2,30,5,2,0,7,9,30,7,0,0,7,5,30,4,0,0,4,1,-15,3,1
2,4,13,3,30,5,2,0,7,0,30,4,0,0,4,2,30,5,2,0,7,9,30,7,0,0,7,5,30,4,0,0,4,1,-15,3,1
2,2,17,3,30,8,6,0,14,2,30,6,0,0,6,0,30,7,7,0,14,1,30,6,8,0,14,2,30,4,0,0,4,1,-15,3,1
2,4,19,0,30,2,11,0,13,2,30,5,3,0,8,0,30,5,8,0,13,5,30,4,9,0,13,1,30,8,1,0,9,1,-15,3,1
2,4,23,1,30,4,9,0,13,3,30,6,0,0,6,5,30,13,0,0,13,2,30,6,7,0,13,2,30,6,0,0,6,1,-15,3,1
2,3,25,1,30,12,2,0,14,4,30,6,0,0,6,0,30,6,8,0,14,0,30,5,9,0,14,5,30,5,1,0,6,1,-15,3,1
2,4,25,1,30,12,2,0,14,4,30,6,0,0,6,0,30,6,8,0,14,0,30,5,9,0,14,5,30,5,1,0,6,1,-15,3,1
2,0,27,1,30,7,8,0,15,4,30,2,0,0,2,0,30,6,9,0,15,4,30,3,12,0,15,4,30,6,0,0,6,1,-15,3,1
2,1,27,1,30,7,8,0,15,4,30,2,0,0,2,0,30,6,9,0,15,4,30,3,12,0,15,4,30,6,0,0,6,1,-15,3,1
2,4,27,1,30,7,8,0,15,0,30,2,0,0,2,0,30,6,9,0,15,4,30,3,12,0,15,0,30,6,0,0,6,1,-15,3,1
2,2,29,0,30,7,7,0,14,6,30,10,2,0,12,0,30,4,10,0,14,0,30,5,9,0,14,1,30,9,0,0,9,1,-15,3,1
2,3,31,3,30,4,8,0,12,4,30,8,0,0,8,3,30,11,1,0,12,0,30,3,9,0,12,0,30,4,2,0,6,1,-15,3,1
2,3,39,0,30,4,7,0,11,5,30,6,0,0,6,0,30,8,3,0,11,1,30,4,7,0,11,3,30,5,0,0,5,1,-15,3,1
2,1,13,1,30,5,2,0,7,0,30,4,0,0,4,5,30,7,0,0,7,7,30,4,3,0,7,3,30,4,0,0,4,1,-15,3,1
2,2,13,1,30,5,2,0,7,0,30,4,0,0,4,5,30,7,0,0,7,7,30,4,3,0,7,3,30,4,0,0,4,1,-15,3,1
2,4,13,1,30,5,2,0,7,0,30,4,0,0,4,5,30,7,0,0,7,7,30,4,3,0,7,3,30,4,0,0,4,1,-15,3,1
2,4,17,3,30,8,6,0,14,2,30,6,0,0,6,0,30,6,8,0,14,3,30,5,9,0,14,5,30,4,0,0,4,1,-15,3,1
2,4,19,0,30,2,11,0,13,2,30,8,0,0,8,0,30,5,8,0,13,2,30,4,9,0,13,1,30,9,0,0,9,1,-15,3,1
2,4,25,0,30,12,2,0,14,3,30,6,0,0,6,0,30,8,6,0,14,1,30,5,9,0,14,5,30,5,1,0,6,1,-15,3,1
2,2,27,0,30,9,6,0,15,3,30,1,1,0,2,0,30,8,7,0,15,4,30,4,11,0,15,0,30,5,1,0,6,1,-15,3,1
2,3,29,0,30,6,8,0,14,6,30,11,1,0,12,0,30,4,10,0,14,0,30,0,14,0,14,3,30,9,0,0,9,1,-15,3,1
2,4,29,0,30,6,8,0,14,6,30,11,1,0,12,0,30,4,10,0,14,0,30,0,14,0,14,3,30,9,0,0,9,1,-15,3,1
2,4,33,5,30,3,8,0,11,6,30,4,0,0,4,2,30,9,2,0,11,0,30,3,8,0,11,4,30,4,0,0,4,1,-15,3,1
2,1,35,1,30,8,5,0,13,6,30,2,0,0,2,1,30,2,11,0,13,5,30,6,7,0,13,1,30,7,1,0,8,1,-15,3,1
2,2,35,1,30,8,5,0,13,6,30,2,0,0,2,1,30,2,11,0,13,5,30,6,7,0,13,1,30,7,1,0,8,1,-15,3,1
2,4,35,1,30,8,5,0,13,6,30,2,0,0,2,1,30,2,11,0,13,5,30,6,7,0,13,1,30,7,1,0,8,1,-15,3,1
2,4,13,2,30,7,0,0,7,0,30,4,0,0,4,2,30,5,2,0,7,7,30,6,1,0,7,3,30,4,0,0,4,1,-15,3,1
2,2,17,3,30,8,6,0,14,4,30,6,0,0,6,0,30,3,11,0,14,2,30,9,5,0,14,3,30,4,0,0,4,1,-15,3,1
2,3,17,3,30,8,6,0,14,4,30,6,0,0,6,0,30,3,11,0,14,2,30,9,5,0,14,3,30,4,0,0,4,1,-15,3,1
2,3,19,0,30,6,7,0,13,1,30,5,3,0,8,0,30,5,8,0,13,0,30,3,10,0,13,0,30,7,2,0,9,1,-15,3,1
2,4,19,0,30,6,7,0,13,1,30,5,3,0,8,0,30,5,8,0,13,0,30,3,10,0,13,0,30,7,2,0,9,1,-15,3,1
2,2,25,1,30,9,5,0,14,3,30,6,0,0,6,0,30,7,7,0,14,1,30,5,9,0,14,4,30,6,0,0,6,1,-15,3,1
2,0,27,1,30,4,11,0,15,5,30,1,1,0,2,0,30,3,12,0,15,1,30,5,10,0,15,5,30,6,0,0,6,1,-15,3,1
2,1,27,1,30,4,11,0,15,5,30,1,1,0,2,0,30,3,12,0,15,1,30,5,10,0,15,5,30,6,0,0,6,1,-15,3,1
2,4,27,0,30,4,11,0,15,5,30,1,1,0,2,0,30,3,12,0,15,1,30,5,10,0,15,5,30,6,0,0,6,1,-15,3,1
2,0,29,0,30,5,9,0,14,5,30,11,1,0,12,0,30,7,7,0,14,0,30,2,12,0,14,2,30,9,0,0,9,1,-15,3,1
2,1,29,0,30,5,9,0,14,5,30,11,1,0,12,0,30,7,7,0,14,0,30,2,12,0,14,2,30,9,0,0,9,1,-15,3,1
2,2,29,0,30,5,9,0,14,5,30,11,1,0,12,0,30,7,7,0,14,0,30,2,12,0,14,2,30,9,0,0,9,1,-15,3,1
2,1,31,4,30,8,4,0,12,5,30,8,0,0,8,5,30,8,4,0,12,0,30,3,9,0,12,0,30,3,3,0,6,1,-15,3,1
2,2,31,4,30,8,4,0,12,5,30,8,0,0,8,5,30,8,4,0,12,0,30,3,9,0,12,0,30,3,3,0,6,1,-15,3,1
2,3,31,4,30,8,4,0,12,5,30,8,0,0,8,5,30,8,4,0,12,0,30,3,9,0,12,0,30,3,3,0,6,1,-15,3,1
2,3,47,0,30,5,9,0,14,7,30,4,0,0,4,0,30,3,11,0,14,0,30,7,7,0,14,5,30,7,0,0,7,1,-15,3,1
2,4,47,0,30,5,9,0,14,7,30,4,0,0,4,0,30,3,11,0,14,0,30,7,7,0,14,5,30,7,0,0,7,1,-15,3,1
2,1,5,0,30,1,4,0,5,3,30,1,3,0,4,0,30,0,5,0,5,0,30,1,4,0,5,0,30,2,0,0,2,0,-27,3,0
2,2,5,0,30,1,4,0,5,3,30,1,3,0,4,0,30,0,5,0,5,0,30,1,4,0,5,0,30,2,0,0,2,0,-27,3,0
2,4,5,0,30,1,4,0,5,3,30,1,3,0,4,0,30,0,5,0,5,0,30,1,4,0,5,0,30,2,0,0,2,0,-27,3,0
2,1,13,1,30,6,1,0,7,0,30,4,0,0,4,2,30,5,2,0,7,5,30,6,1,0,7,5,30,4,0,0,4,1,-15,3,1
2,2,13,1,30,6,1,0,7,0,30,4,0,0,4,2,30,5,2,0,7,5,30,6,1,0,7,5,30,4,0,0,4,1,-15,3,1
2,3,13,1,30,6,1,0,7,0,30,4,0,0,4,2,30,5,2,0,7,5,30,6,1,0,7,5,30,4,0,0,4,1,-15,3,1
2,1,17,4,30,9,5,0,14,2,30,6,0,0,6,0,30,8,6,0,14,2,30,5,9,0,14,4,30,4,0,0,4,1,-15,3,1
2,4,17,0,30,9,5,0,14,1,30,6,0,0,6,0,30,8,6,0,14,2,30,5,9,0,14,4,30,4,0,0,4,1,-15,3,1
2,0,21,3,30,5,5,0,10,4,30,5,1,0,6,1,30,3,7,0,10,4,30,4,6,0,10,5,30,4,0,0,4,1,-15,3,1
2,2,21,3,30,5,5,0,10,4,30,5,1,0,6,1,30,3,7,0,10,4,30,4,6,0,10,5,30,4,0,0,4,1,-15,3,1
2,3,21,3,30,5,5,0,10,4,30,5,1,0,6,1,30,3,7,0,10,4,30,4,6,0,10,5,30,4,0,0,4,1,-15,3,1
2,2,25,1,30,4,10,0,14,4,30,6,0,0,6,0,30,7,7,0,14,1,30,9,5,0,14,3,30,6,0,0,6,1,-15,3,1
2,3,27,1,30,6,9,0,15,3,30,2,0,0,2,0,30,5,10,0,15,0,30,5,10,0,15,2,30,6,0,0,6,1,-15,3,1
2,4,27,1,30,6,9,0,15,3,30,2,0,0,2,0,30,5,10,0,15,0,30,5,10,0,15,2,30,6,0,0,6,1,-15,3,1
2,2,29,0,30,7,7,0,14,6,30,12,0,0,12,0,30,3,11,0,14,0,30,3,11,0,14,0,30,8,1,0,9,1,-15,3,1
2,3,29,0,30,7,7,0,14,6,30,12,0,0,12,0,30,3,11,0,14,0,30,3,11,0,14,0,30,8,1,0,9,1,-15,3,1
2,4,31,1,30,8,4,0,12,3,30,8,0,0,8,6,30,12,0,0,12,0,30,3,9,0,12,0,30,3,3,0,6,1,-15,3,1
2,4,39,0,30,4,7,0,11,7,30,6,0,0,6,0,30,4,7,0,11,1,30,3,8,0,11,2,30,5,0,0,5,1,-15,3,1
2,3,5,0,30,1,4,0,5,3,30,0,4,0,4,0,30,0,5,0,5,0,30,2,3,0,5,3,30,2,0,0,2,0,-27,3,0
2,1,13,5,30,7,0,0,7,1,30,4,0,0,4,3,30,7,0,0,7,1,30,6,1,0,7,0,30,4,0,0,4,1,-15,3,1
2,2,13,5,30,7,0,0,7,1,30,4,0,0,4,3,30,7,0,0,7,1,30,6,1,0,7,0,30,4,0,0,4,1,-15,3,1
2,3,17,2,30,9,5,0,14,3,30,6,0,0,6,0,30,4,10,0,14,1,30,6,8,0,14,4,30,4,0,0,4,1,-15,3,1
2,2,23,4,30,7,6,0,13,3,30,6,0,0,6,4,30,11,2,0,13,0,30,8,5,0,13,0,30,6,0,0,6,1,-15,3,1
2,4,23,4,30,7,6,0,13,3,30,6,0,0,6,4,30,11,2,0,13,0,30,8,5,0,13,0,30,6,0,0,6,1,-15,3,1
2,0,27,1,30,5,10,0,15,5,30,1,1,0,2,0,30,4,11,0,15,0,30,8,7,0,15,3,30,6,0,0,6,1,-15,3,1
2,2,27,1,30,5,10,0,15,5,30,1,1,0,2,0,30,4,11,0,15,0,30,8,7,0,15,3,30,6,0,0,6,1,-15,3,1
2,3,27,1,30,5,10,0,15,5,30,1,1,0,2,0,30,4,11,0,15,0,30,8,7,0,15,3,30,6,0,0,6,1,-15,3,1
2,4,27,1,30,5,10,0,15,5,30,1,1,0,2,0,30,4,11,0,15,0,30,8,7,0,15,3,30,6,0,0,6,1,-15,3,1
2,4,29,0,30,7,7,0,14,4,30,12,0,0,12,0,30,6,8,0,14,0,30,0,14,0,14,0,30,6,3,0,9,1,-15,3,1
2,3,32,0,30,4,5,0,9,4,30,2,0,0,2,0,30,7,2,0,9,1,30,3,6,0,9,3,30,2,0,0,2,1,-15,3,1
2,3,33,1,30,3,8,0,11,4,30,4,0,0,4,1,30,9,2,0,11,0,30,5,6,0,11,4,30,4,0,0,4,1,-15,3,1
2,1,3,1,30,4,7,0,11,3,30,8,0,0,8,0,30,3,8,0,11,8,30,4,7,0,11,1,30,4,3,0,7,0,-27,3,0
2,2,5,2,30,2,3,0,5,3,30,0,4,0,4,1,30,2,3,0,5,0,30,1,4,0,5,1,30,1,1,0,2,0,-27,3,0
2,1,13,2,30,7,0,0,7,0,30,4,0,0,4,2,30,6,1,0,7,7,30,3,4,0,7,4,30,4,0,0,4,1,-15,3,1
2,2,13,2,30,7,0,0,7,0,30,4,0,0,4,2,30,6,1,0,7,7,30,3,4,0,7,4,30,4,0,0,4,1,-15,3,1
2,1,23,1,30,1,12,0,13,1,30,6,0,0,6,2,30,13,0,0,13,1,30,8,5,0,13,4,30,6,0,0,6,1,-15,3,1
2,2,23,1,30,1,12,0,13,1,30,6,0,0,6,2,30,13,0,0,13,1,30,8,5,0,13,4,30,6,0,0,6,1,-15,3,1
2,2,25,1,30,6,8,0,14,3,30,6,0,0,6,0,30,8,6,0,14,1,30,5,9,0,14,5,30,6,0,0,6,1,-15,3,1
2,3,25,1,30,6,8,0,14,3,30,6,0,0,6,0,30,8,6,0,14,1,30,5,9,0,14,5,30,6,0,0,6,1,-15,3,1
2,4,25,1,30,6,8,0,14,3,30,6,0,0,6,0,30,8,6,0,14,1,30,5,9,0,14,5,30,6,0,0,6,1,-15,3,1
2,1,27,0,30,5,10,0,15,1,30,1,1,0,2,0,30,6,9,0,15,2,30,5,10,0,15,4,30,6,0,0,6,1,-15,3,1
2,3,31,2,30,5,7,0,12,5,30,8,0,0,8,4,30,9,3,0,12,2,30,3,9,0,12,1,30,6,0,0,6,1,-15,3,1
2,0,45,4,30,8,5,0,13,8,30,10,0,0,10,0,30,8,5,0,13,0,30,4,9,0,13,3,30,5,0,0,5,1,-15,3,1
2,4,45,4,30,8,5,0,13,8,30,10,0,0,10,0,30,8,5,0,13,0,30,4,9,0,13,3,30,5,0,0,5,1,-15,3,1
2,0,5,0,30,2,3,0,5,3,30,0,4,0,4,0,30,0,5,0,5,0,30,3,2,0,5,0,30,2,0,0,2,0,-27,3,0
2,1,5,0,30,2,3,0,5,3,30,0,4,0,4,0,30,0,5,0,5,0,30,3,2,0,5,0,30,2,0,0,2,0,-27,3,0
2,4,5,0,30,2,3,0,5,3,30,0,4,0,4,0,30,0,5,0,5,0,30,3,2,0,5,0,30,2,0,0,2,0,-27,3,0
2,3,13,9,30,7,0,0,7,3,30,4,0,0,4,2,30,5,2,0,7,5,30,5,2,0,7,0,30,4,0,0,4,1,-15,3,1
2,1,19,0,30,5,8,0,13,1,30,3,5,0,8,0,30,11,2,0,13,3,30,5,8,0,13,3,30,8,1,0,9,1,-15,3,1
2,2,19,0,30,5,8,0,13,1,30,3,5,0,8,0,30,11,2,0,13,3,30,5,8,0,13,3,30,8,1,0,9,1,-15,3,1
2,3,19,0,30,5,8,0,13,1,30,3,5,0,8,0,30,11,2,0,13,3,30,5,8,0,13,3,30,8,1,0,9,1,-15,3,1
2,0,21,2,30,7,3,0,10,3,30,4,2,0,6,0,30,3,7,0,10,5,30,5,5,0,10,6,30,4,0,0,4,1,-15,3,1
2,3,21,1,30,7,3,0,10,3,30,4,2,0,6,0,30,3,7,0,10,5,30,5,5,0,10,6,30,4,0,0,4,1,-15,3,1
2,4,21,1,30,7,3,0,10,3,30,4,2,0,6,0,30,3,7,0,10,5,30,5,5,0,10,6,30,4,0,0,4,1,-15,3,1
2,3,22,1,30,6,2,0,8,3,30,2,0,0,2,0,30,3,5,0,8,0,30,7,1,0,8,5,30,4,0,0,4,1,-15,3,1
2,2,25,0,30,7,7,0,14,4,30,6,0,0,6,0,30,9,5,0,14,1,30,6,8,0,14,2,30,6,0,0,6,1,-15,3,1
2,3,25,0,30,7,7,0,14,4,30,6,0,0,6,0,30,9,5,0,14,1,30,6,8,0,14,2,30,6,0,0,6,1,-15,3,1
2,4,25,0,30,7,7,0,14,4,30,6,0,0,6,0,30,9,5,0,14,1,30,6,8,0,14,2,30,6,0,0,6,1,-15,3,1
2,1,27,4,30,5,10,0,15,4,30,2,0,0,2,0,30,4,11,0,15,0,30,4,11,0,15,1,30,4,2,0,6,1,-15,3,1
2,4,27,4,30,5,10,0,15,4,30,2,0,0,2,0,30,4,11,0,15,0,30,4,11,0,15,1,30,4,2,0,6,1,-15,3,1
2,2,13,6,30,7,0,0,7,0,30,4,0,0,4,0,30,7,0,0,7,5,30,5,2,0,7,3,30,4,0,0,4,1,-15,3,1
2,3,13,6,30,7,0,0,7,0,30,4,0,0,4,0,30,7,0,0,7,5,30,5,2,0,7,3,30,4,0,0,4,1,-15,3,1
2,1,19,0,30,4,9,0,13,2,30,7,1,0,8,0,30,4,9,0,13,3,30,7,6,0,13,1,30,8,1,0,9,1,-15,3,1
2,2,19,0,30,4,9,0,13,2,30,7,1,0,8,0,30,4,9,0,13,3,30,7,6,0,13,1,30,8,1,0,9,1,-15,3,1
2,3,19,0,30,4,9,0,13,2,30,7,1,0,8,0,30,4,9,0,13,3,30,7,6,0,13,1,30,8,1,0,9,1,-15,3,1
2,4,19,0,30,4,9,0,13,2,30,7,1,0,8,0,30,4,9,0,13,3,30,7,6,0,13,1,30,8,1,0,9,1,-15,3,1
2,4,22,1,30,5,3,0,8,1,30,2,0,0,2,0,30,5,3,0,8,4,30,2,6,0,8,1,30,1,3,0,4,1,-15,3,1
2,1,23,3,30,4,9,0,13,2,30,6,0,0,6,7,30,13,0,0,13,2,30,7,6,0,13,1,30,6,0,0,6,1,-15,3,1
2,3,23,3,30,4,9,0,13,2,30,6,0,0,6,7,30,13,0,0,13,2,30,7,6,0,13,1,30,6,0,0,6,1,-15,3,1
2,0,25,4,30,8,6,0,14,4,30,5,1,0,6,0,30,6,8,0,14,1,30,5,9,0,14,5,30,6,0,0,6,1,-15,3,1
2,1,25,4,30,8,6,0,14,4,30,5,1,0,6,0,30,6,8,0,14,1,30,5,9,0,14,5,30,6,0,0,6,1,-15,3,1
2,0,27,0,30,4,11,0,15,3,30,2,0,0,2,0,30,3,12,0,15,0,30,6,9,0,15,4,30,6,0,0,6,1,-15,3,1
2,2,4,2,30,8,0,0,8,4,30,4,0,0,4,0,30,1,7,0,8,0,30,3,5,0,8,2,30,3,1,0,4,0,-27,3,0
2,3,4,2,30,8,0,0,8,4,30,4,0,0,4,0,30,1,7,0,8,0,30,3,5,0,8,2,30,3,1,0,4,0,-27,3,0
2,3,8,1,30,7,0,0,7,3,30,2,0,0,2,2,30,5,2,0,7,0,30,7,0,0,7,5,30,3,0,0,3,0,-27,3,0
2,4,8,1,30,7,0,0,7,3,30,2,0,0,2,2,30,5,2,0,7,0,30,7,0,0,7,5,30,3,0,0,3,0,-27,3,0
2,4,13,0,30,3,0,0,3,0,30,2,0,0,2,1,30,3,0,0,3,7,30,2,1,0,3,4,30,2,0,0,2,1,-15,3,1
2,1,13,2,30,5,2,0,7,0,30,4,0,0,4,2,30,7,0,0,7,8,30,6,1,0,7,4,30,4,0,0,4,1,-15,3,1
2,2,13,2,30,5,2,0,7,0,30,4,0,0,4,2,30,7,0,0,7,8,30,6,1,0,7,4,30,4,0,0,4,1,-15,3,1
2,2,17,2,30,8,6,0,14,3,30,6,0,0,6,0,30,5,9,0,14,3,30,6,8,0,14,2,30,4,0,0,4,1,-15,3,1
2,4,17,2,30,8,6,0,14,3,30,6,0,0,6,0,30,5,9,0,14,3,30,6,8,0,14,2,30,4,0,0,4,1,-15,3,1
2,1,25,1,30,4,10,0,14,4,30,6,0,0,6,0,30,4,10,0,14,0,30,10,4,0,14,7,30,6,0,0,6,1,-15,3,1
2,2,25,1,30,4,10,0,14,4,30,6,0,0,6,0,30,4,10,0,14,0,30,10,4,0,14,7,30,6,0,0,6,1,-15,3,1
2,3,31,3,30,7,5,0,12,4,30,8,0,0,8,3,30,12,0,0,12,0,30,3,9,0,12,1,30,4,2,0,6,1,-15,3,1
2,3,39,0,30,4,7,0,11,7,30,6,0,0,6,0,30,5,6,0,11,2,30,4,7,0,11,3,30,5,0,0,5,1,-15,3,1
2,4,39,0,30,4,7,0,11,7,30,6,0,0,6,0,30,5,6,0,11,2,30,4,7,0,11,3,30,5,0,0,5,1,-15,3,1
2,0,4,3,30,7,1,0,8,4,30,2,2,0,4,2,30,3,5,0,8,0,30,7,1,0,8,1,30,3,1,0,4,0,-27,3,0
2,4,8,0,30,7,0,0,7,4,30,2,0,0,2,7,30,2,5,0,7,1,30,7,0,0,7,2,30,3,0,0,3,0,-27,3,0
2,2,13,1,30,5,2,0,7,0,30,4,0,0,4,0,30,6,1,0,7,11,30,5,2,0,7,4,30,4,0,0,4,1,-15,3,1
2,4,13,1,30,5,2,0,7,0,30,4,0,0,4,0,30,6,1,0,7,11,30,5,2,0,7,4,30,4,0,0,4,1,-15,3,1
2,2,19,0,30,4,9,0,13,1,30,6,2,0,8,0,30,9,4,0,13,1,30,4,9,0,13,2,30,7,2,0,9,1,-15,3,1
2,3,19,0,30,4,9,0,13,1,30,6,2,0,8,0,30,9,4,0,13,1,30,4,9,0,13,2,30,7,2,0,9,1,-15,3,1
2,4,19,0,30,4,9,0,13,1,30,6,2,0,8,0,30,9,4,0,13,1,30,4,9,0,13,2,30,7,2,0,9,1,-15,3,1
2,3,23,1,30,6,7,0,13,3,30,6,0,0,6,7,30,10,3,0,13,0,30,4,9,0,13,2,30,6,0,0,6,1,-15,3,1
2,1,26,0,30,6,3,0,9,5,30,4,0,0,4,5,30,1,8,0,9,0,30,2,7,0,9,5,30,3,0,0,3,1,-15,3,1
2,3,26,0,30,6,3,0,9,5,30,4,0,0,4,5,30,1,8,0,9,0,30,2,7,0,9,5,30,3,0,0,3,1,-15,3,1
2,0,27,1,30,5,10,0,15,3,30,2,0,0,2,0,30,6,9,0,15,1,30,6,9,0,15,1,30,6,0,0,6,1,-15,3,1
2,2,27,1,30,5,10,0,15,3,30,2,0,0,2,0,30,6,9,0,15,1,30,6,9,0,15,1,30,6,0,0,6,1,-15,3,1
2,4,27,1,30,5,10,0,15,3,30,2,0,0,2,0,30,6,9,0,15,1,30,6,9,0,15,1,30,6,0,0,6,1,-15,3,1
2,2,29,0,30,7,7,0,14,6,30,11,1,0,12,0,30,3,11,0,14,0,30,1,13,0,14,0,30,9,0,0,9,1,-15,3,1
2,1,13,1,30,6,1,0,7,0,30,4,0,0,4,2,30,5,2,0,7,6,30,6,1,0,7,4,30,4,0,0,4,1,-15,3,1
2,3,13,1,30,6,1,0,7,0,30,4,0,0,4,2,30,5,2,0,7,6,30,6,1,0,7,4,30,4,0,0,4,1,-15,3,1
2,4,13,1,30,6,1,0,7,0,30,4,0,0,4,2,30,5,2,0,7,6,30,6,1,0,7,4,30,4,0,0,4,1,-15,3,1
2,2,15,1,30,5,8,0,13,0,30,6,0,0,6,1,30,4,9,0,13,1,30,4,9,0,13,2,30,6,3,0,9,1,-15,3,1
2,4,15,1,30,5,8,0,13,0,30,6,0,0,6,1,30,4,9,0,13,1,30,4,9,0,13,2,30,6,3,0,9,1,-15,3,1
2,2,17,4,30,8,6,0,14,4,30,6,0,0,6,0,30,3,11,0,14,6,30,3,11,0,14,5,30,4,0,0,4,1,-15,3,1
2,4,17,4,30,8,6,0,14,4,30,6,0,0,6,0,30,3,11,0,14,6,30,3,11,0,14,5,30,4,0,0,4,1,-15,3,1
2,2,19,0,30,3,10,0,13,2,30,8,0,0,8,0,30,4,9,0,13,0,30,7,6,0,13,1,30,7,2,0,9,1,-15,3,1
2,3,19,0,30,3,10,0,13,2,30,8,0,0,8,0,30,4,9,0,13,0,30,7,6,0,13,1,30,7,2,0,9,1,-15,3,1
2,4,19,0,30,3,10,0,13,2,30,8,0,0,8,0,30,4,9,0,13,0,30,7,6,0,13,1,30,7,2,0,9,1,-15,3,1
2,3,21,4,30,8,2,0,10,4,30,5,1,0,6,1,30,3,7,0,10,2,30,5,5,0,10,1,30,4,0,0,4,1,-15,3,1
2,4,23,2,30,7,6,0,13,0,30,6,0,0,6,1,30,13,0,0,13,0,30,5,8,0,13,2,30,5,1,0,6,1,-15,3,1
2,4,32,0,30,5,4,0,9,4,30,2,0,0,2,1,30,6,3,0,9,1,30,2,7,0,9,3,30,2,0,0,2,1,-15,3,1
2,4,39,0,30,3,8,0,11,6,30,6,0,0,6,0,30,4,7,0,11,0,30,2,9,0,11,5,30,5,0,0,5,1,-15,3,1
2,0,5,0,30,2,3,0,5,3,30,4,0,0,4,0,30,0,5,0,5,0,30,1,4,0,5,2,30,2,0,0,2,0,-27,3,0
2,3,13,1,30,7,0,0,7,0,30,4,0,0,4,0,30,6,1,0,7,6,30,6,1,0,7,5,30,4,0,0,4,1,-15,3,1
2,4,13,1,30,7,0,0,7,0,30,4,0,0,4,0,30,6,1,0,7,6,30,6,1,0,7,5,30,4,0,0,4,1,-15,3,1
2,1,17,2,30,8,6,0,14,3,30,6,0,0,6,0,30,5,9,0,14,3,30,8,6,0,14,6,30,4,0,0,4,1,-15,3,1
2,3,17,2,30,8,6,0,14,3,30,6,0,0,6,0,30,5,9,0,14,3,30,8,6,0,14,6,30,4,0,0,4,1,-15,3,1
2,4,17,2,30,8,6,0,14,3,30,6,0,0,6,0,30,5,9,0,14,3,30,8,6,0,14,6,30,4,0,0,4,1,-15,3,1
2,4,19,0,30,5,8,0,13,2,30,5,3,0,8,0,30,4,9,0,13,0,30,6,7,0,13,0,30,9,0,0,9,1,-15,3,1
2,2,23,1,30,6,7,0,13,3,30,6,0,0,6,5,30,9,4,0,13,0,30,5,8,0,13,2,30,6,0,0,6,1,-15,3,1
2,4,23,1,30,6,7,0,13,3,30,6,0,0,6,5,30,9,4,0,13,0,30,5,8,0,13,2,30,6,0,0,6,1,-15,3,1
2,3,31,2,30,4,8,0,12,5,30,8,0,0,8,0,30,9,3,0,12,0,30,6,6,0,12,2,30,6,0,0,6,1,-15,3,1
2,4,8,2,30,7,0,0,7,4,30,2,0,0,2,3,30,4,3,0,7,0,30,6,1,0,7,1,30,3,0,0,3,0,-27,3,0
2,1,19,0,30,3,10,0,13,2,30,5,3,0,8,0,30,8,5,0,13,2,30,5,8,0,13,2,30,9,0,0,9,1,-15,3,1
2,2,25,1,30,5,9,0,14,4,30,6,0,0,6,0,30,6,8,0,14,1,30,9,5,0,14,4,30,5,1,0,6,1,-15,3,1
2,4,25,1,30,5,9,0,14,4,30,6,0,0,6,0,30,6,8,0,14,1,30,9,5,0,14,4,30,5,1,0,6,1,-15,3,1
2,2,27,1,30,5,10,0,15,4,30,2,0,0,2,0,30,6,9,0,15,0,30,4,11,0,15,2,30,6,0,0,6,1,-15,3,1
2,4,27,1,30,5,10,0,15,4,30,2,0,0,2,0,30,6,9,0,15,0,30,4,11,0,15,2,30,6,0,0,6,1,-15,3,1
2,4,31,3,30,6,6,0,12,4,30,8,0,0,8,6,30,9,3,0,12,0,30,4,8,0,12,1,30,2,4,0,6,1,-15,3,1
2,1,47,0,30,7,7,0,14,6,30,4,0,0,4,0,30,3,11,0,14,0,30,3,11,0,14,8,30,7,0,0,7,1,-15,3,1
2,2,4,2,30,8,0,0,8,4,30,2,2,0,4,3,30,3,5,0,8,0,30,0,8,0,8,0,30,4,0,0,4,0,-27,3,0
2,3,4,2,30,8,0,0,8,4,30,2,2,0,4,3,30,3,5,0,8,0,30,0,8,0,8,0,30,4,0,0,4,0,-27,3,0
2,3,5,0,30,0,5,0,5,3,30,2,2,0,4,0,30,0,5,0,5,0,30,1,4,0,5,0,30,0,2,0,2,0,-27,3,0
2,4,5,0,30,0,5,0,5,3,30,2,2,0,4,0,30,0,5,0,5,0,30,1,4,0,5,0,30,0,2,0,2,0,-27,3,0
2,3,8,2,30,7,0,0,7,4,30,2,0,0,2,0,30,2,5,0,7,0,30,6,1,0,7,5,30,3,0,0,3,0,-27,3,0
2,4,8,2,30,7,0,0,7,4,30,2,0,0,2,0,30,2,5,0,7,0,30,6,1,0,7,5,30,3,0,0,3,0,-27,3,0
2,1,13,12,30,7,0,0,7,2,30,4,0,0,4,2,30,5,2,0,7,4,30,6,1,0,7,1,30,4,0,0,4,1,-15,3,1
2,4,27,1,30,4,11,0,15,4,30,2,0,0,2,0,30,6,9,0,15,0,30,4,11,0,15,0,30,5,1,0,6,1,-15,3,1
2,4,29,0,30,6,8,0,14,6,30,11,1,0,12,0,30,4,10,0,14,0,30,1,13,0,14,3,30,9,0,0,9,1,-15,3,1
2,3,41,1,30,8,4,0,12,7,30,8,0,0,8,0,30,5,7,0,12,0,30,2,10,0,12,1,30,4,3,0,7,1,-15,3,1
2,4,41,1,30,8,4,0,12,7,30,8,0,0,8,0,30,5,7,0,12,0,30,2,10,0,12,1,30,4,3,0,7,1,-15,3,1
2,1,5,0,30,1,4,0,5,2,30,2,2,0,4,2,30,1,4,0,5,0,30,1,4,0,5,0,30,0,2,0,2,0,-27,3,0
2,4,5,0,30,1,4,0,5,2,30,2,2,0,4,2,30,1,4,0,5,0,30,1,4,0,5,0,30,0,2,0,2,0,-27,3,0
2,1,13,3,30,7,0,0,7,0,30,4,0,0,4,2,30,7,0,0,7,6,30,6,1,0,7,3,30,4,0,0,4,1,-15,3,1
2,2,13,3,30,7,0,0,7,0,30,4,0,0,4,2,30,7,0,0,7,6,30,6,1,0,7,3,30,4,0,0,4,1,-15,3,1
2,3,13,3,30,7,0,0,7,0,30,4,0,0,4,2,30,7,0,0,7,6,30,6,1,0,7,3,30,4,0,0,4,1,-15,3,1
2,2,17,9,30,11,3,0,14,4,30,6,0,0,6,0,30,5,9,0,14,1,30,6,8,0,14,2,30,4,0,0,4,1,-15,3,1
2,4,17,9,30,11,3,0,14,4,30,6,0,0,6,0,30,5,9,0,14,1,30,6,8,0,14,2,30,4,0,0,4,1,-15,3,1
2,1,19,0,30,6,7,0,13,1,30,7,1,0,8,4,30,7,6,0,13,1,30,5,8,0,13,1,30,6,3,0,9,1,-15,3,1
2,3,19,0,30,6,7,0,13,1,30,7,1,0,8,4,30,7,6,0,13,1,30,5,8,0,13,1,30,6,3,0,9,1,-15,3,1
2,4,19,0,30,6,7,0,13,1,30,7,1,0,8,4,30,7,6,0,13,1,30,5,8,0,13,1,30,6,3,0,9,1,-15,3,1
2,0,21,2,30,7,3,0,10,4,30,6,0,0,6,1,30,3,7,0,10,6,30,5,5,0,10,1,30,4,0,0,4,1,-15,3,1
2,1,21,2,30,7,3,0,10,4,30,6,0,0,6,1,30,3,7,0,10,6,30,5,5,0,10,1,30,4,0,0,4,1,-15,3,1
2,2,21,2,30,7,3,0,10,4,30,6,0,0,6,1,30,3,7,0,10,6,30,5,5,0,10,1,30,4,0,0,4,1,-15,3,1
2,3,21,2,30,7,3,0,10,4,30,6,0,0,6,1,30,3,7,0,10,6,30,5,5,0,10,1,30,4,0,0,4,1,-15,3,1
2,4,21,2,30,7,3,0,10,4,30,6,0,0,6,1,30,3,7,0,10,6,30,5,5,0,10,1,30,4,0,0,4,1,-15,3,1
2,3,23,1,30,6,7,0,13,3,30,5,1,0,6,7,30,12,1,0,13,0,30,4,9,0,13,3,30,6,0,0,6,1,-15,3,1
2,0,27,1,30,5,10,0,15,4,30,1,1,0,2,0,30,4,11,0,15,0,30,6,9,0,15,4,30,6,0,0,6,1,-15,3,1
2,1,27,1,30,5,10,0,15,4,30,1,1,0,2,0,30,4,11,0,15,0,30,6,9,0,15,4,30,6,0,0,6,1,-15,3,1
2,3,27,1,30,5,10,0,15,4,30,1,1,0,2,0,30,4,11,0,15,0,30,6,9,0,15,4,30,6,0,0,6,1,-15,3,1
2,4,27,1,30,5,10,0,15,4,30,1,1,0,2,0,30,4,11,0,15,0,30,6,9,0,15,4,30,6,0,0,6,1,-15,3,1
2,4,29,0,30,7,7,0,14,6,30,11,1,0,12,0,30,3,11,0,14,0,30,0,14,0,14,4,30,9,0,0,9,1,-15,3,1
2,3,31,4,30,8,4,0,12,5,30,8,0,0,8,5,30,8,4,0,12,0,30,3,9,0,12,0,30,4,2,0,6,1,-15,3,1
2,4,31,4,30,8,4,0,12,5,30,8,0,0,8,5,30,8,4,0,12,0,30,3,9,0,12,0,30,4,2,0,6,1,-15,3,1
2,0,4,2,30,7,1,0,8,4,30,3,1,0,4,1,30,2,6,0,8,0,30,5,3,0,8,3,30,4,0,0,4,0,-27,3,0
2,1,4,2,30,7,1,0,8,4,30,3,1,0,4,1,30,2,6,0,8,0,30,5,3,0,8,3,30,4,0,0,4,0,-27,3,0
2,4,4,2,30,7,1,0,8,4,30,3,1,0,4,0,30,2,6,0,8,0,30,5,3,0,8,3,30,4,0,0,4,0,-27,3,0
2,4,6,0,30,4,5,0,9,4,30,2,0,0,2,0,30,3,6,0,9,0,30,5,4,0,9,2,30,5,0,0,5,0,-27,3,0
2,3,8,3,30,7,0,0,7,4,30,2,0,0,2,0,30,3,4,0,7,1,30,7,0,0,7,2,30,3,0,0,3,0,-27,3,0
2,4,19,1,30,3,10,0,13,2,30,8,0,0,8,0,30,9,4,0,13,1,30,5,8,0,13,2,30,8,1,0,9,1,-15,3,1
2,2,23,2,30,6,7,0,13,2,30,6,0,0,6,6,30,13,0,0,13,0,30,6,7,0,13,0,30,6,0,0,6,1,-15,3,1
2,3,23,2,30,6,7,0,13,2,30,6,0,0,6,6,30,13,0,0,13,0,30,6,7,0,13,0,30,6,0,0,6,1,-15,3,1
2,4,23,2,30,6,7,0,13,2,30,6,0,0,6,6,30,13,0,0,13,0,30,6,7,0,13,0,30,6,0,0,6,1,-15,3,1
2,1,27,1,30,5,10,0,15,4,30,1,1,0,2,0,30,5,10,0,15,2,30,6,9,0,15,2,30,6,0,0,6,1,-15,3,1
2,4,27,1,30,5,10,0,15,4,30,1,1,0,2,0,30,5,10,0,15,2,30,6,9,0,15,2,30,6,0,0,6,1,-15,3,1
2,4,38,0,30,5,5,0,10,7,30,6,0,0,6,0,30,1,9,0,10,0,30,2,8,0,10,6,30,6,0,0,6,1,-15,3,1
2,4,39,0,30,3,8,0,11,6,30,6,0,0,6,0,30,5,6,0,11,0,30,2,9,0,11,1,30,5,0,0,5,1,-15,3,1
2,0,5,0,30,3,2,0,5,3,30,0,4,0,4,0,30,0,5,0,5,0,30,1,4,0,5,0,30,2,0,0,2,0,-27,3,0
2,4,8,2,30,7,0,0,7,3,30,2,0,0,2,3,30,4,3,0,7,1,30,7,0,0,7,0,30,3,0,0,3,0,-27,3,0
2,2,11,1,30,4,8,0,12,1,30,4,0,0,4,0,30,7,5,0,12,7,30,4,8,0,12,1,30,4,0,0,4,1,-15,3,1
2,1,17,1,30,6,8,0,14,3,30,6,0,0,6,0,30,3,11,0,14,2,30,6,8,0,14,6,30,4,0,0,4,1,-15,3,1
2,2,17,1,30,6,8,0,14,3,30,6,0,0,6,0,30,3,11,0,14,2,30,6,8,0,14,6,30,4,0,0,4,1,-15,3,1
2,3,17,1,30,6,8,0,14,3,30,6,0,0,6,0,30,3,11,0,14,2,30,6,8,0,14,6,30,4,0,0,4,1,-15,3,1
2,4,17,1,30,6,8,0,14,3,30,6,0,0,6,0,30,3,11,0,14,2,30,6,8,0,14,6,30,4,0,0,4,1,-15,3,1
2,0,19,0,30,4,9,0,13,2,30,6,2,0,8,0,30,5,8,0,13,10,30,5,8,0,13,2,30,9,0,0,9,1,-15,3,1
2,4,19,0,30,4,9,0,13,2,30,6,2,0,8,0,30,5,8,0,13,10,30,5,8,0,13,2,30,9,0,0,9,1,-15,3,1
2,2,6,0,30,4,5,0,9,4,30,2,0,0,2,0,30,2,7,0,9,2,30,6,3,0,9,4,30,5,0,0,5,0,-27,3,0
2,3,6,0,30,4,5,0,9,4,30,2,0,0,2,0,30,2,7,0,9,2,30,6,3,0,9,4,30,5,0,0,5,0,-27,3,0
2,1,19,0,30,3,10,0,13,1,30,2,6,0,8,3,30,6,7,0,13,5,30,6,7,0,13,2,30,9,0,0,9,1,-15,3,1
2,4,31,1,30,4,8,0,12,7,30,8,0,0,8,2,30,4,8,0,12,0,30,9,3,0,12,1,30,6,0,0,6,1,-15,3,1
2,4,35,0,30,13,0,0,13,5,30,2,0,0,2,1,30,2,11,0,13,9,30,4,9,0,13,0,30,8,0,0,8,1,-15,3,1
2,4,1,0,30,7,3,0,10,4,30,2,0,0,2,0,30,4,6,0,10,0,30,6,4,0,10,6,30,6,0,0,6,0,-27,3,0
2,2,13,3,30,3,0,0,3,1,30,2,0,0,2,0,30,2,1,0,3,5,30,2,1,0,3,3,30,2,0,0,2,1,-15,3,1
2,3,13,3,30,3,0,0,3,1,30,2,0,0,2,0,30,2,1,0,3,5,30,2,1,0,3,3,30,2,0,0,2,1,-15,3,1
2,4,13,1,30,6,1,0,7,0,30,4,0,0,4,2,30,5,2,0,7,10,30,6,1,0,7,3,30,4,0,0,4,1,-15,3,1
2,1,17,2,30,11,3,0,14,2,30,6,0,0,6,0,30,5,9,0,14,1,30,5,9,0,14,5,30,4,0,0,4,1,-15,3,1
2,2,17,2,30,11,3,0,14,2,30,6,0,0,6,0,30,5,9,0,14,1,30,5,9,0,14,5,30,4,0,0,4,1,-15,3,1
2,3,17,2,30,11,3,0,14,2,30,6,0,0,6,0,30,5,9,0,14,1,30,5,9,0,14,5,30,4,0,0,4,1,-15,3,1
2,4,17,2,30,11,3,0,14,2,30,6,0,0,6,0,30,5,9,0,14,1,30,5,9,0,14,5,30,4,0,0,4,1,-15,3,1
2,4,19,0,30,4,9,0,13,2,30,8,0,0,8,0,30,4,9,0,13,0,30,5,8,0,13,3,30,9,0,0,9,1,-15,3,1
2,4,22,1,30,7,1,0,8,2,30,2,0,0,2,0,30,4,4,0,8,1,30,3,5,0,8,1,30,2,2,0,4,1,-15,3,1
2,4,23,1,30,4,9,0,13,3,30,6,0,0,6,6,30,13,0,0,13,0,30,6,7,0,13,1,30,5,1,0,6,1,-15,3,1
2,4,25,1,30,7,7,0,14,4,30,6,0,0,6,0,30,8,6,0,14,0,30,5,9,0,14,4,30,5,1,0,6,1,-15,3,1
2,0,27,1,30,2,13,0,15,2,30,1,1,0,2,0,30,5,10,0,15,3,30,4,11,0,15,4,30,6,0,0,6,1,-15,3,1
2,2,27,1,30,2,13,0,15,2,30,1,1,0,2,0,30,5,10,0,15,2,30,4,11,0,15,4,30,6,0,0,6,1,-15,3,1
2,4,31,1,30,5,7,0,12,4,30,8,0,0,8,3,30,10,2,0,12,0,30,7,5,0,12,0,30,5,1,0,6,1,-15,3,1
2,2,13,1,30,5,2,0,7,0,30,4,0,0,4,4,30,7,0,0,7,7,30,6,1,0,7,0,30,4,0,0,4,1,-15,3,1
2,4,15,0,30,4,9,0,13,1,30,6,0,0,6,0,30,3,10,0,13,1,30,6,7,0,13,2,30,7,2,0,9,1,-15,3,1
2,2,17,3,30,9,5,0,14,4,30,6,0,0,6,0,30,3,11,0,14,0,30,9,5,0,14,4,30,4,0,0,4,1,-15,3,1
2,3,17,3,30,9,5,0,14,4,30,6,0,0,6,0,30,3,11,0,14,0,30,9,5,0,14,4,30,4,0,0,4,1,-15,3,1
2,4,17,3,30,9,5,0,14,4,30,6,0,0,6,0,30,3,11,0,14,0,30,9,5,0,14,4,30,4,0,0,4,1,-15,3,1
2,0,26,0,30,8,1,0,9,4,30,4,0,0,4,5,30,5,4,0,9,0,30,2,7,0,9,6,30,1,2,0,3,1,-15,3,1
2,1,26,0,30,8,1,0,9,4,30,4,0,0,4,5,30,5,4,0,9,0,30,2,7,0,9,6,30,1,2,0,3,1,-15,3,1
2,4,26,0,30,8,1,0,9,4,30,4,0,0,4,5,30,5,4,0,9,0,30,2,7,0,9,6,30,1,2,0,3,1,-15,3,1
2,3,31,1,30,4,8,0,12,8,30,8,0,0,8,3,30,4,8,0,12,2,30,11,1,0,12,3,30,6,0,0,6,1,-15,3,1
2,4,13,2,30,6,1,0,7,0,30,4,0,0,4,2,30,5,2,0,7,10,30,6,1,0,7,3,30,4,0,0,4,1,-15,3,1
2,1,17,3,30,11,3,0,14,2,30,6,0,0,6,0,30,7,7,0,14,1,30,5,9,0,14,5,30,4,0,0,4,1,-15,3,1
2,2,17,3,30,11,3,0,14,2,30,6,0,0,6,0,30,7,7,0,14,1,30,5,9,0,14,5,30,4,0,0,4,1,-15,3,1
2,3,17,3,30,11,3,0,14,2,30,6,0,0,6,0,30,7,7,0,14,1,30,5,9,0,14,5,30,4,0,0,4,1,-15,3,1
2,4,23,4,30,5,8,0,13,3,30,6,0,0,6,3,30,12,1,0,13,0,30,8,5,0,13,1,30,6,0,0,6,1,-15,3,1
2,0,26,0,30,4,5,0,9,5,30,4,0,0,4,9,30,1,8,0,9,2,30,1,8,0,9,4,30,1,2,0,3,1,-15,3,1
2,1,26,0,30,4,5,0,9,5,30,4,0,0,4,9,30,1,8,0,9,2,30,1,8,0,9,4,30,1,2,0,3,1,-15,3,1
2,4,26,0,30,4,5,0,9,5,30,4,0,0,4,9,30,1,8,0,9,2,30,1,8,0,9,4,30,1,2,0,3,1,-15,3,1
2,2,27,1,30,4,11,0,15,0,30,1,1,0,2,0,30,11,4,0,15,1,30,5,10,0,15,0,30,5,1,0,6,1,-15,3,1
2,3,27,1,30,4,11,0,15,0,30,1,1,0,2,0,30,11,4,0,15,1,30,5,10,0,15,0,30,5,1,0,6,1,-15,3,1
2,3,29,0,30,9,5,0,14,6,30,7,5,0,12,0,30,4,10,0,14,0,30,0,14,0,14,5,30,9,0,0,9,1,-15,3,1
2,4,31,1,30,4,8,0,12,5,30,8,0,0,8,3,30,8,4,0,12,0,30,5,7,0,12,2,30,6,0,0,6,1,-15,3,1
2,2,13,1,30,7,0,0,7,0,30,4,0,0,4,2,30,6,1,0,7,6,30,6,1,0,7,3,30,4,0,0,4,1,-15,3,1
2,3,13,1,30,7,0,0,7,0,30,4,0,0,4,2,30,6,1,0,7,6,30,6,1,0,7,3,30,4,0,0,4,1,-15,3,1
2,3,19,0,30,5,8,0,13,1,30,7,1,0,8,0,30,6,7,0,13,0,30,3,10,0,13,2,30,8,1,0,9,1,-15,3,1
2,0,25,0,30,6,8,0,14,5,30,6,0,0,6,0,30,6,8,0,14,3,30,6,8,0,14,6,30,6,0,0,6,1,-15,3,1
2,1,25,0,30,6,8,0,14,5,30,6,0,0,6,0,30,6,8,0,14,3,30,6,8,0,14,6,30,6,0,0,6,1,-15,3,1
2,2,25,0,30,6,8,0,14,5,30,6,0,0,6,0,30,6,8,0,14,3,30,6,8,0,14,6,30,6,0,0,6,1,-15,3,1
2,3,25,0,30,6,8,0,14,5,30,6,0,0,6,0,30,6,8,0,14,3,30,6,8,0,14,6,30,6,0,0,6,1,-15,3,1
2,4,25,0,30,6,8,0,14,5,30,6,0,0,6,0,30,6,8,0,14,3,30,6,8,0,14,6,30,6,0,0,6,1,-15,3,1
2,2,27,1,30,5,10,0,15,4,30,1,1,0,2,0,30,3,12,0,15,0,30,6,9,0,15,5,30,6,0,0,6,1,-15,3,1
2,1,29,0,30,11,3,0,14,5,30,8,4,0,12,0,30,6,8,0,14,0,30,0,14,0,14,4,30,9,0,0,9,1,-15,3,1
2,4,31,4,30,5,7,0,12,6,30,8,0,0,8,3,30,6,6,0,12,0,30,5,7,0,12,2,30,5,1,0,6,1,-15,3,1
2,3,39,1,30,3,8,0,11,7,30,6,0,0,6,0,30,4,7,0,11,2,30,4,7,0,11,5,30,5,0,0,5,1,-15,3,1
2,4,39,1,30,3,8,0,11,7,30,6,0,0,6,0,30,4,7,0,11,2,30,4,7,0,11,5,30,5,0,0,5,1,-15,3,1
2,4,47,0,30,1,13,0,14,6,30,4,0,0,4,0,30,10,4,0,14,0,30,9,5,0,14,4,30,6,1,0,7,1,-15,3,1
2,4,4,3,30,8,0,0,8,4,30,3,1,0,4,0,30,6,2,0,8,0,30,4,4,0,8,1,30,4,0,0,4,0,-27,3,0
2,2,8,2,30,7,0,0,7,4,30,2,0,0,2,0,30,4,3,0,7,0,30,5,2,0,7,4,30,3,0,0,3,0,-27,3,0
2,3,8,2,30,7,0,0,7,4,30,2,0,0,2,0,30,4,3,0,7,0,30,5,2,0,7,4,30,3,0,0,3,0,-27,3,0
2,4,8,2,30,7,0,0,7,4,30,2,0,0,2,0,30,4,3,0,7,0,30,5,2,0,7,4,30,3,0,0,3,0,-27,3,0
2,2,11,0,30,5,7,0,12,1,30,4,0,0,4,0,30,6,6,0,12,3,30,6,6,0,12,1,30,4,0,0,4,1,-15,3,1
2,3,11,0,30,5,7,0,12,1,30,4,0,0,4,0,30,6,6,0,12,3,30,6,6,0,12,1,30,4,0,0,4,1,-15,3,1
2,3,15,1,30,4,9,0,13,1,30,6,0,0,6,0,30,3,10,0,13,1,30,3,10,0,13,2,30,7,2,0,9,1,-15,3,1
2,4,25,1,30,6,8,0,14,5,30,6,0,0,6,0,30,4,10,0,14,1,30,6,8,0,14,0,30,5,1,0,6,1,-15,3,1
2,4,27,1,30,5,10,0,15,4,30,2,0,0,2,0,30,7,8,0,15,0,30,4,11,0,15,1,30,6,0,0,6,1,-15,3,1
2,1,29,0,30,5,9,0,14,4,30,11,1,0,12,0,30,4,10,0,14,0,30,6,8,0,14,2,30,9,0,0,9,1,-15,3,1
2,2,6,1,30,8,1,0,9,5,30,2,0,0,2,0,30,2,7,0,9,0,30,4,5,0,9,4,30,5,0,0,5,0,-27,3,0
2,3,6,1,30,8,1,0,9,5,30,2,0,0,2,0,30,2,7,0,9,0,30,4,5,0,9,4,30,5,0,0,5,0,-27,3,0
2,4,6,1,30,8,1,0,9,5,30,2,0,0,2,0,30,2,7,0,9,0,30,4,5,0,9,4,30,5,0,0,5,0,-27,3,0
2,3,11,1,30,6,6,0,12,2,30,4,0,0,4,0,30,6,6,0,12,6,30,6,6,0,12,0,30,4,0,0,4,1,-15,3,1
2,1,13,9,30,7,0,0,7,3,30,4,0,0,4,2,30,6,1,0,7,2,30,5,2,0,7,4,30,4,0,0,4,1,-15,3,1
2,2,13,9,30,7,0,0,7,3,30,4,0,0,4,2,30,6,1,0,7,2,30,5,2,0,7,4,30,4,0,0,4,1,-15,3,1
2,3,13,9,30,7,0,0,7,3,30,4,0,0,4,2,30,6,1,0,7,2,30,5,2,0,7,4,30,4,0,0,4,1,-15,3,1
2,4,14,3,30,9,0,0,9,4,30,6,0,0,6,2,30,0,9,0,9,0,30,3,6,0,9,4,30,4,0,0,4,1,-15,3,1
2,2,17,2,30,5,9,0,14,3,30,6,0,0,6,0,30,6,8,0,14,4,30,8,6,0,14,5,30,4,0,0,4,1,-15,3,1
2,3,17,2,30,5,9,0,14,3,30,6,0,0,6,0,30,6,8,0,14,4,30,8,6,0,14,5,30,4,0,0,4,1,-15,3,1
2,4,17,2,30,5,9,0,14,3,30,6,0,0,6,0,30,6,8,0,14,4,30,8,6,0,14,5,30,4,0,0,4,1,-15,3,1
2,0,19,0,30,4,9,0,13,2,30,3,5,0,8,0,30,7,6,0,13,2,30,5,8,0,13,3,30,9,0,0,9,1,-15,3,1
2,2,19,0,30,4,9,0,13,2,30,3,5,0,8,0,30,7,6,0,13,2,30,5,8,0,13,3,30,9,0,0,9,1,-15,3,1
2,3,25,2,30,6,8,0,14,1,30,6,0,0,6,0,30,11,3,0,14,1,30,4,10,0,14,4,30,5,1,0,6,1,-15,3,1
2,3,33,2,30,5,6,0,11,5,30,4,0,0,4,6,30,10,1,0,11,0,30,4,7,0,11,4,30,4,0,0,4,1,-15,3,1
2,0,4,0,30,6,2,0,8,5,30,4,0,0,4,1,30,1,7,0,8,0,30,7,1,0,8,2,30,4,0,0,4,0,-27,3,0
2,1,4,0,30,6,2,0,8,5,30,4,0,0,4,1,30,1,7,0,8,0,30,7,1,0,8,2,30,4,0,0,4,0,-27,3,0
2,2,4,0,30,6,2,0,8,5,30,4,0,0,4,1,30,1,7,0,8,0,30,7,1,0,8,2,30,4,0,0,4,0,-27,3,0
2,3,4,0,30,6,2,0,8,5,30,4,0,0,4,1,30,1,7,0,8,0,30,7,1,0,8,2,30,4,0,0,4,0,-27,3,0
2,4,11,1,30,4,8,0,12,0,30,4,0,0,4,0,30,8,4,0,12,3,30,6,6,0,12,5,30,4,0,0,4,1,-15,3,1
2,1,13,5,30,7,0,0,7,0,30,4,0,0,4,2,30,6,1,0,7,6,30,6,1,0,7,5,30,4,0,0,4,1,-15,3,1
2,3,13,5,30,7,0,0,7,0,30,4,0,0,4,2,30,6,1,0,7,6,30,6,1,0,7,5,30,4,0,0,4,1,-15,3,1
2,3,17,0,30,9,5,0,14,1,30,6,0,0,6,0,30,8,6,0,14,2,30,6,8,0,14,2,30,4,0,0,4,1,-15,3,1
2,0,19,0,30,3,10,0,13,2,30,8,0,0,8,0,30,6,7,0,13,4,30,7,6,0,13,1,30,7,2,0,9,1,-15,3,1
2,1,19,0,30,3,10,0,13,2,30,8,0,0,8,0,30,6,7,0,13,4,30,7,6,0,13,1,30,7,2,0,9,1,-15,3,1
2,2,19,0,30,3,10,0,13,2,30,8,0,0,8,0,30,6,7,0,13,4,30,7,6,0,13,1,30,7,2,0,9,1,-15,3,1
2,3,19,0,30,3,10,0,13,2,30,8,0,0,8,0,30,6,7,0,13,4,30,7,6,0,13,1,30,7,2,0,9,1,-15,3,1
2,1,27,1,30,5,10,0,15,4,30,2,0,0,2,1,30,6,9,0,15,0,30,4,11,0,15,3,30,6,0,0,6,1,-15,3,1
2,2,27,1,30,5,10,0,15,4,30,2,0,0,2,1,30,6,9,0,15,0,30,4,11,0,15,3,30,6,0,0,6,1,-15,3,1
2,3,27,1,30,5,10,0,15,4,30,2,0,0,2,1,30,6,9,0,15,0,30,4,11,0,15,3,30,6,0,0,6,1,-15,3,1
2,4,27,1,30,5,10,0,15,4,30,2,0,0,2,1,30,6,9,0,15,0,30,4,11,0,15,3,30,6,0,0,6,1,-15,3,1
2,1,29,0,30,7,7,0,14,6,30,7,5,0,12,0,30,5,9,0,14,1,30,4,10,0,14,2,30,9,0,0,9,1,-15,3,1
2,3,31,4,30,6,6,0,12,4,30,8,0,0,8,3,30,12,0,0,12,0,30,3,9,0,12,1,30,3,3,0,6,1,-15,3,1
2,2,37,1,30,8,3,0,11,6,30,8,0,0,8,0,30,8,3,0,11,0,30,3,8,0,11,5,30,6,0,0,6,1,-15,3,1
2,3,37,1,30,8,3,0,11,6,30,8,0,0,8,0,30,8,3,0,11,0,30,3,8,0,11,5,30,6,0,0,6,1,-15,3,1
2,4,38,0,30,2,8,0,10,6,30,6,0,0,6,0,30,1,9,0,10,0,30,2,8,0,10,6,30,6,0,0,6,1,-15,3,1
2,3,39,0,30,2,9,0,11,6,30,6,0,0,6,0,30,7,4,0,11,0,30,2,9,0,11,4,30,5,0,0,5,1,-15,3,1
2,2,45,2,30,10,3,0,13,10,30,10,0,0,10,0,30,2,11,0,13,0,30,4,9,0,13,5,30,5,0,0,5,1,-15,3,1
2,3,45,2,30,10,3,0,13,10,30,10,0,0,10,0,30,2,11,0,13,0,30,4,9,0,13,5,30,5,0,0,5,1,-15,3,1
2,1,13,1,30,7,0,0,7,0,30,4,0,0,4,2,30,6,1,0,7,3,30,6,1,0,7,4,30,4,0,0,4,1,-15,3,1
2,2,13,1,30,7,0,0,7,0,30,4,0,0,4,2,30,6,1,0,7,3,30,6,1,0,7,4,30,4,0,0,4,1,-15,3,1
2,4,13,1,30,7,0,0,7,0,30,4,0,0,4,2,30,6,1,0,7,3,30,6,1,0,7,4,30,4,0,0,4,1,-15,3,1
2,3,17,3,30,7,7,0,14,3,30,6,0,0,6,0,30,7,7,0,14,6,30,5,9,0,14,1,30,2,2,0,4,1,-15,3,1
2,4,17,3,30,7,7,0,14,3,30,6,0,0,6,0,30,7,7,0,14,6,30,5,9,0,14,1,30,2,2,0,4,1,-15,3,1
2,3,19,0,30,4,9,0,13,2,30,6,2,0,8,1,30,6,7,0,13,0,30,7,6,0,13,0,30,8,1,0,9,1,-15,3,1
2,4,19,0,30,4,9,0,13,2,30,6,2,0,8,1,30,6,7,0,13,0,30,7,6,0,13,0,30,8,1,0,9,1,-15,3,1
2,1,25,1,30,7,7,0,14,3,30,6,0,0,6,0,30,6,8,0,14,1,30,5,9,0,14,3,30,6,0,0,6,1,-15,3,1
2,2,25,1,30,7,7,0,14,3,30,6,0,0,6,0,30,6,8,0,14,1,30,5,9,0,14,3,30,6,0,0,6,1,-15,3,1
2,4,25,0,30,7,7,0,14,3,30,6,0,0,6,0,30,6,8,0,14,1,30,5,9,0,14,3,30,6,0,0,6,1,-15,3,1
2,0,27,3,30,5,10,0,15,2,30,1,1,0,2,0,30,6,9,0,15,0,30,6,9,0,15,1,30,5,1,0,6,1,-15,3,1
2,1,27,3,30,5,10,0,15,2,30,1,1,0,2,0,30,6,9,0,15,0,30,6,9,0,15,1,30,5,1,0,6,1,-15,3,1
2,3,27,3,30,5,10,0,15,2,30,1,1,0,2,0,30,6,9,0,15,0,30,6,9,0,15,1,30,5,1,0,6,1,-15,3,1
2,4,31,3,30,7,5,0,12,5,30,8,0,0,8,3,30,7,5,0,12,0,30,3,9,0,12,0,30,3,3,0,6,1,-15,3,1
2,1,33,7,30,2,9,0,11,4,30,4,0,0,4,3,30,11,0,0,11,0,30,4,7,0,11,7,30,4,0,0,4,1,-15,3,1
2,3,33,7,30,2,9,0,11,4,30,4,0,0,4,3,30,11,0,0,11,0,30,4,7,0,11,7,30,4,0,0,4,1,-15,3,1
2,2,39,0,30,3,8,0,11,6,30,6,0,0,6,0,30,7,4,0,11,1,30,2,9,0,11,5,30,5,0,0,5,1,-15,3,1
2,3,45,0,30,3,10,0,13,9,30,10,0,0,10,0,30,2,11,0,13,0,30,4,9,0,13,3,30,5,0,0,5,1,-15,3,1
2,0,5,0,30,2,3,0,5,3,30,0,4,0,4,0,30,1,4,0,5,0,30,1,4,0,5,0,30,1,1,0,2,0,-27,3,0
2,1,5,0,30,2,3,0,5,3,30,0,4,0,4,0,30,1,4,0,5,0,30,1,4,0,5,0,30,1,1,0,2,0,-27,3,0
2,2,5,0,30,2,3,0,5,3,30,0,4,0,4,0,30,1,4,0,5,0,30,1,4,0,5,0,30,1,1,0,2,0,-27,3,0
2,4,5,0,30,2,3,0,5,3,30,0,4,0,4,0,30,1,4,0,5,0,30,1,4,0,5,0,30,1,1,0,2,0,-27,3,0
2,3,9,0,30,1,3,0,4,2,30,2,0,0,2,0,30,0,4,0,4,4,30,1,3,0,4,1,30,1,0,0,1,0,-27,3,0
2,4,11,0,30,3,9,0,12,1,30,4,0,0,4,7,30,5,7,0,12,4,30,4,8,0,12,0,30,3,1,0,4,1,-15,3,1
2,2,13,7,30,7,0,0,7,3,30,4,0,0,4,3,30,7,0,0,7,2,30,7,0,0,7,0,30,4,0,0,4,1,-15,3,1
2,3,13,7,30,7,0,0,7,3,30,4,0,0,4,3,30,7,0,0,7,2,30,7,0,0,7,0,30,4,0,0,4,1,-15,3,1
2,4,13,7,30,7,0,0,7,3,30,4,0,0,4,3,30,7,0,0,7,2,30,7,0,0,7,0,30,4,0,0,4,1,-15,3,1
2,4,17,1,30,8,6,0,14,2,30,6,0,0,6,0,30,7,7,0,14,1,30,5,9,0,14,3,30,4,0,0,4,1,-15,3,1
2,1,23,1,30,5,8,0,13,2,30,6,0,0,6,4,30,10,3,0,13,0,30,6,7,0,13,3,30,6,0,0,6,1,-15,3,1
2,4,23,0,30,5,8,0,13,2,30,6,0,0,6,4,30,10,3,0,13,0,30,6,7,0,13,2,30,6,0,0,6,1,-15,3,1
2,1,25,1,30,6,8,0,14,3,30,6,0,0,6,0,30,3,11,0,14,3,30,7,7,0,14,4,30,6,0,0,6,1,-15,3,1
2,4,27,1,30,5,10,0,15,4,30,2,0,0,2,0,30,4,11,0,15,2,30,5,10,0,15,5,30,6,0,0,6,1,-15,3,1
2,0,4,2,30,8,0,0,8,4,30,4,0,0,4,0,30,2,6,0,8,0,30,4,4,0,8,2,30,3,1,0,4,0,-27,3,0
2,1,4,2,30,8,0,0,8,4,30,4,0,0,4,0,30,2,6,0,8,0,30,4,4,0,8,2,30,3,1,0,4,0,-27,3,0
2,2,4,2,30,8,0,0,8,4,30,4,0,0,4,0,30,2,6,0,8,0,30,4,4,0,8,2,30,3,1,0,4,0,-27,3,0
2,4,5,0,30,4,1,0,5,3,30,3,1,0,4,0,30,0,5,0,5,0,30,1,4,0,5,0,30,2,0,0,2,0,-27,3,0
2,0,19,0,30,2,11,0,13,2,30,3,5,0,8,0,30,6,7,0,13,7,30,4,9,0,13,3,30,8,1,0,9,1,-15,3,1
2,2,19,0,30,2,11,0,13,2,30,3,5,0,8,0,30,6,7,0,13,7,30,4,9,0,13,0,30,8,1,0,9,1,-15,3,1
2,4,19,0,30,2,11,0,13,2,30,3,5,0,8,0,30,6,7,0,13,7,30,4,9,0,13,0,30,8,1,0,9,1,-15,3,1
2,2,17,3,30,9,5,0,14,1,30,6,0,0,6,0,30,4,10,0,14,1,30,6,8,0,14,7,30,4,0,0,4,1,-15,3,1
2,1,19,0,30,5,8,0,13,2,30,5,3,0,8,0,30,6,7,0,13,3,30,5,8,0,13,3,30,9,0,0,9,1,-15,3,1
2,0,21,3,30,8,2,0,10,4,30,6,0,0,6,1,30,3,7,0,10,5,30,5,5,0,10,1,30,4,0,0,4,1,-15,3,1
2,2,21,3,30,8,2,0,10,4,30,6,0,0,6,1,30,3,7,0,10,5,30,5,5,0,10,1,30,4,0,0,4,1,-15,3,1
2,3,25,1,30,8,6,0,14,1,30,6,0,0,6,0,30,8,6,0,14,1,30,4,10,0,14,4,30,5,1,0,6,1,-15,3,1
2,4,25,1,30,8,6,0,14,1,30,6,0,0,6,0,30,8,6,0,14,1,30,4,10,0,14,4,30,5,1,0,6,1,-15,3,1
2,3,35,1,30,9,4,0,13,5,30,2,0,0,2,5,30,2,11,0,13,0,30,2,11,0,13,6,30,8,0,0,8,1,-15,3,1
2,2,47,0,30,5,9,0,14,8,30,4,0,0,4,6,30,9,5,0,14,0,30,2,12,0,14,3,30,7,0,0,7,1,-15,3,1
2,3,47,0,30,5,9,0,14,8,30,4,0,0,4,6,30,9,5,0,14,0,30,2,12,0,14,3,30,7,0,0,7,1,-15,3,1
2,4,47,0,30,5,9,0,14,8,30,4,0,0,4,6,30,9,5,0,14,0,30,2,12,0,14,3,30,7,0,0,7,1,-15,3,1
2,4,8,3,30,7,0,0,7,4,30,2,0,0,2,2,30,3,4,0,7,0,30,4,3,0,7,3,30,3,0,0,3,0,-27,3,0
2,2,17,2,30,8,6,0,14,3,30,6,0,0,6,0,30,5,9,0,14,1,30,7,7,0,14,3,30,4,0,0,4,1,-15,3,1
2,3,17,2,30,8,6,0,14,3,30,6,0,0,6,0,30,5,9,0,14,1,30,7,7,0,14,3,30,4,0,0,4,1,-15,3,1
2,4,17,2,30,8,6,0,14,3,30,6,0,0,6,0,30,5,9,0,14,1,30,7,7,0,14,3,30,4,0,0,4,1,-15,3,1
2,3,19,0,30,4,9,0,13,2,30,6,2,0,8,0,30,6,7,0,13,5,30,4,9,0,13,1,30,7,2,0,9,1,-15,3,1
2,4,19,0,30,4,9,0,13,2,30,6,2,0,8,0,30,6,7,0,13,5,30,4,9,0,13,1,30,7,2,0,9,1,-15,3,1
2,3,21,3,30,8,2,0,10,3,30,4,2,0,6,0,30,4,6,0,10,6,30,4,6,0,10,0,30,4,0,0,4,1,-15,3,1
2,2,23,3,30,5,8,0,13,4,30,6,0,0,6,6,30,11,2,0,13,0,30,3,10,0,13,3,30,6,0,0,6,1,-15,3,1
2,4,23,3,30,5,8,0,13,4,30,6,0,0,6,6,30,11,2,0,13,0,30,3,10,0,13,0,30,6,0,0,6,1,-15,3,1
2,2,27,1,30,4,11,0,15,2,30,1,1,0,2,0,30,8,7,0,15,5,30,5,10,0,15,3,30,6,0,0,6,1,-15,3,1
2,4,29,0,30,4,10,0,14,6,30,10,2,0,12,0,30,3,11,0,14,0,30,0,14,0,14,0,30,9,0,0,9,1,-15,3,1
2,3,31,0,30,9,3,0,12,5,30,8,0,0,8,3,30,5,7,0,12,0,30,3,9,0,12,0,30,1,5,0,6,1,-15,3,1
2,3,6,1,30,9,0,0,9,4,30,2,0,0,2,0,30,2,7,0,9,3,30,4,5,0,9,0,30,5,0,0,5,0,-27,3,0
2,4,8,4,30,7,0,0,7,4,30,2,0,0,2,4,30,6,1,0,7,0,30,5,2,0,7,0,30,2,1,0,3,0,-27,3,0
2,1,13,4,30,5,2,0,7,0,30,4,0,0,4,1,30,7,0,0,7,5,30,6,1,0,7,8,30,4,0,0,4,1,-15,3,1
2,2,13,4,30,5,2,0,7,0,30,4,0,0,4,1,30,7,0,0,7,5,30,6,1,0,7,8,30,4,0,0,4,1,-15,3,1
2,3,13,4,30,5,2,0,7,0,30,4,0,0,4,1,30,7,0,0,7,5,30,6,1,0,7,8,30,4,0,0,4,1,-15,3,1
2,3,15,0,30,4,9,0,13,0,30,6,0,0,6,0,30,6,7,0,13,1,30,4,9,0,13,2,30,9,0,0,9,1,-15,3,1
2,4,15,0,30,4,9,0,13,0,30,6,0,0,6,0,30,6,7,0,13,1,30,4,9,0,13,2,30,9,0,0,9,1,-15,3,1
2,3,19,0,30,3,10,0,13,2,30,8,0,0,8,0,30,4,9,0,13,0,30,4,9,0,13,0,30,9,0,0,9,1,-15,3,1
2,3,23,0,30,6,7,0,13,2,30,6,0,0,6,5,30,12,1,0,13,4,30,6,7,0,13,1,30,6,0,0,6,1,-15,3,1
2,4,25,1,30,8,6,0,14,4,30,6,0,0,6,0,30,5,9,0,14,2,30,6,8,0,14,5,30,5,1,0,6,1,-15,3,1
2,1,27,0,30,4,11,0,15,4,30,1,1,0,2,0,30,5,10,0,15,1,30,5,10,0,15,4,30,6,0,0,6,1,-15,3,1
2,3,27,0,30,4,11,0,15,4,30,1,1,0,2,0,30,5,10,0,15,1,30,5,10,0,15,4,30,6,0,0,6,1,-15,3,1
2,3,29,0,30,6,8,0,14,5,30,11,1,0,12,0,30,7,7,0,14,0,30,0,14,0,14,1,30,9,0,0,9,1,-15,3,1
2,4,19,0,30,8,5,0,13,3,30,7,1,0,8,9,30,5,8,0,13,0,30,3,10,0,13,1,30,6,3,0,9,1,-15,3,1
2,4,23,1,30,5,8,0,13,3,30,6,0,0,6,1,30,12,1,0,13,0,30,6,7,0,13,5,30,6,0,0,6,1,-15,3,1
2,1,25,1,30,9,5,0,14,2,30,6,0,0,6,0,30,10,4,0,14,1,30,5,9,0,14,5,30,6,0,0,6,1,-15,3,1
2,3,25,1,30,9,5,0,14,2,30,6,0,0,6,0,30,10,4,0,14,0,30,5,9,0,14,5,30,6,0,0,6,1,-15,3,1
2,0,27,1,30,3,12,0,15,5,30,1,1,0,2,0,30,5,10,0,15,6,30,5,10,0,15,2,30,6,0,0,6,1,-15,3,1
2,2,27,1,30,3,12,0,15,5,30,1,1,0,2,0,30,5,10,0,15,6,30,5,10,0,15,2,30,6,0,0,6,1,-15,3,1
2,3,29,0,30,6,8,0,14,6,30,12,0,0,12,0,30,6,8,0,14,0,30,0,14,0,14,1,30,9,0,0,9,1,-15,3,1
2,4,31,4,30,9,3,0,12,5,30,8,0,0,8,3,30,8,4,0,12,0,30,6,6,0,12,2,30,1,5,0,6,1,-15,3,1
2,1,33,2,30,3,8,0,11,6,30,4,0,0,4,7,30,3,8,0,11,1,30,4,7,0,11,3,30,4,0,0,4,1,-15,3,1
2,2,35,0,30,9,4,0,13,6,30,2,0,0,2,1,30,2,11,0,13,0,30,4,9,0,13,4,30,8,0,0,8,1,-15,3,1
2,3,35,0,30,9,4,0,13,6,30,2,0,0,2,1,30,2,11,0,13,0,30,4,9,0,13,4,30,8,0,0,8,1,-15,3,1
2,4,35,0,30,9,4,0,13,6,30,2,0,0,2,1,30,2,11,0,13,0,30,4,9,0,13,4,30,8,0,0,8,1,-15,3,1
2,0,4,2,30,6,2,0,8,5,30,4,0,0,4,0,30,3,5,0,8,1,30,8,0,0,8,3,30,3,1,0,4,0,-27,3,0
2,1,4,2,30,6,2,0,8,5,30,4,0,0,4,0,30,3,5,0,8,1,30,8,0,0,8,3,30,3,1,0,4,0,-27,3,0
2,1,13,3,30,7,0,0,7,0,30,4,0,0,4,2,30,5,2,0,7,11,30,5,2,0,7,3,30,4,0,0,4,1,-15,3,1
2,2,17,4,30,9,5,0,14,2,30,6,0,0,6,0,30,6,8,0,14,2,30,3,11,0,14,2,30,4,0,0,4,1,-15,3,1
2,1,19,0,30,2,11,0,13,2,30,6,2,0,8,0,30,7,6,0,13,7,30,4,9,0,13,4,30,8,1,0,9,1,-15,3,1
2,2,19,0,30,2,11,0,13,2,30,6,2,0,8,0,30,7,6,0,13,7,30,4,9,0,13,4,30,8,1,0,9,1,-15,3,1
2,4,19,0,30,2,11,0,13,2,30,6,2,0,8,0,30,7,6,0,13,7,30,4,9,0,13,4,30,8,1,0,9,1,-15,3,1
2,3,22,1,30,6,2,0,8,3,30,2,0,0,2,2,30,4,4,0,8,1,30,6,2,0,8,5,30,4,0,0,4,1,-15,3,1
2,3,25,1,30,6,8,0,14,3,30,6,0,0,6,0,30,8,6,0,14,1,30,6,8,0,14,6,30,6,0,0,6,1,-15,3,1
2,0,27,1,30,3,12,0,15,4,30,2,0,0,2,0,30,4,11,0,15,0,30,5,10,0,15,5,30,6,0,0,6,1,-15,3,1
2,1,27,1,30,3,12,0,15,4,30,2,0,0,2,0,30,4,11,0,15,0,30,5,10,0,15,5,30,6,0,0,6,1,-15,3,1
2,2,27,1,30,3,12,0,15,4,30,2,0,0,2,0,30,4,11,0,15,0,30,5,10,0,15,5,30,6,0,0,6,1,-15,3,1
2,2,29,0,30,6,8,0,14,6,30,11,1,0,12,0,30,4,10,0,14,0,30,3,11,0,14,4,30,9,0,0,9,1,-15,3,1
2,4,11,1,30,4,8,0,12,1,30,4,0,0,4,0,30,6,6,0,12,3,30,5,7,0,12,4,30,4,0,0,4,1,-15,3,1
2,1,13,1,30,7,0,0,7,0,30,4,0,0,4,2,30,6,1,0,7,5,30,6,1,0,7,6,30,4,0,0,4,1,-15,3,1
2,3,15,1,30,4,9,0,13,0,30,6,0,0,6,0,30,4,9,0,13,1,30,3,10,0,13,2,30,9,0,0,9,1,-15,3,1
2,1,17,3,30,10,4,0,14,4,30,6,0,0,6,0,30,3,11,0,14,5,30,7,7,0,14,4,30,4,0,0,4,1,-15,3,1
2,2,17,3,30,10,4,0,14,4,30,6,0,0,6,0,30,3,11,0,14,5,30,7,7,0,14,4,30,4,0,0,4,1,-15,3,1
2,2,25,1,30,4,10,0,14,6,30,6,0,0,6,0,30,4,10,0,14,1,30,7,7,0,14,4,30,6,0,0,6,1,-15,3,1
2,2,27,1,30,5,10,0,15,4,30,2,0,0,2,0,30,6,9,0,15,2,30,6,9,0,15,0,30,6,0,0,6,1,-15,3,1
2,3,27,1,30,5,10,0,15,4,30,2,0,0,2,0,30,6,9,0,15,2,30,6,9,0,15,0,30,6,0,0,6,1,-15,3,1
2,4,29,0,30,7,7,0,14,6,30,12,0,0,12,0,30,3,11,0,14,0,30,1,13,0,14,0,30,8,1,0,9,1,-15,3,1
2,4,11,1,30,4,8,0,12,0,30,4,0,0,4,0,30,9,3,0,12,11,30,2,10,0,12,3,30,4,0,0,4,1,-15,3,1
2,1,13,2,30,6,1,0,7,0,30,4,0,0,4,2,30,6,1,0,7,9,30,7,0,0,7,7,30,4,0,0,4,1,-15,3,1
2,2,13,2,30,6,1,0,7,0,30,4,0,0,4,2,30,6,1,0,7,9,30,7,0,0,7,7,30,4,0,0,4,1,-15,3,1
2,4,17,5,30,12,2,0,14,3,30,6,0,0,6,0,30,4,10,0,14,1,30,6,8,0,14,2,30,4,0,0,4,1,-15,3,1
2,2,19,0,30,3,10,0,13,2,30,6,2,0,8,0,30,7,6,0,13,4,30,3,10,0,13,1,30,8,1,0,9,1,-15,3,1
2,3,22,1,30,5,3,0,8,3,30,2,0,0,2,2,30,4,4,0,8,1,30,5,3,0,8,5,30,4,0,0,4,1,-15,3,1
2,4,22,1,30,5,3,0,8,3,30,2,0,0,2,2,30,4,4,0,8,1,30,5,3,0,8,5,30,4,0,0,4,1,-15,3,1
2,4,23,1,30,4,9,0,13,3,30,6,0,0,6,6,30,8,5,0,13,2,30,6,7,0,13,3,30,6,0,0,6,1,-15,3,1
2,0,26,0,30,5,4,0,9,4,30,3,1,0,4,5,30,2,7,0,9,0,30,2,7,0,9,4,30,3,0,0,3,1,-15,3,1
2,1,26,0,30,5,4,0,9,4,30,3,1,0,4,5,30,2,7,0,9,0,30,2,7,0,9,4,30,3,0,0,3,1,-15,3,1
2,3,26,0,30,5,4,0,9,4,30,3,1,0,4,5,30,2,7,0,9,0,30,2,7,0,9,4,30,3,0,0,3,1,-15,3,1
2,0,27,1,30,6,9,0,15,3,30,2,0,0,2,0,30,6,9,0,15,3,30,7,8,0,15,1,30,5,1,0,6,1,-15,3,1
2,1,27,1,30,6,9,0,15,3,30,2,0,0,2,0,30,6,9,0,15,3,30,7,8,0,15,1,30,5,1,0,6,1,-15,3,1
2,2,27,1,30,6,9,0,15,3,30,2,0,0,2,0,30,6,9,0,15,3,30,7,8,0,15,1,30,5,1,0,6,1,-15,3,1
2,4,27,1,30,6,9,0,15,3,30,2,0,0,2,0,30,6,9,0,15,3,30,7,8,0,15,1,30,5,1,0,6,1,-15,3,1
2,0,4,2,30,5,3,0,8,5,30,2,2,0,4,0,30,2,6,0,8,0,30,7,1,0,8,1,30,3,1,0,4,0,-27,3,0
2,3,5,0,30,2,3,0,5,2,30,3,1,0,4,0,30,2,3,0,5,0,30,1,4,0,5,1,30,0,2,0,2,0,-27,3,0
2,2,8,2,30,6,1,0,7,3,30,2,0,0,2,0,30,4,3,0,7,0,30,4,3,0,7,1,30,3,0,0,3,0,-27,3,0
2,4,8,2,30,6,1,0,7,3,30,2,0,0,2,0,30,4,3,0,7,0,30,4,3,0,7,1,30,3,0,0,3,0,-27,3,0
2,3,17,2,30,9,5,0,14,2,30,6,0,0,6,0,30,8,6,0,14,4,30,5,9,0,14,0,30,4,0,0,4,1,-15,3,1
2,4,19,0,30,3,10,0,13,1,30,6,2,0,8,0,30,13,0,0,13,3,30,5,8,0,13,2,30,8,1,0,9,1,-15,3,1
2,2,25,1,30,6,8,0,14,3,30,6,0,0,6,0,30,13,1,0,14,1,30,5,9,0,14,3,30,5,1,0,6,1,-15,3,1
2,3,35,0,30,4,9,0,13,1,30,2,0,0,2,2,30,13,0,0,13,5,30,2,11,0,13,4,30,8,0,0,8,1,-15,3,1
2,3,7,0,30,2,2,0,4,2,30,2,0,0,2,0,30,3,1,0,4,0,30,4,0,0,4,1,30,1,1,0,2,0,-27,3,0
2,4,7,0,30,2,2,0,4,2,30,2,0,0,2,0,30,3,1,0,4,0,30,4,0,0,4,1,30,1,1,0,2,0,-27,3,0
2,3,8,2,30,7,0,0,7,4,30,2,0,0,2,6,30,4,3,0,7,0,30,7,0,0,7,0,30,3,0,0,3,0,-27,3,0
2,2,15,0,30,4,9,0,13,0,30,5,1,0,6,0,30,3,10,0,13,1,30,3,10,0,13,2,30,9,0,0,9,1,-15,3,1
2,2,17,3,30,9,5,0,14,4,30,6,0,0,6,0,30,4,10,0,14,1,30,7,7,0,14,2,30,4,0,0,4,1,-15,3,1
2,4,17,3,30,9,5,0,14,4,30,6,0,0,6,0,30,4,10,0,14,1,30,7,7,0,14,2,30,4,0,0,4,1,-15,3,1
2,4,22,1,30,7,1,0,8,2,30,2,0,0,2,0,30,5,3,0,8,1,30,2,6,0,8,1,30,4,0,0,4,1,-15,3,1
2,3,23,1,30,6,7,0,13,2,30,6,0,0,6,0,30,13,0,0,13,0,30,6,7,0,13,3,30,6,0,0,6,1,-15,3,1
2,4,23,1,30,6,7,0,13,2,30,6,0,0,6,0,30,13,0,0,13,0,30,6,7,0,13,3,30,6,0,0,6,1,-15,3,1
2,3,27,0,30,8,7,0,15,4,30,1,1,0,2,0,30,1,14,0,15,2,30,5,10,0,15,4,30,4,2,0,6,1,-15,3,1
2,4,27,0,30,8,7,0,15,4,30,1,1,0,2,0,30,1,14,0,15,2,30,5,10,0,15,4,30,4,2,0,6,1,-15,3,1
2,4,32,0,30,4,5,0,9,5,30,2,0,0,2,1,30,4,5,0,9,1,30,3,6,0,9,3,30,2,0,0,2,1,-15,3,1
2,4,39,0,30,1,10,0,11,6,30,6,0,0,6,0,30,7,4,0,11,1,30,5,6,0,11,5,30,5,0,0,5,1,-15,3,1
2,2,6,2,30,6,3,0,9,4,30,2,0,0,2,0,30,3,6,0,9,0,30,4,5,0,9,1,30,4,1,0,5,0,-27,3,0
2,3,6,2,30,6,3,0,9,4,30,2,0,0,2,0,30,3,6,0,9,0,30,4,5,0,9,1,30,4,1,0,5,0,-27,3,0
2,4,6,2,30,6,3,0,9,4,30,2,0,0,2,0,30,3,6,0,9,0,30,4,5,0,9,1,30,4,1,0,5,0,-27,3,0
2,4,8,1,30,7,0,0,7,3,30,2,0,0,2,4,30,3,4,0,7,3,30,6,1,0,7,4,30,3,0,0,3,0,-27,3,0
2,3,13,4,30,6,1,0,7,0,30,4,0,0,4,3,30,7,0,0,7,4,30,7,0,0,7,4,30,4,0,0,4,1,-15,3,1
2,2,17,3,30,7,7,0,14,4,30,6,0,0,6,0,30,4,10,0,14,2,30,8,6,0,14,1,30,3,1,0,4,1,-15,3,1
2,3,25,1,30,9,5,0,14,2,30,6,0,0,6,0,30,7,7,0,14,1,30,7,7,0,14,3,30,5,1,0,6,1,-15,3,1
2,4,25,1,30,9,5,0,14,2,30,6,0,0,6,0,30,7,7,0,14,1,30,7,7,0,14,3,30,5,1,0,6,1,-15,3,1
2,1,27,1,30,4,11,0,15,4,30,1,1,0,2,0,30,8,7,0,15,1,30,7,8,0,15,3,30,6,0,0,6,1,-15,3,1
2,2,29,0,30,5,9,0,14,5,30,12,0,0,12,0,30,6,8,0,14,0,30,0,14,0,14,0,30,9,0,0,9,1,-15,3,1
2,4,29,0,30,5,9,0,14,5,30,12,0,0,12,0,30,6,8,0,14,0,30,0,14,0,14,0,30,9,0,0,9,1,-15,3,1
2,2,31,2,30,8,4,0,12,3,30,8,0,0,8,3,30,11,1,0,12,0,30,3,9,0,12,1,30,2,4,0,6,1,-15,3,1
2,0,38,0,30,5,5,0,10,7,30,6,0,0,6,0,30,3,7,0,10,0,30,4,6,0,10,2,30,6,0,0,6,1,-15,3,1
2,2,38,0,30,5,5,0,10,7,30,6,0,0,6,0,30,3,7,0,10,0,30,4,6,0,10,2,30,6,0,0,6,1,-15,3,1
2,3,38,0,30,5,5,0,10,7,30,6,0,0,6,0,30,3,7,0,10,0,30,4,6,0,10,2,30,6,0,0,6,1,-15,3,1
2,4,38,0,30,5,5,0,10,7,30,6,0,0,6,0,30,3,7,0,10,0,30,4,6,0,10,2,30,6,0,0,6,1,-15,3,1
2,0,41,0,30,10,2,0,12,8,30,5,3,0,8,0,30,3,9,0,12,0,30,5,7,0,12,6,30,7,0,0,7,1,-15,3,1
2,3,41,0,30,10,2,0,12,8,30,5,3,0,8,0,30,3,9,0,12,0,30,5,7,0,12,6,30,7,0,0,7,1,-15,3,1
2,4,41,0,30,10,2,0,12,8,30,5,3,0,8,0,30,3,9,0,12,0,30,5,7,0,12,6,30,7,0,0,7,1,-15,3,1
2,3,15,0,30,4,9,0,13,0,30,6,0,0,6,0,30,3,10,0,13,1,30,3,10,0,13,2,30,9,0,0,9,1,-15,3,1
2,4,19,1,30,5,8,0,13,2,30,6,2,0,8,0,30,4,9,0,13,4,30,7,6,0,13,1,30,8,1,0,9,1,-15,3,1
2,3,22,1,30,7,1,0,8,2,30,2,0,0,2,0,30,6,2,0,8,1,30,4,4,0,8,1,30,4,0,0,4,1,-15,3,1
2,3,23,0,30,6,7,0,13,4,30,6,0,0,6,0,30,7,6,0,13,4,30,10,3,0,13,1,30,6,0,0,6,1,-15,3,1
2,4,26,0,30,5,4,0,9,5,30,4,0,0,4,3,30,3,6,0,9,0,30,2,7,0,9,5,30,2,1,0,3,1,-15,3,1
2,0,27,3,30,5,10,0,15,4,30,1,1,0,2,0,30,9,6,0,15,1,30,5,10,0,15,2,30,6,0,0,6,1,-15,3,1
2,0,29,0,30,4,10,0,14,4,30,10,2,0,12,0,30,5,9,0,14,0,30,4,10,0,14,2,30,9,0,0,9,1,-15,3,1
2,2,29,0,30,4,10,0,14,4,30,10,2,0,12,0,30,5,9,0,14,0,30,4,10,0,14,2,30,9,0,0,9,1,-15,3,1
2,4,29,0,30,4,10,0,14,4,30,10,2,0,12,0,30,5,9,0,14,0,30,4,10,0,14,2,30,9,0,0,9,1,-15,3,1
2,0,38,0,30,3,7,0,10,5,30,6,0,0,6,2,30,7,3,0,10,0,30,2,8,0,10,2,30,6,0,0,6,1,-15,3,1
2,3,38,0,30,3,7,0,10,5,30,6,0,0,6,2,30,7,3,0,10,0,30,2,8,0,10,2,30,6,0,0,6,1,-15,3,1
2,3,4,2,30,4,4,0,8,4,30,4,0,0,4,1,30,5,3,0,8,1,30,8,0,0,8,2,30,4,0,0,4,0,-27,3,0
2,2,6,1,30,7,2,0,9,4,30,2,0,0,2,0,30,2,7,0,9,0,30,4,5,0,9,2,30,5,0,0,5,0,-27,3,0
2,3,6,1,30,7,2,0,9,4,30,2,0,0,2,0,30,2,7,0,9,0,30,4,5,0,9,2,30,5,0,0,5,0,-27,3,0
2,1,19,1,30,8,5,0,13,2,30,4,4,0,8,0,30,8,5,0,13,7,30,4,9,0,13,0,30,8,1,0,9,1,-15,3,1
2,2,27,2,30,8,7,0,15,3,30,2,0,0,2,1,30,7,8,0,15,0,30,3,12,0,15,1,30,4,2,0,6,1,-15,3,1
2,2,29,0,30,4,10,0,14,6,30,9,3,0,12,0,30,5,9,0,14,0,30,1,13,0,14,3,30,9,0,0,9,1,-15,3,1
2,3,29,0,30,4,10,0,14,6,30,9,3,0,12,0,30,5,9,0,14,0,30,1,13,0,14,3,30,9,0,0,9,1,-15,3,1
2,4,31,1,30,6,6,0,12,5,30,8,0,0,8,4,30,9,3,0,12,0,30,3,9,0,12,3,30,6,0,0,6,1,-15,3,1
2,0,5,0,30,3,2,0,5,3,30,3,1,0,4,0,30,1,4,0,5,0,30,1,4,0,5,1,30,0,2,0,2,0,-27,3,0
2,1,13,1,30,6,1,0,7,0,30,4,0,0,4,3,30,7,0,0,7,7,30,4,3,0,7,4,30,4,0,0,4,1,-15,3,1
2,4,13,1,30,6,1,0,7,0,30,4,0,0,4,3,30,7,0,0,7,7,30,4,3,0,7,4,30,4,0,0,4,1,-15,3,1
2,0,17,3,30,10,4,0,14,3,30,6,0,0,6,0,30,6,8,0,14,4,30,5,9,0,14,3,30,4,0,0,4,1,-15,3,1
2,1,17,3,30,10,4,0,14,3,30,6,0,0,6,0,30,6,8,0,14,4,30,5,9,0,14,3,30,4,0,0,4,1,-15,3,1
2,2,17,3,30,10,4,0,14,3,30,6,0,0,6,0,30,6,8,0,14,4,30,5,9,0,14,3,30,4,0,0,4,1,-15,3,1
2,0,19,0,30,5,8,0,13,2,30,5,3,0,8,0,30,4,9,0,13,6,30,4,9,0,13,2,30,8,1,0,9,1,-15,3,1
2,4,19,0,30,5,8,0,13,2,30,5,3,0,8,0,30,4,9,0,13,6,30,4,9,0,13,2,30,8,1,0,9,1,-15,3,1
2,3,22,1,30,7,1,0,8,3,30,2,0,0,2,4,30,4,4,0,8,0,30,5,3,0,8,0,30,1,3,0,4,1,-15,3,1
2,3,23,1,30,5,8,0,13,1,30,6,0,0,6,0,30,9,4,0,13,2,30,6,7,0,13,5,30,6,0,0,6,1,-15,3,1
2,4,23,1,30,5,8,0,13,1,30,6,0,0,6,0,30,9,4,0,13,2,30,6,7,0,13,5,30,6,0,0,6,1,-15,3,1
2,4,27,1,30,6,9,0,15,2,30,1,1,0,2,0,30,7,8,0,15,2,30,4,11,0,15,2,30,6,0,0,6,1,-15,3,1
2,2,29,0,30,6,8,0,14,6,30,10,2,0,12,0,30,4,10,0,14,0,30,0,14,0,14,0,30,9,0,0,9,1,-15,3,1
2,0,31,4,30,5,7,0,12,6,30,8,0,0,8,3,30,6,6,0,12,0,30,3,9,0,12,1,30,6,0,0,6,1,-15,3,1
2,1,31,4,30,5,7,0,12,6,30,8,0,0,8,3,30,6,6,0,12,0,30,3,9,0,12,1,30,6,0,0,6,1,-15,3,1
2,2,31,4,30,5,7,0,12,6,30,8,0,0,8,3,30,6,6,0,12,0,30,3,9,0,12,1,30,6,0,0,6,1,-15,3,1
2,4,31,1,30,5,7,0,12,6,30,8,0,0,8,3,30,6,6,0,12,0,30,3,9,0,12,1,30,6,0,0,6,1,-15,3,1
2,3,11,0,30,2,2,0,4,0,30,0,0,0,0,0,30,0,4,0,4,3,30,3,1,0,4,2,30,1,0,0,1,1,-15,3,1
2,4,11,0,30,2,2,0,4,0,30,0,0,0,0,0,30,0,4,0,4,3,30,3,1,0,4,2,30,1,0,0,1,1,-15,3,1
2,1,13,6,30,7,0,0,7,0,30,4,0,0,4,1,30,6,1,0,7,2,30,5,2,0,7,5,30,4,0,0,4,1,-15,3,1
2,4,13,6,30,7,0,0,7,0,30,4,0,0,4,1,30,6,1,0,7,2,30,5,2,0,7,5,30,4,0,0,4,1,-15,3,1
2,2,17,3,30,7,7,0,14,2,30,6,0,0,6,0,30,9,5,0,14,2,30,5,9,0,14,6,30,4,0,0,4,1,-15,3,1
2,3,17,3,30,7,7,0,14,2,30,6,0,0,6,0,30,9,5,0,14,2,30,5,9,0,14,6,30,4,0,0,4,1,-15,3,1
2,4,17,3,30,7,7,0,14,2,30,6,0,0,6,0,30,9,5,0,14,2,30,5,9,0,14,6,30,4,0,0,4,1,-15,3,1
2,0,21,2,30,7,3,0,10,3,30,6,0,0,6,1,30,3,7,0,10,4,30,4,6,0,10,7,30,4,0,0,4,1,-15,3,1
2,1,21,2,30,7,3,0,10,3,30,6,0,0,6,1,30,3,7,0,10,4,30,4,6,0,10,7,30,4,0,0,4,1,-15,3,1
2,3,25,0,30,9,5,0,14,4,30,6,0,0,6,0,30,9,5,0,14,0,30,6,8,0,14,3,30,5,1,0,6,1,-15,3,1
2,2,4,2,30,4,4,0,8,4,30,4,0,0,4,3,30,1,7,0,8,2,30,3,5,0,8,0,30,3,1,0,4,0,-27,3,0
2,3,6,0,30,9,0,0,9,3,30,2,0,0,2,0,30,5,4,0,9,2,30,4,5,0,9,0,30,5,0,0,5,0,-27,3,0
2,2,7,1,30,6,3,0,9,3,30,4,0,0,4,1,30,5,4,0,9,4,30,2,7,0,9,3,30,5,1,0,6,0,-27,3,0
2,3,7,1,30,6,3,0,9,3,30,4,0,0,4,1,30,5,4,0,9,4,30,2,7,0,9,3,30,5,1,0,6,0,-27,3,0
2,4,8,2,30,7,0,0,7,4,30,2,0,0,2,1,30,5,2,0,7,0,30,4,3,0,7,6,30,3,0,0,3,0,-27,3,0
2,2,13,6,30,7,0,0,7,0,30,4,0,0,4,2,30,5,2,0,7,4,30,6,1,0,7,3,30,4,0,0,4,1,-15,3,1
2,3,17,0,30,9,5,0,14,2,30,6,0,0,6,0,30,6,8,0,14,1,30,7,7,0,14,6,30,4,0,0,4,1,-15,3,1
2,2,19,0,30,5,8,0,13,2,30,4,4,0,8,0,30,5,8,0,13,4,30,6,7,0,13,1,30,9,0,0,9,1,-15,3,1
2,3,9,0,30,3,1,0,4,2,30,2,0,0,2,0,30,0,4,0,4,2,30,1,3,0,4,2,30,1,0,0,1,0,-27,3,0
2,1,19,0,30,9,4,0,13,2,30,3,5,0,8,0,30,4,9,0,13,3,30,5,8,0,13,1,30,9,0,0,9,1,-15,3,1
2,3,25,1,30,7,7,0,14,2,30,6,0,0,6,0,30,11,3,0,14,1,30,8,6,0,14,3,30,5,1,0,6,1,-15,3,1
2,0,27,1,30,5,10,0,15,2,30,1,1,0,2,0,30,6,9,0,15,4,30,5,10,0,15,6,30,6,0,0,6,1,-15,3,1
2,1,27,1,30,5,10,0,15,2,30,1,1,0,2,0,30,6,9,0,15,4,30,5,10,0,15,6,30,6,0,0,6,1,-15,3,1
2,4,27,0,30,5,10,0,15,2,30,1,1,0,2,0,30,6,9,0,15,4,30,5,10,0,15,6,30,6,0,0,6,1,-15,3,1
2,2,29,0,30,2,12,0,14,6,30,11,1,0,12,0,30,2,12,0,14,0,30,0,14,0,14,2,30,9,0,0,9,1,-15,3,1
2,3,29,0,30,2,12,0,14,6,30,11,1,0,12,0,30,2,12,0,14,0,30,0,14,0,14,2,30,9,0,0,9,1,-15,3,1
2,2,33,4,30,6,5,0,11,5,30,4,0,0,4,1,30,9,2,0,11,0,30,3,8,0,11,5,30,4,0,0,4,1,-15,3,1
2,4,35,1,30,8,5,0,13,4,30,2,0,0,2,1,30,5,8,0,13,8,30,1,12,0,13,4,30,8,0,0,8,1,-15,3,1
2,0,37,1,30,8,3,0,11,5,30,6,2,0,8,0,30,8,3,0,11,4,30,3,8,0,11,5,30,6,0,0,6,1,-15,3,1
2,2,37,1,30,8,3,0,11,5,30,6,2,0,8,0,30,8,3,0,11,4,30,3,8,0,11,5,30,6,0,0,6,1,-15,3,1
2,3,37,1,30,8,3,0,11,5,30,6,2,0,8,0,30,8,3,0,11,4,30,3,8,0,11,5,30,6,0,0,6,1,-15,3,1
2,0,4,2,30,7,1,0,8,5,30,4,0,0,4,1,30,2,6,0,8,2,30,8,0,0,8,1,30,4,0,0,4,0,-27,3,0
2,1,4,2,30,7,1,0,8,5,30,4,0,0,4,1,30,2,6,0,8,2,30,8,0,0,8,1,30,4,0,0,4,0,-27,3,0
2,2,4,2,30,7,1,0,8,5,30,4,0,0,4,1,30,2,6,0,8,2,30,8,0,0,8,1,30,4,0,0,4,0,-27,3,0
2,0,5,0,30,2,3,0,5,3,30,3,1,0,4,2,30,0,5,0,5,0,30,1,4,0,5,0,30,0,2,0,2,0,-27,3,0
2,1,5,0,30,2,3,0,5,3,30,3,1,0,4,2,30,0,5,0,5,0,30,1,4,0,5,0,30,0,2,0,2,0,-27,3,0
2,2,11,0,30,5,7,0,12,2,30,4,0,0,4,3,30,3,9,0,12,0,30,6,6,0,12,3,30,4,0,0,4,1,-15,3,1
2,1,19,0,30,4,9,0,13,0,30,5,3,0,8,0,30,4,9,0,13,3,30,5,8,0,13,2,30,9,0,0,9,1,-15,3,1
2,4,21,2,30,9,1,0,10,4,30,6,0,0,6,1,30,3,7,0,10,2,30,5,5,0,10,0,30,3,1,0,4,1,-15,3,1
2,4,22,2,30,8,0,0,8,4,30,2,0,0,2,7,30,4,4,0,8,0,30,3,5,0,8,1,30,1,3,0,4,1,-15,3,1
2,3,25,2,30,7,7,0,14,5,30,6,0,0,6,0,30,8,6,0,14,1,30,5,9,0,14,5,30,5,1,0,6,1,-15,3,1
2,0,27,2,30,9,6,0,15,3,30,1,1,0,2,0,30,5,10,0,15,0,30,3,12,0,15,5,30,6,0,0,6,1,-15,3,1
2,2,17,4,30,8,6,0,14,3,30,6,0,0,6,0,30,6,8,0,14,4,30,5,9,0,14,6,30,4,0,0,4,1,-15,3,1
2,4,17,4,30,8,6,0,14,3,30,6,0,0,6,0,30,6,8,0,14,4,30,5,9,0,14,6,30,4,0,0,4,1,-15,3,1
2,1,19,0,30,2,11,0,13,3,30,8,0,0,8,0,30,5,8,0,13,7,30,8,5,0,13,1,30,9,0,0,9,1,-15,3,1
2,2,19,0,30,2,11,0,13,3,30,8,0,0,8,0,30,5,8,0,13,7,30,8,5,0,13,1,30,9,0,0,9,1,-15,3,1
2,4,19,0,30,2,11,0,13,3,30,8,0,0,8,0,30,5,8,0,13,7,30,8,5,0,13,1,30,9,0,0,9,1,-15,3,1
2,4,23,1,30,8,5,0,13,3,30,6,0,0,6,5,30,10,3,0,13,0,30,6,7,0,13,1,30,5,1,0,6,1,-15,3,1
2,0,25,1,30,4,10,0,14,5,30,6,0,0,6,0,30,6,8,0,14,2,30,10,4,0,14,5,30,5,1,0,6,1,-15,3,1
2,2,25,1,30,4,10,0,14,5,30,6,0,0,6,0,30,6,8,0,14,2,30,10,4,0,14,5,30,5,1,0,6,1,-15,3,1
2,4,25,0,30,4,10,0,14,5,30,6,0,0,6,0,30,6,8,0,14,2,30,10,4,0,14,5,30,5,1,0,6,1,-15,3,1
2,3,27,3,30,5,10,0,15,3,30,2,0,0,2,0,30,2,13,0,15,0,30,5,10,0,15,0,30,5,1,0,6,1,-15,3,1
2,4,27,3,30,5,10,0,15,3,30,2,0,0,2,0,30,2,13,0,15,0,30,5,10,0,15,0,30,5,1,0,6,1,-15,3,1
2,2,31,1,30,7,5,0,12,4,30,8,0,0,8,3,30,10,2,0,12,0,30,3,9,0,12,1,30,3,3,0,6,1,-15,3,1
2,3,31,1,30,7,5,0,12,4,30,8,0,0,8,3,30,10,2,0,12,0,30,3,9,0,12,1,30,3,3,0,6,1,-15,3,1
2,4,31,1,30,7,5,0,12,4,30,8,0,0,8,3,30,10,2,0,12,0,30,3,9,0,12,1,30,3,3,0,6,1,-15,3,1
2,1,17,3,30,10,4,0,14,3,30,6,0,0,6,0,30,6,8,0,14,1,30,6,8,0,14,1,30,4,0,0,4,1,-15,3,1
2,2,17,3,30,10,4,0,14,3,30,6,0,0,6,0,30,6,8,0,14,1,30,6,8,0,14,1,30,4,0,0,4,1,-15,3,1
2,4,19,0,30,3,10,0,13,2,30,7,1,0,8,1,30,4,9,0,13,0,30,3,10,0,13,2,30,8,1,0,9,1,-15,3,1
2,3,25,1,30,2,12,0,14,5,30,6,0,0,6,0,30,8,6,0,14,1,30,5,9,0,14,4,30,5,1,0,6,1,-15,3,1
2,4,25,1,30,2,12,0,14,5,30,6,0,0,6,0,30,8,6,0,14,1,30,5,9,0,14,4,30,5,1,0,6,1,-15,3,1
2,0,27,6,30,5,10,0,15,4,30,2,0,0,2,0,30,6,9,0,15,0,30,6,9,0,15,1,30,4,2,0,6,1,-15,3,1
2,3,31,6,30,8,4,0,12,4,30,8,0,0,8,4,30,9,3,0,12,0,30,3,9,0,12,0,30,3,3,0,6,1,-15,3,1
2,4,31,6,30,8,4,0,12,4,30,8,0,0,8,4,30,9,3,0,12,0,30,3,9,0,12,0,30,3,3,0,6,1,-15,3,1
2,2,33,1,30,2,9,0,11,5,30,4,0,0,4,1,30,9,2,0,11,0,30,6,5,0,11,7,30,4,0,0,4,1,-15,3,1
2,3,37,0,30,4,7,0,11,4,30,7,1,0,8,2,30,11,0,0,11,5,30,3,8,0,11,6,30,6,0,0,6,1,-15,3,1
2,4,37,0,30,4,7,0,11,4,30,7,1,0,8,2,30,11,0,0,11,5,30,3,8,0,11,6,30,6,0,0,6,1,-15,3,1
2,2,47,0,30,4,10,0,14,7,30,4,0,0,4,0,30,3,11,0,14,0,30,2,12,0,14,6,30,7,0,0,7,1,-15,3,1
2,3,47,0,30,4,10,0,14,7,30,4,0,0,4,0,30,3,11,0,14,0,30,2,12,0,14,6,30,7,0,0,7,1,-15,3,1
2,4,47,0,30,4,10,0,14,7,30,4,0,0,4,0,30,3,11,0,14,0,30,2,12,0,14,6,30,7,0,0,7,1,-15,3,1
2,2,19,0,30,2,11,0,13,0,30,8,0,0,8,0,30,5,8,0,13,0,30,6,7,0,13,0,30,5,4,0,9,1,-15,3,1
2,3,19,0,30,2,11,0,13,0,30,8,0,0,8,0,30,5,8,0,13,0,30,6,7,0,13,0,30,5,4,0,9,1,-15,3,1
2,4,23,1,30,8,5,0,13,0,30,6,0,0,6,0,30,13,0,0,13,0,30,4,9,0,13,3,30,6,0,0,6,1,-15,3,1
2,3,25,0,30,4,10,0,14,4,30,6,0,0,6,0,30,7,7,0,14,4,30,7,7,0,14,3,30,6,0,0,6,1,-15,3,1
2,3,27,1,30,4,11,0,15,4,30,2,0,0,2,3,30,8,7,0,15,2,30,4,11,0,15,0,30,5,1,0,6,1,-15,3,1
2,4,27,1,30,4,11,0,15,4,30,2,0,0,2,3,30,8,7,0,15,2,30,4,11,0,15,0,30,5,1,0,6,1,-15,3,1
2,2,29,0,30,7,7,0,14,6,30,11,1,0,12,0,30,4,10,0,14,0,30,1,13,0,14,1,30,9,0,0,9,1,-15,3,1
2,2,31,3,30,8,4,0,12,4,30,8,0,0,8,4,30,7,5,0,12,0,30,3,9,0,12,1,30,6,0,0,6,1,-15,3,1
2,3,31,3,30,8,4,0,12,4,30,8,0,0,8,4,30,7,5,0,12,0,30,3,9,0,12,1,30,6,0,0,6,1,-15,3,1
2,4,31,3,30,8,4,0,12,4,30,8,0,0,8,4,30,7,5,0,12,0,30,3,9,0,12,1,30,6,0,0,6,1,-15,3,1
2,2,39,2,30,6,5,0,11,6,30,6,0,0,6,1,30,8,3,0,11,0,30,1,10,0,11,4,30,5,0,0,5,1,-15,3,1
2,3,47,0,30,2,12,0,14,6,30,4,0,0,4,0,30,3,11,0,14,0,30,2,12,0,14,5,30,7,0,0,7,1,-15,3,1
2,4,1,0,30,7,3,0,10,5,30,2,0,0,2,1,30,3,7,0,10,5,30,9,1,0,10,5,30,6,0,0,6,0,-27,3,0
2,1,4,2,30,6,2,0,8,5,30,4,0,0,4,0,30,1,7,0,8,3,30,8,0,0,8,2,30,4,0,0,4,0,-27,3,0
2,1,13,1,30,5,2,0,7,0,30,4,0,0,4,4,30,5,2,0,7,7,30,6,1,0,7,7,30,4,0,0,4,1,-15,3,1
2,2,13,1,30,5,2,0,7,0,30,4,0,0,4,4,30,5,2,0,7,7,30,6,1,0,7,7,30,4,0,0,4,1,-15,3,1
2,4,17,4,30,11,3,0,14,3,30,6,0,0,6,0,30,4,10,0,14,1,30,7,7,0,14,0,30,3,1,0,4,1,-15,3,1
2,4,25,2,30,7,7,0,14,4,30,6,0,0,6,0,30,6,8,0,14,1,30,9,5,0,14,1,30,5,1,0,6,1,-15,3,1
2,2,27,2,30,6,9,0,15,5,30,2,0,0,2,0,30,3,12,0,15,0,30,4,11,0,15,4,30,6,0,0,6,1,-15,3,1
2,3,27,2,30,6,9,0,15,5,30,2,0,0,2,0,30,3,12,0,15,0,30,4,11,0,15,4,30,6,0,0,6,1,-15,3,1
2,4,27,2,30,6,9,0,15,5,30,2,0,0,2,0,30,3,12,0,15,0,30,4,11,0,15,4,30,6,0,0,6,1,-15,3,1
2,4,31,1,30,9,3,0,12,4,30,8,0,0,8,4,30,7,5,0,12,0,30,3,9,0,12,0,30,2,4,0,6,1,-15,3,1
2,2,35,0,30,5,8,0,13,5,30,2,0,0,2,1,30,2,11,0,13,0,30,8,5,0,13,11,30,8,0,0,8,1,-15,3,1
2,3,35,0,30,5,8,0,13,5,30,2,0,0,2,1,30,2,11,0,13,0,30,8,5,0,13,11,30,8,0,0,8,1,-15,3,1
2,3,39,1,30,5,6,0,11,5,30,6,0,0,6,0,30,8,3,0,11,0,30,2,9,0,11,1,30,4,1,0,5,1,-15,3,1
2,4,39,1,30,5,6,0,11,5,30,6,0,0,6,0,30,8,3,0,11,0,30,2,9,0,11,1,30,4,1,0,5,1,-15,3,1
2,0,41,0,30,6,6,0,12,7,30,8,0,0,8,0,30,3,9,0,12,0,30,2,10,0,12,5,30,7,0,0,7,1,-15,3,1
2,4,41,0,30,6,6,0,12,7,30,8,0,0,8,0,30,3,9,0,12,0,30,2,10,0,12,5,30,7,0,0,7,1,-15,3,1
2,1,4,2,30,5,3,0,8,4,30,4,0,0,4,1,30,5,3,0,8,0,30,8,0,0,8,1,30,3,1,0,4,0,-27,3,0
2,2,4,2,30,5,3,0,8,4,30,4,0,0,4,1,30,5,3,0,8,0,30,8,0,0,8,1,30,3,1,0,4,0,-27,3,0
2,0,5,4,30,2,3,0,5,3,30,0,4,0,4,0,30,1,4,0,5,0,30,1,4,0,5,0,30,1,1,0,2,0,-27,3,0
2,2,25,2,30,5,9,0,14,3,30,6,0,0,6,0,30,9,5,0,14,1,30,5,9,0,14,5,30,6,0,0,6,1,-15,3,1
2,0,27,1,30,6,9,0,15,5,30,2,0,0,2,0,30,2,13,0,15,8,30,4,11,0,15,1,30,4,2,0,6,1,-15,3,1
2,2,27,1,30,6,9,0,15,5,30,2,0,0,2,0,30,2,13,0,15,8,30,4,11,0,15,1,30,4,2,0,6,1,-15,3,1
2,0,5,0,30,1,4,0,5,3,30,2,2,0,4,3,30,0,5,0,5,0,30,1,4,0,5,0,30,0,2,0,2,0,-27,3,0
2,1,5,0,30,1,4,0,5,3,30,2,2,0,4,3,30,0,5,0,5,0,30,1,4,0,5,0,30,0,2,0,2,0,-27,3,0
2,2,5,0,30,1,4,0,5,3,30,2,2,0,4,3,30,0,5,0,5,0,30,1,4,0,5,0,30,0,2,0,2,0,-27,3,0
2,3,5,0,30,1,4,0,5,3,30,2,2,0,4,3,30,0,5,0,5,0,30,1,4,0,5,0,30,0,2,0,2,0,-27,3,0
2,3,17,3,30,8,6,0,14,2,30,6,0,0,6,0,30,8,6,0,14,1,30,6,8,0,14,3,30,4,0,0,4,1,-15,3,1
2,0,19,0,30,3,10,0,13,1,30,8,0,0,8,0,30,9,4,0,13,0,30,4,9,0,13,2,30,7,2,0,9,1,-15,3,1
2,1,19,0,30,3,10,0,13,1,30,8,0,0,8,0,30,9,4,0,13,0,30,4,9,0,13,2,30,7,2,0,9,1,-15,3,1
2,2,19,0,30,3,10,0,13,1,30,8,0,0,8,0,30,9,4,0,13,0,30,4,9,0,13,2,30,7,2,0,9,1,-15,3,1
2,4,19,0,30,3,10,0,13,1,30,8,0,0,8,0,30,9,4,0,13,0,30,4,9,0,13,2,30,7,2,0,9,1,-15,3,1
2,2,25,1,30,8,6,0,14,4,30,6,0,0,6,0,30,8,6,0,14,1,30,7,7,0,14,4,30,5,1,0,6,1,-15,3,1
2,0,27,1,30,3,12,0,15,1,30,2,0,0,2,0,30,5,10,0,15,3,30,4,11,0,15,2,30,6,0,0,6,1,-15,3,1
2,4,27,1,30,3,12,0,15,1,30,2,0,0,2,0,30,5,10,0,15,3,30,4,11,0,15,2,30,6,0,0,6,1,-15,3,1
2,3,13,1,30,7,0,0,7,0,30,4,0,0,4,2,30,6,1,0,7,6,30,5,2,0,7,2,30,4,0,0,4,1,-15,3,1
2,3,19,0,30,3,10,0,13,1,30,4,4,0,8,0,30,9,4,0,13,6,30,4,9,0,13,1,30,8,1,0,9,1,-15,3,1
2,1,25,2,30,7,7,0,14,2,30,6,0,0,6,0,30,9,5,0,14,2,30,6,8,0,14,3,30,6,0,0,6,1,-15,3,1
2,3,25,2,30,7,7,0,14,2,30,6,0,0,6,0,30,9,5,0,14,2,30,6,8,0,14,0,30,6,0,0,6,1,-15,3,1
2,4,25,2,30,7,7,0,14,2,30,6,0,0,6,0,30,9,5,0,14,2,30,6,8,0,14,0,30,6,0,0,6,1,-15,3,1
2,2,26,0,30,5,4,0,9,5,30,2,2,0,4,1,30,0,9,0,9,0,30,3,6,0,9,4,30,2,1,0,3,1,-15,3,1
2,3,26,0,30,5,4,0,9,5,30,2,2,0,4,1,30,0,9,0,9,0,30,3,6,0,9,4,30,2,1,0,3,1,-15,3,1
2,4,27,1,30,7,8,0,15,3,30,1,1,0,2,0,30,7,8,0,15,0,30,4,11,0,15,2,30,6,0,0,6,1,-15,3,1
2,2,39,5,30,6,5,0,11,8,30,6,0,0,6,0,30,4,7,0,11,0,30,2,9,0,11,0,30,5,0,0,5,1,-15,3,1
2,4,5,0,30,2,3,0,5,3,30,1,3,0,4,0,30,1,4,0,5,0,30,1,4,0,5,0,30,1,1,0,2,0,-27,3,0
2,3,8,1,30,7,0,0,7,4,30,2,0,0,2,7,30,3,4,0,7,1,30,7,0,0,7,4,30,3,0,0,3,0,-27,3,0
2,1,13,2,30,6,1,0,7,0,30,4,0,0,4,2,30,6,1,0,7,9,30,5,2,0,7,3,30,4,0,0,4,1,-15,3,1
2,4,13,2,30,6,1,0,7,0,30,4,0,0,4,2,30,6,1,0,7,9,30,5,2,0,7,3,30,4,0,0,4,1,-15,3,1
2,3,15,2,30,4,9,0,13,1,30,6,0,0,6,0,30,5,8,0,13,1,30,7,6,0,13,2,30,5,4,0,9,1,-15,3,1
2,4,22,1,30,7,1,0,8,2,30,2,0,0,2,3,30,4,4,0,8,1,30,3,5,0,8,1,30,2,2,0,4,1,-15,3,1
2,3,25,1,30,7,7,0,14,1,30,6,0,0,6,0,30,6,8,0,14,2,30,6,8,0,14,5,30,5,1,0,6,1,-15,3,1
2,4,25,1,30,7,7,0,14,1,30,6,0,0,6,0,30,6,8,0,14,2,30,6,8,0,14,5,30,5,1,0,6,1,-15,3,1
2,1,27,1,30,8,7,0,15,3,30,2,0,0,2,0,30,4,11,0,15,0,30,6,9,0,15,4,30,6,0,0,6,1,-15,3,1
2,0,29,0,30,7,7,0,14,6,30,8,4,0,12,0,30,6,8,0,14,0,30,3,11,0,14,3,30,9,0,0,9,1,-15,3,1
2,1,29,0,30,7,7,0,14,6,30,8,4,0,12,0,30,6,8,0,14,0,30,3,11,0,14,3,30,9,0,0,9,1,-15,3,1
2,2,29,0,30,7,7,0,14,6,30,8,4,0,12,0,30,6,8,0,14,0,30,3,11,0,14,3,30,9,0,0,9,1,-15,3,1
2,4,29,0,30,7,7,0,14,6,30,8,4,0,12,0,30,6,8,0,14,0,30,3,11,0,14,3,30,9,0,0,9,1,-15,3,1
2,1,35,0,30,7,6,0,13,5,30,2,0,0,2,1,30,6,7,0,13,0,30,5,8,0,13,5,30,8,0,0,8,1,-15,3,1
2,0,47,0,30,1,13,0,14,8,30,4,0,0,4,0,30,3,11,0,14,0,30,6,8,0,14,9,30,7,0,0,7,1,-15,3,1
2,3,1,0,30,7,3,0,10,4,30,2,0,0,2,1,30,6,4,0,10,3,30,7,3,0,10,3,30,6,0,0,6,0,-27,3,0
2,0,5,0,30,1,4,0,5,3,30,1,3,0,4,0,30,0,5,0,5,0,30,1,4,0,5,0,30,0,2,0,2,0,-27,3,0
2,3,5,0,30,1,4,0,5,3,30,1,3,0,4,0,30,0,5,0,5,0,30,1,4,0,5,0,30,0,2,0,2,0,-27,3,0
2,4,5,0,30,1,4,0,5,3,30,1,3,0,4,0,30,0,5,0,5,0,30,1,4,0,5,0,30,0,2,0,2,0,-27,3,0
2,0,6,3,30,9,0,0,9,4,30,2,0,0,2,0,30,2,7,0,9,0,30,4,5,0,9,1,30,5,0,0,5,0,-27,3,0
2,1,6,3,30,9,0,0,9,4,30,2,0,0,2,0,30,2,7,0,9,0,30,4,5,0,9,1,30,5,0,0,5,0,-27,3,0
2,3,6,3,30,9,0,0,9,4,30,2,0,0,2,0,30,2,7,0,9,0,30,4,5,0,9,1,30,5,0,0,5,0,-27,3,0
2,4,6,3,30,9,0,0,9,4,30,2,0,0,2,0,30,2,7,0,9,0,30,4,5,0,9,1,30,5,0,0,5,0,-27,3,0
2,1,17,6,30,7,7,0,14,3,30,6,0,0,6,0,30,7,7,0,14,1,30,5,9,0,14,0,30,3,1,0,4,1,-15,3,1
2,2,25,1,30,9,5,0,14,4,30,6,0,0,6,0,30,8,6,0,14,1,30,4,10,0,14,4,30,5,1,0,6,1,-15,3,1
2,0,27,1,30,4,11,0,15,3,30,1,1,0,2,0,30,6,9,0,15,1,30,5,10,0,15,3,30,6,0,0,6,1,-15,3,1
2,2,27,1,30,4,11,0,15,3,30,1,1,0,2,0,30,6,9,0,15,1,30,5,10,0,15,0,30,6,0,0,6,1,-15,3,1
2,4,27,1,30,4,11,0,15,3,30,1,1,0,2,0,30,6,9,0,15,0,30,5,10,0,15,0,30,6,0,0,6,1,-15,3,1
2,2,29,0,30,10,4,0,14,5,30,11,1,0,12,0,30,3,11,0,14,0,30,1,13,0,14,0,30,7,2,0,9,1,-15,3,1
2,2,1,0,30,7,3,0,10,4,30,2,0,0,2,1,30,4,6,0,10,10,30,8,2,0,10,3,30,6,0,0,6,0,-27,3,0
2,4,3,0,30,1,3,0,4,2,30,4,0,0,4,0,30,0,4,0,4,0,30,0,4,0,4,0,30,3,0,0,3,0,-27,3,0
2,1,4,2,30,7,1,0,8,5,30,4,0,0,4,0,30,2,6,0,8,1,30,8,0,0,8,2,30,3,1,0,4,0,-27,3,0
2,2,11,1,30,5,7,0,12,0,30,4,0,0,4,0,30,7,5,0,12,0,30,5,7,0,12,1,30,4,0,0,4,1,-15,3,1
2,3,11,1,30,5,7,0,12,0,30,4,0,0,4,0,30,7,5,0,12,0,30,5,7,0,12,1,30,4,0,0,4,1,-15,3,1
2,2,19,0,30,4,9,0,13,2,30,6,2,0,8,0,30,4,9,0,13,9,30,4,9,0,13,3,30,9,0,0,9,1,-15,3,1
2,2,27,1,30,5,10,0,15,0,30,2,0,0,2,0,30,11,4,0,15,0,30,4,11,0,15,1,30,5,1,0,6,1,-15,3,1
2,3,27,1,30,5,10,0,15,0,30,2,0,0,2,0,30,11,4,0,15,0,30,4,11,0,15,1,30,5,1,0,6,1,-15,3,1
2,2,29,0,30,5,9,0,14,6,30,9,3,0,12,0,30,2,12,0,14,0,30,1,13,0,14,2,30,9,0,0,9,1,-15,3,1
2,0,5,0,30,2,3,0,5,3,30,1,3,0,4,2,30,2,3,0,5,0,30,1,4,0,5,0,30,1,1,0,2,0,-27,3,0
2,4,5,0,30,2,3,0,5,3,30,1,3,0,4,2,30,2,3,0,5,0,30,1,4,0,5,0,30,1,1,0,2,0,-27,3,0
2,4,15,1,30,5,8,0,13,0,30,6,0,0,6,0,30,3,10,0,13,1,30,4,9,0,13,2,30,7,2,0,9,1,-15,3,1
2,3,17,3,30,9,5,0,14,2,30,6,0,0,6,0,30,8,6,0,14,3,30,6,8,0,14,0,30,4,0,0,4,1,-15,3,1
2,4,17,3,30,9,5,0,14,2,30,6,0,0,6,0,30,8,6,0,14,3,30,6,8,0,14,0,30,4,0,0,4,1,-15,3,1
2,1,19,0,30,4,9,0,13,1,30,6,2,0,8,0,30,7,6,0,13,4,30,5,8,0,13,1,30,6,3,0,9,1,-15,3,1
2,2,19,0,30,4,9,0,13,1,30,6,2,0,8,0,30,7,6,0,13,4,30,5,8,0,13,1,30,6,3,0,9,1,-15,3,1
2,4,19,0,30,4,9,0,13,1,30,6,2,0,8,0,30,7,6,0,13,4,30,5,8,0,13,1,30,6,3,0,9,1,-15,3,1
2,3,25,1,30,11,3,0,14,4,30,6,0,0,6,0,30,7,7,0,14,2,30,7,7,0,14,1,30,6,0,0,6,1,-15,3,1
2,2,27,0,30,4,11,0,15,3,30,2,0,0,2,0,30,5,10,0,15,0,30,6,9,0,15,0,30,5,1,0,6,1,-15,3,1
2,3,27,0,30,4,11,0,15,3,30,2,0,0,2,0,30,5,10,0,15,0,30,6,9,0,15,0,30,5,1,0,6,1,-15,3,1
2,4,27,0,30,4,11,0,15,3,30,2,0,0,2,0,30,5,10,0,15,0,30,6,9,0,15,0,30,5,1,0,6,1,-15,3,1
2,2,29,3,30,10,4,0,14,4,30,8,4,0,12,0,30,4,10,0,14,0,30,1,13,0,14,0,30,9,0,0,9,1,-15,3,1
2,4,31,3,30,7,5,0,12,5,30,8,0,0,8,0,30,5,7,0,12,0,30,3,9,0,12,6,30,2,4,0,6,1,-15,3,1
2,2,38,0,30,6,4,0,10,7,30,6,0,0,6,0,30,1,9,0,10,0,30,2,8,0,10,4,30,6,0,0,6,1,-15,3,1
2,4,4,0,30,5,3,0,8,5,30,4,0,0,4,1,30,1,7,0,8,1,30,8,0,0,8,0,30,3,1,0,4,0,-27,3,0
2,4,13,0,30,5,2,0,7,0,30,4,0,0,4,0,30,6,1,0,7,9,30,6,1,0,7,5,30,4,0,0,4,1,-15,3,1
2,4,15,0,30,4,9,0,13,1,30,6,0,0,6,0,30,3,10,0,13,1,30,6,7,0,13,0,30,8,1,0,9,1,-15,3,1
2,3,17,5,30,11,3,0,14,2,30,6,0,0,6,0,30,7,7,0,14,1,30,5,9,0,14,3,30,4,0,0,4,1,-15,3,1
2,1,19,0,30,5,8,0,13,0,30,7,1,0,8,4,30,4,9,0,13,4,30,4,9,0,13,0,30,7,2,0,9,1,-15,3,1
2,3,21,2,30,6,4,0,10,4,30,6,0,0,6,1,30,3,7,0,10,2,30,5,5,0,10,2,30,4,0,0,4,1,-15,3,1
2,1,27,2,30,6,9,0,15,3,30,2,0,0,2,0,30,8,7,0,15,0,30,3,12,0,15,1,30,4,2,0,6,1,-15,3,1
2,3,27,2,30,6,9,0,15,3,30,2,0,0,2,0,30,8,7,0,15,0,30,3,12,0,15,1,30,4,2,0,6,1,-15,3,1
2,3,29,0,30,4,10,0,14,6,30,12,0,0,12,0,30,6,8,0,14,0,30,1,13,0,14,2,30,9,0,0,9,1,-15,3,1
2,4,43,0,30,8,6,0,14,10,30,6,0,0,6,0,30,5,9,0,14,0,30,7,7,0,14,4,30,5,0,0,5,1,-15,3,1
2,4,3,0,30,0,4,0,4,3,30,4,0,0,4,0,30,0,4,0,4,4,30,2,2,0,4,2,30,3,0,0,3,0,-27,3,0
2,0,4,4,30,8,0,0,8,4,30,4,0,0,4,0,30,1,7,0,8,1,30,3,5,0,8,2,30,4,0,0,4,0,-27,3,0
2,0,5,0,30,0,5,0,5,3,30,1,3,0,4,0,30,0,5,0,5,3,30,2,3,0,5,0,30,0,2,0,2,0,-27,3,0
2,3,5,0,30,0,5,0,5,3,30,1,3,0,4,0,30,0,5,0,5,3,30,2,3,0,5,0,30,0,2,0,2,0,-27,3,0
2,2,6,0,30,7,2,0,9,4,30,2,0,0,2,0,30,2,7,0,9,0,30,4,5,0,9,1,30,4,1,0,5,0,-27,3,0
2,4,8,2,30,7,0,0,7,5,30,2,0,0,2,2,30,3,4,0,7,1,30,7,0,0,7,0,30,3,0,0,3,0,-27,3,0
2,1,13,1,30,4,3,0,7,0,30,4,0,0,4,2,30,5,2,0,7,9,30,6,1,0,7,3,30,4,0,0,4,1,-15,3,1
2,4,13,1,30,4,3,0,7,0,30,4,0,0,4,2,30,5,2,0,7,9,30,6,1,0,7,3,30,4,0,0,4,1,-15,3,1
2,2,17,4,30,10,4,0,14,2,30,6,0,0,6,0,30,6,8,0,14,1,30,3,11,0,14,2,30,4,0,0,4,1,-15,3,1
2,3,19,0,30,5,8,0,13,2,30,8,0,0,8,0,30,5,8,0,13,5,30,4,9,0,13,0,30,6,3,0,9,1,-15,3,1
2,3,35,0,30,9,4,0,13,3,30,2,0,0,2,1,30,9,4,0,13,1,30,4,9,0,13,4,30,8,0,0,8,1,-15,3,1
2,4,39,5,30,4,7,0,11,8,30,6,0,0,6,0,30,4,7,0,11,0,30,2,9,0,11,1,30,5,0,0,5,1,-15,3,1
2,3,1,1,30,7,3,0,10,5,30,2,0,0,2,1,30,3,7,0,10,4,30,6,4,0,10,5,30,6,0,0,6,0,-27,3,0
2,0,4,2,30,5,3,0,8,4,30,4,0,0,4,0,30,3,5,0,8,0,30,6,2,0,8,4,30,4,0,0,4,0,-27,3,0
2,4,11,3,30,5,7,0,12,0,30,4,0,0,4,0,30,9,3,0,12,3,30,4,8,0,12,0,30,4,0,0,4,1,-15,3,1
2,3,19,0,30,9,4,0,13,2,30,4,4,0,8,4,30,5,8,0,13,0,30,3,10,0,13,0,30,7,2,0,9,1,-15,3,1
2,4,19,0,30,9,4,0,13,2,30,4,4,0,8,4,30,5,8,0,13,0,30,3,10,0,13,0,30,7,2,0,9,1,-15,3,1
2,4,23,2,30,5,8,0,13,3,30,6,0,0,6,0,30,12,1,0,13,0,30,5,8,0,13,3,30,6,0,0,6,1,-15,3,1
2,3,25,0,30,5,9,0,14,4,30,6,0,0,6,3,30,5,9,0,14,1,30,7,7,0,14,3,30,6,0,0,6,1,-15,3,1
2,4,25,0,30,5,9,0,14,4,30,6,0,0,6,3,30,5,9,0,14,1,30,7,7,0,14,3,30,6,0,0,6,1,-15,3,1
2,0,27,2,30,6,9,0,15,4,30,1,1,0,2,0,30,6,9,0,15,1,30,5,10,0,15,2,30,6,0,0,6,1,-15,3,1
2,2,27,1,30,6,9,0,15,4,30,1,1,0,2,0,30,6,9,0,15,1,30,5,10,0,15,2,30,6,0,0,6,1,-15,3,1
2,2,31,2,30,9,3,0,12,4,30,8,0,0,8,5,30,10,2,0,12,1,30,4,8,0,12,0,30,3,3,0,6,1,-15,3,1
2,3,31,2,30,9,3,0,12,4,30,8,0,0,8,5,30,10,2,0,12,1,30,4,8,0,12,0,30,3,3,0,6,1,-15,3,1
2,4,32,0,30,7,2,0,9,5,30,2,0,0,2,0,30,6,3,0,9,1,30,3,6,0,9,2,30,2,0,0,2,1,-15,3,1
2,3,33,1,30,4,7,0,11,4,30,4,0,0,4,0,30,11,0,0,11,2,30,3,8,0,11,6,30,4,0,0,4,1,-15,3,1
2,2,43,0,30,6,8,0,14,7,30,6,0,0,6,0,30,7,7,0,14,1,30,6,8,0,14,6,30,5,0,0,5,1,-15,3,1
2,4,43,0,30,6,8,0,14,7,30,6,0,0,6,0,30,7,7,0,14,1,30,6,8,0,14,6,30,5,0,0,5,1,-15,3,1
2,1,13,2,30,7,0,0,7,0,30,4,0,0,4,2,30,5,2,0,7,5,30,6,1,0,7,5,30,4,0,0,4,1,-15,3,1
2,1,17,3,30,11,3,0,14,3,30,6,0,0,6,0,30,5,9,0,14,3,30,7,7,0,14,5,30,4,0,0,4,1,-15,3,1
2,2,17,3,30,11,3,0,14,3,30,6,0,0,6,0,30,5,9,0,14,3,30,7,7,0,14,5,30,4,0,0,4,1,-15,3,1
2,3,17,3,30,11,3,0,14,3,30,6,0,0,6,0,30,5,9,0,14,3,30,7,7,0,14,5,30,4,0,0,4,1,-15,3,1
2,2,19,0,30,4,9,0,13,2,30,5,3,0,8,0,30,8,5,0,13,0,30,5,8,0,13,0,30,9,0,0,9,1,-15,3,1
2,4,19,0,30,4,9,0,13,2,30,5,3,0,8,0,30,8,5,0,13,0,30,5,8,0,13,0,30,9,0,0,9,1,-15,3,1
2,2,23,2,30,4,9,0,13,1,30,6,0,0,6,5,30,13,0,0,13,5,30,6,7,0,13,2,30,6,0,0,6,1,-15,3,1
2,3,25,1,30,10,4,0,14,5,30,6,0,0,6,0,30,3,11,0,14,2,30,6,8,0,14,7,30,6,0,0,6,1,-15,3,1
2,4,27,1,30,4,11,0,15,3,30,2,0,0,2,0,30,11,4,0,15,3,30,3,12,0,15,3,30,6,0,0,6,1,-15,3,1
2,0,29,0,30,5,9,0,14,5,30,12,0,0,12,0,30,4,10,0,14,0,30,1,13,0,14,1,30,8,1,0,9,1,-15,3,1
2,3,39,0,30,4,7,0,11,5,30,6,0,0,6,0,30,8,3,0,11,0,30,2,9,0,11,4,30,5,0,0,5,1,-15,3,1
2,4,8,3,30,7,0,0,7,4,30,2,0,0,2,0,30,1,6,0,7,3,30,6,1,0,7,0,30,2,1,0,3,0,-27,3,0
2,0,19,0,30,5,8,0,13,2,30,5,3,0,8,0,30,4,9,0,13,7,30,4,9,0,13,6,30,9,0,0,9,1,-15,3,1
2,2,19,0,30,5,8,0,13,2,30,5,3,0,8,0,30,4,9,0,13,7,30,4,9,0,13,6,30,9,0,0,9,1,-15,3,1
2,4,19,0,30,5,8,0,13,2,30,5,3,0,8,0,30,4,9,0,13,7,30,4,9,0,13,6,30,9,0,0,9,1,-15,3,1
2,1,23,1,30,9,4,0,13,2,30,6,0,0,6,4,30,10,3,0,13,0,30,6,7,0,13,4,30,5,1,0,6,1,-15,3,1
2,2,23,1,30,9,4,0,13,2,30,6,0,0,6,4,30,10,3,0,13,0,30,6,7,0,13,4,30,5,1,0,6,1,-15,3,1
2,3,23,1,30,9,4,0,13,2,30,6,0,0,6,4,30,10,3,0,13,0,30,6,7,0,13,4,30,5,1,0,6,1,-15,3,1
2,1,27,1,30,4,11,0,15,4,30,1,1,0,2,0,30,6,9,0,15,2,30,6,9,0,15,4,30,6,0,0,6,1,-15,3,1
2,2,27,1,30,4,11,0,15,4,30,1,1,0,2,0,30,6,9,0,15,2,30,6,9,0,15,4,30,6,0,0,6,1,-15,3,1
2,4,29,0,30,5,9,0,14,5,30,12,0,0,12,0,30,3,11,0,14,0,30,5,9,0,14,0,30,7,2,0,9,1,-15,3,1
2,4,31,0,30,10,2,0,12,4,30,8,0,0,8,6,30,9,3,0,12,0,30,3,9,0,12,0,30,3,3,0,6,1,-15,3,1
2,1,33,2,30,6,5,0,11,3,30,4,0,0,4,1,30,10,1,0,11,7,30,4,7,0,11,5,30,4,0,0,4,1,-15,3,1
2,0,35,0,30,8,5,0,13,6,30,2,0,0,2,1,30,2,11,0,13,0,30,4,9,0,13,7,30,8,0,0,8,1,-15,3,1
2,1,35,0,30,8,5,0,13,6,30,2,0,0,2,1,30,2,11,0,13,0,30,4,9,0,13,7,30,8,0,0,8,1,-15,3,1
2,2,35,0,30,8,5,0,13,6,30,2,0,0,2,1,30,2,11,0,13,0,30,4,9,0,13,7,30,8,0,0,8,1,-15,3,1
2,3,35,0,30,8,5,0,13,6,30,2,0,0,2,1,30,2,11,0,13,0,30,4,9,0,13,7,30,8,0,0,8,1,-15,3,1
2,0,4,1,30,5,3,0,8,3,30,4,0,0,4,1,30,5,3,0,8,5,30,7,1,0,8,1,30,4,0,0,4,0,-27,3,0
2,0,11,2,30,6,6,0,12,2,30,4,0,0,4,0,30,5,7,0,12,6,30,7,5,0,12,4,30,4,0,0,4,1,-15,3,1
2,1,11,2,30,6,6,0,12,2,30,4,0,0,4,0,30,5,7,0,12,6,30,7,5,0,12,4,30,4,0,0,4,1,-15,3,1
2,1,13,3,30,5,2,0,7,0,30,4,0,0,4,2,30,6,1,0,7,9,30,7,0,0,7,3,30,4,0,0,4,1,-15,3,1
2,4,19,0,30,4,9,0,13,2,30,8,0,0,8,0,30,7,6,0,13,4,30,3,10,0,13,4,30,8,1,0,9,1,-15,3,1
2,4,23,1,30,5,8,0,13,3,30,6,0,0,6,0,30,12,1,0,13,0,30,6,7,0,13,1,30,6,0,0,6,1,-15,3,1
2,3,25,1,30,11,3,0,14,2,30,6,0,0,6,0,30,7,7,0,14,1,30,6,8,0,14,4,30,5,1,0,6,1,-15,3,1
2,4,25,1,30,11,3,0,14,2,30,6,0,0,6,0,30,7,7,0,14,1,30,6,8,0,14,4,30,5,1,0,6,1,-15,3,1
2,3,27,1,30,4,11,0,15,2,30,1,1,0,2,0,30,6,9,0,15,4,30,6,9,0,15,3,30,6,0,0,6,1,-15,3,1
2,2,29,0,30,4,10,0,14,6,30,12,0,0,12,0,30,4,10,0,14,0,30,0,14,0,14,3,30,9,0,0,9,1,-15,3,1
2,3,35,0,30,5,8,0,13,4,30,2,0,0,2,1,30,10,3,0,13,2,30,1,12,0,13,0,30,8,0,0,8,1,-15,3,1
2,2,5,2,30,5,0,0,5,4,30,1,3,0,4,0,30,0,5,0,5,0,30,3,2,0,5,0,30,0,2,0,2,0,-27,3,0
2,1,13,4,30,7,0,0,7,2,30,4,0,0,4,2,30,6,1,0,7,1,30,5,2,0,7,2,30,4,0,0,4,1,-15,3,1
2,2,13,4,30,7,0,0,7,2,30,4,0,0,4,2,30,6,1,0,7,1,30,5,2,0,7,2,30,4,0,0,4,1,-15,3,1
2,3,13,4,30,7,0,0,7,2,30,4,0,0,4,2,30,6,1,0,7,1,30,5,2,0,7,2,30,4,0,0,4,1,-15,3,1
2,3,17,4,30,9,5,0,14,2,30,6,0,0,6,0,30,8,6,0,14,0,30,6,8,0,14,3,30,4,0,0,4,1,-15,3,1
2,4,17,4,30,9,5,0,14,2,30,6,0,0,6,0,30,8,6,0,14,0,30,6,8,0,14,3,30,4,0,0,4,1,-15,3,1
2,4,19,0,30,5,8,0,13,1,30,5,3,0,8,0,30,7,6,0,13,8,30,4,9,0,13,2,30,7,2,0,9,1,-15,3,1
2,0,21,5,30,7,3,0,10,4,30,4,2,0,6,0,30,3,7,0,10,4,30,5,5,0,10,4,30,4,0,0,4,1,-15,3,1
2,1,21,5,30,7,3,0,10,4,30,4,2,0,6,0,30,3,7,0,10,4,30,5,5,0,10,4,30,4,0,0,4,1,-15,3,1
2,4,21,5,30,7,3,0,10,4,30,4,2,0,6,0,30,3,7,0,10,2,30,5,5,0,10,4,30,4,0,0,4,1,-15,3,1
2,4,22,2,30,8,0,0,8,2,30,2,0,0,2,0,30,4,4,0,8,0,30,2,6,0,8,4,30,4,0,0,4,1,-15,3,1
2,3,23,1,30,4,9,0,13,4,30,6,0,0,6,7,30,10,3,0,13,1,30,4,9,0,13,4,30,6,0,0,6,1,-15,3,1
2,4,23,1,30,4,9,0,13,4,30,6,0,0,6,7,30,10,3,0,13,1,30,4,9,0,13,4,30,6,0,0,6,1,-15,3,1
2,3,25,0,30,6,8,0,14,3,30,6,0,0,6,0,30,9,5,0,14,2,30,8,6,0,14,3,30,5,1,0,6,1,-15,3,1
2,4,25,0,30,6,8,0,14,3,30,6,0,0,6,0,30,9,5,0,14,2,30,8,6,0,14,3,30,5,1,0,6,1,-15,3,1
2,0,29,1,30,5,9,0,14,4,30,12,0,0,12,0,30,6,8,0,14,0,30,0,14,0,14,3,30,9,0,0,9,1,-15,3,1
2,1,29,1,30,5,9,0,14,4,30,12,0,0,12,0,30,6,8,0,14,0,30,0,14,0,14,3,30,9,0,0,9,1,-15,3,1
2,3,29,1,30,5,9,0,14,4,30,12,0,0,12,0,30,6,8,0,14,0,30,0,14,0,14,3,30,9,0,0,9,1,-15,3,1
2,2,17,3,30,12,2,0,14,2,30,6,0,0,6,0,30,4,10,0,14,3,30,5,9,0,14,0,30,4,0,0,4,1,-15,3,1
2,4,17,0,30,12,2,0,14,2,30,6,0,0,6,0,30,4,10,0,14,3,30,5,9,0,14,0,30,4,0,0,4,1,-15,3,1
2,3,19,0,30,6,7,0,13,1,30,4,4,0,8,0,30,5,8,0,13,1,30,5,8,0,13,0,30,8,1,0,9,1,-15,3,1
2,4,23,1,30,7,6,0,13,3,30,5,1,0,6,3,30,9,4,0,13,0,30,4,9,0,13,0,30,6,0,0,6,1,-15,3,1
2,3,25,1,30,6,8,0,14,4,30,6,0,0,6,0,30,8,6,0,14,2,30,10,4,0,14,3,30,5,1,0,6,1,-15,3,1
2,0,39,3,30,4,7,0,11,7,30,6,0,0,6,0,30,8,3,0,11,1,30,5,6,0,11,1,30,5,0,0,5,1,-15,3,1
2,4,39,3,30,4,7,0,11,7,30,6,0,0,6,0,30,8,3,0,11,1,30,5,6,0,11,1,30,5,0,0,5,1,-15,3,1
2,0,5,0,30,2,3,0,5,3,30,1,3,0,4,1,30,0,5,0,5,0,30,1,4,0,5,0,30,0,2,0,2,0,-27,3,0
2,1,5,0,30,2,3,0,5,3,30,1,3,0,4,1,30,0,5,0,5,0,30,1,4,0,5,0,30,0,2,0,2,0,-27,3,0
2,2,5,0,30,2,3,0,5,3,30,1,3,0,4,1,30,0,5,0,5,0,30,1,4,0,5,0,30,0,2,0,2,0,-27,3,0
2,3,5,0,30,2,3,0,5,3,30,1,3,0,4,1,30,0,5,0,5,0,30,1,4,0,5,0,30,0,2,0,2,0,-27,3,0
2,4,5,0,30,2,3,0,5,3,30,1,3,0,4,1,30,0,5,0,5,0,30,1,4,0,5,0,30,0,2,0,2,0,-27,3,0
2,3,9,0,30,2,2,0,4,1,30,2,0,0,2,0,30,4,0,0,4,4,30,1,3,0,4,5,30,1,0,0,1,0,-27,3,0
2,2,13,5,30,7,0,0,7,0,30,4,0,0,4,2,30,6,1,0,7,3,30,5,2,0,7,2,30,4,0,0,4,1,-15,3,1
2,3,13,5,30,7,0,0,7,0,30,4,0,0,4,2,30,6,1,0,7,3,30,5,2,0,7,2,30,4,0,0,4,1,-15,3,1
2,4,13,5,30,7,0,0,7,0,30,4,0,0,4,2,30,6,1,0,7,3,30,5,2,0,7,2,30,4,0,0,4,1,-15,3,1
2,2,17,4,30,10,4,0,14,3,30,6,0,0,6,0,30,4,10,0,14,1,30,5,9,0,14,2,30,2,2,0,4,1,-15,3,1
2,4,17,4,30,10,4,0,14,3,30,6,0,0,6,0,30,4,10,0,14,1,30,5,9,0,14,2,30,2,2,0,4,1,-15,3,1
2,2,19,0,30,3,10,0,13,2,30,4,4,0,8,0,30,4,9,0,13,5,30,7,6,0,13,1,30,8,1,0,9,1,-15,3,1
2,3,25,1,30,2,12,0,14,5,30,6,0,0,6,0,30,6,8,0,14,1,30,5,9,0,14,5,30,5,1,0,6,1,-15,3,1
2,4,25,1,30,2,12,0,14,5,30,6,0,0,6,0,30,6,8,0,14,1,30,5,9,0,14,5,30,5,1,0,6,1,-15,3,1
2,0,27,1,30,4,11,0,15,3,30,1,1,0,2,0,30,5,10,0,15,3,30,5,10,0,15,5,30,6,0,0,6,1,-15,3,1
2,2,27,1,30,4,11,0,15,3,30,1,1,0,2,0,30,5,10,0,15,3,30,5,10,0,15,5,30,6,0,0,6,1,-15,3,1
2,3,27,1,30,4,11,0,15,3,30,1,1,0,2,0,30,5,10,0,15,3,30,5,10,0,15,5,30,6,0,0,6,1,-15,3,1
2,3,29,0,30,7,7,0,14,6,30,9,3,0,12,0,30,3,11,0,14,0,30,5,9,0,14,0,30,7,2,0,9,1,-15,3,1
2,3,33,0,30,3,8,0,11,4,30,4,0,0,4,0,30,11,0,0,11,2,30,5,6,0,11,7,30,4,0,0,4,1,-15,3,1
2,1,4,0,30,7,1,0,8,3,30,4,0,0,4,0,30,1,7,0,8,0,30,0,8,0,8,1,30,4,0,0,4,0,-27,3,0
2,2,4,0,30,7,1,0,8,3,30,4,0,0,4,0,30,1,7,0,8,0,30,0,8,0,8,1,30,4,0,0,4,0,-27,3,0
2,3,5,0,30,1,4,0,5,3,30,1,3,0,4,0,30,1,4,0,5,0,30,1,4,0,5,1,30,0,2,0,2,0,-27,3,0
2,4,5,0,30,1,4,0,5,3,30,1,3,0,4,0,30,1,4,0,5,0,30,1,4,0,5,1,30,0,2,0,2,0,-27,3,0
2,4,15,0,30,8,5,0,13,0,30,6,0,0,6,0,30,4,9,0,13,1,30,5,8,0,13,1,30,4,5,0,9,1,-15,3,1
2,3,17,1,30,9,5,0,14,2,30,6,0,0,6,0,30,7,7,0,14,2,30,5,9,0,14,4,30,4,0,0,4,1,-15,3,1
2,4,17,1,30,9,5,0,14,2,30,6,0,0,6,0,30,7,7,0,14,2,30,5,9,0,14,4,30,4,0,0,4,1,-15,3,1
2,4,19,0,30,3,10,0,13,2,30,6,2,0,8,0,30,6,7,0,13,3,30,7,6,0,13,2,30,8,1,0,9,1,-15,3,1
2,3,23,2,30,6,7,0,13,1,30,6,0,0,6,3,30,11,2,0,13,0,30,6,7,0,13,2,30,6,0,0,6,1,-15,3,1
2,1,27,1,30,4,11,0,15,3,30,2,0,0,2,0,30,12,3,0,15,0,30,4,11,0,15,0,30,2,4,0,6,1,-15,3,1
2,2,27,1,30,4,11,0,15,3,30,2,0,0,2,0,30,12,3,0,15,0,30,4,11,0,15,0,30,2,4,0,6,1,-15,3,1
2,3,27,1,30,4,11,0,15,3,30,2,0,0,2,0,30,12,3,0,15,0,30,4,11,0,15,0,30,2,4,0,6,1,-15,3,1
2,4,33,5,30,6,5,0,11,5,30,4,0,0,4,5,30,9,2,0,11,0,30,3,8,0,11,3,30,4,0,0,4,1,-15,3,1
2,3,35,0,30,7,6,0,13,3,30,2,0,0,2,1,30,6,7,0,13,3,30,2,11,0,13,4,30,8,0,0,8,1,-15,3,1
2,4,35,0,30,7,6,0,13,3,30,2,0,0,2,1,30,6,7,0,13,3,30,2,11,0,13,4,30,8,0,0,8,1,-15,3,1
2,3,4,2,30,4,4,0,8,4,30,4,0,0,4,0,30,5,3,0,8,4,30,8,0,0,8,1,30,3,1,0,4,0,-27,3,0
2,3,13,2,30,7,0,0,7,1,30,4,0,0,4,2,30,5,2,0,7,4,30,5,2,0,7,0,30,4,0,0,4,1,-15,3,1
2,3,23,2,30,4,9,0,13,2,30,6,0,0,6,6,30,10,3,0,13,0,30,4,9,0,13,1,30,6,0,0,6,1,-15,3,1
2,4,23,2,30,4,9,0,13,2,30,6,0,0,6,6,30,10,3,0,13,0,30,4,9,0,13,1,30,6,0,0,6,1,-15,3,1
2,0,26,0,30,6,3,0,9,5,30,4,0,0,4,2,30,0,9,0,9,0,30,2,7,0,9,6,30,3,0,0,3,1,-15,3,1
2,2,27,1,30,4,11,0,15,2,30,2,0,0,2,0,30,7,8,0,15,4,30,6,9,0,15,4,30,6,0,0,6,1,-15,3,1
2,0,29,0,30,7,7,0,14,6,30,10,2,0,12,0,30,3,11,0,14,0,30,1,13,0,14,5,30,9,0,0,9,1,-15,3,1
2,1,29,0,30,7,7,0,14,6,30,10,2,0,12,0,30,3,11,0,14,0,30,1,13,0,14,5,30,9,0,0,9,1,-15,3,1
2,2,29,0,30,7,7,0,14,6,30,10,2,0,12,0,30,3,11,0,14,0,30,1,13,0,14,5,30,9,0,0,9,1,-15,3,1
2,2,31,1,30,5,7,0,12,4,30,8,0,0,8,3,30,12,0,0,12,0,30,3,9,0,12,3,30,2,4,0,6,1,-15,3,1
2,3,31,1,30,5,7,0,12,4,30,8,0,0,8,3,30,12,0,0,12,0,30,3,9,0,12,3,30,2,4,0,6,1,-15,3,1
2,4,31,1,30,5,7,0,12,4,30,8,0,0,8,3,30,12,0,0,12,0,30,3,9,0,12,3,30,2,4,0,6,1,-15,3,1
2,4,6,1,30,6,3,0,9,3,30,2,0,0,2,0,30,3,6,0,9,0,30,3,6,0,9,0,30,2,3,0,5,0,-27,3,0
2,4,13,1,30,5,2,0,7,0,30,4,0,0,4,2,30,6,1,0,7,10,30,7,0,0,7,6,30,4,0,0,4,1,-15,3,1
2,4,15,1,30,3,10,0,13,1,30,6,0,0,6,0,30,4,9,0,13,1,30,3,10,0,13,2,30,9,0,0,9,1,-15,3,1
2,2,17,5,30,10,4,0,14,3,30,6,0,0,6,0,30,6,8,0,14,0,30,5,9,0,14,2,30,3,1,0,4,1,-15,3,1
2,4,17,5,30,10,4,0,14,3,30,6,0,0,6,0,30,6,8,0,14,0,30,5,9,0,14,0,30,3,1,0,4,1,-15,3,1
2,3,19,1,30,4,9,0,13,2,30,3,5,0,8,0,30,4,9,0,13,4,30,3,10,0,13,0,30,8,1,0,9,1,-15,3,1
2,4,19,1,30,4,9,0,13,2,30,3,5,0,8,0,30,4,9,0,13,4,30,3,10,0,13,0,30,8,1,0,9,1,-15,3,1
2,2,21,2,30,6,4,0,10,4,30,6,0,0,6,0,30,3,7,0,10,5,30,4,6,0,10,1,30,4,0,0,4,1,-15,3,1
2,1,27,1,30,3,12,0,15,3,30,2,0,0,2,3,30,10,5,0,15,0,30,4,11,0,15,1,30,4,2,0,6,1,-15,3,1
2,4,27,1,30,3,12,0,15,3,30,2,0,0,2,3,30,10,5,0,15,0,30,4,11,0,15,1,30,4,2,0,6,1,-15,3,1
2,2,29,0,30,6,8,0,14,6,30,11,1,0,12,0,30,4,10,0,14,0,30,1,13,0,14,2,30,9,0,0,9,1,-15,3,1
2,4,32,0,30,5,4,0,9,4,30,2,0,0,2,0,30,6,3,0,9,0,30,2,7,0,9,6,30,2,0,0,2,1,-15,3,1
2,0,47,0,30,4,10,0,14,7,30,4,0,0,4,0,30,5,9,0,14,0,30,2,12,0,14,3,30,7,0,0,7,1,-15,3,1
2,2,47,0,30,4,10,0,14,7,30,4,0,0,4,0,30,5,9,0,14,0,30,2,12,0,14,3,30,7,0,0,7,1,-15,3,1
2,3,47,0,30,4,10,0,14,7,30,4,0,0,4,0,30,5,9,0,14,0,30,2,12,0,14,3,30,7,0,0,7,1,-15,3,1
2,3,17,1,30,9,5,0,14,2,30,6,0,0,6,0,30,5,9,0,14,1,30,6,8,0,14,6,30,4,0,0,4,1,-15,3,1
2,2,19,0,30,4,9,0,13,2,30,6,2,0,8,0,30,4,9,0,13,8,30,6,7,0,13,0,30,9,0,0,9,1,-15,3,1
2,4,25,0,30,6,8,0,14,1,30,5,1,0,6,0,30,10,4,0,14,1,30,7,7,0,14,4,30,6,0,0,6,1,-15,3,1
2,0,27,1,30,4,11,0,15,2,30,1,1,0,2,0,30,8,7,0,15,0,30,6,9,0,15,3,30,6,0,0,6,1,-15,3,1
2,1,27,1,30,4,11,0,15,2,30,1,1,0,2,0,30,8,7,0,15,0,30,6,9,0,15,3,30,6,0,0,6,1,-15,3,1
2,3,27,1,30,4,11,0,15,2,30,1,1,0,2,0,30,8,7,0,15,0,30,6,9,0,15,3,30,6,0,0,6,1,-15,3,1
2,2,29,0,30,6,8,0,14,6,30,12,0,0,12,0,30,3,11,0,14,0,30,0,14,0,14,2,30,9,0,0,9,1,-15,3,1
2,3,29,0,30,6,8,0,14,6,30,12,0,0,12,0,30,3,11,0,14,0,30,0,14,0,14,2,30,9,0,0,9,1,-15,3,1
2,3,31,2,30,10,2,0,12,3,30,8,0,0,8,3,30,10,2,0,12,0,30,3,9,0,12,1,30,4,2,0,6,1,-15,3,1
2,4,31,2,30,10,2,0,12,3,30,8,0,0,8,3,30,10,2,0,12,0,30,3,9,0,12,1,30,4,2,0,6,1,-15,3,1
2,3,35,0,30,8,5,0,13,5,30,2,0,0,2,1,30,2,11,0,13,4,30,1,12,0,13,8,30,8,0,0,8,1,-15,3,1
2,1,11,0,30,4,8,0,12,1,30,4,0,0,4,5,30,6,6,0,12,6,30,4,8,0,12,3,30,3,1,0,4,1,-15,3,1
2,2,19,0,30,2,11,0,13,3,30,7,1,0,8,0,30,4,9,0,13,7,30,3,10,0,13,3,30,9,0,0,9,1,-15,3,1
2,1,23,2,30,6,7,0,13,2,30,6,0,0,6,6,30,13,0,0,13,0,30,5,8,0,13,2,30,5,1,0,6,1,-15,3,1
2,3,23,2,30,6,7,0,13,2,30,6,0,0,6,6,30,13,0,0,13,0,30,5,8,0,13,2,30,5,1,0,6,1,-15,3,1
2,4,25,1,30,5,9,0,14,5,30,6,0,0,6,0,30,8,6,0,14,2,30,6,8,0,14,5,30,6,0,0,6,1,-15,3,1
2,0,27,1,30,7,8,0,15,4,30,1,1,0,2,0,30,5,10,0,15,2,30,6,9,0,15,4,30,6,0,0,6,1,-15,3,1
2,3,29,0,30,6,8,0,14,6,30,12,0,0,12,0,30,5,9,0,14,0,30,0,14,0,14,3,30,9,0,0,9,1,-15,3,1
2,3,31,2,30,7,5,0,12,3,30,8,0,0,8,3,30,10,2,0,12,0,30,3,9,0,12,2,30,5,1,0,6,1,-15,3,1
2,3,39,0,30,4,7,0,11,6,30,6,0,0,6,0,30,6,5,0,11,0,30,4,7,0,11,6,30,5,0,0,5,1,-15,3,1
2,4,39,0,30,4,7,0,11,6,30,6,0,0,6,0,30,6,5,0,11,0,30,4,7,0,11,6,30,5,0,0,5,1,-15,3,1
2,3,45,1,30,6,7,0,13,11,30,10,0,0,10,0,30,0,13,0,13,0,30,6,7,0,13,10,30,5,0,0,5,1,-15,3,1
2,2,5,0,30,0,5,0,5,2,30,1,3,0,4,0,30,3,2,0,5,0,30,1,4,0,5,0,30,0,2,0,2,0,-27,3,0
2,4,5,0,30,0,5,0,5,2,30,1,3,0,4,0,30,3,2,0,5,0,30,1,4,0,5,0,30,0,2,0,2,0,-27,3,0
2,2,17,4,30,11,3,0,14,3,30,6,0,0,6,0,30,3,11,0,14,1,30,5,9,0,14,7,30,4,0,0,4,1,-15,3,1
2,4,22,2,30,8,0,0,8,2,30,2,0,0,2,0,30,5,3,0,8,0,30,3,5,0,8,2,30,2,2,0,4,1,-15,3,1
2,4,27,1,30,6,9,0,15,3,30,2,0,0,2,0,30,5,10,0,15,0,30,4,11,0,15,0,30,3,3,0,6,1,-15,3,1
2,2,39,0,30,2,9,0,11,5,30,6,0,0,6,1,30,9,2,0,11,0,30,4,7,0,11,5,30,5,0,0,5,1,-15,3,1
2,0,5,0,30,4,1,0,5,3,30,1,3,0,4,0,30,0,5,0,5,0,30,1,4,0,5,0,30,0,2,0,2,0,-27,3,0
2,1,5,0,30,4,1,0,5,3,30,1,3,0,4,0,30,0,5,0,5,0,30,1,4,0,5,0,30,0,2,0,2,0,-27,3,0
2,3,5,0,30,4,1,0,5,3,30,1,3,0,4,0,30,0,5,0,5,0,30,1,4,0,5,0,30,0,2,0,2,0,-27,3,0
2,4,8,1,30,7,0,0,7,4,30,2,0,0,2,2,30,4,3,0,7,1,30,7,0,0,7,2,30,3,0,0,3,0,-27,3,0
2,1,13,2,30,7,0,0,7,0,30,4,0,0,4,2,30,6,1,0,7,7,30,5,2,0,7,6,30,4,0,0,4,1,-15,3,1
2,2,17,4,30,9,5,0,14,3,30,6,0,0,6,0,30,6,8,0,14,0,30,7,7,0,14,5,30,4,0,0,4,1,-15,3,1
2,4,23,1,30,8,5,0,13,0,30,6,0,0,6,5,30,13,0,0,13,0,30,6,7,0,13,2,30,6,0,0,6,1,-15,3,1
2,0,25,1,30,6,8,0,14,4,30,6,0,0,6,0,30,10,4,0,14,1,30,4,10,0,14,4,30,5,1,0,6,1,-15,3,1
2,3,25,1,30,6,8,0,14,2,30,6,0,0,6,0,30,10,4,0,14,1,30,4,10,0,14,4,30,5,1,0,6,1,-15,3,1
2,4,25,1,30,6,8,0,14,2,30,6,0,0,6,0,30,10,4,0,14,1,30,4,10,0,14,4,30,5,1,0,6,1,-15,3,1
2,3,29,0,30,7,7,0,14,6,30,10,2,0,12,0,30,4,10,0,14,0,30,1,13,0,14,3,30,9,0,0,9,1,-15,3,1
2,4,29,0,30,7,7,0,14,6,30,10,2,0,12,0,30,4,10,0,14,0,30,1,13,0,14,3,30,9,0,0,9,1,-15,3,1
2,4,31,2,30,8,4,0,12,5,30,8,0,0,8,2,30,7,5,0,12,0,30,3,9,0,12,0,30,5,1,0,6,1,-15,3,1
2,3,39,0,30,3,8,0,11,6,30,6,0,0,6,0,30,6,5,0,11,0,30,2,9,0,11,6,30,5,0,0,5,1,-15,3,1
2,2,5,0,30,2,3,0,5,3,30,0,4,0,4,0,30,2,3,0,5,0,30,1,4,0,5,0,30,2,0,0,2,0,-27,3,0
2,0,11,3,30,6,6,0,12,2,30,4,0,0,4,4,30,4,8,0,12,8,30,2,10,0,12,2,30,4,0,0,4,1,-15,3,1
2,2,11,3,30,6,6,0,12,2,30,4,0,0,4,0,30,4,8,0,12,8,30,2,10,0,12,2,30,4,0,0,4,1,-15,3,1
2,1,13,1,30,6,1,0,7,0,30,4,0,0,4,2,30,6,1,0,7,11,30,6,1,0,7,5,30,4,0,0,4,1,-15,3,1
2,1,17,5,30,8,6,0,14,3,30,6,0,0,6,0,30,5,9,0,14,1,30,5,9,0,14,3,30,4,0,0,4,1,-15,3,1
2,2,17,5,30,8,6,0,14,3,30,6,0,0,6,0,30,5,9,0,14,1,30,5,9,0,14,3,30,4,0,0,4,1,-15,3,1
2,3,19,0,30,4,9,0,13,2,30,6,2,0,8,0,30,4,9,0,13,5,30,4,9,0,13,0,30,8,1,0,9,1,-15,3,1
2,2,23,3,30,5,8,0,13,3,30,6,0,0,6,5,30,13,0,0,13,0,30,6,7,0,13,2,30,6,0,0,6,1,-15,3,1
2,4,23,3,30,5,8,0,13,3,30,6,0,0,6,5,30,13,0,0,13,0,30,6,7,0,13,2,30,6,0,0,6,1,-15,3,1
2,3,25,0,30,8,6,0,14,4,30,6,0,0,6,0,30,5,9,0,14,1,30,5,9,0,14,6,30,5,1,0,6,1,-15,3,1
2,4,25,0,30,8,6,0,14,4,30,6,0,0,6,0,30,5,9,0,14,1,30,5,9,0,14,6,30,5,1,0,6,1,-15,3,1
2,0,27,1,30,4,11,0,15,4,30,1,1,0,2,0,30,6,9,0,15,4,30,6,9,0,15,4,30,6,0,0,6,1,-15,3,1
2,3,27,1,30,4,11,0,15,4,30,1,1,0,2,0,30,6,9,0,15,4,30,6,9,0,15,4,30,6,0,0,6,1,-15,3,1
2,3,31,1,30,9,3,0,12,4,30,8,0,0,8,6,30,9,3,0,12,0,30,3,9,0,12,0,30,3,3,0,6,1,-15,3,1
2,2,37,1,30,8,3,0,11,6,30,8,0,0,8,0,30,2,9,0,11,4,30,3,8,0,11,9,30,6,0,0,6,1,-15,3,1
2,4,39,0,30,3,8,0,11,7,30,6,0,0,6,0,30,6,5,0,11,4,30,3,8,0,11,2,30,5,0,0,5,1,-15,3,1
2,2,11,0,30,3,9,0,12,1,30,3,1,0,4,0,30,5,7,0,12,0,30,7,5,0,12,0,30,4,0,0,4,1,-15,3,1
2,3,17,1,30,6,8,0,14,2,30,6,0,0,6,0,30,8,6,0,14,5,30,7,7,0,14,7,30,4,0,0,4,1,-15,3,1
2,0,27,1,30,4,11,0,15,4,30,1,1,0,2,0,30,7,8,0,15,0,30,8,7,0,15,3,30,6,0,0,6,1,-15,3,1
2,1,27,1,30,4,11,0,15,4,30,1,1,0,2,0,30,7,8,0,15,0,30,8,7,0,15,3,30,6,0,0,6,1,-15,3,1
2,2,27,1,30,4,11,0,15,4,30,1,1,0,2,0,30,7,8,0,15,0,30,8,7,0,15,3,30,6,0,0,6,1,-15,3,1
2,4,27,1,30,4,11,0,15,4,30,1,1,0,2,0,30,7,8,0,15,0,30,8,7,0,15,3,30,6,0,0,6,1,-15,3,1
2,1,29,0,30,6,8,0,14,5,30,12,0,0,12,0,30,7,7,0,14,0,30,0,14,0,14,4,30,9,0,0,9,1,-15,3,1
2,4,29,0,30,6,8,0,14,5,30,12,0,0,12,0,30,7,7,0,14,0,30,0,14,0,14,0,30,9,0,0,9,1,-15,3,1
2,3,32,0,30,4,5,0,9,4,30,2,0,0,2,1,30,7,2,0,9,1,30,3,6,0,9,5,30,2,0,0,2,1,-15,3,1
2,4,32,0,30,4,5,0,9,4,30,2,0,0,2,1,30,7,2,0,9,1,30,3,6,0,9,5,30,2,0,0,2,1,-15,3,1
2,2,4,0,30,8,0,0,8,4,30,3,1,0,4,0,30,3,5,0,8,0,30,5,3,0,8,1,30,4,0,0,4,0,-27,3,0
2,2,8,5,30,7,0,0,7,4,30,2,0,0,2,2,30,4,3,0,7,0,30,4,3,0,7,2,30,3,0,0,3,0,-27,3,0
2,3,8,5,30,7,0,0,7,4,30,2,0,0,2,2,30,4,3,0,7,0,30,4,3,0,7,2,30,3,0,0,3,0,-27,3,0
2,4,19,0,30,4,9,0,13,2,30,3,5,0,8,0,30,5,8,0,13,2,30,3,10,0,13,2,30,8,1,0,9,1,-15,3,1
2,4,23,2,30,4,9,0,13,4,30,6,0,0,6,0,30,9,4,0,13,0,30,4,9,0,13,0,30,6,0,0,6,1,-15,3,1
2,0,27,3,30,5,10,0,15,3,30,2,0,0,2,0,30,12,3,0,15,1,30,5,10,0,15,1,30,4,2,0,6,1,-15,3,1
2,2,27,3,30,5,10,0,15,3,30,2,0,0,2,0,30,12,3,0,15,1,30,5,10,0,15,1,30,4,2,0,6,1,-15,3,1
2,4,27,3,30,5,10,0,15,3,30,2,0,0,2,0,30,12,3,0,15,1,30,5,10,0,15,1,30,4,2,0,6,1,-15,3,1
2,0,31,1,30,4,8,0,12,8,30,8,0,0,8,3,30,4,8,0,12,1,30,10,2,0,12,4,30,6,0,0,6,1,-15,3,1
2,2,31,1,30,4,8,0,12,8,30,8,0,0,8,3,30,4,8,0,12,1,30,10,2,0,12,4,30,6,0,0,6,1,-15,3,1
2,3,31,1,30,4,8,0,12,8,30,8,0,0,8,3,30,4,8,0,12,1,30,10,2,0,12,4,30,6,0,0,6,1,-15,3,1
2,0,5,2,30,1,4,0,5,3,30,2,2,0,4,0,30,0,5,0,5,0,30,1,4,0,5,0,30,1,1,0,2,0,-27,3,0
2,1,5,2,30,1,4,0,5,3,30,2,2,0,4,0,30,0,5,0,5,0,30,1,4,0,5,0,30,1,1,0,2,0,-27,3,0
2,2,5,2,30,1,4,0,5,3,30,2,2,0,4,0,30,0,5,0,5,0,30,1,4,0,5,0,30,1,1,0,2,0,-27,3,0
2,3,5,2,30,1,4,0,5,3,30,2,2,0,4,0,30,0,5,0,5,0,30,1,4,0,5,0,30,1,1,0,2,0,-27,3,0
2,4,5,2,30,1,4,0,5,3,30,2,2,0,4,0,30,0,5,0,5,0,30,1,4,0,5,0,30,1,1,0,2,0,-27,3,0
2,3,11,1,30,5,7,0,12,1,30,3,1,0,4,0,30,5,7,0,12,3,30,5,7,0,12,4,30,4,0,0,4,1,-15,3,1
2,1,13,4,30,7,0,0,7,0,30,4,0,0,4,2,30,6,1,0,7,5,30,7,0,0,7,3,30,4,0,0,4,1,-15,3,1
2,3,17,3,30,11,3,0,14,2,30,6,0,0,6,0,30,7,7,0,14,2,30,6,8,0,14,1,30,4,0,0,4,1,-15,3,1
2,3,25,0,30,6,8,0,14,5,30,6,0,0,6,0,30,8,6,0,14,1,30,5,9,0,14,6,30,5,1,0,6,1,-15,3,1
2,0,27,1,30,4,11,0,15,4,30,2,0,0,2,0,30,7,8,0,15,2,30,4,11,0,15,0,30,5,1,0,6,1,-15,3,1
2,1,27,1,30,4,11,0,15,4,30,2,0,0,2,0,30,7,8,0,15,2,30,4,11,0,15,0,30,5,1,0,6,1,-15,3,1
2,0,29,0,30,7,7,0,14,6,30,10,2,0,12,0,30,4,10,0,14,0,30,1,13,0,14,4,30,9,0,0,9,1,-15,3,1
2,3,29,0,30,7,7,0,14,6,30,10,2,0,12,0,30,4,10,0,14,0,30,1,13,0,14,4,30,9,0,0,9,1,-15,3,1
2,3,35,3,30,6,7,0,13,4,30,2,0,0,2,0,30,9,4,0,13,0,30,3,10,0,13,4,30,8,0,0,8,1,-15,3,1
2,3,45,0,30,11,2,0,13,11,30,10,0,0,10,0,30,0,13,0,13,0,30,4,9,0,13,9,30,5,0,0,5,1,-15,3,1
2,1,5,0,30,3,2,0,5,2,30,2,2,0,4,1,30,2,3,0,5,0,30,1,4,0,5,0,30,0,2,0,2,0,-27,3,0
2,2,5,0,30,3,2,0,5,2,30,2,2,0,4,1,30,2,3,0,5,0,30,1,4,0,5,0,30,0,2,0,2,0,-27,3,0
2,2,17,4,30,8,6,0,14,3,30,6,0,0,6,0,30,7,7,0,14,3,30,5,9,0,14,2,30,4,0,0,4,1,-15,3,1
2,4,17,4,30,8,6,0,14,3,30,6,0,0,6,0,30,7,7,0,14,3,30,5,9,0,14,2,30,4,0,0,4,1,-15,3,1
2,3,19,0,30,4,9,0,13,2,30,5,3,0,8,0,30,5,8,0,13,6,30,5,8,0,13,4,30,8,1,0,9,1,-15,3,1
2,4,19,0,30,4,9,0,13,2,30,5,3,0,8,0,30,5,8,0,13,6,30,5,8,0,13,4,30,8,1,0,9,1,-15,3,1
2,0,25,1,30,6,8,0,14,5,30,6,0,0,6,0,30,8,6,0,14,1,30,6,8,0,14,5,30,6,0,0,6,1,-15,3,1
2,1,27,1,30,5,10,0,15,2,30,2,0,0,2,0,30,5,10,0,15,4,30,4,11,0,15,0,30,5,1,0,6,1,-15,3,1
2,2,27,1,30,5,10,0,15,2,30,2,0,0,2,0,30,5,10,0,15,4,30,4,11,0,15,0,30,5,1,0,6,1,-15,3,1
2,3,27,1,30,5,10,0,15,2,30,2,0,0,2,0,30,5,10,0,15,4,30,4,11,0,15,0,30,5,1,0,6,1,-15,3,1
2,2,29,0,30,6,8,0,14,4,30,11,1,0,12,0,30,7,7,0,14,0,30,1,13,0,14,3,30,9,0,0,9,1,-15,3,1
2,4,29,0,30,6,8,0,14,4,30,11,1,0,12,0,30,7,7,0,14,0,30,1,13,0,14,3,30,9,0,0,9,1,-15,3,1
2,0,31,1,30,7,5,0,12,5,30,8,0,0,8,3,30,8,4,0,12,0,30,5,7,0,12,3,30,6,0,0,6,1,-15,3,1
2,2,31,1,30,7,5,0,12,5,30,8,0,0,8,3,30,8,4,0,12,0,30,5,7,0,12,3,30,6,0,0,6,1,-15,3,1
2,3,47,0,30,0,14,0,14,5,30,4,0,0,4,0,30,6,8,0,14,2,30,2,12,0,14,8,30,7,0,0,7,1,-15,3,1
2,3,3,0,30,0,4,0,4,1,30,4,0,0,4,0,30,0,4,0,4,5,30,1,3,0,4,0,30,3,0,0,3,0,-27,3,0
2,1,5,0,30,0,5,0,5,3,30,2,2,0,4,0,30,0,5,0,5,1,30,2,3,0,5,1,30,2,0,0,2,0,-27,3,0
2,3,8,3,30,7,0,0,7,4,30,2,0,0,2,3,30,5,2,0,7,0,30,5,2,0,7,2,30,3,0,0,3,0,-27,3,0
2,0,13,2,30,7,0,0,7,2,30,4,0,0,4,2,30,5,2,0,7,6,30,6,1,0,7,3,30,4,0,0,4,1,-15,3,1
2,2,13,2,30,7,0,0,7,2,30,4,0,0,4,2,30,5,2,0,7,6,30,6,1,0,7,3,30,4,0,0,4,1,-15,3,1
2,3,13,2,30,7,0,0,7,2,30,4,0,0,4,2,30,5,2,0,7,6,30,6,1,0,7,3,30,4,0,0,4,1,-15,3,1
2,4,13,2,30,7,0,0,7,2,30,4,0,0,4,2,30,5,2,0,7,6,30,6,1,0,7,3,30,4,0,0,4,1,-15,3,1
2,2,19,0,30,2,11,0,13,3,30,8,0,0,8,0,30,6,7,0,13,9,30,6,7,0,13,0,30,7,2,0,9,1,-15,3,1
2,4,19,0,30,2,11,0,13,3,30,8,0,0,8,0,30,6,7,0,13,9,30,6,7,0,13,0,30,7,2,0,9,1,-15,3,1
2,4,23,1,30,6,7,0,13,3,30,6,0,0,6,7,30,12,1,0,13,0,30,6,7,0,13,2,30,5,1,0,6,1,-15,3,1
2,0,27,1,30,4,11,0,15,2,30,1,1,0,2,0,30,6,9,0,15,3,30,7,8,0,15,3,30,6,0,0,6,1,-15,3,1
2,2,35,0,30,7,6,0,13,5,30,2,0,0,2,1,30,2,11,0,13,3,30,2,11,0,13,3,30,8,0,0,8,1,-15,3,1
2,0,37,1,30,8,3,0,11,5,30,2,6,0,8,2,30,4,7,0,11,4,30,2,9,0,11,1,30,6,0,0,6,1,-15,3,1
2,4,6,0,30,8,1,0,9,4,30,2,0,0,2,0,30,2,7,0,9,0,30,4,5,0,9,1,30,5,0,0,5,0,-27,3,0
2,3,8,1,30,7,0,0,7,4,30,2,0,0,2,6,30,4,3,0,7,1,30,7,0,0,7,2,30,3,0,0,3,0,-27,3,0
2,4,8,1,30,7,0,0,7,4,30,2,0,0,2,6,30,4,3,0,7,1,30,7,0,0,7,2,30,3,0,0,3,0,-27,3,0
2,0,11,2,30,5,7,0,12,2,30,4,0,0,4,0,30,3,9,0,12,4,30,4,8,0,12,4,30,4,0,0,4,1,-15,3,1
2,1,11,2,30,5,7,0,12,2,30,4,0,0,4,0,30,3,9,0,12,4,30,4,8,0,12,4,30,4,0,0,4,1,-15,3,1
2,2,13,4,30,7,0,0,7,2,30,4,0,0,4,2,30,6,1,0,7,1,30,7,0,0,7,0,30,4,0,0,4,1,-15,3,1
2,4,13,4,30,7,0,0,7,2,30,4,0,0,4,2,30,6,1,0,7,1,30,7,0,0,7,0,30,4,0,0,4,1,-15,3,1
2,4,17,3,30,9,5,0,14,1,30,6,0,0,6,0,30,9,5,0,14,1,30,5,9,0,14,5,30,4,0,0,4,1,-15,3,1
2,1,21,2,30,5,5,0,10,3,30,5,1,0,6,1,30,6,4,0,10,1,30,5,5,0,10,5,30,4,0,0,4,1,-15,3,1
2,2,21,2,30,5,5,0,10,3,30,5,1,0,6,1,30,6,4,0,10,1,30,5,5,0,10,5,30,4,0,0,4,1,-15,3,1
2,3,23,1,30,6,7,0,13,1,30,6,0,0,6,4,30,9,4,0,13,1,30,6,7,0,13,4,30,6,0,0,6,1,-15,3,1
2,3,25,0,30,6,8,0,14,3,30,6,0,0,6,0,30,9,5,0,14,1,30,10,4,0,14,3,30,5,1,0,6,1,-15,3,1
2,4,27,1,30,4,11,0,15,0,30,2,0,0,2,0,30,2,13,0,15,4,30,3,12,0,15,4,30,6,0,0,6,1,-15,3,1
2,4,31,1,30,6,6,0,12,4,30,8,0,0,8,4,30,11,1,0,12,0,30,3,9,0,12,0,30,4,2,0,6,1,-15,3,1
2,4,11,1,30,3,9,0,12,0,30,4,0,0,4,0,30,7,5,0,12,2,30,5,7,0,12,3,30,4,0,0,4,1,-15,3,1
2,1,13,1,30,7,0,0,7,0,30,4,0,0,4,2,30,6,1,0,7,10,30,6,1,0,7,4,30,4,0,0,4,1,-15,3,1
2,2,13,1,30,7,0,0,7,0,30,4,0,0,4,2,30,6,1,0,7,10,30,6,1,0,7,4,30,4,0,0,4,1,-15,3,1
2,3,19,0,30,2,11,0,13,2,30,6,2,0,8,0,30,12,1,0,13,0,30,5,8,0,13,2,30,8,1,0,9,1,-15,3,1
2,4,19,0,30,2,11,0,13,2,30,6,2,0,8,0,30,12,1,0,13,0,30,5,8,0,13,2,30,8,1,0,9,1,-15,3,1
2,2,25,1,30,5,9,0,14,4,30,6,0,0,6,0,30,5,9,0,14,1,30,5,9,0,14,0,30,6,0,0,6,1,-15,3,1
2,3,26,0,30,6,3,0,9,4,30,4,0,0,4,2,30,6,3,0,9,0,30,6,3,0,9,7,30,1,2,0,3,1,-15,3,1
2,0,27,2,30,4,11,0,15,3,30,2,0,0,2,0,30,6,9,0,15,2,30,3,12,0,15,2,30,6,0,0,6,1,-15,3,1
2,1,27,2,30,4,11,0,15,3,30,2,0,0,2,0,30,6,9,0,15,2,30,3,12,0,15,2,30,6,0,0,6,1,-15,3,1
2,2,27,2,30,4,11,0,15,3,30,2,0,0,2,0,30,6,9,0,15,2,30,3,12,0,15,2,30,6,0,0,6,1,-15,3,1
2,3,27,2,30,4,11,0,15,3,30,2,0,0,2,0,30,6,9,0,15,2,30,3,12,0,15,2,30,6,0,0,6,1,-15,3,1
2,4,27,2,30,4,11,0,15,3,30,2,0,0,2,0,30,6,9,0,15,2,30,3,12,0,15,2,30,6,0,0,6,1,-15,3,1
2,2,29,0,30,7,7,0,14,6,30,12,0,0,12,0,30,4,10,0,14,0,30,1,13,0,14,3,30,9,0,0,9,1,-15,3,1
2,3,29,0,30,7,7,0,14,6,30,12,0,0,12,0,30,4,10,0,14,0,30,1,13,0,14,3,30,9,0,0,9,1,-15,3,1
2,2,4,2,30,8,0,0,8,5,30,4,0,0,4,1,30,2,6,0,8,1,30,8,0,0,8,3,30,4,0,0,4,0,-27,3,0
2,2,11,0,30,5,7,0,12,1,30,4,0,0,4,0,30,6,6,0,12,7,30,7,5,0,12,6,30,4,0,0,4,1,-15,3,1
2,3,13,3,30,7,0,0,7,0,30,4,0,0,4,2,30,6,1,0,7,3,30,5,2,0,7,4,30,4,0,0,4,1,-15,3,1
2,4,13,3,30,7,0,0,7,0,30,4,0,0,4,2,30,6,1,0,7,3,30,5,2,0,7,4,30,4,0,0,4,1,-15,3,1
2,4,19,0,30,5,8,0,13,1,30,6,2,0,8,0,30,7,6,0,13,1,30,4,9,0,13,1,30,8,1,0,9,1,-15,3,1
2,3,23,1,30,4,9,0,13,3,30,6,0,0,6,9,30,13,0,0,13,0,30,5,8,0,13,2,30,5,1,0,6,1,-15,3,1
2,3,25,2,30,5,9,0,14,2,30,6,0,0,6,0,30,8,6,0,14,1,30,5,9,0,14,5,30,5,1,0,6,1,-15,3,1
2,0,27,5,30,6,9,0,15,3,30,1,1,0,2,0,30,6,9,0,15,2,30,4,11,0,15,1,30,4,2,0,6,1,-15,3,1
2,3,27,5,30,6,9,0,15,1,30,1,1,0,2,0,30,6,9,0,15,2,30,4,11,0,15,1,30,4,2,0,6,1,-15,3,1
2,4,27,5,30,6,9,0,15,1,30,1,1,0,2,0,30,6,9,0,15,2,30,4,11,0,15,1,30,4,2,0,6,1,-15,3,1
2,3,7,0,30,2,2,0,4,2,30,2,0,0,2,0,30,1,3,0,4,2,30,0,4,0,4,3,30,2,0,0,2,0,-27,3,0
2,4,7,0,30,2,2,0,4,2,30,2,0,0,2,0,30,1,3,0,4,2,30,0,4,0,4,3,30,2,0,0,2,0,-27,3,0
2,4,8,0,30,7,0,0,7,4,30,2,0,0,2,0,30,4,3,0,7,1,30,5,2,0,7,4,30,3,0,0,3,0,-27,3,0
2,3,15,0,30,5,8,0,13,1,30,5,1,0,6,0,30,4,9,0,13,1,30,6,7,0,13,0,30,9,0,0,9,1,-15,3,1
2,1,17,3,30,7,7,0,14,0,30,6,0,0,6,0,30,8,6,0,14,7,30,5,9,0,14,7,30,4,0,0,4,1,-15,3,1
2,3,19,0,30,3,10,0,13,2,30,5,3,0,8,0,30,9,4,0,13,0,30,4,9,0,13,1,30,8,1,0,9,1,-15,3,1
2,0,21,2,30,8,2,0,10,3,30,5,1,0,6,1,30,4,6,0,10,3,30,4,6,0,10,2,30,4,0,0,4,1,-15,3,1
2,4,23,4,30,7,6,0,13,1,30,6,0,0,6,0,30,13,0,0,13,0,30,4,9,0,13,1,30,6,0,0,6,1,-15,3,1
2,4,25,1,30,12,2,0,14,4,30,6,0,0,6,0,30,6,8,0,14,1,30,5,9,0,14,4,30,5,1,0,6,1,-15,3,1
2,4,26,0,30,4,5,0,9,6,30,4,0,0,4,7,30,1,8,0,9,0,30,2,7,0,9,5,30,3,0,0,3,1,-15,3,1
2,2,27,1,30,4,11,0,15,4,30,2,0,0,2,0,30,8,7,0,15,2,30,6,9,0,15,0,30,6,0,0,6,1,-15,3,1
2,3,27,1,30,4,11,0,15,4,30,2,0,0,2,0,30,8,7,0,15,2,30,6,9,0,15,0,30,6,0,0,6,1,-15,3,1
2,4,27,1,30,4,11,0,15,4,30,2,0,0,2,0,30,8,7,0,15,2,30,6,9,0,15,0,30,6,0,0,6,1,-15,3,1
2,3,13,9,30,7,0,0,7,3,30,4,0,0,4,2,30,5,2,0,7,0,30,6,1,0,7,4,30,4,0,0,4,1,-15,3,1
2,4,17,2,30,7,7,0,14,2,30,6,0,0,6,0,30,7,7,0,14,2,30,3,11,0,14,2,30,4,0,0,4,1,-15,3,1
2,0,19,0,30,5,8,0,13,1,30,2,6,0,8,0,30,6,7,0,13,6,30,5,8,0,13,2,30,9,0,0,9,1,-15,3,1
2,2,19,0,30,5,8,0,13,1,30,2,6,0,8,0,30,6,7,0,13,6,30,5,8,0,13,2,30,9,0,0,9,1,-15,3,1
2,4,23,1,30,7,6,0,13,1,30,6,0,0,6,3,30,10,3,0,13,1,30,4,9,0,13,3,30,6,0,0,6,1,-15,3,1
2,2,25,0,30,8,6,0,14,3,30,6,0,0,6,3,30,11,3,0,14,1,30,7,7,0,14,3,30,5,1,0,6,1,-15,3,1
2,3,27,1,30,4,11,0,15,2,30,1,1,0,2,0,30,5,10,0,15,2,30,2,13,0,15,2,30,6,0,0,6,1,-15,3,1
2,4,27,1,30,4,11,0,15,2,30,1,1,0,2,0,30,5,10,0,15,2,30,2,13,0,15,2,30,6,0,0,6,1,-15,3,1
2,1,31,3,30,7,5,0,12,6,30,8,0,0,8,3,30,8,4,0,12,0,30,9,3,0,12,0,30,6,0,0,6,1,-15,3,1
2,2,31,3,30,7,5,0,12,6,30,8,0,0,8,3,30,8,4,0,12,0,30,9,3,0,12,0,30,6,0,0,6,1,-15,3,1
2,1,17,3,30,11,3,0,14,2,30,6,0,0,6,0,30,7,7,0,14,3,30,3,11,0,14,5,30,4,0,0,4,1,-15,3,1
2,3,17,3,30,11,3,0,14,2,30,6,0,0,6,0,30,7,7,0,14,3,30,3,11,0,14,5,30,4,0,0,4,1,-15,3,1
2,4,17,3,30,11,3,0,14,2,30,6,0,0,6,0,30,7,7,0,14,3,30,3,11,0,14,5,30,4,0,0,4,1,-15,3,1
2,3,19,0,30,1,12,0,13,2,30,6,2,0,8,0,30,4,9,0,13,3,30,5,8,0,13,0,30,7,2,0,9,1,-15,3,1
2,4,23,2,30,8,5,0,13,2,30,6,0,0,6,4,30,11,2,0,13,0,30,5,8,0,13,2,30,5,1,0,6,1,-15,3,1
2,2,25,1,30,7,7,0,14,4,30,6,0,0,6,0,30,5,9,0,14,3,30,5,9,0,14,3,30,5,1,0,6,1,-15,3,1
2,3,35,0,30,12,1,0,13,4,30,2,0,0,2,2,30,5,8,0,13,0,30,1,12,0,13,5,30,8,0,0,8,1,-15,3,1
2,4,13,2,30,6,1,0,7,0,30,4,0,0,4,2,30,6,1,0,7,6,30,7,0,0,7,2,30,4,0,0,4,1,-15,3,1
2,4,15,0,30,5,8,0,13,1,30,6,0,0,6,0,30,3,10,0,13,1,30,7,6,0,13,2,30,6,3,0,9,1,-15,3,1
2,4,19,0,30,3,10,0,13,2,30,5,3,0,8,0,30,4,9,0,13,5,30,6,7,0,13,3,30,8,1,0,9,1,-15,3,1
2,3,25,1,30,4,10,0,14,4,30,6,0,0,6,0,30,7,7,0,14,3,30,4,10,0,14,3,30,6,0,0,6,1,-15,3,1
2,1,27,1,30,4,11,0,15,3,30,2,0,0,2,0,30,6,9,0,15,0,30,7,8,0,15,1,30,4,2,0,6,1,-15,3,1
2,3,27,1,30,4,11,0,15,3,30,2,0,0,2,0,30,6,9,0,15,0,30,7,8,0,15,1,30,4,2,0,6,1,-15,3,1
2,3,29,0,30,9,5,0,14,4,30,10,2,0,12,0,30,6,8,0,14,0,30,1,13,0,14,0,30,9,0,0,9,1,-15,3,1
2,4,29,0,30,9,5,0,14,4,30,10,2,0,12,0,30,6,8,0,14,0,30,1,13,0,14,0,30,9,0,0,9,1,-15,3,1
2,4,31,4,30,8,4,0,12,4,30,8,0,0,8,3,30,8,4,0,12,0,30,3,9,0,12,0,30,4,2,0,6,1,-15,3,1
2,0,47,0,30,2,12,0,14,5,30,4,0,0,4,0,30,6,8,0,14,0,30,2,12,0,14,6,30,7,0,0,7,1,-15,3,1
2,1,47,0,30,2,12,0,14,5,30,4,0,0,4,0,30,6,8,0,14,0,30,2,12,0,14,6,30,7,0,0,7,1,-15,3,1
2,4,47,0,30,2,12,0,14,5,30,4,0,0,4,0,30,6,8,0,14,0,30,2,12,0,14,4,30,7,0,0,7,1,-15,3,1
2,4,8,1,30,7,0,0,7,3,30,2,0,0,2,1,30,7,0,0,7,0,30,2,5,0,7,0,30,3,0,0,3,0,-27,3,0
2,4,11,0,30,1,3,0,4,0,30,0,0,0,0,0,30,2,2,0,4,3,30,3,1,0,4,2,30,1,0,0,1,1,-15,3,1
2,2,17,3,30,9,5,0,14,1,30,6,0,0,6,0,30,10,4,0,14,4,30,6,8,0,14,3,30,4,0,0,4,1,-15,3,1
2,3,17,3,30,9,5,0,14,1,30,6,0,0,6,0,30,10,4,0,14,4,30,6,8,0,14,3,30,4,0,0,4,1,-15,3,1
2,2,19,0,30,4,9,0,13,2,30,7,1,0,8,0,30,7,6,0,13,3,30,8,5,0,13,0,30,7,2,0,9,1,-15,3,1
2,3,19,0,30,4,9,0,13,2,30,7,1,0,8,0,30,7,6,0,13,3,30,8,5,0,13,0,30,7,2,0,9,1,-15,3,1
2,3,23,2,30,6,7,0,13,2,30,6,0,0,6,10,30,11,2,0,13,0,30,5,8,0,13,1,30,6,0,0,6,1,-15,3,1
2,4,23,2,30,6,7,0,13,2,30,6,0,0,6,10,30,11,2,0,13,0,30,5,8,0,13,1,30,6,0,0,6,1,-15,3,1
2,1,27,2,30,3,12,0,15,1,30,1,1,0,2,0,30,6,9,0,15,2,30,5,10,0,15,5,30,6,0,0,6,1,-15,3,1
2,3,27,2,30,3,12,0,15,1,30,1,1,0,2,0,30,6,9,0,15,2,30,5,10,0,15,0,30,6,0,0,6,1,-15,3,1
2,1,5,0,30,3,2,0,5,3,30,2,2,0,4,0,30,2,3,0,5,0,30,1,4,0,5,0,30,1,1,0,2,0,-27,3,0
2,1,13,2,30,7,0,0,7,0,30,4,0,0,4,2,30,6,1,0,7,5,30,6,1,0,7,2,30,4,0,0,4,1,-15,3,1
2,1,17,5,30,10,4,0,14,4,30,6,0,0,6,0,30,4,10,0,14,1,30,6,8,0,14,1,30,4,0,0,4,1,-15,3,1
2,4,17,5,30,10,4,0,14,4,30,6,0,0,6,0,30,4,10,0,14,1,30,6,8,0,14,0,30,4,0,0,4,1,-15,3,1
2,3,23,1,30,8,5,0,13,0,30,6,0,0,6,2,30,13,0,0,13,0,30,6,7,0,13,2,30,6,0,0,6,1,-15,3,1
2,4,23,1,30,8,5,0,13,0,30,6,0,0,6,2,30,13,0,0,13,0,30,6,7,0,13,2,30,6,0,0,6,1,-15,3,1
2,4,25,1,30,7,7,0,14,3,30,6,0,0,6,0,30,7,7,0,14,3,30,4,10,0,14,3,30,5,1,0,6,1,-15,3,1
2,2,27,1,30,3,12,0,15,3,30,2,0,0,2,0,30,7,8,0,15,0,30,6,9,0,15,2,30,6,0,0,6,1,-15,3,1
2,1,4,2,30,7,1,0,8,5,30,4,0,0,4,0,30,1,7,0,8,0,30,8,0,0,8,3,30,3,1,0,4,0,-27,3,0
2,2,17,3,30,9,5,0,14,2,30,6,0,0,6,0,30,7,7,0,14,0,30,5,9,0,14,4,30,4,0,0,4,1,-15,3,1
2,3,23,1,30,6,7,0,13,2,30,6,0,0,6,3,30,11,2,0,13,5,30,6,7,0,13,0,30,5,1,0,6,1,-15,3,1
2,4,23,1,30,6,7,0,13,2,30,6,0,0,6,3,30,11,2,0,13,5,30,6,7,0,13,0,30,5,1,0,6,1,-15,3,1
2,4,25,2,30,10,4,0,14,2,30,6,0,0,6,0,30,7,7,0,14,1,30,5,9,0,14,5,30,5,1,0,6,1,-15,3,1
2,0,27,1,30,4,11,0,15,3,30,2,0,0,2,0,30,6,9,0,15,0,30,6,9,0,15,4,30,6,0,0,6,1,-15,3,1
2,1,27,1,30,4,11,0,15,3,30,2,0,0,2,0,30,6,9,0,15,0,30,6,9,0,15,4,30,6,0,0,6,1,-15,3,1
2,2,27,1,30,4,11,0,15,3,30,2,0,0,2,0,30,6,9,0,15,0,30,6,9,0,15,4,30,6,0,0,6,1,-15,3,1
2,3,27,1,30,4,11,0,15,3,30,2,0,0,2,0,30,6,9,0,15,0,30,6,9,0,15,4,30,6,0,0,6,1,-15,3,1
2,4,31,2,30,8,4,0,12,4,30,8,0,0,8,6,30,9,3,0,12,0,30,3,9,0,12,0,30,3,3,0,6,1,-15,3,1
2,2,5,0,30,2,3,0,5,3,30,0,4,0,4,0,30,0,5,0,5,0,30,1,4,0,5,3,30,2,0,0,2,0,-27,3,0
2,3,5,0,30,2,3,0,5,3,30,0,4,0,4,0,30,0,5,0,5,0,30,1,4,0,5,3,30,2,0,0,2,0,-27,3,0
2,4,5,0,30,2,3,0,5,3,30,0,4,0,4,0,30,0,5,0,5,0,30,1,4,0,5,3,30,2,0,0,2,0,-27,3,0
2,4,6,0,30,5,4,0,9,4,30,2,0,0,2,0,30,2,7,0,9,0,30,5,4,0,9,2,30,5,0,0,5,0,-27,3,0
2,1,19,0,30,1,12,0,13,2,30,6,2,0,8,0,30,9,4,0,13,5,30,4,9,0,13,2,30,8,1,0,9,1,-15,3,1
2,3,19,0,30,1,12,0,13,0,30,6,2,0,8,0,30,9,4,0,13,5,30,4,9,0,13,2,30,8,1,0,9,1,-15,3,1
2,4,19,0,30,1,12,0,13,0,30,6,2,0,8,0,30,9,4,0,13,5,30,4,9,0,13,2,30,8,1,0,9,1,-15,3,1
2,1,21,2,30,7,3,0,10,4,30,4,2,0,6,0,30,3,7,0,10,4,30,5,5,0,10,6,30,4,0,0,4,1,-15,3,1
2,3,25,1,30,8,6,0,14,5,30,6,0,0,6,0,30,3,11,0,14,0,30,6,8,0,14,6,30,6,0,0,6,1,-15,3,1
2,0,27,1,30,2,13,0,15,3,30,2,0,0,2,0,30,2,13,0,15,0,30,9,6,0,15,4,30,6,0,0,6,1,-15,3,1
2,1,27,1,30,2,13,0,15,3,30,2,0,0,2,0,30,2,13,0,15,0,30,9,6,0,15,4,30,6,0,0,6,1,-15,3,1
2,4,27,1,30,2,13,0,15,3,30,2,0,0,2,0,30,2,13,0,15,0,30,9,6,0,15,0,30,6,0,0,6,1,-15,3,1
2,4,29,1,30,10,4,0,14,5,30,12,0,0,12,0,30,4,10,0,14,0,30,1,13,0,14,0,30,5,4,0,9,1,-15,3,1
2,4,9,0,30,4,7,0,11,2,30,6,0,0,6,1,30,9,2,0,11,3,30,4,7,0,11,5,30,4,0,0,4,0,-27,3,0
2,4,13,4,30,7,0,0,7,0,30,4,0,0,4,2,30,6,1,0,7,10,30,5,2,0,7,4,30,4,0,0,4,1,-15,3,1
2,4,23,2,30,6,7,0,13,1,30,6,0,0,6,2,30,10,3,0,13,0,30,6,7,0,13,1,30,6,0,0,6,1,-15,3,1
2,3,25,2,30,5,9,0,14,4,30,6,0,0,6,0,30,10,4,0,14,1,30,5,9,0,14,2,30,5,1,0,6,1,-15,3,1
2,0,27,1,30,5,10,0,15,4,30,1,1,0,2,0,30,7,8,0,15,2,30,5,10,0,15,1,30,5,1,0,6,1,-15,3,1
2,3,27,1,30,5,10,0,15,4,30,1,1,0,2,0,30,7,8,0,15,0,30,5,10,0,15,1,30,5,1,0,6,1,-15,3,1
2,4,27,1,30,5,10,0,15,4,30,1,1,0,2,0,30,7,8,0,15,0,30,5,10,0,15,1,30,5,1,0,6,1,-15,3,1
2,2,5,0,30,2,3,0,5,2,30,3,1,0,4,0,30,3,2,0,5,0,30,1,4,0,5,0,30,0,2,0,2,0,-27,3,0
2,4,8,1,30,6,1,0,7,3,30,2,0,0,2,1,30,5,2,0,7,0,30,4,3,0,7,0,30,3,0,0,3,0,-27,3,0
2,3,11,2,30,7,5,0,12,1,30,4,0,0,4,0,30,6,6,0,12,1,30,5,7,0,12,4,30,4,0,0,4,1,-15,3,1
2,4,11,2,30,7,5,0,12,1,30,4,0,0,4,0,30,6,6,0,12,1,30,5,7,0,12,4,30,4,0,0,4,1,-15,3,1
2,1,17,1,30,7,7,0,14,3,30,6,0,0,6,0,30,4,10,0,14,4,30,5,9,0,14,7,30,4,0,0,4,1,-15,3,1
2,3,17,1,30,7,7,0,14,1,30,6,0,0,6,0,30,4,10,0,14,4,30,5,9,0,14,7,30,4,0,0,4,1,-15,3,1
2,1,19,0,30,3,10,0,13,2,30,4,4,0,8,0,30,9,4,0,13,8,30,4,9,0,13,4,30,9,0,0,9,1,-15,3,1
2,2,19,0,30,3,10,0,13,2,30,4,4,0,8,0,30,9,4,0,13,8,30,4,9,0,13,4,30,9,0,0,9,1,-15,3,1
2,2,25,1,30,6,8,0,14,3,30,6,0,0,6,0,30,9,5,0,14,1,30,5,9,0,14,4,30,5,1,0,6,1,-15,3,1
2,3,25,1,30,6,8,0,14,3,30,6,0,0,6,0,30,9,5,0,14,1,30,5,9,0,14,4,30,5,1,0,6,1,-15,3,1
2,3,27,1,30,5,10,0,15,1,30,1,1,0,2,0,30,7,8,0,15,2,30,7,8,0,15,0,30,6,0,0,6,1,-15,3,1
2,4,29,0,30,4,10,0,14,6,30,12,0,0,12,0,30,5,9,0,14,0,30,0,14,0,14,0,30,9,0,0,9,1,-15,3,1
2,4,6,0,30,5,4,0,9,3,30,2,0,0,2,0,30,3,6,0,9,1,30,3,6,0,9,3,30,5,0,0,5,0,-27,3,0
2,3,12,7,30,4,3,0,7,3,30,5,1,0,6,0,30,2,5,0,7,1,30,7,0,0,7,3,30,1,2,0,3,1,-15,3,1
2,2,17,2,30,8,6,0,14,3,30,6,0,0,6,0,30,6,8,0,14,5,30,5,9,0,14,6,30,4,0,0,4,1,-15,3,1
2,3,17,2,30,8,6,0,14,3,30,6,0,0,6,0,30,6,8,0,14,5,30,5,9,0,14,6,30,4,0,0,4,1,-15,3,1
2,4,17,2,30,8,6,0,14,3,30,6,0,0,6,0,30,6,8,0,14,5,30,5,9,0,14,6,30,4,0,0,4,1,-15,3,1
2,1,19,0,30,3,10,0,13,2,30,4,4,0,8,0,30,4,9,0,13,5,30,6,7,0,13,2,30,9,0,0,9,1,-15,3,1
2,3,19,0,30,3,10,0,13,2,30,4,4,0,8,0,30,4,9,0,13,5,30,6,7,0,13,2,30,9,0,0,9,1,-15,3,1
2,4,19,0,30,3,10,0,13,2,30,4,4,0,8,0,30,4,9,0,13,5,30,6,7,0,13,2,30,9,0,0,9,1,-15,3,1
2,2,23,3,30,5,8,0,13,3,30,6,0,0,6,3,30,13,0,0,13,0,30,6,7,0,13,2,30,5,1,0,6,1,-15,3,1
2,3,23,3,30,5,8,0,13,3,30,6,0,0,6,3,30,13,0,0,13,0,30,6,7,0,13,2,30,5,1,0,6,1,-15,3,1
2,2,25,1,30,9,5,0,14,5,30,6,0,0,6,0,30,6,8,0,14,1,30,5,9,0,14,5,30,5,1,0,6,1,-15,3,1
2,3,25,1,30,9,5,0,14,5,30,6,0,0,6,0,30,6,8,0,14,1,30,5,9,0,14,5,30,5,1,0,6,1,-15,3,1
2,4,25,1,30,9,5,0,14,5,30,6,0,0,6,0,30,6,8,0,14,1,30,5,9,0,14,5,30,5,1,0,6,1,-15,3,1
2,0,41,0,30,5,7,0,12,6,30,8,0,0,8,0,30,8,4,0,12,1,30,5,7,0,12,2,30,5,2,0,7,1,-15,3,1
2,0,5,0,30,0,5,0,5,3,30,2,2,0,4,0,30,0,5,0,5,0,30,4,1,0,5,0,30,0,2,0,2,0,-27,3,0
2,3,5,0,30,0,5,0,5,3,30,2,2,0,4,0,30,0,5,0,5,0,30,4,1,0,5,0,30,0,2,0,2,0,-27,3,0
2,3,8,2,30,7,0,0,7,4,30,2,0,0,2,2,30,4,3,0,7,0,30,7,0,0,7,4,30,3,0,0,3,0,-27,3,0
2,3,15,0,30,4,9,0,13,0,30,6,0,0,6,0,30,5,8,0,13,1,30,2,11,0,13,2,30,7,2,0,9,1,-15,3,1
2,4,15,0,30,4,9,0,13,0,30,6,0,0,6,0,30,5,8,0,13,1,30,2,11,0,13,2,30,7,2,0,9,1,-15,3,1
2,3,17,3,30,9,5,0,14,2,30,6,0,0,6,0,30,7,7,0,14,1,30,7,7,0,14,5,30,4,0,0,4,1,-15,3,1
2,4,17,3,30,9,5,0,14,2,30,6,0,0,6,0,30,7,7,0,14,1,30,7,7,0,14,5,30,4,0,0,4,1,-15,3,1
2,1,19,0,30,3,10,0,13,2,30,4,4,0,8,0,30,6,7,0,13,4,30,4,9,0,13,2,30,9,0,0,9,1,-15,3,1
2,3,19,0,30,3,10,0,13,2,30,4,4,0,8,0,30,6,7,0,13,4,30,4,9,0,13,2,30,9,0,0,9,1,-15,3,1
2,1,25,1,30,6,8,0,14,5,30,6,0,0,6,0,30,3,11,0,14,1,30,5,9,0,14,4,30,5,1,0,6,1,-15,3,1
2,0,26,4,30,8,1,0,9,5,30,4,0,0,4,2,30,1,8,0,9,0,30,2,7,0,9,6,30,3,0,0,3,1,-15,3,1
2,2,26,4,30,8,1,0,9,5,30,4,0,0,4,2,30,1,8,0,9,0,30,2,7,0,9,6,30,3,0,0,3,1,-15,3,1
2,3,26,4,30,8,1,0,9,5,30,4,0,0,4,2,30,1,8,0,9,0,30,2,7,0,9,6,30,3,0,0,3,1,-15,3,1
2,2,27,1,30,5,10,0,15,4,30,2,0,0,2,0,30,3,12,0,15,3,30,7,8,0,15,1,30,6,0,0,6,1,-15,3,1
2,3,27,1,30,5,10,0,15,4,30,2,0,0,2,0,30,3,12,0,15,3,30,7,8,0,15,1,30,6,0,0,6,1,-15,3,1
2,3,29,0,30,8,6,0,14,5,30,12,0,0,12,2,30,5,9,0,14,0,30,1,13,0,14,0,30,6,3,0,9,1,-15,3,1
2,3,4,2,30,4,4,0,8,4,30,4,0,0,4,0,30,3,5,0,8,1,30,6,2,0,8,4,30,4,0,0,4,0,-27,3,0
2,3,8,1,30,7,0,0,7,4,30,2,0,0,2,4,30,4,3,0,7,1,30,7,0,0,7,4,30,3,0,0,3,0,-27,3,0
2,2,11,3,30,4,8,0,12,2,30,4,0,0,4,0,30,5,7,0,12,7,30,5,7,0,12,3,30,4,0,0,4,1,-15,3,1
2,4,11,3,30,4,8,0,12,2,30,4,0,0,4,0,30,5,7,0,12,7,30,5,7,0,12,3,30,4,0,0,4,1,-15,3,1
2,1,13,2,30,7,0,0,7,0,30,4,0,0,4,2,30,5,2,0,7,6,30,5,2,0,7,1,30,4,0,0,4,1,-15,3,1
2,3,13,2,30,7,0,0,7,0,30,4,0,0,4,2,30,5,2,0,7,6,30,5,2,0,7,1,30,4,0,0,4,1,-15,3,1
2,3,15,1,30,4,9,0,13,2,30,6,0,0,6,0,30,3,10,0,13,2,30,8,5,0,13,2,30,5,4,0,9,1,-15,3,1
2,3,17,5,30,9,5,0,14,3,30,6,0,0,6,0,30,8,6,0,14,1,30,7,7,0,14,0,30,4,0,0,4,1,-15,3,1
2,3,19,0,30,8,5,0,13,0,30,4,4,0,8,0,30,9,4,0,13,0,30,6,7,0,13,1,30,7,2,0,9,1,-15,3,1
2,4,19,0,30,8,5,0,13,0,30,4,4,0,8,0,30,9,4,0,13,0,30,6,7,0,13,1,30,7,2,0,9,1,-15,3,1
2,1,21,2,30,7,3,0,10,4,30,6,0,0,6,1,30,3,7,0,10,5,30,5,5,0,10,5,30,4,0,0,4,1,-15,3,1
2,3,23,0,30,4,9,0,13,4,30,6,0,0,6,4,30,12,1,0,13,0,30,5,8,0,13,4,30,6,0,0,6,1,-15,3,1
2,1,25,1,30,7,7,0,14,3,30,6,0,0,6,0,30,6,8,0,14,1,30,9,5,0,14,4,30,5,1,0,6,1,-15,3,1
2,2,25,1,30,7,7,0,14,3,30,6,0,0,6,0,30,6,8,0,14,1,30,9,5,0,14,4,30,5,1,0,6,1,-15,3,1
2,4,25,1,30,7,7,0,14,3,30,6,0,0,6,0,30,6,8,0,14,1,30,9,5,0,14,4,30,5,1,0,6,1,-15,3,1
2,0,27,1,30,4,11,0,15,4,30,2,0,0,2,0,30,5,10,0,15,3,30,7,8,0,15,2,30,6,0,0,6,1,-15,3,1
2,3,27,1,30,4,11,0,15,4,30,2,0,0,2,0,30,5,10,0,15,3,30,7,8,0,15,2,30,6,0,0,6,1,-15,3,1
2,4,27,1,30,4,11,0,15,4,30,2,0,0,2,0,30,5,10,0,15,3,30,7,8,0,15,2,30,6,0,0,6,1,-15,3,1
2,2,11,0,30,1,3,0,4,0,30,0,0,0,0,0,30,2,2,0,4,2,30,4,0,0,4,1,30,1,0,0,1,1,-15,3,1
2,3,11,0,30,1,3,0,4,0,30,0,0,0,0,0,30,2,2,0,4,2,30,4,0,0,4,1,30,1,0,0,1,1,-15,3,1
2,2,17,5,30,7,7,0,14,2,30,6,0,0,6,0,30,7,7,0,14,3,30,5,9,0,14,4,30,4,0,0,4,1,-15,3,1
2,4,17,5,30,7,7,0,14,2,30,6,0,0,6,0,30,7,7,0,14,3,30,5,9,0,14,4,30,4,0,0,4,1,-15,3,1
2,4,23,2,30,8,5,0,13,1,30,6,0,0,6,5,30,12,1,0,13,0,30,5,8,0,13,0,30,5,1,0,6,1,-15,3,1
2,3,25,1,30,7,7,0,14,4,30,6,0,0,6,0,30,10,4,0,14,1,30,5,9,0,14,0,30,6,0,0,6,1,-15,3,1
2,1,26,1,30,7,2,0,9,4,30,4,0,0,4,6,30,0,9,0,9,0,30,1,8,0,9,4,30,2,1,0,3,1,-15,3,1
2,2,26,1,30,7,2,0,9,4,30,4,0,0,4,6,30,0,9,0,9,0,30,1,8,0,9,4,30,2,1,0,3,1,-15,3,1
2,3,26,1,30,7,2,0,9,4,30,4,0,0,4,6,30,0,9,0,9,0,30,1,8,0,9,4,30,2,1,0,3,1,-15,3,1
2,4,26,1,30,7,2,0,9,4,30,4,0,0,4,6,30,0,9,0,9,0,30,1,8,0,9,4,30,2,1,0,3,1,-15,3,1
2,0,27,1,30,5,10,0,15,2,30,1,1,0,2,0,30,7,8,0,15,2,30,4,11,0,15,2,30,4,2,0,6,1,-15,3,1
2,1,27,1,30,5,10,0,15,2,30,1,1,0,2,0,30,7,8,0,15,2,30,4,11,0,15,2,30,4,2,0,6,1,-15,3,1
2,3,27,1,30,5,10,0,15,2,30,1,1,0,2,0,30,7,8,0,15,2,30,4,11,0,15,2,30,4,2,0,6,1,-15,3,1
2,1,4,2,30,6,2,0,8,5,30,4,0,0,4,0,30,1,7,0,8,0,30,7,1,0,8,1,30,4,0,0,4,0,-27,3,0
2,4,8,1,30,7,0,0,7,3,30,2,0,0,2,3,30,2,5,0,7,0,30,6,1,0,7,1,30,3,0,0,3,0,-27,3,0
2,3,23,3,30,3,10,0,13,4,30,6,0,0,6,4,30,10,3,0,13,0,30,6,7,0,13,3,30,6,0,0,6,1,-15,3,1
2,0,27,1,30,6,9,0,15,4,30,1,1,0,2,0,30,5,10,0,15,2,30,7,8,0,15,3,30,6,0,0,6,1,-15,3,1
2,1,27,1,30,6,9,0,15,4,30,1,1,0,2,0,30,5,10,0,15,2,30,7,8,0,15,3,30,6,0,0,6,1,-15,3,1
2,2,31,5,30,3,9,0,12,6,30,8,0,0,8,6,30,9,3,0,12,0,30,3,9,0,12,0,30,6,0,0,6,1,-15,3,1
2,2,11,0,30,6,6,0,12,1,30,4,0,0,4,0,30,7,5,0,12,4,30,8,4,0,12,7,30,4,0,0,4,1,-15,3,1
2,3,11,0,30,6,6,0,12,1,30,4,0,0,4,0,30,7,5,0,12,4,30,8,4,0,12,7,30,4,0,0,4,1,-15,3,1
2,1,13,2,30,7,0,0,7,1,30,4,0,0,4,1,30,7,0,0,7,10,30,6,1,0,7,0,30,4,0,0,4,1,-15,3,1
2,4,13,2,30,7,0,0,7,1,30,4,0,0,4,1,30,7,0,0,7,10,30,6,1,0,7,0,30,4,0,0,4,1,-15,3,1
2,2,17,3,30,9,5,0,14,3,30,6,0,0,6,0,30,7,7,0,14,6,30,5,9,0,14,5,30,4,0,0,4,1,-15,3,1
2,3,25,0,30,11,3,0,14,4,30,6,0,0,6,0,30,5,9,0,14,1,30,5,9,0,14,0,30,5,1,0,6,1,-15,3,1
2,3,27,1,30,4,11,0,15,2,30,1,1,0,2,0,30,8,7,0,15,3,30,5,10,0,15,3,30,6,0,0,6,1,-15,3,1
2,4,27,1,30,4,11,0,15,2,30,1,1,0,2,0,30,8,7,0,15,3,30,5,10,0,15,3,30,6,0,0,6,1,-15,3,1
2,1,31,1,30,7,5,0,12,5,30,8,0,0,8,6,30,7,5,0,12,0,30,6,6,0,12,1,30,6,0,0,6,1,-15,3,1
2,3,31,1,30,7,5,0,12,5,30,8,0,0,8,6,30,7,5,0,12,0,30,6,6,0,12,1,30,6,0,0,6,1,-15,3,1
2,4,31,1,30,7,5,0,12,5,30,8,0,0,8,6,30,7,5,0,12,0,30,6,6,0,12,1,30,6,0,0,6,1,-15,3,1
2,3,35,2,30,13,0,0,13,4,30,2,0,0,2,5,30,2,11,0,13,0,30,1,12,0,13,4,30,7,1,0,8,1,-15,3,1
2,1,13,3,30,6,1,0,7,0,30,4,0,0,4,2,30,6,1,0,7,7,30,5,2,0,7,2,30,4,0,0,4,1,-15,3,1
2,1,17,4,30,10,4,0,14,3,30,6,0,0,6,1,30,6,8,0,14,1,30,8,6,0,14,5,30,4,0,0,4,1,-15,3,1
2,4,17,4,30,10,4,0,14,3,30,6,0,0,6,1,30,6,8,0,14,1,30,8,6,0,14,5,30,4,0,0,4,1,-15,3,1
2,2,19,1,30,6,7,0,13,1,30,5,3,0,8,0,30,6,7,0,13,0,30,4,9,0,13,0,30,8,1,0,9,1,-15,3,1
2,3,19,1,30,6,7,0,13,1,30,5,3,0,8,0,30,6,7,0,13,0,30,4,9,0,13,0,30,8,1,0,9,1,-15,3,1
2,3,23,3,30,3,10,0,13,4,30,6,0,0,6,6,30,8,5,0,13,0,30,4,9,0,13,1,30,6,0,0,6,1,-15,3,1
2,4,23,3,30,3,10,0,13,4,30,6,0,0,6,6,30,8,5,0,13,0,30,4,9,0,13,1,30,6,0,0,6,1,-15,3,1
2,1,25,0,30,9,5,0,14,1,30,6,0,0,6,0,30,11,3,0,14,1,30,5,9,0,14,4,30,5,1,0,6,1,-15,3,1
2,3,25,0,30,9,5,0,14,1,30,6,0,0,6,0,30,11,3,0,14,1,30,5,9,0,14,4,30,5,1,0,6,1,-15,3,1
2,4,25,0,30,9,5,0,14,1,30,6,0,0,6,0,30,11,3,0,14,1,30,5,9,0,14,4,30,5,1,0,6,1,-15,3,1
2,1,27,1,30,4,11,0,15,3,30,2,0,0,2,0,30,5,10,0,15,3,30,6,9,0,15,7,30,6,0,0,6,1,-15,3,1
2,2,27,1,30,4,11,0,15,3,30,2,0,0,2,0,30,5,10,0,15,3,30,6,9,0,15,7,30,6,0,0,6,1,-15,3,1
2,0,33,3,30,5,6,0,11,5,30,4,0,0,4,5,30,9,2,0,11,1,30,4,7,0,11,3,30,4,0,0,4,1,-15,3,1
2,4,35,1,30,12,1,0,13,6,30,2,0,0,2,1,30,2,11,0,13,0,30,3,10,0,13,2,30,8,0,0,8,1,-15,3,1
2,3,37,1,30,6,5,0,11,6,30,8,0,0,8,3,30,7,4,0,11,2,30,3,8,0,11,3,30,6,0,0,6,1,-15,3,1
2,4,38,0,30,2,8,0,10,6,30,6,0,0,6,0,30,5,5,0,10,0,30,4,6,0,10,3,30,5,1,0,6,1,-15,3,1
2,2,45,0,30,3,10,0,13,7,30,10,0,0,10,0,30,10,3,0,13,0,30,4,9,0,13,5,30,5,0,0,5,1,-15,3,1
2,1,5,4,30,1,4,0,5,3,30,1,3,0,4,0,30,1,4,0,5,0,30,1,4,0,5,0,30,0,2,0,2,0,-27,3,0
2,2,5,4,30,1,4,0,5,3,30,1,3,0,4,0,30,1,4,0,5,0,30,1,4,0,5,0,30,0,2,0,2,0,-27,3,0
2,1,13,3,30,3,0,0,3,1,30,2,0,0,2,0,30,2,1,0,3,5,30,2,1,0,3,2,30,2,0,0,2,1,-15,3,1
2,3,13,0,30,7,0,0,7,0,30,4,0,0,4,2,30,5,2,0,7,6,30,6,1,0,7,3,30,4,0,0,4,1,-15,3,1
2,2,17,3,30,9,5,0,14,3,30,6,0,0,6,0,30,6,8,0,14,1,30,5,9,0,14,0,30,3,1,0,4,1,-15,3,1
2,3,17,3,30,9,5,0,14,3,30,6,0,0,6,0,30,6,8,0,14,1,30,5,9,0,14,0,30,3,1,0,4,1,-15,3,1
2,0,21,3,30,6,4,0,10,4,30,6,0,0,6,1,30,3,7,0,10,4,30,5,5,0,10,4,30,4,0,0,4,1,-15,3,1
2,1,21,3,30,6,4,0,10,4,30,6,0,0,6,1,30,3,7,0,10,4,30,5,5,0,10,4,30,4,0,0,4,1,-15,3,1
2,2,21,3,30,6,4,0,10,4,30,6,0,0,6,1,30,3,7,0,10,4,30,5,5,0,10,4,30,4,0,0,4,1,-15,3,1
2,3,21,3,30,6,4,0,10,4,30,6,0,0,6,1,30,3,7,0,10,4,30,5,5,0,10,4,30,4,0,0,4,1,-15,3,1
2,4,23,2,30,6,7,0,13,3,30,6,0,0,6,4,30,12,1,0,13,0,30,5,8,0,13,0,30,6,0,0,6,1,-15,3,1
2,3,25,1,30,9,5,0,14,2,30,6,0,0,6,0,30,9,5,0,14,1,30,5,9,0,14,4,30,5,1,0,6,1,-15,3,1
2,0,27,1,30,7,8,0,15,5,30,2,0,0,2,8,30,6,9,0,15,0,30,4,11,0,15,1,30,4,2,0,6,1,-15,3,1
2,1,27,1,30,7,8,0,15,5,30,2,0,0,2,8,30,6,9,0,15,0,30,4,11,0,15,1,30,4,2,0,6,1,-15,3,1
2,0,31,3,30,2,10,0,12,7,30,8,0,0,8,3,30,4,8,0,12,0,30,7,5,0,12,4,30,6,0,0,6,1,-15,3,1
2,3,31,3,30,2,10,0,12,7,30,8,0,0,8,3,30,4,8,0,12,0,30,7,5,0,12,4,30,6,0,0,6,1,-15,3,1
2,2,33,2,30,4,7,0,11,5,30,4,0,0,4,3,30,11,0,0,11,0,30,3,8,0,11,7,30,4,0,0,4,1,-15,3,1
2,1,4,4,30,8,0,0,8,4,30,4,0,0,4,0,30,2,6,0,8,0,30,4,4,0,8,3,30,4,0,0,4,0,-27,3,0
2,3,11,2,30,4,8,0,12,1,30,4,0,0,4,0,30,7,5,0,12,2,30,8,4,0,12,6,30,4,0,0,4,1,-15,3,1
2,1,27,1,30,4,11,0,15,3,30,1,1,0,2,0,30,6,9,0,15,2,30,5,10,0,15,2,30,6,0,0,6,1,-15,3,1
2,4,27,1,30,4,11,0,15,3,30,1,1,0,2,0,30,6,9,0,15,2,30,5,10,0,15,2,30,6,0,0,6,1,-15,3,1
2,2,29,0,30,6,8,0,14,5,30,10,2,0,12,0,30,10,4,0,14,0,30,0,14,0,14,0,30,8,1,0,9,1,-15,3,1
2,0,31,3,30,7,5,0,12,4,30,8,0,0,8,3,30,10,2,0,12,0,30,3,9,0,12,2,30,4,2,0,6,1,-15,3,1
2,1,31,3,30,7,5,0,12,4,30,8,0,0,8,3,30,10,2,0,12,0,30,3,9,0,12,2,30,4,2,0,6,1,-15,3,1
2,2,31,3,30,7,5,0,12,4,30,8,0,0,8,3,30,10,2,0,12,0,30,3,9,0,12,2,30,4,2,0,6,1,-15,3,1
2,3,31,3,30,7,5,0,12,4,30,8,0,0,8,3,30,10,2,0,12,0,30,3,9,0,12,2,30,4,2,0,6,1,-15,3,1
2,3,32,0,30,6,3,0,9,4,30,2,0,0,2,0,30,7,2,0,9,1,30,2,7,0,9,4,30,2,0,0,2,1,-15,3,1
2,3,35,0,30,8,5,0,13,4,30,2,0,0,2,1,30,6,7,0,13,2,30,4,9,0,13,3,30,8,0,0,8,1,-15,3,1
2,4,35,0,30,8,5,0,13,4,30,2,0,0,2,1,30,6,7,0,13,2,30,4,9,0,13,3,30,8,0,0,8,1,-15,3,1
2,2,4,2,30,7,1,0,8,4,30,4,0,0,4,0,30,2,6,0,8,0,30,3,5,0,8,3,30,4,0,0,4,0,-27,3,0
2,4,4,2,30,7,1,0,8,4,30,4,0,0,4,0,30,2,6,0,8,0,30,3,5,0,8,3,30,4,0,0,4,0,-27,3,0
2,3,13,1,30,3,0,0,3,0,30,2,0,0,2,0,30,3,0,0,3,6,30,3,0,0,3,3,30,2,0,0,2,1,-15,3,1
2,1,13,1,30,5,2,0,7,0,30,4,0,0,4,5,30,6,1,0,7,10,30,7,0,0,7,3,30,4,0,0,4,1,-15,3,1
2,2,13,1,30,5,2,0,7,0,30,4,0,0,4,5,30,6,1,0,7,10,30,7,0,0,7,3,30,4,0,0,4,1,-15,3,1
2,4,13,1,30,5,2,0,7,0,30,4,0,0,4,5,30,6,1,0,7,10,30,7,0,0,7,3,30,4,0,0,4,1,-15,3,1
2,3,15,0,30,6,7,0,13,0,30,6,0,0,6,0,30,3,10,0,13,1,30,2,11,0,13,2,30,9,0,0,9,1,-15,3,1
2,4,15,0,30,6,7,0,13,0,30,6,0,0,6,0,30,3,10,0,13,1,30,2,11,0,13,2,30,9,0,0,9,1,-15,3,1
2,2,19,0,30,4,9,0,13,2,30,7,1,0,8,0,30,5,8,0,13,1,30,3,10,0,13,0,30,8,1,0,9,1,-15,3,1
2,4,19,0,30,4,9,0,13,2,30,7,1,0,8,0,30,5,8,0,13,1,30,3,10,0,13,0,30,8,1,0,9,1,-15,3,1
2,4,23,1,30,6,7,0,13,3,30,6,0,0,6,7,30,12,1,0,13,0,30,5,8,0,13,2,30,6,0,0,6,1,-15,3,1
2,1,25,2,30,6,8,0,14,3,30,6,0,0,6,0,30,6,8,0,14,1,30,7,7,0,14,5,30,5,1,0,6,1,-15,3,1
2,3,25,2,30,6,8,0,14,3,30,6,0,0,6,0,30,6,8,0,14,1,30,7,7,0,14,5,30,5,1,0,6,1,-15,3,1
2,1,27,1,30,5,10,0,15,3,30,1,1,0,2,0,30,6,9,0,15,0,30,6,9,0,15,4,30,6,0,0,6,1,-15,3,1
2,2,27,1,30,5,10,0,15,3,30,1,1,0,2,0,30,6,9,0,15,0,30,6,9,0,15,4,30,6,0,0,6,1,-15,3,1
2,4,29,0,30,7,7,0,14,5,30,12,0,0,12,0,30,3,11,0,14,0,30,0,14,0,14,0,30,7,2,0,9,1,-15,3,1
2,3,31,4,30,8,4,0,12,3,30,8,0,0,8,3,30,12,0,0,12,0,30,3,9,0,12,0,30,2,4,0,6,1,-15,3,1
2,4,31,4,30,8,4,0,12,3,30,8,0,0,8,3,30,12,0,0,12,0,30,3,9,0,12,0,30,2,4,0,6,1,-15,3,1
2,4,43,0,30,9,5,0,14,7,30,6,0,0,6,0,30,6,8,0,14,0,30,1,13,0,14,5,30,5,0,0,5,1,-15,3,1
2,2,47,0,30,0,14,0,14,6,30,4,0,0,4,0,30,10,4,0,14,0,30,2,12,0,14,4,30,7,0,0,7,1,-15,3,1
2,3,47,0,30,0,14,0,14,6,30,4,0,0,4,0,30,10,4,0,14,0,30,2,12,0,14,4,30,7,0,0,7,1,-15,3,1
2,1,11,2,30,5,7,0,12,1,30,4,0,0,4,0,30,6,6,0,12,7,30,5,7,0,12,6,30,4,0,0,4,1,-15,3,1
2,2,13,3,30,7,0,0,7,0,30,4,0,0,4,0,30,6,1,0,7,10,30,6,1,0,7,4,30,4,0,0,4,1,-15,3,1
2,4,13,3,30,7,0,0,7,0,30,4,0,0,4,0,30,6,1,0,7,10,30,6,1,0,7,4,30,4,0,0,4,1,-15,3,1
2,2,17,3,30,10,4,0,14,2,30,6,0,0,6,0,30,7,7,0,14,2,30,5,9,0,14,4,30,4,0,0,4,1,-15,3,1
2,2,23,1,30,5,8,0,13,3,30,6,0,0,6,5,30,13,0,0,13,0,30,5,8,0,13,2,30,5,1,0,6,1,-15,3,1
2,4,23,1,30,5,8,0,13,3,30,6,0,0,6,5,30,13,0,0,13,0,30,5,8,0,13,2,30,5,1,0,6,1,-15,3,1
2,4,25,0,30,8,6,0,14,3,30,6,0,0,6,0,30,4,10,0,14,1,30,7,7,0,14,5,30,6,0,0,6,1,-15,3,1
2,1,27,1,30,4,11,0,15,3,30,2,0,0,2,0,30,8,7,0,15,2,30,4,11,0,15,1,30,6,0,0,6,1,-15,3,1
2,2,27,1,30,4,11,0,15,3,30,2,0,0,2,0,30,8,7,0,15,2,30,4,11,0,15,1,30,6,0,0,6,1,-15,3,1
2,4,27,1,30,4,11,0,15,3,30,2,0,0,2,0,30,8,7,0,15,2,30,4,11,0,15,1,30,6,0,0,6,1,-15,3,1
2,3,29,0,30,8,6,0,14,6,30,11,1,0,12,0,30,4,10,0,14,0,30,1,13,0,14,1,30,9,0,0,9,1,-15,3,1
2,4,29,0,30,8,6,0,14,6,30,11,1,0,12,0,30,4,10,0,14,0,30,1,13,0,14,1,30,9,0,0,9,1,-15,3,1
2,3,35,0,30,7,6,0,13,5,30,2,0,0,2,0,30,2,11,0,13,3,30,3,10,0,13,7,30,8,0,0,8,1,-15,3,1
2,3,2,0,30,8,2,0,10,3,30,3,1,0,4,0,30,3,7,0,10,0,30,5,5,0,10,1,30,4,4,0,8,0,-27,3,0
2,0,4,2,30,4,4,0,8,4,30,4,0,0,4,0,30,2,6,0,8,0,30,5,3,0,8,3,30,3,1,0,4,0,-27,3,0
2,4,4,2,30,4,4,0,8,4,30,4,0,0,4,0,30,2,6,0,8,0,30,5,3,0,8,3,30,3,1,0,4,0,-27,3,0
2,4,11,0,30,3,9,0,12,1,30,4,0,0,4,0,30,6,6,0,12,8,30,8,4,0,12,6,30,4,0,0,4,1,-15,3,1
2,2,17,5,30,8,6,0,14,4,30,6,0,0,6,0,30,3,11,0,14,1,30,5,9,0,14,2,30,4,0,0,4,1,-15,3,1
2,3,17,5,30,8,6,0,14,4,30,6,0,0,6,0,30,3,11,0,14,1,30,5,9,0,14,2,30,4,0,0,4,1,-15,3,1
2,0,19,0,30,3,10,0,13,1,30,5,3,0,8,0,30,6,7,0,13,8,30,7,6,0,13,0,30,8,1,0,9,1,-15,3,1
2,3,25,1,30,4,10,0,14,4,30,6,0,0,6,0,30,8,6,0,14,1,30,5,9,0,14,4,30,6,0,0,6,1,-15,3,1
2,1,27,1,30,4,11,0,15,4,30,1,1,0,2,0,30,2,13,0,15,1,30,5,10,0,15,0,30,6,0,0,6,1,-15,3,1
2,4,27,1,30,4,11,0,15,4,30,1,1,0,2,0,30,2,13,0,15,1,30,5,10,0,15,0,30,6,0,0,6,1,-15,3,1
2,2,37,0,30,6,5,0,11,4,30,6,2,0,8,0,30,11,0,0,11,5,30,3,8,0,11,0,30,6,0,0,6,1,-15,3,1
2,3,37,0,30,6,5,0,11,4,30,6,2,0,8,0,30,11,0,0,11,5,30,3,8,0,11,0,30,6,0,0,6,1,-15,3,1
2,1,17,3,30,9,5,0,14,3,30,6,0,0,6,0,30,7,7,0,14,5,30,6,8,0,14,5,30,4,0,0,4,1,-15,3,1
2,3,17,3,30,9,5,0,14,3,30,6,0,0,6,0,30,7,7,0,14,5,30,6,8,0,14,5,30,4,0,0,4,1,-15,3,1
2,3,19,0,30,5,8,0,13,1,30,6,2,0,8,0,30,4,9,0,13,0,30,4,9,0,13,1,30,8,1,0,9,1,-15,3,1
2,2,31,3,30,9,3,0,12,3,30,8,0,0,8,3,30,12,0,0,12,0,30,3,9,0,12,1,30,2,4,0,6,1,-15,3,1
2,3,7,0,30,3,1,0,4,2,30,2,0,0,2,0,30,1,3,0,4,0,30,1,3,0,4,2,30,2,0,0,2,0,-27,3,0
2,3,17,5,30,12,2,0,14,3,30,6,0,0,6,0,30,5,9,0,14,0,30,4,10,0,14,1,30,4,0,0,4,1,-15,3,1
2,1,19,0,30,3,10,0,13,1,30,6,2,0,8,0,30,4,9,0,13,1,30,7,6,0,13,0,30,8,1,0,9,1,-15,3,1
2,3,19,0,30,3,10,0,13,1,30,6,2,0,8,0,30,4,9,0,13,1,30,7,6,0,13,0,30,8,1,0,9,1,-15,3,1
2,3,23,1,30,6,7,0,13,1,30,6,0,0,6,5,30,13,0,0,13,0,30,5,8,0,13,2,30,5,1,0,6,1,-15,3,1
2,4,23,1,30,6,7,0,13,1,30,6,0,0,6,5,30,13,0,0,13,0,30,5,8,0,13,2,30,5,1,0,6,1,-15,3,1
2,0,25,1,30,3,11,0,14,4,30,6,0,0,6,0,30,8,6,0,14,1,30,5,9,0,14,5,30,6,0,0,6,1,-15,3,1
2,2,25,1,30,3,11,0,14,4,30,6,0,0,6,0,30,8,6,0,14,1,30,5,9,0,14,5,30,6,0,0,6,1,-15,3,1
2,1,33,5,30,7,4,0,11,4,30,4,0,0,4,4,30,10,1,0,11,0,30,3,8,0,11,5,30,4,0,0,4,1,-15,3,1
2,2,33,5,30,7,4,0,11,4,30,4,0,0,4,4,30,10,1,0,11,0,30,3,8,0,11,5,30,4,0,0,4,1,-15,3,1
2,2,13,2,30,6,1,0,7,0,30,4,0,0,4,2,30,6,1,0,7,14,30,6,1,0,7,4,30,4,0,0,4,1,-15,3,1
2,3,17,4,30,12,2,0,14,2,30,6,0,0,6,0,30,5,9,0,14,1,30,3,11,0,14,0,30,4,0,0,4,1,-15,3,1
2,1,27,3,30,8,7,0,15,2,30,2,0,0,2,0,30,6,9,0,15,0,30,4,11,0,15,1,30,3,3,0,6,1,-15,3,1
2,2,27,3,30,8,7,0,15,2,30,2,0,0,2,0,30,6,9,0,15,0,30,4,11,0,15,1,30,3,3,0,6,1,-15,3,1
2,4,31,2,30,6,6,0,12,4,30,8,0,0,8,0,30,11,1,0,12,0,30,3,9,0,12,1,30,5,1,0,6,1,-15,3,1
2,2,4,0,30,4,4,0,8,4,30,4,0,0,4,1,30,2,6,0,8,3,30,6,2,0,8,2,30,4,0,0,4,0,-27,3,0
2,2,17,1,30,7,7,0,14,2,30,6,0,0,6,0,30,6,8,0,14,1,30,6,8,0,14,5,30,4,0,0,4,1,-15,3,1
2,4,23,1,30,5,8,0,13,1,30,6,0,0,6,8,30,12,1,0,13,0,30,5,8,0,13,3,30,5,1,0,6,1,-15,3,1
2,2,25,2,30,6,8,0,14,2,30,6,0,0,6,0,30,11,3,0,14,0,30,5,9,0,14,4,30,5,1,0,6,1,-15,3,1
2,0,5,0,30,2,3,0,5,3,30,1,3,0,4,0,30,1,4,0,5,0,30,2,3,0,5,0,30,1,1,0,2,0,-27,3,0
2,3,5,0,30,2,3,0,5,3,30,1,3,0,4,0,30,1,4,0,5,0,30,2,3,0,5,0,30,1,1,0,2,0,-27,3,0
2,4,5,0,30,2,3,0,5,3,30,1,3,0,4,0,30,1,4,0,5,0,30,2,3,0,5,0,30,1,1,0,2,0,-27,3,0
2,4,7,0,30,7,2,0,9,3,30,4,0,0,4,0,30,5,4,0,9,4,30,3,6,0,9,0,30,5,1,0,6,0,-27,3,0
2,4,8,0,30,7,0,0,7,4,30,2,0,0,2,4,30,3,4,0,7,0,30,4,3,0,7,1,30,3,0,0,3,0,-27,3,0
2,3,11,1,30,6,6,0,12,2,30,4,0,0,4,0,30,5,7,0,12,2,30,6,6,0,12,1,30,4,0,0,4,1,-15,3,1
2,2,13,3,30,5,2,0,7,0,30,4,0,0,4,6,30,6,1,0,7,6,30,5,2,0,7,0,30,4,0,0,4,1,-15,3,1
2,3,19,1,30,5,8,0,13,1,30,7,1,0,8,0,30,8,5,0,13,1,30,7,6,0,13,1,30,8,1,0,9,1,-15,3,1
2,4,19,1,30,5,8,0,13,1,30,7,1,0,8,0,30,8,5,0,13,1,30,7,6,0,13,1,30,8,1,0,9,1,-15,3,1
2,3,25,0,30,9,5,0,14,3,30,6,0,0,6,0,30,9,5,0,14,1,30,12,2,0,14,3,30,5,1,0,6,1,-15,3,1
2,4,25,0,30,9,5,0,14,3,30,6,0,0,6,0,30,9,5,0,14,1,30,12,2,0,14,3,30,5,1,0,6,1,-15,3,1
2,0,27,1,30,6,9,0,15,3,30,1,1,0,2,2,30,6,9,0,15,2,30,6,9,0,15,3,30,6,0,0,6,1,-15,3,1
2,3,27,1,30,6,9,0,15,3,30,1,1,0,2,2,30,6,9,0,15,2,30,6,9,0,15,1,30,6,0,0,6,1,-15,3,1
2,4,32,0,30,6,3,0,9,4,30,2,0,0,2,0,30,8,1,0,9,1,30,3,6,0,9,5,30,2,0,0,2,1,-15,3,1
2,3,4,2,30,5,3,0,8,5,30,4,0,0,4,1,30,3,5,0,8,0,30,8,0,0,8,1,30,4,0,0,4,0,-27,3,0
2,3,8,4,30,7,0,0,7,3,30,2,0,0,2,0,30,6,1,0,7,0,30,6,1,0,7,0,30,3,0,0,3,0,-27,3,0
2,4,8,4,30,7,0,0,7,3,30,2,0,0,2,0,30,6,1,0,7,0,30,6,1,0,7,0,30,3,0,0,3,0,-27,3,0
2,1,17,5,30,11,3,0,14,3,30,6,0,0,6,0,30,6,8,0,14,1,30,8,6,0,14,1,30,2,2,0,4,1,-15,3,1
2,2,17,5,30,11,3,0,14,3,30,6,0,0,6,0,30,6,8,0,14,1,30,8,6,0,14,1,30,2,2,0,4,1,-15,3,1
2,3,21,0,30,5,5,0,10,3,30,5,1,0,6,1,30,4,6,0,10,2,30,5,5,0,10,4,30,4,0,0,4,1,-15,3,1
2,3,25,1,30,11,3,0,14,3,30,6,0,0,6,0,30,10,4,0,14,0,30,5,9,0,14,3,30,5,1,0,6,1,-15,3,1
2,3,45,0,30,9,4,0,13,10,30,10,0,0,10,0,30,0,13,0,13,0,30,4,9,0,13,8,30,5,0,0,5,1,-15,3,1
2,3,3,0,30,1,3,0,4,2,30,4,0,0,4,1,30,3,1,0,4,2,30,1,3,0,4,0,30,1,2,0,3,0,-27,3,0
2,2,17,2,30,9,5,0,14,2,30,6,0,0,6,0,30,7,7,0,14,1,30,5,9,0,14,4,30,4,0,0,4,1,-15,3,1
2,3,17,2,30,9,5,0,14,2,30,6,0,0,6,0,30,7,7,0,14,1,30,5,9,0,14,4,30,4,0,0,4,1,-15,3,1
2,3,23,2,30,4,9,0,13,0,30,6,0,0,6,4,30,12,1,0,13,0,30,6,7,0,13,3,30,6,0,0,6,1,-15,3,1
2,0,27,1,30,4,11,0,15,4,30,1,1,0,2,0,30,3,12,0,15,0,30,7,8,0,15,4,30,6,0,0,6,1,-15,3,1
2,3,27,1,30,4,11,0,15,4,30,1,1,0,2,0,30,3,12,0,15,0,30,7,8,0,15,4,30,6,0,0,6,1,-15,3,1
2,4,27,1,30,4,11,0,15,4,30,1,1,0,2,0,30,3,12,0,15,0,30,7,8,0,15,4,30,6,0,0,6,1,-15,3,1
2,3,29,1,30,8,6,0,14,6,30,10,2,0,12,0,30,3,11,0,14,0,30,0,14,0,14,1,30,9,0,0,9,1,-15,3,1
2,4,31,1,30,5,7,0,12,4,30,8,0,0,8,6,30,9,3,0,12,0,30,4,8,0,12,0,30,1,5,0,6,1,-15,3,1
2,0,19,0,30,7,6,0,13,2,30,4,4,0,8,0,30,4,9,0,13,1,30,7,6,0,13,2,30,9,0,0,9,1,-15,3,1
2,2,19,0,30,7,6,0,13,2,30,4,4,0,8,0,30,4,9,0,13,1,30,7,6,0,13,2,30,9,0,0,9,1,-15,3,1
2,4,19,0,30,7,6,0,13,2,30,4,4,0,8,0,30,4,9,0,13,1,30,7,6,0,13,2,30,9,0,0,9,1,-15,3,1
2,1,25,2,30,3,11,0,14,2,30,6,0,0,6,0,30,10,4,0,14,1,30,5,9,0,14,4,30,5,1,0,6,1,-15,3,1
2,4,25,2,30,3,11,0,14,2,30,6,0,0,6,0,30,10,4,0,14,1,30,5,9,0,14,4,30,5,1,0,6,1,-15,3,1
2,3,27,1,30,4,11,0,15,2,30,2,0,0,2,0,30,2,13,0,15,0,30,6,9,0,15,5,30,6,0,0,6,1,-15,3,1
2,0,38,0,30,1,9,0,10,6,30,6,0,0,6,0,30,2,8,0,10,0,30,4,6,0,10,7,30,6,0,0,6,1,-15,3,1
2,2,38,0,30,1,9,0,10,6,30,6,0,0,6,0,30,2,8,0,10,0,30,4,6,0,10,7,30,6,0,0,6,1,-15,3,1
2,3,38,0,30,1,9,0,10,6,30,6,0,0,6,0,30,2,8,0,10,0,30,4,6,0,10,7,30,6,0,0,6,1,-15,3,1
2,0,5,0,30,2,3,0,5,3,30,0,4,0,4,0,30,0,5,0,5,0,30,1,4,0,5,2,30,2,0,0,2,0,-27,3,0
2,4,5,0,30,2,3,0,5,3,30,0,4,0,4,0,30,0,5,0,5,0,30,1,4,0,5,2,30,2,0,0,2,0,-27,3,0
2,2,8,5,30,7,0,0,7,3,30,2,0,0,2,0,30,3,4,0,7,0,30,1,6,0,7,0,30,3,0,0,3,0,-27,3,0
2,3,8,5,30,7,0,0,7,3,30,2,0,0,2,0,30,3,4,0,7,0,30,1,6,0,7,0,30,3,0,0,3,0,-27,3,0
2,4,8,5,30,7,0,0,7,3,30,2,0,0,2,0,30,3,4,0,7,0,30,1,6,0,7,0,30,3,0,0,3,0,-27,3,0
2,1,17,1,30,2,12,0,14,3,30,6,0,0,6,0,30,7,7,0,14,8,30,6,8,0,14,5,30,4,0,0,4,1,-15,3,1
2,4,17,1,30,2,12,0,14,3,30,6,0,0,6,0,30,7,7,0,14,8,30,6,8,0,14,5,30,4,0,0,4,1,-15,3,1
2,0,21,6,30,10,0,0,10,4,30,6,0,0,6,1,30,3,7,0,10,2,30,4,6,0,10,0,30,3,1,0,4,1,-15,3,1
2,3,21,6,30,10,0,0,10,4,30,6,0,0,6,0,30,3,7,0,10,2,30,4,6,0,10,0,30,3,1,0,4,1,-15,3,1
2,1,25,1,30,8,6,0,14,2,30,6,0,0,6,0,30,9,5,0,14,1,30,5,9,0,14,4,30,5,1,0,6,1,-15,3,1
2,0,26,0,30,6,3,0,9,4,30,2,2,0,4,2,30,1,8,0,9,4,30,2,7,0,9,6,30,2,1,0,3,1,-15,3,1
2,4,26,0,30,6,3,0,9,4,30,2,2,0,4,2,30,1,8,0,9,4,30,2,7,0,9,6,30,2,1,0,3,1,-15,3,1
2,0,27,1,30,5,10,0,15,3,30,1,1,0,2,0,30,7,8,0,15,2,30,5,10,0,15,2,30,6,0,0,6,1,-15,3,1
2,1,27,1,30,5,10,0,15,3,30,1,1,0,2,0,30,7,8,0,15,2,30,5,10,0,15,2,30,6,0,0,6,1,-15,3,1
2,3,35,0,30,10,3,0,13,5,30,2,0,0,2,1,30,3,10,0,13,1,30,4,9,0,13,4,30,8,0,0,8,1,-15,3,1
2,0,5,0,30,5,0,0,5,3,30,0,4,0,4,0,30,0,5,0,5,4,30,1,4,0,5,0,30,0,2,0,2,0,-27,3,0
2,1,5,0,30,5,0,0,5,3,30,0,4,0,4,0,30,0,5,0,5,4,30,1,4,0,5,0,30,0,2,0,2,0,-27,3,0
2,1,6,1,30,8,1,0,9,4,30,2,0,0,2,0,30,2,7,0,9,0,30,4,5,0,9,1,30,4,1,0,5,0,-27,3,0
2,2,19,0,30,4,9,0,13,2,30,6,2,0,8,4,30,6,7,0,13,3,30,8,5,0,13,1,30,7,2,0,9,1,-15,3,1
2,3,22,2,30,8,0,0,8,3,30,2,0,0,2,0,30,4,4,0,8,1,30,2,6,0,8,1,30,4,0,0,4,1,-15,3,1
2,1,27,1,30,4,11,0,15,3,30,1,1,0,2,0,30,10,5,0,15,3,30,5,10,0,15,4,30,6,0,0,6,1,-15,3,1
2,2,27,1,30,4,11,0,15,3,30,1,1,0,2,0,30,10,5,0,15,3,30,5,10,0,15,4,30,6,0,0,6,1,-15,3,1
2,3,27,1,30,4,11,0,15,3,30,1,1,0,2,0,30,10,5,0,15,3,30,5,10,0,15,4,30,6,0,0,6,1,-15,3,1
2,3,33,0,30,5,6,0,11,4,30,4,0,0,4,3,30,11,0,0,11,0,30,3,8,0,11,4,30,4,0,0,4,1,-15,3,1
2,0,17,4,30,11,3,0,14,3,30,6,0,0,6,0,30,4,10,0,14,1,30,5,9,0,14,1,30,4,0,0,4,1,-15,3,1
2,1,17,4,30,11,3,0,14,3,30,6,0,0,6,0,30,4,10,0,14,1,30,5,9,0,14,1,30,4,0,0,4,1,-15,3,1
2,1,19,0,30,7,6,0,13,2,30,3,5,0,8,0,30,4,9,0,13,3,30,4,9,0,13,1,30,9,0,0,9,1,-15,3,1
2,3,19,0,30,7,6,0,13,2,30,3,5,0,8,0,30,4,9,0,13,3,30,4,9,0,13,1,30,9,0,0,9,1,-15,3,1
2,4,19,0,30,7,6,0,13,2,30,3,5,0,8,0,30,4,9,0,13,3,30,4,9,0,13,1,30,9,0,0,9,1,-15,3,1
2,3,23,2,30,5,8,0,13,0,30,6,0,0,6,0,30,13,0,0,13,0,30,6,7,0,13,1,30,6,0,0,6,1,-15,3,1
2,2,25,1,30,5,9,0,14,4,30,6,0,0,6,0,30,7,7,0,14,1,30,6,8,0,14,5,30,6,0,0,6,1,-15,3,1
2,1,27,1,30,4,11,0,15,4,30,2,0,0,2,0,30,2,13,0,15,0,30,5,10,0,15,6,30,6,0,0,6,1,-15,3,1
2,2,27,1,30,4,11,0,15,4,30,2,0,0,2,0,30,2,13,0,15,0,30,5,10,0,15,6,30,6,0,0,6,1,-15,3,1
2,3,27,1,30,4,11,0,15,4,30,2,0,0,2,0,30,2,13,0,15,0,30,5,10,0,15,6,30,6,0,0,6,1,-15,3,1
2,3,31,2,30,9,3,0,12,4,30,8,0,0,8,3,30,8,4,0,12,0,30,5,7,0,12,0,30,3,3,0,6,1,-15,3,1
2,3,32,0,30,5,4,0,9,4,30,2,0,0,2,0,30,7,2,0,9,1,30,3,6,0,9,6,30,2,0,0,2,1,-15,3,1
2,4,32,0,30,5,4,0,9,4,30,2,0,0,2,0,30,7,2,0,9,1,30,3,6,0,9,6,30,2,0,0,2,1,-15,3,1
2,3,43,0,30,6,8,0,14,7,30,6,0,0,6,0,30,4,10,0,14,1,30,1,13,0,14,3,30,5,0,0,5,1,-15,3,1
2,4,43,0,30,6,8,0,14,7,30,6,0,0,6,0,30,4,10,0,14,1,30,1,13,0,14,3,30,5,0,0,5,1,-15,3,1
2,0,45,0,30,5,8,0,13,7,30,10,0,0,10,0,30,6,7,0,13,4,30,4,9,0,13,6,30,5,0,0,5,1,-15,3,1
2,3,45,0,30,5,8,0,13,7,30,10,0,0,10,0,30,6,7,0,13,4,30,4,9,0,13,6,30,5,0,0,5,1,-15,3,1
2,4,45,0,30,5,8,0,13,7,30,10,0,0,10,0,30,6,7,0,13,4,30,4,9,0,13,6,30,5,0,0,5,1,-15,3,1
2,2,4,0,30,6,2,0,8,4,30,4,0,0,4,0,30,2,6,0,8,0,30,4,4,0,8,3,30,4,0,0,4,0,-27,3,0
2,3,4,0,30,6,2,0,8,4,30,4,0,0,4,0,30,2,6,0,8,0,30,4,4,0,8,3,30,4,0,0,4,0,-27,3,0
2,3,23,2,30,9,4,0,13,1,30,6,0,0,6,3,30,12,1,0,13,0,30,3,10,0,13,2,30,6,0,0,6,1,-15,3,1
2,4,23,2,30,9,4,0,13,1,30,6,0,0,6,3,30,12,1,0,13,0,30,3,10,0,13,2,30,6,0,0,6,1,-15,3,1
2,4,25,0,30,6,8,0,14,3,30,6,0,0,6,0,30,6,8,0,14,1,30,5,9,0,14,2,30,5,1,0,6,1,-15,3,1
2,2,27,1,30,4,11,0,15,3,30,2,0,0,2,0,30,5,10,0,15,0,30,4,11,0,15,2,30,6,0,0,6,1,-15,3,1
2,3,27,1,30,4,11,0,15,3,30,2,0,0,2,0,30,5,10,0,15,0,30,4,11,0,15,2,30,6,0,0,6,1,-15,3,1
2,4,27,1,30,4,11,0,15,3,30,2,0,0,2,0,30,5,10,0,15,0,30,4,11,0,15,2,30,6,0,0,6,1,-15,3,1
2,2,33,1,30,2,9,0,11,5,30,4,0,0,4,1,30,10,1,0,11,3,30,4,7,0,11,5,30,4,0,0,4,1,-15,3,1
2,1,37,0,30,8,3,0,11,5,30,3,5,0,8,0,30,7,4,0,11,7,30,3,8,0,11,6,30,5,1,0,6,1,-15,3,1
2,4,39,0,30,4,7,0,11,6,30,6,0,0,6,0,30,3,8,0,11,0,30,2,9,0,11,2,30,5,0,0,5,1,-15,3,1
2,3,8,1,30,7,0,0,7,3,30,2,0,0,2,4,30,3,4,0,7,1,30,7,0,0,7,1,30,3,0,0,3,0,-27,3,0
2,4,13,2,30,6,1,0,7,0,30,4,0,0,4,1,30,7,0,0,7,9,30,6,1,0,7,4,30,4,0,0,4,1,-15,3,1
2,2,17,4,30,9,5,0,14,3,30,6,0,0,6,0,30,4,10,0,14,2,30,4,10,0,14,4,30,4,0,0,4,1,-15,3,1
2,3,17,4,30,9,5,0,14,3,30,6,0,0,6,0,30,4,10,0,14,2,30,4,10,0,14,4,30,4,0,0,4,1,-15,3,1
2,2,19,0,30,4,9,0,13,2,30,8,0,0,8,4,30,5,8,0,13,4,30,3,10,0,13,0,30,8,1,0,9,1,-15,3,1
2,4,19,0,30,4,9,0,13,2,30,8,0,0,8,4,30,5,8,0,13,4,30,3,10,0,13,0,30,8,1,0,9,1,-15,3,1
2,2,23,2,30,4,9,0,13,4,30,6,0,0,6,6,30,13,0,0,13,0,30,5,8,0,13,4,30,6,0,0,6,1,-15,3,1
2,0,25,1,30,1,13,0,14,5,30,6,0,0,6,0,30,5,9,0,14,4,30,9,5,0,14,5,30,6,0,0,6,1,-15,3,1
2,1,25,1,30,1,13,0,14,5,30,6,0,0,6,0,30,5,9,0,14,4,30,9,5,0,14,5,30,6,0,0,6,1,-15,3,1
2,0,27,1,30,6,9,0,15,4,30,2,0,0,2,4,30,3,12,0,15,2,30,4,11,0,15,1,30,5,1,0,6,1,-15,3,1
2,2,27,1,30,6,9,0,15,4,30,2,0,0,2,4,30,3,12,0,15,2,30,4,11,0,15,1,30,5,1,0,6,1,-15,3,1
2,4,41,0,30,10,2,0,12,6,30,8,0,0,8,0,30,3,9,0,12,2,30,3,9,0,12,3,30,2,5,0,7,1,-15,3,1
2,1,13,1,30,5,2,0,7,1,30,4,0,0,4,1,30,5,2,0,7,5,30,6,1,0,7,2,30,4,0,0,4,1,-15,3,1
2,3,19,0,30,2,11,0,13,1,30,7,1,0,8,0,30,10,3,0,13,3,30,6,7,0,13,0,30,8,1,0,9,1,-15,3,1
2,2,25,2,30,4,10,0,14,5,30,6,0,0,6,0,30,6,8,0,14,1,30,4,10,0,14,4,30,6,0,0,6,1,-15,3,1
2,3,25,2,30,4,10,0,14,5,30,6,0,0,6,0,30,6,8,0,14,1,30,4,10,0,14,4,30,6,0,0,6,1,-15,3,1
2,1,27,0,30,3,12,0,15,3,30,2,0,0,2,0,30,6,9,0,15,2,30,5,10,0,15,2,30,6,0,0,6,1,-15,3,1
2,4,27,0,30,3,12,0,15,3,30,2,0,0,2,0,30,6,9,0,15,0,30,5,10,0,15,2,30,6,0,0,6,1,-15,3,1
2,2,29,0,30,7,7,0,14,6,30,11,1,0,12,0,30,5,9,0,14,0,30,1,13,0,14,4,30,9,0,0,9,1,-15,3,1
2,3,29,0,30,7,7,0,14,6,30,11,1,0,12,0,30,5,9,0,14,0,30,1,13,0,14,4,30,9,0,0,9,1,-15,3,1
2,4,4,2,30,7,1,0,8,5,30,4,0,0,4,0,30,1,7,0,8,0,30,5,3,0,8,2,30,4,0,0,4,0,-27,3,0
2,3,17,1,30,9,5,0,14,2,30,6,0,0,6,0,30,7,7,0,14,1,30,7,7,0,14,3,30,4,0,0,4,1,-15,3,1
2,3,23,5,30,5,8,0,13,2,30,6,0,0,6,0,30,8,5,0,13,0,30,3,10,0,13,2,30,6,0,0,6,1,-15,3,1
2,4,25,0,30,11,3,0,14,2,30,6,0,0,6,0,30,8,6,0,14,1,30,5,9,0,14,1,30,5,1,0,6,1,-15,3,1
2,0,31,1,30,4,8,0,12,8,30,8,0,0,8,3,30,4,8,0,12,0,30,9,3,0,12,9,30,6,0,0,6,1,-15,3,1
2,4,1,0,30,7,3,0,10,4,30,2,0,0,2,1,30,4,6,0,10,6,30,7,3,0,10,6,30,6,0,0,6,0,-27,3,0
2,1,5,0,30,2,3,0,5,3,30,0,4,0,4,0,30,2,3,0,5,0,30,1,4,0,5,1,30,0,2,0,2,0,-27,3,0
2,2,6,2,30,7,2,0,9,4,30,2,0,0,2,0,30,3,6,0,9,0,30,4,5,0,9,1,30,5,0,0,5,0,-27,3,0
2,3,6,2,30,7,2,0,9,4,30,2,0,0,2,0,30,3,6,0,9,0,30,4,5,0,9,1,30,5,0,0,5,0,-27,3,0
2,4,6,2,30,7,2,0,9,4,30,2,0,0,2,0,30,3,6,0,9,0,30,4,5,0,9,1,30,5,0,0,5,0,-27,3,0
2,4,13,3,30,7,0,0,7,0,30,4,0,0,4,2,30,5,2,0,7,9,30,6,1,0,7,2,30,4,0,0,4,1,-15,3,1
2,4,19,0,30,6,7,0,13,3,30,8,0,0,8,8,30,4,9,0,13,0,30,3,10,0,13,0,30,8,1,0,9,1,-15,3,1
2,4,22,1,30,5,3,0,8,2,30,2,0,0,2,0,30,5,3,0,8,1,30,4,4,0,8,2,30,4,0,0,4,1,-15,3,1
2,4,25,1,30,6,8,0,14,5,30,6,0,0,6,0,30,8,6,0,14,1,30,4,10,0,14,3,30,6,0,0,6,1,-15,3,1
2,4,26,0,30,7,2,0,9,5,30,4,0,0,4,5,30,0,9,0,9,0,30,3,6,0,9,6,30,3,0,0,3,1,-15,3,1
2,2,27,1,30,4,11,0,15,4,30,1,1,0,2,2,30,7,8,0,15,0,30,4,11,0,15,0,30,4,2,0,6,1,-15,3,1
2,4,27,1,30,4,11,0,15,4,30,1,1,0,2,2,30,7,8,0,15,0,30,4,11,0,15,0,30,4,2,0,6,1,-15,3,1
2,3,31,1,30,6,6,0,12,4,30,8,0,0,8,5,30,10,2,0,12,0,30,3,9,0,12,0,30,6,0,0,6,1,-15,3,1
2,2,35,0,30,8,5,0,13,5,30,2,0,0,2,1,30,2,11,0,13,2,30,7,6,0,13,9,30,8,0,0,8,1,-15,3,1
2,3,13,3,30,6,1,0,7,1,30,4,0,0,4,2,30,6,1,0,7,2,30,6,1,0,7,0,30,4,0,0,4,1,-15,3,1
2,4,19,0,30,3,10,0,13,3,30,8,0,0,8,0,30,4,9,0,13,5,30,7,6,0,13,0,30,7,2,0,9,1,-15,3,1
2,4,23,1,30,8,5,0,13,0,30,6,0,0,6,0,30,13,0,0,13,0,30,5,8,0,13,2,30,5,1,0,6,1,-15,3,1
2,4,25,1,30,1,13,0,14,5,30,6,0,0,6,0,30,7,7,0,14,3,30,4,10,0,14,2,30,5,1,0,6,1,-15,3,1
2,1,27,1,30,4,11,0,15,3,30,1,1,0,2,0,30,5,10,0,15,2,30,8,7,0,15,3,30,6,0,0,6,1,-15,3,1
2,2,27,1,30,4,11,0,15,3,30,1,1,0,2,0,30,5,10,0,15,2,30,8,7,0,15,3,30,6,0,0,6,1,-15,3,1
2,3,27,1,30,4,11,0,15,3,30,1,1,0,2,0,30,5,10,0,15,2,30,8,7,0,15,3,30,6,0,0,6,1,-15,3,1
2,4,29,1,30,6,8,0,14,6,30,10,2,0,12,0,30,3,11,0,14,0,30,0,14,0,14,0,30,9,0,0,9,1,-15,3,1
2,2,5,1,30,3,2,0,5,3,30,1,3,0,4,0,30,0,5,0,5,0,30,1,4,0,5,0,30,1,1,0,2,0,-27,3,0
2,3,5,1,30,3,2,0,5,3,30,1,3,0,4,0,30,0,5,0,5,0,30,1,4,0,5,0,30,1,1,0,2,0,-27,3,0
2,4,5,1,30,3,2,0,5,3,30,1,3,0,4,0,30,0,5,0,5,0,30,1,4,0,5,0,30,1,1,0,2,0,-27,3,0
2,3,9,8,30,8,3,0,11,4,30,6,0,0,6,1,30,9,2,0,11,1,30,4,7,0,11,1,30,2,2,0,4,0,-27,3,0
2,4,9,8,30,8,3,0,11,4,30,6,0,0,6,1,30,9,2,0,11,1,30,4,7,0,11,1,30,2,2,0,4,0,-27,3,0
2,4,25,4,30,8,6,0,14,5,30,6,0,0,6,0,30,6,8,0,14,0,30,5,9,0,14,5,30,6,0,0,6,1,-15,3,1
2,3,27,1,30,5,10,0,15,3,30,1,1,0,2,0,30,3,12,0,15,0,30,7,8,0,15,5,30,6,0,0,6,1,-15,3,1
2,2,29,1,30,7,7,0,14,5,30,9,3,0,12,0,30,6,8,0,14,0,30,0,14,0,14,4,30,9,0,0,9,1,-15,3,1
2,4,29,1,30,7,7,0,14,5,30,9,3,0,12,0,30,6,8,0,14,0,30,0,14,0,14,4,30,9,0,0,9,1,-15,3,1
2,3,31,3,30,4,8,0,12,5,30,8,0,0,8,3,30,8,4,0,12,0,30,5,7,0,12,2,30,6,0,0,6,1,-15,3,1
2,0,41,1,30,9,3,0,12,5,30,4,4,0,8,0,30,6,6,0,12,0,30,3,9,0,12,3,30,6,1,0,7,1,-15,3,1
2,1,41,1,30,9,3,0,12,5,30,4,4,0,8,0,30,6,6,0,12,0,30,3,9,0,12,3,30,6,1,0,7,1,-15,3,1
2,3,41,1,30,9,3,0,12,5,30,4,4,0,8,0,30,6,6,0,12,0,30,3,9,0,12,3,30,6,1,0,7,1,-15,3,1
2,4,41,1,30,9,3,0,12,5,30,4,4,0,8,0,30,6,6,0,12,0,30,3,9,0,12,3,30,6,1,0,7,1,-15,3,1
2,4,11,0,30,0,4,0,4,0,30,0,0,0,0,0,30,4,0,0,4,5,30,4,0,0,4,2,30,1,0,0,1,1,-15,3,1
2,1,13,3,30,5,2,0,7,1,30,4,0,0,4,6,30,6,1,0,7,6,30,6,1,0,7,3,30,4,0,0,4,1,-15,3,1
2,2,13,3,30,5,2,0,7,1,30,4,0,0,4,6,30,6,1,0,7,6,30,6,1,0,7,3,30,4,0,0,4,1,-15,3,1
2,4,13,3,30,5,2,0,7,1,30,4,0,0,4,6,30,6,1,0,7,6,30,6,1,0,7,3,30,4,0,0,4,1,-15,3,1
2,4,15,1,30,6,7,0,13,0,30,5,1,0,6,0,30,6,7,0,13,1,30,4,9,0,13,3,30,8,1,0,9,1,-15,3,1
2,2,17,3,30,8,6,0,14,3,30,6,0,0,6,0,30,5,9,0,14,2,30,8,6,0,14,7,30,4,0,0,4,1,-15,3,1
2,4,19,0,30,5,8,0,13,2,30,5,3,0,8,0,30,7,6,0,13,6,30,5,8,0,13,0,30,9,0,0,9,1,-15,3,1
2,3,25,0,30,10,4,0,14,4,30,6,0,0,6,0,30,6,8,0,14,1,30,6,8,0,14,4,30,4,2,0,6,1,-15,3,1
2,0,27,2,30,8,7,0,15,4,30,2,0,0,2,2,30,7,8,0,15,0,30,4,11,0,15,5,30,2,4,0,6,1,-15,3,1
2,1,27,2,30,8,7,0,15,4,30,2,0,0,2,2,30,7,8,0,15,0,30,4,11,0,15,5,30,2,4,0,6,1,-15,3,1
2,4,29,0,30,5,9,0,14,6,30,8,4,0,12,0,30,4,10,0,14,0,30,7,7,0,14,4,30,9,0,0,9,1,-15,3,1
2,3,6,0,30,6,3,0,9,4,30,2,0,0,2,0,30,2,7,0,9,0,30,4,5,0,9,0,30,5,0,0,5,0,-27,3,0
2,4,6,0,30,6,3,0,9,4,30,2,0,0,2,0,30,2,7,0,9,0,30,4,5,0,9,0,30,5,0,0,5,0,-27,3,0
2,2,8,1,30,7,0,0,7,4,30,2,0,0,2,4,30,2,5,0,7,1,30,7,0,0,7,3,30,3,0,0,3,0,-27,3,0
2,3,8,1,30,7,0,0,7,4,30,2,0,0,2,4,30,2,5,0,7,1,30,7,0,0,7,3,30,3,0,0,3,0,-27,3,0
2,4,19,0,30,3,10,0,13,1,30,6,2,0,8,0,30,6,7,0,13,0,30,4,9,0,13,1,30,6,3,0,9,1,-15,3,1
2,4,23,1,30,3,10,0,13,3,30,6,0,0,6,0,30,5,8,0,13,0,30,10,3,0,13,5,30,6,0,0,6,1,-15,3,1
2,1,25,1,30,7,7,0,14,1,30,6,0,0,6,0,30,11,3,0,14,3,30,7,7,0,14,0,30,6,0,0,6,1,-15,3,1
2,3,25,1,30,7,7,0,14,1,30,6,0,0,6,0,30,11,3,0,14,2,30,7,7,0,14,0,30,6,0,0,6,1,-15,3,1
2,0,27,1,30,4,11,0,15,4,30,2,0,0,2,2,30,5,10,0,15,0,30,4,11,0,15,1,30,4,2,0,6,1,-15,3,1
2,2,27,1,30,4,11,0,15,4,30,2,0,0,2,2,30,5,10,0,15,0,30,4,11,0,15,1,30,4,2,0,6,1,-15,3,1
2,3,27,1,30,4,11,0,15,4,30,2,0,0,2,2,30,5,10,0,15,0,30,4,11,0,15,1,30,4,2,0,6,1,-15,3,1
2,4,27,1,30,4,11,0,15,4,30,2,0,0,2,2,30,5,10,0,15,0,30,4,11,0,15,1,30,4,2,0,6,1,-15,3,1
2,1,31,0,30,7,5,0,12,6,30,8,0,0,8,3,30,5,7,0,12,0,30,3,9,0,12,4,30,6,0,0,6,1,-15,3,1
2,2,31,0,30,7,5,0,12,6,30,8,0,0,8,3,30,5,7,0,12,0,30,3,9,0,12,4,30,6,0,0,6,1,-15,3,1
2,3,31,0,30,7,5,0,12,6,30,8,0,0,8,3,30,5,7,0,12,0,30,3,9,0,12,4,30,6,0,0,6,1,-15,3,1
2,4,32,0,30,4,5,0,9,4,30,2,0,0,2,0,30,7,2,0,9,1,30,3,6,0,9,5,30,2,0,0,2,1,-15,3,1
2,4,8,2,30,7,0,0,7,3,30,2,0,0,2,3,30,2,5,0,7,0,30,6,1,0,7,2,30,3,0,0,3,0,-27,3,0
2,4,17,2,30,8,6,0,14,2,30,6,0,0,6,0,30,5,9,0,14,0,30,6,8,0,14,5,30,4,0,0,4,1,-15,3,1
2,3,23,1,30,3,10,0,13,5,30,6,0,0,6,11,30,11,2,0,13,0,30,5,8,0,13,6,30,6,0,0,6,1,-15,3,1
2,1,25,1,30,4,10,0,14,5,30,6,0,0,6,0,30,9,5,0,14,2,30,8,6,0,14,3,30,6,0,0,6,1,-15,3,1
2,2,25,1,30,4,10,0,14,5,30,6,0,0,6,0,30,9,5,0,14,2,30,8,6,0,14,3,30,6,0,0,6,1,-15,3,1
2,3,25,1,30,4,10,0,14,5,30,6,0,0,6,0,30,9,5,0,14,2,30,8,6,0,14,3,30,6,0,0,6,1,-15,3,1
2,4,25,1,30,4,10,0,14,5,30,6,0,0,6,0,30,9,5,0,14,2,30,8,6,0,14,3,30,6,0,0,6,1,-15,3,1
2,0,27,1,30,4,11,0,15,4,30,1,1,0,2,0,30,4,11,0,15,0,30,6,9,0,15,6,30,4,2,0,6,1,-15,3,1
2,3,27,1,30,4,11,0,15,4,30,1,1,0,2,0,30,4,11,0,15,0,30,6,9,0,15,6,30,4,2,0,6,1,-15,3,1
2,4,27,1,30,4,11,0,15,4,30,1,1,0,2,0,30,4,11,0,15,0,30,6,9,0,15,6,30,4,2,0,6,1,-15,3,1
2,4,29,0,30,4,10,0,14,6,30,11,1,0,12,0,30,4,10,0,14,0,30,1,13,0,14,4,30,9,0,0,9,1,-15,3,1
2,4,31,1,30,7,5,0,12,3,30,8,0,0,8,1,30,10,2,0,12,0,30,3,9,0,12,0,30,6,0,0,6,1,-15,3,1
2,3,35,0,30,4,9,0,13,3,30,2,0,0,2,1,30,11,2,0,13,0,30,1,12,0,13,0,30,8,0,0,8,1,-15,3,1
2,0,47,0,30,0,14,0,14,7,30,4,0,0,4,0,30,3,11,0,14,1,30,2,12,0,14,9,30,7,0,0,7,1,-15,3,1
2,4,3,1,30,1,3,0,4,3,30,4,0,0,4,0,30,0,4,0,4,1,30,2,2,0,4,0,30,1,2,0,3,0,-27,3,0
2,1,13,1,30,7,0,0,7,0,30,4,0,0,4,2,30,5,2,0,7,7,30,5,2,0,7,4,30,4,0,0,4,1,-15,3,1
2,2,13,1,30,7,0,0,7,0,30,4,0,0,4,2,30,5,2,0,7,7,30,5,2,0,7,4,30,4,0,0,4,1,-15,3,1
2,4,17,3,30,11,3,0,14,4,30,6,0,0,6,0,30,4,10,0,14,1,30,6,8,0,14,0,30,2,2,0,4,1,-15,3,1
2,0,19,0,30,5,8,0,13,2,30,8,0,0,8,3,30,7,6,0,13,7,30,5,8,0,13,1,30,6,3,0,9,1,-15,3,1
2,2,19,0,30,5,8,0,13,2,30,8,0,0,8,3,30,7,6,0,13,7,30,5,8,0,13,0,30,6,3,0,9,1,-15,3,1
2,4,22,2,30,7,1,0,8,2,30,2,0,0,2,0,30,4,4,0,8,1,30,2,6,0,8,1,30,4,0,0,4,1,-15,3,1
2,3,23,2,30,7,6,0,13,0,30,6,0,0,6,2,30,13,0,0,13,2,30,6,7,0,13,3,30,6,0,0,6,1,-15,3,1
2,2,27,1,30,6,9,0,15,0,30,2,0,0,2,0,30,12,3,0,15,0,30,4,11,0,15,1,30,5,1,0,6,1,-15,3,1
2,4,27,1,30,6,9,0,15,0,30,2,0,0,2,0,30,12,3,0,15,0,30,4,11,0,15,1,30,5,1,0,6,1,-15,3,1
2,0,31,1,30,5,7,0,12,8,30,8,0,0,8,3,30,4,8,0,12,1,30,9,3,0,12,5,30,6,0,0,6,1,-15,3,1
2,2,31,1,30,5,7,0,12,8,30,8,0,0,8,3,30,4,8,0,12,1,30,9,3,0,12,5,30,6,0,0,6,1,-15,3,1
2,4,31,1,30,5,7,0,12,8,30,8,0,0,8,3,30,4,8,0,12,0,30,9,3,0,12,5,30,6,0,0,6,1,-15,3,1
2,2,35,0,30,8,5,0,13,5,30,2,0,0,2,1,30,4,9,0,13,2,30,1,12,0,13,3,30,8,0,0,8,1,-15,3,1
2,3,35,0,30,8,5,0,13,5,30,2,0,0,2,1,30,4,9,0,13,2,30,1,12,0,13,3,30,8,0,0,8,1,-15,3,1
2,3,4,2,30,4,4,0,8,5,30,4,0,0,4,2,30,2,6,0,8,4,30,8,0,0,8,1,30,3,1,0,4,0,-27,3,0
2,4,4,2,30,4,4,0,8,5,30,4,0,0,4,2,30,2,6,0,8,4,30,8,0,0,8,1,30,3,1,0,4,0,-27,3,0
2,1,13,5,30,7,0,0,7,0,30,4,0,0,4,2,30,5,2,0,7,8,30,5,2,0,7,4,30,4,0,0,4,1,-15,3,1
2,2,13,5,30,7,0,0,7,0,30,4,0,0,4,2,30,5,2,0,7,8,30,5,2,0,7,4,30,4,0,0,4,1,-15,3,1
2,0,17,3,30,8,6,0,14,3,30,6,0,0,6,0,30,6,8,0,14,5,30,5,9,0,14,1,30,2,2,0,4,1,-15,3,1
2,3,17,2,30,8,6,0,14,3,30,6,0,0,6,0,30,6,8,0,14,5,30,5,9,0,14,1,30,2,2,0,4,1,-15,3,1
2,4,17,2,30,8,6,0,14,3,30,6,0,0,6,0,30,6,8,0,14,5,30,5,9,0,14,1,30,2,2,0,4,1,-15,3,1
2,3,23,1,30,7,6,0,13,2,30,6,0,0,6,2,30,13,0,0,13,0,30,6,7,0,13,2,30,5,1,0,6,1,-15,3,1
2,4,35,2,30,6,7,0,13,4,30,2,0,0,2,1,30,8,5,0,13,1,30,2,11,0,13,4,30,8,0,0,8,1,-15,3,1
2,2,4,0,30,6,2,0,8,4,30,4,0,0,4,0,30,1,7,0,8,0,30,3,5,0,8,3,30,4,0,0,4,0,-27,3,0
2,3,4,0,30,6,2,0,8,4,30,4,0,0,4,0,30,1,7,0,8,0,30,3,5,0,8,3,30,4,0,0,4,0,-27,3,0
2,3,9,0,30,2,2,0,4,2,30,2,0,0,2,0,30,0,4,0,4,2,30,1,3,0,4,0,30,1,0,0,1,0,-27,3,0
2,4,9,0,30,2,2,0,4,2,30,2,0,0,2,0,30,0,4,0,4,2,30,1,3,0,4,0,30,1,0,0,1,0,-27,3,0
2,4,13,1,30,4,3,0,7,0,30,4,0,0,4,3,30,7,0,0,7,9,30,6,1,0,7,0,30,4,0,0,4,1,-15,3,1
2,2,17,4,30,11,3,0,14,3,30,6,0,0,6,0,30,4,10,0,14,1,30,4,10,0,14,5,30,4,0,0,4,1,-15,3,1
2,4,17,3,30,11,3,0,14,3,30,6,0,0,6,0,30,4,10,0,14,1,30,4,10,0,14,5,30,4,0,0,4,1,-15,3,1
2,1,25,1,30,1,13,0,14,6,30,6,0,0,6,0,30,3,11,0,14,8,30,10,4,0,14,9,30,6,0,0,6,1,-15,3,1
2,2,25,1,30,1,13,0,14,6,30,6,0,0,6,0,30,3,11,0,14,8,30,10,4,0,14,9,30,6,0,0,6,1,-15,3,1
2,2,27,2,30,8,7,0,15,3,30,2,0,0,2,0,30,3,12,0,15,0,30,4,11,0,15,0,30,4,2,0,6,1,-15,3,1
2,4,27,2,30,8,7,0,15,3,30,2,0,0,2,0,30,3,12,0,15,0,30,4,11,0,15,0,30,4,2,0,6,1,-15,3,1
2,4,29,0,30,11,3,0,14,4,30,9,3,0,12,0,30,3,11,0,14,0,30,1,13,0,14,0,30,9,0,0,9,1,-15,3,1
2,2,31,3,30,6,6,0,12,6,30,8,0,0,8,3,30,6,6,0,12,0,30,6,6,0,12,0,30,4,2,0,6,1,-15,3,1
2,3,35,0,30,6,7,0,13,2,30,2,0,0,2,1,30,10,3,0,13,2,30,0,13,0,13,0,30,8,0,0,8,1,-15,3,1
2,4,35,0,30,6,7,0,13,2,30,2,0,0,2,1,30,10,3,0,13,2,30,0,13,0,13,0,30,8,0,0,8,1,-15,3,1
2,1,38,0,30,1,9,0,10,6,30,6,0,0,6,0,30,1,9,0,10,0,30,3,7,0,10,8,30,6,0,0,6,1,-15,3,1
2,2,38,0,30,1,9,0,10,6,30,6,0,0,6,0,30,1,9,0,10,0,30,3,7,0,10,8,30,6,0,0,6,1,-15,3,1
2,3,17,0,30,10,4,0,14,3,30,6,0,0,6,0,30,4,10,0,14,1,30,9,5,0,14,7,30,4,0,0,4,1,-15,3,1
2,1,19,0,30,5,8,0,13,1,30,4,4,0,8,0,30,4,9,0,13,8,30,7,6,0,13,2,30,9,0,0,9,1,-15,3,1
2,3,25,1,30,7,7,0,14,1,30,6,0,0,6,0,30,10,4,0,14,1,30,7,7,0,14,3,30,5,1,0,6,1,-15,3,1
2,4,25,1,30,7,7,0,14,1,30,6,0,0,6,0,30,10,4,0,14,1,30,7,7,0,14,3,30,5,1,0,6,1,-15,3,1
2,0,27,1,30,3,12,0,15,3,30,1,1,0,2,0,30,2,13,0,15,1,30,3,12,0,15,5,30,6,0,0,6,1,-15,3,1
2,1,27,1,30,3,12,0,15,3,30,1,1,0,2,0,30,2,13,0,15,1,30,3,12,0,15,5,30,6,0,0,6,1,-15,3,1
2,2,27,1,30,3,12,0,15,3,30,1,1,0,2,0,30,2,13,0,15,1,30,3,12,0,15,5,30,6,0,0,6,1,-15,3,1
2,4,27,1,30,3,12,0,15,3,30,1,1,0,2,0,30,2,13,0,15,1,30,3,12,0,15,0,30,6,0,0,6,1,-15,3,1
2,3,39,0,30,4,7,0,11,7,30,6,0,0,6,0,30,4,7,0,11,0,30,5,6,0,11,7,30,5,0,0,5,1,-15,3,1
2,3,43,0,30,7,7,0,14,7,30,6,0,0,6,0,30,4,10,0,14,1,30,7,7,0,14,8,30,5,0,0,5,1,-15,3,1
2,0,5,2,30,3,2,0,5,3,30,3,1,0,4,0,30,3,2,0,5,0,30,1,4,0,5,0,30,0,2,0,2,0,-27,3,0
2,1,5,2,30,3,2,0,5,3,30,3,1,0,4,0,30,3,2,0,5,0,30,1,4,0,5,0,30,0,2,0,2,0,-27,3,0
2,3,5,2,30,3,2,0,5,3,30,3,1,0,4,0,30,3,2,0,5,0,30,1,4,0,5,0,30,0,2,0,2,0,-27,3,0
2,3,8,2,30,7,0,0,7,4,30,2,0,0,2,1,30,4,3,0,7,0,30,6,1,0,7,1,30,3,0,0,3,0,-27,3,0
2,4,8,2,30,7,0,0,7,4,30,2,0,0,2,1,30,4,3,0,7,0,30,6,1,0,7,1,30,3,0,0,3,0,-27,3,0
2,2,17,3,30,10,4,0,14,2,30,6,0,0,6,0,30,5,9,0,14,2,30,6,8,0,14,2,30,4,0,0,4,1,-15,3,1
2,3,17,3,30,10,4,0,14,2,30,6,0,0,6,0,30,5,9,0,14,2,30,6,8,0,14,2,30,4,0,0,4,1,-15,3,1
2,2,19,0,30,2,11,0,13,2,30,7,1,0,8,0,30,5,8,0,13,0,30,6,7,0,13,0,30,8,1,0,9,1,-15,3,1
2,2,23,2,30,4,9,0,13,2,30,5,1,0,6,6,30,12,1,0,13,0,30,5,8,0,13,2,30,6,0,0,6,1,-15,3,1
2,3,23,2,30,4,9,0,13,2,30,5,1,0,6,6,30,12,1,0,13,0,30,5,8,0,13,2,30,6,0,0,6,1,-15,3,1
2,4,23,2,30,4,9,0,13,2,30,5,1,0,6,6,30,12,1,0,13,0,30,5,8,0,13,2,30,6,0,0,6,1,-15,3,1
2,4,25,2,30,7,7,0,14,3,30,6,0,0,6,0,30,6,8,0,14,1,30,7,7,0,14,0,30,5,1,0,6,1,-15,3,1
2,0,27,1,30,5,10,0,15,3,30,1,1,0,2,0,30,2,13,0,15,0,30,8,7,0,15,3,30,6,0,0,6,1,-15,3,1
2,3,35,0,30,7,6,0,13,3,30,2,0,0,2,1,30,2,11,0,13,5,30,2,11,0,13,6,30,8,0,0,8,1,-15,3,1
2,1,13,4,30,7,0,0,7,0,30,4,0,0,4,1,30,5,2,0,7,12,30,7,0,0,7,3,30,4,0,0,4,1,-15,3,1
2,4,13,4,30,7,0,0,7,0,30,4,0,0,4,1,30,5,2,0,7,12,30,7,0,0,7,3,30,4,0,0,4,1,-15,3,1
2,2,17,3,30,8,6,0,14,4,30,6,0,0,6,0,30,3,11,0,14,3,30,6,8,0,14,8,30,4,0,0,4,1,-15,3,1
2,0,25,1,30,3,11,0,14,6,30,6,0,0,6,2,30,7,7,0,14,3,30,5,9,0,14,6,30,6,0,0,6,1,-15,3,1
2,1,25,1,30,3,11,0,14,6,30,6,0,0,6,2,30,7,7,0,14,3,30,5,9,0,14,6,30,6,0,0,6,1,-15,3,1
2,4,25,1,30,3,11,0,14,5,30,6,0,0,6,2,30,7,7,0,14,3,30,5,9,0,14,2,30,6,0,0,6,1,-15,3,1
2,3,27,0,30,7,8,0,15,0,30,2,0,0,2,0,30,5,10,0,15,0,30,4,11,0,15,1,30,6,0,0,6,1,-15,3,1
2,2,29,0,30,7,7,0,14,5,30,7,5,0,12,0,30,8,6,0,14,0,30,3,11,0,14,4,30,9,0,0,9,1,-15,3,1
2,3,29,0,30,7,7,0,14,5,30,7,5,0,12,0,30,8,6,0,14,0,30,3,11,0,14,4,30,9,0,0,9,1,-15,3,1
2,2,35,1,30,9,4,0,13,6,30,2,0,0,2,1,30,2,11,0,13,2,30,3,10,0,13,6,30,8,0,0,8,1,-15,3,1
2,4,3,0,30,0,4,0,4,2,30,4,0,0,4,0,30,3,1,0,4,2,30,2,2,0,4,0,30,2,1,0,3,0,-27,3,0
2,2,4,4,30,7,1,0,8,4,30,4,0,0,4,0,30,3,5,0,8,0,30,4,4,0,8,1,30,4,0,0,4,0,-27,3,0
2,4,13,0,30,5,2,0,7,0,30,4,0,0,4,1,30,6,1,0,7,7,30,6,1,0,7,3,30,4,0,0,4,1,-15,3,1
2,3,15,2,30,3,10,0,13,0,30,6,0,0,6,0,30,6,7,0,13,1,30,3,10,0,13,1,30,6,3,0,9,1,-15,3,1
2,1,19,1,30,3,10,0,13,1,30,4,4,0,8,0,30,6,7,0,13,4,30,2,11,0,13,1,30,9,0,0,9,1,-15,3,1
2,1,27,1,30,4,11,0,15,2,30,1,1,0,2,0,30,8,7,0,15,3,30,4,11,0,15,4,30,6,0,0,6,1,-15,3,1
2,4,13,0,30,5,2,0,7,0,30,4,0,0,4,2,30,7,0,0,7,8,30,5,2,0,7,2,30,4,0,0,4,1,-15,3,1
2,4,19,2,30,3,10,0,13,3,30,8,0,0,8,0,30,4,9,0,13,3,30,3,10,0,13,2,30,8,1,0,9,1,-15,3,1
2,4,25,1,30,5,9,0,14,3,30,6,0,0,6,0,30,9,5,0,14,1,30,5,9,0,14,5,30,5,1,0,6,1,-15,3,1
2,4,31,1,30,6,6,0,12,5,30,8,0,0,8,3,30,8,4,0,12,0,30,7,5,0,12,3,30,6,0,0,6,1,-15,3,1
2,2,37,1,30,6,5,0,11,4,30,3,5,0,8,6,30,10,1,0,11,4,30,2,9,0,11,0,30,6,0,0,6,1,-15,3,1
2,4,39,0,30,4,7,0,11,7,30,6,0,0,6,0,30,3,8,0,11,0,30,4,7,0,11,5,30,5,0,0,5,1,-15,3,1
2,1,4,3,30,8,0,0,8,5,30,4,0,0,4,0,30,2,6,0,8,0,30,7,1,0,8,3,30,3,1,0,4,0,-27,3,0
2,2,4,3,30,8,0,0,8,5,30,4,0,0,4,0,30,2,6,0,8,0,30,7,1,0,8,3,30,3,1,0,4,0,-27,3,0
2,3,4,3,30,8,0,0,8,5,30,4,0,0,4,0,30,2,6,0,8,0,30,7,1,0,8,3,30,3,1,0,4,0,-27,3,0
2,1,17,4,30,9,5,0,14,3,30,6,0,0,6,0,30,5,9,0,14,1,30,6,8,0,14,3,30,4,0,0,4,1,-15,3,1
2,4,17,4,30,9,5,0,14,3,30,6,0,0,6,0,30,5,9,0,14,1,30,6,8,0,14,3,30,4,0,0,4,1,-15,3,1
2,1,19,0,30,4,9,0,13,2,30,8,0,0,8,4,30,7,6,0,13,0,30,5,8,0,13,0,30,5,4,0,9,1,-15,3,1
2,3,19,0,30,4,9,0,13,2,30,8,0,0,8,4,30,7,6,0,13,0,30,5,8,0,13,0,30,5,4,0,9,1,-15,3,1
2,1,25,1,30,5,9,0,14,5,30,6,0,0,6,0,30,6,8,0,14,0,30,7,7,0,14,7,30,6,0,0,6,1,-15,3,1
2,2,25,1,30,5,9,0,14,5,30,6,0,0,6,0,30,6,8,0,14,0,30,7,7,0,14,7,30,6,0,0,6,1,-15,3,1
2,0,27,1,30,5,10,0,15,5,30,2,0,0,2,0,30,4,11,0,15,2,30,8,7,0,15,4,30,6,0,0,6,1,-15,3,1
2,2,27,1,30,5,10,0,15,5,30,2,0,0,2,0,30,4,11,0,15,2,30,8,7,0,15,4,30,6,0,0,6,1,-15,3,1
2,4,27,1,30,5,10,0,15,5,30,2,0,0,2,0,30,4,11,0,15,2,30,8,7,0,15,4,30,6,0,0,6,1,-15,3,1
2,0,29,0,30,8,6,0,14,6,30,8,4,0,12,3,30,7,7,0,14,0,30,1,13,0,14,1,30,9,0,0,9,1,-15,3,1
2,3,29,0,30,8,6,0,14,6,30,8,4,0,12,3,30,7,7,0,14,0,30,1,13,0,14,1,30,9,0,0,9,1,-15,3,1
2,2,43,0,30,4,10,0,14,6,30,6,0,0,6,0,30,4,10,0,14,1,30,1,13,0,14,6,30,5,0,0,5,1,-15,3,1
2,3,43,0,30,4,10,0,14,6,30,6,0,0,6,0,30,4,10,0,14,1,30,1,13,0,14,6,30,5,0,0,5,1,-15,3,1
2,4,43,0,30,4,10,0,14,6,30,6,0,0,6,0,30,4,10,0,14,1,30,1,13,0,14,6,30,5,0,0,5,1,-15,3,1
2,3,5,0,30,2,3,0,5,3,30,1,3,0,4,0,30,0,5,0,5,1,30,5,0,0,5,0,30,0,2,0,2,0,-27,3,0
2,4,17,3,30,9,5,0,14,3,30,6,0,0,6,0,30,3,11,0,14,0,30,7,7,0,14,6,30,4,0,0,4,1,-15,3,1
2,3,19,0,30,3,10,0,13,2,30,7,1,0,8,0,30,4,9,0,13,4,30,5,8,0,13,2,30,9,0,0,9,1,-15,3,1
2,4,23,0,30,7,6,0,13,0,30,6,0,0,6,4,30,13,0,0,13,0,30,5,8,0,13,2,30,5,1,0,6,1,-15,3,1
2,2,25,2,30,7,7,0,14,3,30,6,0,0,6,0,30,11,3,0,14,1,30,4,10,0,14,5,30,6,0,0,6,1,-15,3,1
2,2,27,1,30,4,11,0,15,3,30,1,1,0,2,0,30,6,9,0,15,4,30,6,9,0,15,4,30,6,0,0,6,1,-15,3,1
2,3,35,4,30,5,8,0,13,6,30,2,0,0,2,3,30,2,11,0,13,1,30,2,11,0,13,3,30,8,0,0,8,1,-15,3,1
2,2,4,2,30,8,0,0,8,4,30,4,0,0,4,6,30,2,6,0,8,0,30,3,5,0,8,1,30,3,1,0,4,0,-27,3,0
2,4,11,0,30,2,2,0,4,0,30,0,0,0,0,2,30,3,1,0,4,4,30,2,2,0,4,1,30,1,0,0,1,1,-15,3,1
2,2,11,0,30,5,7,0,12,1,30,4,0,0,4,0,30,7,5,0,12,7,30,7,5,0,12,2,30,4,0,0,4,1,-15,3,1
2,4,19,0,30,8,5,0,13,1,30,3,5,0,8,0,30,6,7,0,13,4,30,7,6,0,13,3,30,8,1,0,9,1,-15,3,1
2,2,27,1,30,5,10,0,15,3,30,2,0,0,2,4,30,6,9,0,15,0,30,11,4,0,15,0,30,2,4,0,6,1,-15,3,1
2,3,27,1,30,5,10,0,15,3,30,2,0,0,2,4,30,6,9,0,15,0,30,11,4,0,15,0,30,2,4,0,6,1,-15,3,1
2,1,29,1,30,9,5,0,14,4,30,11,1,0,12,0,30,8,6,0,14,0,30,1,13,0,14,3,30,9,0,0,9,1,-15,3,1
2,4,29,1,30,9,5,0,14,4,30,11,1,0,12,0,30,8,6,0,14,0,30,1,13,0,14,3,30,9,0,0,9,1,-15,3,1
2,2,31,3,30,7,5,0,12,5,30,8,0,0,8,3,30,8,4,0,12,0,30,3,9,0,12,3,30,2,4,0,6,1,-15,3,1
2,3,31,3,30,7,5,0,12,5,30,8,0,0,8,3,30,8,4,0,12,0,30,3,9,0,12,3,30,2,4,0,6,1,-15,3,1
2,4,31,3,30,7,5,0,12,5,30,8,0,0,8,3,30,8,4,0,12,0,30,3,9,0,12,3,30,2,4,0,6,1,-15,3,1
2,1,4,2,30,6,2,0,8,5,30,4,0,0,4,0,30,1,7,0,8,0,30,7,1,0,8,2,30,2,2,0,4,0,-27,3,0
2,1,5,0,30,2,3,0,5,3,30,0,4,0,4,0,30,0,5,0,5,3,30,3,2,0,5,1,30,2,0,0,2,0,-27,3,0
2,4,5,0,30,2,3,0,5,3,30,0,4,0,4,0,30,0,5,0,5,3,30,3,2,0,5,1,30,2,0,0,2,0,-27,3,0
2,2,13,2,30,7,0,0,7,0,30,4,0,0,4,2,30,7,0,0,7,8,30,6,1,0,7,1,30,4,0,0,4,1,-15,3,1
2,4,15,0,30,4,9,0,13,0,30,6,0,0,6,0,30,3,10,0,13,1,30,6,7,0,13,2,30,5,4,0,9,1,-15,3,1
2,3,19,0,30,3,10,0,13,2,30,4,4,0,8,0,30,8,5,0,13,3,30,9,4,0,13,2,30,8,1,0,9,1,-15,3,1
2,4,25,1,30,3,11,0,14,4,30,6,0,0,6,1,30,14,0,0,14,1,30,5,9,0,14,2,30,5,1,0,6,1,-15,3,1
2,4,29,0,30,7,7,0,14,6,30,9,3,0,12,0,30,3,11,0,14,0,30,0,14,0,14,4,30,9,0,0,9,1,-15,3,1
2,0,43,0,30,5,9,0,14,8,30,6,0,0,6,0,30,4,10,0,14,1,30,7,7,0,14,8,30,5,0,0,5,1,-15,3,1
2,0,47,0,30,2,12,0,14,7,30,4,0,0,4,0,30,3,11,0,14,2,30,8,6,0,14,9,30,7,0,0,7,1,-15,3,1
2,3,47,0,30,2,12,0,14,7,30,4,0,0,4,0,30,3,11,0,14,2,30,8,6,0,14,9,30,7,0,0,7,1,-15,3,1
2,1,5,0,30,1,4,0,5,2,30,2,2,0,4,0,30,1,4,0,5,0,30,2,3,0,5,2,30,2,0,0,2,0,-27,3,0
2,2,13,2,30,5,2,0,7,0,30,4,0,0,4,1,30,7,0,0,7,9,30,6,1,0,7,4,30,4,0,0,4,1,-15,3,1
2,4,22,2,30,8,0,0,8,3,30,2,0,0,2,0,30,4,4,0,8,1,30,4,4,0,8,1,30,2,2,0,4,1,-15,3,1
2,4,25,1,30,8,6,0,14,3,30,6,0,0,6,0,30,9,5,0,14,1,30,5,9,0,14,4,30,5,1,0,6,1,-15,3,1
2,3,31,1,30,6,6,0,12,5,30,8,0,0,8,3,30,8,4,0,12,0,30,7,5,0,12,0,30,6,0,0,6,1,-15,3,1
2,0,4,2,30,6,2,0,8,4,30,2,2,0,4,0,30,3,5,0,8,0,30,8,0,0,8,3,30,4,0,0,4,0,-27,3,0
2,3,8,1,30,7,0,0,7,4,30,2,0,0,2,5,30,4,3,0,7,2,30,7,0,0,7,1,30,3,0,0,3,0,-27,3,0
2,3,15,0,30,3,10,0,13,0,30,6,0,0,6,0,30,9,4,0,13,1,30,2,11,0,13,2,30,6,3,0,9,1,-15,3,1
2,4,15,0,30,3,10,0,13,0,30,6,0,0,6,0,30,9,4,0,13,1,30,2,11,0,13,2,30,6,3,0,9,1,-15,3,1
2,2,17,2,30,8,6,0,14,2,30,6,0,0,6,0,30,7,7,0,14,5,30,6,8,0,14,5,30,4,0,0,4,1,-15,3,1
2,1,25,2,30,6,8,0,14,2,30,6,0,0,6,0,30,10,4,0,14,1,30,5,9,0,14,3,30,5,1,0,6,1,-15,3,1
2,2,25,2,30,6,8,0,14,2,30,6,0,0,6,0,30,10,4,0,14,1,30,5,9,0,14,3,30,5,1,0,6,1,-15,3,1
2,4,25,2,30,6,8,0,14,2,30,6,0,0,6,0,30,10,4,0,14,1,30,5,9,0,14,3,30,5,1,0,6,1,-15,3,1
2,0,27,1,30,4,11,0,15,3,30,1,1,0,2,0,30,6,9,0,15,2,30,6,9,0,15,4,30,6,0,0,6,1,-15,3,1
2,1,27,1,30,4,11,0,15,3,30,1,1,0,2,0,30,6,9,0,15,2,30,6,9,0,15,4,30,6,0,0,6,1,-15,3,1
2,2,27,1,30,4,11,0,15,3,30,1,1,0,2,0,30,6,9,0,15,2,30,6,9,0,15,4,30,6,0,0,6,1,-15,3,1
2,3,27,1,30,4,11,0,15,3,30,1,1,0,2,0,30,6,9,0,15,2,30,6,9,0,15,4,30,6,0,0,6,1,-15,3,1
2,1,31,4,30,6,6,0,12,5,30,8,0,0,8,4,30,9,3,0,12,0,30,5,7,0,12,0,30,5,1,0,6,1,-15,3,1
2,3,31,4,30,6,6,0,12,5,30,8,0,0,8,4,30,9,3,0,12,0,30,5,7,0,12,0,30,5,1,0,6,1,-15,3,1
2,2,39,0,30,4,7,0,11,6,30,6,0,0,6,0,30,7,4,0,11,0,30,4,7,0,11,5,30,5,0,0,5,1,-15,3,1
2,3,39,0,30,4,7,0,11,6,30,6,0,0,6,0,30,7,4,0,11,0,30,4,7,0,11,5,30,5,0,0,5,1,-15,3,1
2,2,17,5,30,8,6,0,14,2,30,6,0,0,6,0,30,9,5,0,14,4,30,6,8,0,14,7,30,4,0,0,4,1,-15,3,1
2,1,19,0,30,4,9,0,13,1,30,6,2,0,8,0,30,7,6,0,13,0,30,9,4,0,13,1,30,6,3,0,9,1,-15,3,1
2,4,19,0,30,4,9,0,13,1,30,6,2,0,8,0,30,7,6,0,13,0,30,9,4,0,13,0,30,6,3,0,9,1,-15,3,1
2,2,25,0,30,8,6,0,14,4,30,6,0,0,6,0,30,9,5,0,14,1,30,5,9,0,14,5,30,6,0,0,6,1,-15,3,1
2,4,25,0,30,8,6,0,14,4,30,6,0,0,6,0,30,9,5,0,14,1,30,5,9,0,14,5,30,6,0,0,6,1,-15,3,1
2,1,27,0,30,4,11,0,15,4,30,2,0,0,2,0,30,3,12,0,15,1,30,5,10,0,15,5,30,6,0,0,6,1,-15,3,1
2,2,27,0,30,4,11,0,15,4,30,2,0,0,2,0,30,3,12,0,15,1,30,5,10,0,15,5,30,6,0,0,6,1,-15,3,1
2,3,27,0,30,4,11,0,15,4,30,2,0,0,2,0,30,3,12,0,15,1,30,5,10,0,15,5,30,6,0,0,6,1,-15,3,1
2,1,33,1,30,5,6,0,11,4,30,4,0,0,4,1,30,8,3,0,11,6,30,4,7,0,11,6,30,4,0,0,4,1,-15,3,1
2,3,33,1,30,5,6,0,11,4,30,4,0,0,4,1,30,8,3,0,11,6,30,4,7,0,11,6,30,4,0,0,4,1,-15,3,1
2,4,33,1,30,5,6,0,11,4,30,4,0,0,4,1,30,8,3,0,11,6,30,4,7,0,11,6,30,4,0,0,4,1,-15,3,1
2,2,35,0,30,8,5,0,13,6,30,2,0,0,2,1,30,2,11,0,13,3,30,4,9,0,13,4,30,8,0,0,8,1,-15,3,1
2,3,8,1,30,7,0,0,7,4,30,2,0,0,2,0,30,2,5,0,7,1,30,7,0,0,7,0,30,3,0,0,3,0,-27,3,0
2,3,23,2,30,4,9,0,13,3,30,6,0,0,6,3,30,13,0,0,13,0,30,6,7,0,13,1,30,6,0,0,6,1,-15,3,1
2,2,25,1,30,9,5,0,14,5,30,6,0,0,6,0,30,5,9,0,14,1,30,5,9,0,14,6,30,5,1,0,6,1,-15,3,1
2,4,25,1,30,9,5,0,14,5,30,6,0,0,6,0,30,5,9,0,14,1,30,5,9,0,14,6,30,5,1,0,6,1,-15,3,1
2,1,27,1,30,3,12,0,15,4,30,2,0,0,2,0,30,10,5,0,15,0,30,6,9,0,15,1,30,4,2,0,6,1,-15,3,1
2,2,27,1,30,3,12,0,15,4,30,2,0,0,2,0,30,10,5,0,15,0,30,6,9,0,15,1,30,4,2,0,6,1,-15,3,1
2,1,29,1,30,6,8,0,14,6,30,7,5,0,12,0,30,3,11,0,14,0,30,10,4,0,14,3,30,9,0,0,9,1,-15,3,1
2,2,29,1,30,6,8,0,14,6,30,7,5,0,12,0,30,3,11,0,14,0,30,10,4,0,14,3,30,9,0,0,9,1,-15,3,1
2,2,47,0,30,0,14,0,14,7,30,4,0,0,4,5,30,5,9,0,14,0,30,2,12,0,14,5,30,7,0,0,7,1,-15,3,1
2,3,47,0,30,0,14,0,14,7,30,4,0,0,4,5,30,5,9,0,14,0,30,2,12,0,14,5,30,7,0,0,7,1,-15,3,1
2,0,4,2,30,8,0,0,8,5,30,4,0,0,4,0,30,2,6,0,8,1,30,8,0,0,8,2,30,3,1,0,4,0,-27,3,0
2,4,11,1,30,3,9,0,12,1,30,4,0,0,4,0,30,5,7,0,12,3,30,3,9,0,12,3,30,4,0,0,4,1,-15,3,1
2,2,13,2,30,6,1,0,7,0,30,4,0,0,4,0,30,7,0,0,7,6,30,6,1,0,7,6,30,4,0,0,4,1,-15,3,1
2,3,13,2,30,6,1,0,7,0,30,4,0,0,4,0,30,7,0,0,7,6,30,6,1,0,7,6,30,4,0,0,4,1,-15,3,1
2,4,13,2,30,6,1,0,7,0,30,4,0,0,4,0,30,7,0,0,7,6,30,6,1,0,7,6,30,4,0,0,4,1,-15,3,1
2,4,17,4,30,10,4,0,14,2,30,6,0,0,6,0,30,7,7,0,14,2,30,8,6,0,14,2,30,4,0,0,4,1,-15,3,1
2,3,19,0,30,4,9,0,13,1,30,6,2,0,8,0,30,7,6,0,13,0,30,6,7,0,13,0,30,5,4,0,9,1,-15,3,1
2,3,25,1,30,9,5,0,14,3,30,6,0,0,6,0,30,6,8,0,14,1,30,5,9,0,14,3,30,5,1,0,6,1,-15,3,1
2,0,29,0,30,9,5,0,14,6,30,8,4,0,12,0,30,3,11,0,14,0,30,1,13,0,14,3,30,9,0,0,9,1,-15,3,1
2,1,29,0,30,9,5,0,14,6,30,8,4,0,12,0,30,3,11,0,14,0,30,1,13,0,14,3,30,9,0,0,9,1,-15,3,1
2,2,29,0,30,9,5,0,14,6,30,8,4,0,12,0,30,3,11,0,14,0,30,1,13,0,14,3,30,9,0,0,9,1,-15,3,1
2,3,43,0,30,7,7,0,14,6,30,6,0,0,6,3,30,13,1,0,14,1,30,1,13,0,14,0,30,4,1,0,5,1,-15,3,1
2,4,43,0,30,7,7,0,14,6,30,6,0,0,6,3,30,13,1,0,14,1,30,1,13,0,14,0,30,4,1,0,5,1,-15,3,1
2,3,8,2,30,7,0,0,7,5,30,2,0,0,2,0,30,2,5,0,7,2,30,7,0,0,7,1,30,3,0,0,3,0,-27,3,0
2,4,13,3,30,6,1,0,7,0,30,4,0,0,4,2,30,6,1,0,7,7,30,5,2,0,7,1,30,4,0,0,4,1,-15,3,1
2,4,22,1,30,6,2,0,8,3,30,2,0,0,2,4,30,5,3,0,8,1,30,5,3,0,8,1,30,2,2,0,4,1,-15,3,1
2,3,25,2,30,4,10,0,14,5,30,6,0,0,6,0,30,6,8,0,14,1,30,7,7,0,14,4,30,6,0,0,6,1,-15,3,1
2,4,25,2,30,4,10,0,14,5,30,6,0,0,6,0,30,6,8,0,14,1,30,7,7,0,14,4,30,6,0,0,6,1,-15,3,1
2,4,26,0,30,7,2,0,9,5,30,4,0,0,4,1,30,0,9,0,9,0,30,4,5,0,9,6,30,3,0,0,3,1,-15,3,1
2,0,27,1,30,5,10,0,15,3,30,2,0,0,2,0,30,3,12,0,15,2,30,8,7,0,15,6,30,6,0,0,6,1,-15,3,1
2,2,27,1,30,5,10,0,15,3,30,2,0,0,2,0,30,3,12,0,15,2,30,8,7,0,15,6,30,6,0,0,6,1,-15,3,1
2,3,27,1,30,5,10,0,15,3,30,2,0,0,2,0,30,3,12,0,15,2,30,8,7,0,15,6,30,6,0,0,6,1,-15,3,1
2,4,27,1,30,5,10,0,15,3,30,2,0,0,2,0,30,3,12,0,15,2,30,8,7,0,15,6,30,6,0,0,6,1,-15,3,1
2,3,29,0,30,8,6,0,14,4,30,12,0,0,12,0,30,8,6,0,14,0,30,1,13,0,14,0,30,5,4,0,9,1,-15,3,1
2,3,39,0,30,3,8,0,11,7,30,6,0,0,6,0,30,4,7,0,11,1,30,5,6,0,11,4,30,5,0,0,5,1,-15,3,1
2,4,39,0,30,3,8,0,11,7,30,6,0,0,6,0,30,4,7,0,11,1,30,5,6,0,11,4,30,5,0,0,5,1,-15,3,1
2,4,47,0,30,0,14,0,14,7,30,4,0,0,4,0,30,3,11,0,14,0,30,2,12,0,14,6,30,7,0,0,7,1,-15,3,1
2,3,7,0,30,1,3,0,4,2,30,2,0,0,2,1,30,3,1,0,4,2,30,2,2,0,4,2,30,1,1,0,2,0,-27,3,0
2,4,7,0,30,1,3,0,4,2,30,2,0,0,2,1,30,3,1,0,4,2,30,2,2,0,4,2,30,1,1,0,2,0,-27,3,0
2,3,8,1,30,7,0,0,7,4,30,2,0,0,2,7,30,3,4,0,7,0,30,4,3,0,7,0,30,3,0,0,3,0,-27,3,0
2,4,11,0,30,5,7,0,12,1,30,4,0,0,4,0,30,5,7,0,12,0,30,5,7,0,12,3,30,4,0,0,4,1,-15,3,1
2,3,13,5,30,6,1,0,7,0,30,4,0,0,4,3,30,7,0,0,7,3,30,6,1,0,7,5,30,4,0,0,4,1,-15,3,1
2,0,17,2,30,10,4,0,14,4,30,6,0,0,6,0,30,3,11,0,14,1,30,9,5,0,14,3,30,4,0,0,4,1,-15,3,1
2,3,17,2,30,10,4,0,14,4,30,6,0,0,6,0,30,3,11,0,14,1,30,9,5,0,14,3,30,4,0,0,4,1,-15,3,1
2,1,19,1,30,3,10,0,13,2,30,6,2,0,8,0,30,5,8,0,13,3,30,4,9,0,13,1,30,9,0,0,9,1,-15,3,1
2,2,19,1,30,3,10,0,13,2,30,6,2,0,8,0,30,5,8,0,13,3,30,4,9,0,13,1,30,9,0,0,9,1,-15,3,1
2,4,22,4,30,6,2,0,8,3,30,2,0,0,2,5,30,4,4,0,8,1,30,2,6,0,8,1,30,1,3,0,4,1,-15,3,1
2,0,29,0,30,5,9,0,14,6,30,11,1,0,12,0,30,4,10,0,14,0,30,2,12,0,14,3,30,9,0,0,9,1,-15,3,1
2,4,29,0,30,5,9,0,14,6,30,11,1,0,12,0,30,4,10,0,14,0,30,2,12,0,14,3,30,9,0,0,9,1,-15,3,1
2,1,39,3,30,4,7,0,11,6,30,6,0,0,6,0,30,8,3,0,11,0,30,2,9,0,11,3,30,5,0,0,5,1,-15,3,1
2,2,39,3,30,4,7,0,11,6,30,6,0,0,6,0,30,8,3,0,11,0,30,2,9,0,11,3,30,5,0,0,5,1,-15,3,1
2,3,8,3,30,7,0,0,7,5,30,2,0,0,2,4,30,2,5,0,7,1,30,7,0,0,7,3,30,3,0,0,3,0,-27,3,0
2,4,8,3,30,7,0,0,7,5,30,2,0,0,2,4,30,2,5,0,7,1,30,7,0,0,7,3,30,3,0,0,3,0,-27,3,0
2,4,11,2,30,4,8,0,12,0,30,4,0,0,4,0,30,9,3,0,12,7,30,4,8,0,12,6,30,4,0,0,4,1,-15,3,1
2,2,17,3,30,8,6,0,14,3,30,6,0,0,6,0,30,6,8,0,14,1,30,8,6,0,14,3,30,4,0,0,4,1,-15,3,1
2,2,8,2,30,7,0,0,7,4,30,2,0,0,2,4,30,3,4,0,7,0,30,6,1,0,7,1,30,3,0,0,3,0,-27,3,0
2,3,8,2,30,7,0,0,7,4,30,2,0,0,2,4,30,3,4,0,7,0,30,6,1,0,7,1,30,3,0,0,3,0,-27,3,0
2,3,17,3,30,9,5,0,14,2,30,6,0,0,6,0,30,6,8,0,14,5,30,3,11,0,14,3,30,4,0,0,4,1,-15,3,1
2,1,19,0,30,4,9,0,13,2,30,4,4,0,8,0,30,4,9,0,13,4,30,7,6,0,13,2,30,8,1,0,9,1,-15,3,1
2,2,19,0,30,4,9,0,13,2,30,4,4,0,8,0,30,4,9,0,13,4,30,7,6,0,13,2,30,8,1,0,9,1,-15,3,1
2,4,23,2,30,6,7,0,13,1,30,6,0,0,6,1,30,13,0,0,13,1,30,6,7,0,13,0,30,5,1,0,6,1,-15,3,1
2,2,25,2,30,5,9,0,14,4,30,6,0,0,6,0,30,9,5,0,14,1,30,5,9,0,14,3,30,6,0,0,6,1,-15,3,1
2,3,25,2,30,5,9,0,14,4,30,6,0,0,6,0,30,9,5,0,14,1,30,5,9,0,14,3,30,6,0,0,6,1,-15,3,1
2,4,25,2,30,5,9,0,14,4,30,6,0,0,6,0,30,9,5,0,14,1,30,5,9,0,14,3,30,6,0,0,6,1,-15,3,1
2,0,27,1,30,4,11,0,15,5,30,2,0,0,2,0,30,3,12,0,15,0,30,6,9,0,15,3,30,6,0,0,6,1,-15,3,1
2,2,47,0,30,0,14,0,14,6,30,4,0,0,4,4,30,3,11,0,14,0,30,2,12,0,14,5,30,7,0,0,7,1,-15,3,1
2,3,47,0,30,0,14,0,14,6,30,4,0,0,4,4,30,3,11,0,14,0,30,2,12,0,14,5,30,7,0,0,7,1,-15,3,1
2,4,4,1,30,8,0,0,8,5,30,4,0,0,4,0,30,1,7,0,8,2,30,7,1,0,8,1,30,2,2,0,4,0,-27,3,0
2,2,11,0,30,2,2,0,4,0,30,0,0,0,0,1,30,4,0,0,4,4,30,4,0,0,4,2,30,1,0,0,1,1,-15,3,1
2,4,17,2,30,8,6,0,14,1,30,6,0,0,6,0,30,9,5,0,14,1,30,5,9,0,14,5,30,4,0,0,4,1,-15,3,1
2,3,23,2,30,4,9,0,13,3,30,6,0,0,6,6,30,12,1,0,13,0,30,5,8,0,13,2,30,6,0,0,6,1,-15,3,1
2,2,27,1,30,3,12,0,15,3,30,2,0,0,2,0,30,2,13,0,15,0,30,7,8,0,15,5,30,6,0,0,6,1,-15,3,1
2,4,27,0,30,3,12,0,15,3,30,2,0,0,2,0,30,2,13,0,15,0,30,7,8,0,15,5,30,6,0,0,6,1,-15,3,1
2,3,29,1,30,8,6,0,14,5,30,12,0,0,12,0,30,6,8,0,14,0,30,1,13,0,14,1,30,8,1,0,9,1,-15,3,1
2,4,29,1,30,8,6,0,14,5,30,12,0,0,12,0,30,6,8,0,14,0,30,1,13,0,14,1,30,8,1,0,9,1,-15,3,1
2,3,31,3,30,8,4,0,12,4,30,8,0,0,8,3,30,8,4,0,12,0,30,3,9,0,12,0,30,2,4,0,6,1,-15,3,1
2,3,43,0,30,5,9,0,14,8,30,6,0,0,6,0,30,4,10,0,14,1,30,3,11,0,14,9,30,5,0,0,5,1,-15,3,1
2,0,6,0,30,8,1,0,9,4,30,2,0,0,2,0,30,3,6,0,9,0,30,5,4,0,9,0,30,5,0,0,5,0,-27,3,0
2,1,6,0,30,8,1,0,9,4,30,2,0,0,2,0,30,3,6,0,9,0,30,5,4,0,9,0,30,5,0,0,5,0,-27,3,0
2,3,8,2,30,7,0,0,7,5,30,2,0,0,2,0,30,1,6,0,7,0,30,2,5,0,7,4,30,3,0,0,3,0,-27,3,0
2,1,13,1,30,3,4,0,7,0,30,4,0,0,4,2,30,5,2,0,7,9,30,5,2,0,7,5,30,4,0,0,4,1,-15,3,1
2,2,13,1,30,3,4,0,7,0,30,4,0,0,4,2,30,5,2,0,7,9,30,5,2,0,7,5,30,4,0,0,4,1,-15,3,1
2,0,17,3,30,11,3,0,14,3,30,6,0,0,6,0,30,3,11,0,14,4,30,6,8,0,14,4,30,4,0,0,4,1,-15,3,1
2,3,17,3,30,11,3,0,14,3,30,6,0,0,6,0,30,3,11,0,14,4,30,6,8,0,14,4,30,4,0,0,4,1,-15,3,1
2,0,21,4,30,8,2,0,10,4,30,6,0,0,6,1,30,3,7,0,10,2,30,4,6,0,10,2,30,4,0,0,4,1,-15,3,1
2,0,25,2,30,8,6,0,14,5,30,6,0,0,6,0,30,6,8,0,14,1,30,5,9,0,14,5,30,5,1,0,6,1,-15,3,1
2,2,27,1,30,3,12,0,15,4,30,1,1,0,2,0,30,4,11,0,15,3,30,5,10,0,15,4,30,6,0,0,6,1,-15,3,1
2,4,27,1,30,3,12,0,15,4,30,1,1,0,2,0,30,4,11,0,15,3,30,5,10,0,15,4,30,6,0,0,6,1,-15,3,1
2,2,29,0,30,8,6,0,14,5,30,10,2,0,12,0,30,4,10,0,14,0,30,0,14,0,14,0,30,8,1,0,9,1,-15,3,1
2,3,29,0,30,8,6,0,14,5,30,10,2,0,12,0,30,4,10,0,14,0,30,0,14,0,14,0,30,8,1,0,9,1,-15,3,1
2,1,13,3,30,4,3,0,7,0,30,4,0,0,4,5,30,6,1,0,7,7,30,6,1,0,7,7,30,4,0,0,4,1,-15,3,1
2,2,17,3,30,11,3,0,14,2,30,6,0,0,6,0,30,5,9,0,14,1,30,3,11,0,14,2,30,4,0,0,4,1,-15,3,1
2,3,17,3,30,11,3,0,14,2,30,6,0,0,6,0,30,5,9,0,14,1,30,3,11,0,14,2,30,4,0,0,4,1,-15,3,1
2,4,19,0,30,2,11,0,13,2,30,6,2,0,8,0,30,5,8,0,13,0,30,4,9,0,13,0,30,7,2,0,9,1,-15,3,1
2,2,33,3,30,2,9,0,11,4,30,4,0,0,4,0,30,11,0,0,11,2,30,3,8,0,11,7,30,4,0,0,4,1,-15,3,1
2,3,33,3,30,2,9,0,11,4,30,4,0,0,4,0,30,11,0,0,11,2,30,3,8,0,11,7,30,4,0,0,4,1,-15,3,1
2,4,3,0,30,0,4,0,4,2,30,4,0,0,4,2,30,2,2,0,4,0,30,3,1,0,4,0,30,1,2,0,3,0,-27,3,0
2,4,13,2,30,7,0,0,7,0,30,4,0,0,4,2,30,6,1,0,7,13,30,6,1,0,7,3,30,4,0,0,4,1,-15,3,1
2,2,21,2,30,7,3,0,10,4,30,6,0,0,6,1,30,3,7,0,10,3,30,5,5,0,10,2,30,4,0,0,4,1,-15,3,1
2,3,21,2,30,7,3,0,10,4,30,6,0,0,6,1,30,3,7,0,10,3,30,5,5,0,10,2,30,4,0,0,4,1,-15,3,1
2,1,25,1,30,5,9,0,14,5,30,6,0,0,6,1,30,9,5,0,14,2,30,6,8,0,14,3,30,6,0,0,6,1,-15,3,1
2,2,25,1,30,5,9,0,14,5,30,6,0,0,6,1,30,9,5,0,14,2,30,6,8,0,14,3,30,6,0,0,6,1,-15,3,1
2,3,25,1,30,5,9,0,14,5,30,6,0,0,6,1,30,9,5,0,14,2,30,6,8,0,14,3,30,6,0,0,6,1,-15,3,1
2,1,31,4,30,7,5,0,12,3,30,8,0,0,8,3,30,12,0,0,12,0,30,3,9,0,12,0,30,2,4,0,6,1,-15,3,1
2,4,31,4,30,7,5,0,12,3,30,8,0,0,8,3,30,12,0,0,12,0,30,3,9,0,12,0,30,2,4,0,6,1,-15,3,1
2,2,43,8,30,8,6,0,14,11,30,6,0,0,6,0,30,4,10,0,14,1,30,3,11,0,14,3,30,5,0,0,5,1,-15,3,1
2,4,43,8,30,8,6,0,14,11,30,6,0,0,6,0,30,4,10,0,14,1,30,3,11,0,14,3,30,5,0,0,5,1,-15,3,1
2,4,15,2,30,4,9,0,13,1,30,6,0,0,6,0,30,4,9,0,13,1,30,2,11,0,13,2,30,7,2,0,9,1,-15,3,1
2,2,25,3,30,6,8,0,14,5,30,6,0,0,6,0,30,6,8,0,14,1,30,5,9,0,14,4,30,5,1,0,6,1,-15,3,1
2,4,25,3,30,6,8,0,14,5,30,6,0,0,6,0,30,6,8,0,14,1,30,5,9,0,14,4,30,5,1,0,6,1,-15,3,1
2,2,27,2,30,9,6,0,15,4,30,2,0,0,2,0,30,6,9,0,15,0,30,4,11,0,15,1,30,4,2,0,6,1,-15,3,1
2,4,27,2,30,9,6,0,15,4,30,2,0,0,2,0,30,6,9,0,15,0,30,4,11,0,15,1,30,4,2,0,6,1,-15,3,1
2,1,35,0,30,6,7,0,13,5,30,1,1,0,2,1,30,6,7,0,13,0,30,4,9,0,13,6,30,8,0,0,8,1,-15,3,1
2,3,35,0,30,6,7,0,13,5,30,1,1,0,2,1,30,6,7,0,13,0,30,4,9,0,13,6,30,8,0,0,8,1,-15,3,1
2,3,1,0,30,7,3,0,10,4,30,2,0,0,2,0,30,4,6,0,10,1,30,9,1,0,10,8,30,6,0,0,6,0,-27,3,0
2,0,5,0,30,2,3,0,5,3,30,4,0,0,4,3,30,0,5,0,5,0,30,1,4,0,5,0,30,1,1,0,2,0,-27,3,0
2,2,13,3,30,7,0,0,7,0,30,4,0,0,4,2,30,7,0,0,7,7,30,5,2,0,7,1,30,4,0,0,4,1,-15,3,1
2,4,13,3,30,7,0,0,7,0,30,4,0,0,4,2,30,7,0,0,7,7,30,5,2,0,7,1,30,4,0,0,4,1,-15,3,1
2,3,17,2,30,10,4,0,14,3,30,6,0,0,6,0,30,4,10,0,14,1,30,7,7,0,14,1,30,4,0,0,4,1,-15,3,1
2,4,17,2,30,10,4,0,14,3,30,6,0,0,6,0,30,4,10,0,14,1,30,7,7,0,14,1,30,4,0,0,4,1,-15,3,1
2,2,19,0,30,5,8,0,13,1,30,7,1,0,8,0,30,7,6,0,13,3,30,4,9,0,13,1,30,6,3,0,9,1,-15,3,1
2,3,19,0,30,5,8,0,13,1,30,7,1,0,8,0,30,7,6,0,13,3,30,4,9,0,13,1,30,6,3,0,9,1,-15,3,1
2,4,22,4,30,6,2,0,8,3,30,2,0,0,2,0,30,5,3,0,8,1,30,1,7,0,8,1,30,4,0,0,4,1,-15,3,1
2,2,25,1,30,6,8,0,14,4,30,6,0,0,6,0,30,8,6,0,14,2,30,6,8,0,14,4,30,5,1,0,6,1,-15,3,1
2,3,25,1,30,6,8,0,14,4,30,6,0,0,6,0,30,8,6,0,14,2,30,6,8,0,14,4,30,5,1,0,6,1,-15,3,1
2,0,27,1,30,5,10,0,15,3,30,2,0,0,2,0,30,5,10,0,15,2,30,6,9,0,15,3,30,6,0,0,6,1,-15,3,1
2,1,27,1,30,5,10,0,15,3,30,2,0,0,2,0,30,5,10,0,15,2,30,6,9,0,15,3,30,6,0,0,6,1,-15,3,1
2,3,27,1,30,5,10,0,15,3,30,2,0,0,2,0,30,5,10,0,15,0,30,6,9,0,15,3,30,6,0,0,6,1,-15,3,1
2,4,31,1,30,5,7,0,12,4,30,8,0,0,8,3,30,11,1,0,12,0,30,5,7,0,12,3,30,5,1,0,6,1,-15,3,1
2,3,38,0,30,4,6,0,10,7,30,6,0,0,6,0,30,1,9,0,10,0,30,3,7,0,10,7,30,6,0,0,6,1,-15,3,1
2,2,43,0,30,8,6,0,14,8,30,6,0,0,6,0,30,4,10,0,14,1,30,4,10,0,14,6,30,5,0,0,5,1,-15,3,1
2,4,43,0,30,8,6,0,14,8,30,6,0,0,6,0,30,4,10,0,14,1,30,4,10,0,14,6,30,5,0,0,5,1,-15,3,1
2,0,5,0,30,2,3,0,5,3,30,3,1,0,4,0,30,0,5,0,5,0,30,1,4,0,5,2,30,0,2,0,2,0,-27,3,0
2,4,17,0,30,8,6,0,14,3,30,6,0,0,6,0,30,4,10,0,14,3,30,7,7,0,14,0,30,4,0,0,4,1,-15,3,1
2,4,19,0,30,2,11,0,13,0,30,8,0,0,8,0,30,6,7,0,13,0,30,4,9,0,13,1,30,8,1,0,9,1,-15,3,1
2,3,25,1,30,7,7,0,14,4,30,6,0,0,6,0,30,9,5,0,14,1,30,4,10,0,14,2,30,5,1,0,6,1,-15,3,1
2,4,25,1,30,7,7,0,14,4,30,6,0,0,6,0,30,9,5,0,14,1,30,4,10,0,14,2,30,5,1,0,6,1,-15,3,1
2,1,27,2,30,4,11,0,15,4,30,2,0,0,2,0,30,8,7,0,15,0,30,6,9,0,15,1,30,5,1,0,6,1,-15,3,1
2,3,29,0,30,6,8,0,14,6,30,12,0,0,12,0,30,6,8,0,14,1,30,1,13,0,14,0,30,9,0,0,9,1,-15,3,1
2,4,29,0,30,6,8,0,14,6,30,12,0,0,12,0,30,6,8,0,14,1,30,1,13,0,14,0,30,9,0,0,9,1,-15,3,1
2,2,35,0,30,8,5,0,13,4,30,2,0,0,2,1,30,2,11,0,13,4,30,3,10,0,13,8,30,8,0,0,8,1,-15,3,1
2,3,35,0,30,8,5,0,13,4,30,2,0,0,2,1,30,2,11,0,13,4,30,3,10,0,13,8,30,8,0,0,8,1,-15,3,1
2,4,1,0,30,7,3,0,10,4,30,2,0,0,2,0,30,4,6,0,10,1,30,7,3,0,10,6,30,6,0,0,6,0,-27,3,0
2,0,5,0,30,2,3,0,5,3,30,2,2,0,4,0,30,0,5,0,5,0,30,3,2,0,5,4,30,2,0,0,2,0,-27,3,0
2,1,5,0,30,2,3,0,5,3,30,2,2,0,4,0,30,0,5,0,5,0,30,3,2,0,5,4,30,2,0,0,2,0,-27,3,0
2,3,5,0,30,2,3,0,5,3,30,2,2,0,4,0,30,0,5,0,5,0,30,3,2,0,5,4,30,2,0,0,2,0,-27,3,0
2,1,13,4,30,3,0,0,3,1,30,2,0,0,2,0,30,3,0,0,3,4,30,2,1,0,3,2,30,2,0,0,2,1,-15,3,1
2,0,19,0,30,6,7,0,13,2,30,4,4,0,8,0,30,4,9,0,13,10,30,8,5,0,13,0,30,9,0,0,9,1,-15,3,1
2,1,19,0,30,6,7,0,13,2,30,4,4,0,8,0,30,4,9,0,13,10,30,8,5,0,13,0,30,9,0,0,9,1,-15,3,1
2,1,25,2,30,5,9,0,14,2,30,6,0,0,6,0,30,10,4,0,14,1,30,6,8,0,14,3,30,5,1,0,6,1,-15,3,1
2,2,25,2,30,5,9,0,14,2,30,6,0,0,6,0,30,10,4,0,14,1,30,6,8,0,14,3,30,5,1,0,6,1,-15,3,1
2,2,27,1,30,5,10,0,15,2,30,1,1,0,2,0,30,5,10,0,15,2,30,3,12,0,15,1,30,6,0,0,6,1,-15,3,1
2,4,27,1,30,5,10,0,15,2,30,1,1,0,2,0,30,5,10,0,15,2,30,3,12,0,15,1,30,6,0,0,6,1,-15,3,1
2,3,47,0,30,2,12,0,14,6,30,4,0,0,4,0,30,3,11,0,14,1,30,3,11,0,14,8,30,7,0,0,7,1,-15,3,1
2,3,8,0,30,6,1,0,7,3,30,2,0,0,2,0,30,3,4,0,7,0,30,4,3,0,7,1,30,3,0,0,3,0,-27,3,0
2,4,8,0,30,6,1,0,7,3,30,2,0,0,2,0,30,3,4,0,7,0,30,4,3,0,7,1,30,3,0,0,3,0,-27,3,0
2,2,13,3,30,5,2,0,7,1,30,4,0,0,4,2,30,5,2,0,7,6,30,7,0,0,7,6,30,4,0,0,4,1,-15,3,1
2,3,13,3,30,5,2,0,7,1,30,4,0,0,4,2,30,5,2,0,7,6,30,7,0,0,7,6,30,4,0,0,4,1,-15,3,1
2,1,19,0,30,7,6,0,13,2,30,7,1,0,8,0,30,6,7,0,13,6,30,5,8,0,13,3,30,8,1,0,9,1,-15,3,1
2,2,21,2,30,6,4,0,10,4,30,6,0,0,6,5,30,3,7,0,10,3,30,4,6,0,10,0,30,4,0,0,4,1,-15,3,1
2,3,21,2,30,6,4,0,10,4,30,6,0,0,6,5,30,3,7,0,10,3,30,4,6,0,10,0,30,4,0,0,4,1,-15,3,1
2,4,23,2,30,6,7,0,13,3,30,6,0,0,6,6,30,9,4,0,13,0,30,6,7,0,13,0,30,6,0,0,6,1,-15,3,1
2,0,27,2,30,4,11,0,15,3,30,1,1,0,2,0,30,6,9,0,15,2,30,9,6,0,15,2,30,2,4,0,6,1,-15,3,1
2,4,29,0,30,8,6,0,14,6,30,8,4,0,12,0,30,5,9,0,14,0,30,5,9,0,14,2,30,9,0,0,9,1,-15,3,1
2,3,31,2,30,9,3,0,12,3,30,8,0,0,8,0,30,10,2,0,12,0,30,3,9,0,12,0,30,4,2,0,6,1,-15,3,1
2,4,31,2,30,9,3,0,12,3,30,8,0,0,8,0,30,10,2,0,12,0,30,3,9,0,12,0,30,4,2,0,6,1,-15,3,1
2,3,32,0,30,7,2,0,9,5,30,2,0,0,2,1,30,4,5,0,9,1,30,2,7,0,9,2,30,2,0,0,2,1,-15,3,1
2,4,32,0,30,7,2,0,9,5,30,2,0,0,2,1,30,4,5,0,9,1,30,2,7,0,9,2,30,2,0,0,2,1,-15,3,1
2,3,39,0,30,4,7,0,11,6,30,6,0,0,6,4,30,6,5,0,11,0,30,2,9,0,11,6,30,5,0,0,5,1,-15,3,1
2,2,47,0,30,8,6,0,14,8,30,4,0,0,4,0,30,5,9,0,14,0,30,2,12,0,14,0,30,7,0,0,7,1,-15,3,1
2,3,1,0,30,4,6,0,10,4,30,2,0,0,2,1,30,4,6,0,10,5,30,9,1,0,10,6,30,6,0,0,6,0,-27,3,0
2,4,1,0,30,4,6,0,10,4,30,2,0,0,2,1,30,4,6,0,10,5,30,9,1,0,10,6,30,6,0,0,6,0,-27,3,0
2,4,4,2,30,7,1,0,8,5,30,4,0,0,4,1,30,2,6,0,8,0,30,7,1,0,8,0,30,4,0,0,4,0,-27,3,0
2,0,5,0,30,2,3,0,5,3,30,4,0,0,4,0,30,0,5,0,5,1,30,3,2,0,5,0,30,0,2,0,2,0,-27,3,0
2,1,5,0,30,2,3,0,5,3,30,4,0,0,4,0,30,0,5,0,5,1,30,3,2,0,5,0,30,0,2,0,2,0,-27,3,0
2,2,5,0,30,2,3,0,5,3,30,4,0,0,4,0,30,0,5,0,5,1,30,3,2,0,5,0,30,0,2,0,2,0,-27,3,0
2,3,5,0,30,2,3,0,5,3,30,4,0,0,4,0,30,0,5,0,5,1,30,3,2,0,5,0,30,0,2,0,2,0,-27,3,0
2,4,5,0,30,2,3,0,5,3,30,4,0,0,4,0,30,0,5,0,5,1,30,3,2,0,5,0,30,0,2,0,2,0,-27,3,0
2,0,19,0,30,3,10,0,13,2,30,4,4,0,8,0,30,6,7,0,13,1,30,6,7,0,13,3,30,9,0,0,9,1,-15,3,1
2,3,25,2,30,9,5,0,14,3,30,6,0,0,6,0,30,8,6,0,14,1,30,5,9,0,14,2,30,5,1,0,6,1,-15,3,1
2,4,25,2,30,9,5,0,14,3,30,6,0,0,6,0,30,8,6,0,14,1,30,5,9,0,14,2,30,5,1,0,6,1,-15,3,1
2,1,27,1,30,5,10,0,15,3,30,2,0,0,2,0,30,7,8,0,15,0,30,5,10,0,15,2,30,6,0,0,6,1,-15,3,1
2,3,27,1,30,5,10,0,15,3,30,2,0,0,2,0,30,7,8,0,15,0,30,5,10,0,15,2,30,6,0,0,6,1,-15,3,1
2,4,27,1,30,5,10,0,15,3,30,2,0,0,2,0,30,7,8,0,15,0,30,5,10,0,15,2,30,6,0,0,6,1,-15,3,1
2,4,8,0,30,7,0,0,7,3,30,2,0,0,2,0,30,5,2,0,7,0,30,5,2,0,7,2,30,3,0,0,3,0,-27,3,0
2,2,11,1,30,4,8,0,12,1,30,4,0,0,4,2,30,4,8,0,12,6,30,4,8,0,12,5,30,4,0,0,4,1,-15,3,1
2,3,11,1,30,4,8,0,12,1,30,4,0,0,4,2,30,4,8,0,12,6,30,4,8,0,12,5,30,4,0,0,4,1,-15,3,1
2,4,11,1,30,4,8,0,12,1,30,4,0,0,4,2,30,4,8,0,12,6,30,4,8,0,12,5,30,4,0,0,4,1,-15,3,1
2,1,17,3,30,9,5,0,14,2,30,6,0,0,6,0,30,6,8,0,14,2,30,7,7,0,14,2,30,4,0,0,4,1,-15,3,1
2,3,17,3,30,9,5,0,14,2,30,6,0,0,6,0,30,6,8,0,14,2,30,7,7,0,14,2,30,4,0,0,4,1,-15,3,1
2,4,17,3,30,9,5,0,14,2,30,6,0,0,6,0,30,6,8,0,14,2,30,7,7,0,14,2,30,4,0,0,4,1,-15,3,1
2,2,19,0,30,6,7,0,13,1,30,8,0,0,8,4,30,6,7,0,13,0,30,3,10,0,13,0,30,7,2,0,9,1,-15,3,1
2,3,19,0,30,6,7,0,13,1,30,8,0,0,8,4,30,6,7,0,13,0,30,3,10,0,13,0,30,7,2,0,9,1,-15,3,1
2,4,19,0,30,6,7,0,13,1,30,8,0,0,8,4,30,6,7,0,13,0,30,3,10,0,13,0,30,7,2,0,9,1,-15,3,1
2,4,23,2,30,5,8,0,13,1,30,6,0,0,6,2,30,12,1,0,13,2,30,5,8,0,13,0,30,6,0,0,6,1,-15,3,1
2,1,25,1,30,7,7,0,14,1,30,6,0,0,6,0,30,8,6,0,14,1,30,7,7,0,14,5,30,6,0,0,6,1,-15,3,1
2,2,25,1,30,7,7,0,14,1,30,6,0,0,6,0,30,8,6,0,14,1,30,7,7,0,14,5,30,6,0,0,6,1,-15,3,1
2,0,27,1,30,4,11,0,15,5,30,1,1,0,2,2,30,4,11,0,15,2,30,5,10,0,15,3,30,6,0,0,6,1,-15,3,1
2,1,27,1,30,4,11,0,15,5,30,1,1,0,2,2,30,4,11,0,15,2,30,5,10,0,15,3,30,6,0,0,6,1,-15,3,1
2,3,29,0,30,7,7,0,14,6,30,12,0,0,12,0,30,3,11,0,14,0,30,2,12,0,14,1,30,9,0,0,9,1,-15,3,1
2,3,5,0,30,1,4,0,5,2,30,4,0,0,4,0,30,0,5,0,5,0,30,1,4,0,5,2,30,2,0,0,2,0,-27,3,0
2,3,8,4,30,7,0,0,7,3,30,2,0,0,2,1,30,2,5,0,7,3,30,6,1,0,7,2,30,3,0,0,3,0,-27,3,0
2,4,19,1,30,6,7,0,13,1,30,5,3,0,8,0,30,7,6,0,13,0,30,6,7,0,13,2,30,5,4,0,9,1,-15,3,1
2,2,25,2,30,4,10,0,14,5,30,6,0,0,6,0,30,8,6,0,14,1,30,11,3,0,14,1,30,5,1,0,6,1,-15,3,1
2,4,25,2,30,4,10,0,14,5,30,6,0,0,6,0,30,8,6,0,14,1,30,11,3,0,14,1,30,5,1,0,6,1,-15,3,1
2,0,27,2,30,7,8,0,15,4,30,1,1,0,2,0,30,6,9,0,15,1,30,5,10,0,15,0,30,4,2,0,6,1,-15,3,1
2,0,31,1,30,7,5,0,12,5,30,8,0,0,8,3,30,9,3,0,12,4,30,7,5,0,12,1,30,4,2,0,6,1,-15,3,1
2,3,39,0,30,4,7,0,11,6,30,6,0,0,6,3,30,7,4,0,11,0,30,4,7,0,11,3,30,4,1,0,5,1,-15,3,1
2,4,39,0,30,4,7,0,11,6,30,6,0,0,6,3,30,7,4,0,11,0,30,4,7,0,11,3,30,4,1,0,5,1,-15,3,1
2,4,15,0,30,4,9,0,13,1,30,6,0,0,6,0,30,3,10,0,13,2,30,3,10,0,13,2,30,9,0,0,9,1,-15,3,1
2,4,17,3,30,10,4,0,14,3,30,6,0,0,6,5,30,7,7,0,14,0,30,5,9,0,14,3,30,4,0,0,4,1,-15,3,1
2,3,19,1,30,3,10,0,13,2,30,3,5,0,8,0,30,8,5,0,13,2,30,5,8,0,13,0,30,8,1,0,9,1,-15,3,1
2,2,23,2,30,6,7,0,13,3,30,6,0,0,6,4,30,11,2,0,13,0,30,5,8,0,13,2,30,6,0,0,6,1,-15,3,1
2,3,23,2,30,6,7,0,13,3,30,6,0,0,6,4,30,11,2,0,13,0,30,5,8,0,13,2,30,6,0,0,6,1,-15,3,1
2,4,23,2,30,6,7,0,13,3,30,6,0,0,6,4,30,11,2,0,13,0,30,5,8,0,13,2,30,6,0,0,6,1,-15,3,1
2,4,25,1,30,8,6,0,14,4,30,6,0,0,6,0,30,6,8,0,14,0,30,5,9,0,14,4,30,5,1,0,6,1,-15,3,1
2,1,26,0,30,7,2,0,9,5,30,4,0,0,4,5,30,0,9,0,9,1,30,1,8,0,9,6,30,3,0,0,3,1,-15,3,1
2,0,27,1,30,5,10,0,15,4,30,1,1,0,2,0,30,6,9,0,15,1,30,5,10,0,15,2,30,6,0,0,6,1,-15,3,1
2,1,27,1,30,5,10,0,15,4,30,1,1,0,2,0,30,6,9,0,15,1,30,5,10,0,15,2,30,6,0,0,6,1,-15,3,1
2,3,29,0,30,6,8,0,14,6,30,10,2,0,12,0,30,3,11,0,14,0,30,0,14,0,14,1,30,9,0,0,9,1,-15,3,1
2,4,29,0,30,6,8,0,14,6,30,10,2,0,12,0,30,3,11,0,14,0,30,0,14,0,14,1,30,9,0,0,9,1,-15,3,1
2,2,33,1,30,3,8,0,11,5,30,4,0,0,4,1,30,9,2,0,11,2,30,3,8,0,11,4,30,4,0,0,4,1,-15,3,1
2,3,33,1,30,3,8,0,11,5,30,4,0,0,4,1,30,9,2,0,11,2,30,3,8,0,11,4,30,4,0,0,4,1,-15,3,1
2,1,4,2,30,8,0,0,8,4,30,4,0,0,4,4,30,1,7,0,8,0,30,6,2,0,8,1,30,3,1,0,4,0,-27,3,0
2,2,4,2,30,8,0,0,8,4,30,4,0,0,4,4,30,1,7,0,8,0,30,6,2,0,8,1,30,3,1,0,4,0,-27,3,0
2,4,6,1,30,7,2,0,9,4,30,2,0,0,2,0,30,2,7,0,9,0,30,4,5,0,9,1,30,4,1,0,5,0,-27,3,0
2,3,19,0,30,2,11,0,13,3,30,7,1,0,8,0,30,4,9,0,13,5,30,7,6,0,13,0,30,9,0,0,9,1,-15,3,1
2,4,23,1,30,9,4,0,13,0,30,6,0,0,6,2,30,12,1,0,13,0,30,5,8,0,13,2,30,5,1,0,6,1,-15,3,1
2,3,27,1,30,9,6,0,15,0,30,2,0,0,2,0,30,11,4,0,15,0,30,4,11,0,15,2,30,3,3,0,6,1,-15,3,1
2,2,35,0,30,6,7,0,13,4,30,2,0,0,2,1,30,5,8,0,13,5,30,4,9,0,13,8,30,8,0,0,8,1,-15,3,1
2,3,35,0,30,6,7,0,13,4,30,2,0,0,2,1,30,5,8,0,13,5,30,4,9,0,13,8,30,8,0,0,8,1,-15,3,1
2,2,9,0,30,2,2,0,4,2,30,2,0,0,2,0,30,3,1,0,4,4,30,0,4,0,4,1,30,1,0,0,1,0,-27,3,0
2,3,9,0,30,2,2,0,4,2,30,2,0,0,2,0,30,3,1,0,4,4,30,0,4,0,4,1,30,1,0,0,1,0,-27,3,0
2,2,11,0,30,7,5,0,12,1,30,4,0,0,4,0,30,5,7,0,12,8,30,3,9,0,12,5,30,4,0,0,4,1,-15,3,1
2,2,13,2,30,7,0,0,7,1,30,4,0,0,4,1,30,6,1,0,7,9,30,5,2,0,7,0,30,4,0,0,4,1,-15,3,1
2,4,13,2,30,7,0,0,7,1,30,4,0,0,4,1,30,6,1,0,7,9,30,5,2,0,7,0,30,4,0,0,4,1,-15,3,1
2,3,15,0,30,4,9,0,13,1,30,6,0,0,6,0,30,4,9,0,13,1,30,7,6,0,13,1,30,5,4,0,9,1,-15,3,1
2,4,15,0,30,4,9,0,13,1,30,6,0,0,6,0,30,4,9,0,13,1,30,7,6,0,13,1,30,5,4,0,9,1,-15,3,1
2,2,17,0,30,11,3,0,14,2,30,6,0,0,6,0,30,5,9,0,14,3,30,3,11,0,14,2,30,4,0,0,4,1,-15,3,1
2,4,17,0,30,11,3,0,14,2,30,6,0,0,6,0,30,5,9,0,14,3,30,3,11,0,14,2,30,4,0,0,4,1,-15,3,1
2,2,25,1,30,4,10,0,14,5,30,6,0,0,6,0,30,7,7,0,14,1,30,10,4,0,14,3,30,6,0,0,6,1,-15,3,1
2,1,27,2,30,6,9,0,15,1,30,2,0,0,2,0,30,11,4,0,15,0,30,7,8,0,15,0,30,4,2,0,6,1,-15,3,1
2,2,27,2,30,6,9,0,15,1,30,2,0,0,2,0,30,11,4,0,15,0,30,7,8,0,15,0,30,4,2,0,6,1,-15,3,1
2,4,29,0,30,5,9,0,14,6,30,12,0,0,12,0,30,3,11,0,14,0,30,1,13,0,14,4,30,9,0,0,9,1,-15,3,1
2,4,39,0,30,1,10,0,11,6,30,6,0,0,6,0,30,5,6,0,11,2,30,4,7,0,11,4,30,5,0,0,5,1,-15,3,1
2,4,1,0,30,7,3,0,10,4,30,2,0,0,2,1,30,4,6,0,10,2,30,6,4,0,10,4,30,6,0,0,6,0,-27,3,0
2,3,5,0,30,1,4,0,5,3,30,2,2,0,4,3,30,0,5,0,5,0,30,1,4,0,5,0,30,1,1,0,2,0,-27,3,0
2,1,13,1,30,5,2,0,7,0,30,4,0,0,4,2,30,7,0,0,7,10,30,6,1,0,7,4,30,4,0,0,4,1,-15,3,1
2,2,13,1,30,5,2,0,7,0,30,4,0,0,4,2,30,7,0,0,7,10,30,6,1,0,7,4,30,4,0,0,4,1,-15,3,1
2,4,13,1,30,5,2,0,7,0,30,4,0,0,4,2,30,7,0,0,7,10,30,6,1,0,7,4,30,4,0,0,4,1,-15,3,1
2,2,19,1,30,4,9,0,13,3,30,7,1,0,8,0,30,4,9,0,13,7,30,6,7,0,13,1,30,8,1,0,9,1,-15,3,1
2,4,19,1,30,4,9,0,13,3,30,7,1,0,8,0,30,4,9,0,13,7,30,6,7,0,13,1,30,8,1,0,9,1,-15,3,1
2,4,23,1,30,7,6,0,13,2,30,6,0,0,6,0,30,12,1,0,13,0,30,6,7,0,13,2,30,6,0,0,6,1,-15,3,1
2,2,25,1,30,6,8,0,14,4,30,6,0,0,6,0,30,10,4,0,14,1,30,5,9,0,14,2,30,5,1,0,6,1,-15,3,1
2,1,27,2,30,5,10,0,15,3,30,1,1,0,2,0,30,7,8,0,15,0,30,6,9,0,15,3,30,5,1,0,6,1,-15,3,1
2,4,29,6,30,7,7,0,14,6,30,12,0,0,12,0,30,6,8,0,14,0,30,0,14,0,14,0,30,8,1,0,9,1,-15,3,1
2,1,31,5,30,3,9,0,12,5,30,8,0,0,8,3,30,6,6,0,12,0,30,3,9,0,12,1,30,2,4,0,6,1,-15,3,1
2,2,31,5,30,3,9,0,12,5,30,8,0,0,8,3,30,6,6,0,12,0,30,3,9,0,12,1,30,2,4,0,6,1,-15,3,1
2,4,31,5,30,3,9,0,12,5,30,8,0,0,8,0,30,6,6,0,12,0,30,3,9,0,12,1,30,2,4,0,6,1,-15,3,1
2,4,32,0,30,6,3,0,9,4,30,2,0,0,2,2,30,8,1,0,9,1,30,3,6,0,9,2,30,2,0,0,2,1,-15,3,1
2,4,39,0,30,5,6,0,11,6,30,6,0,0,6,0,30,8,3,0,11,0,30,4,7,0,11,0,30,5,0,0,5,1,-15,3,1
2,4,5,0,30,1,4,0,5,3,30,2,2,0,4,1,30,0,5,0,5,0,30,1,4,0,5,2,30,2,0,0,2,0,-27,3,0
2,4,8,4,30,7,0,0,7,4,30,2,0,0,2,0,30,4,3,0,7,0,30,4,3,0,7,0,30,3,0,0,3,0,-27,3,0
2,4,13,1,30,5,2,0,7,1,30,4,0,0,4,3,30,7,0,0,7,11,30,5,2,0,7,0,30,4,0,0,4,1,-15,3,1
2,4,17,3,30,11,3,0,14,0,30,6,0,0,6,0,30,7,7,0,14,1,30,5,9,0,14,2,30,4,0,0,4,1,-15,3,1
2,2,19,0,30,4,9,0,13,2,30,5,3,0,8,0,30,5,8,0,13,2,30,8,5,0,13,1,30,9,0,0,9,1,-15,3,1
2,3,19,0,30,4,9,0,13,2,30,5,3,0,8,0,30,5,8,0,13,2,30,8,5,0,13,1,30,9,0,0,9,1,-15,3,1
2,4,19,0,30,4,9,0,13,2,30,5,3,0,8,0,30,5,8,0,13,2,30,8,5,0,13,1,30,9,0,0,9,1,-15,3,1
2,1,13,5,30,5,2,0,7,0,30,4,0,0,4,1,30,7,0,0,7,7,30,7,0,0,7,4,30,4,0,0,4,1,-15,3,1
2,2,19,0,30,3,10,0,13,2,30,4,4,0,8,0,30,5,8,0,13,3,30,5,8,0,13,0,30,9,0,0,9,1,-15,3,1
2,4,22,1,30,7,1,0,8,2,30,2,0,0,2,0,30,4,4,0,8,0,30,2,6,0,8,2,30,2,2,0,4,1,-15,3,1
2,3,25,1,30,6,8,0,14,4,30,6,0,0,6,0,30,9,5,0,14,1,30,9,5,0,14,3,30,5,1,0,6,1,-15,3,1
2,4,25,1,30,6,8,0,14,4,30,6,0,0,6,0,30,9,5,0,14,1,30,9,5,0,14,3,30,5,1,0,6,1,-15,3,1
2,1,27,1,30,5,10,0,15,2,30,1,1,0,2,0,30,4,11,0,15,4,30,4,11,0,15,4,30,6,0,0,6,1,-15,3,1
2,2,27,1,30,5,10,0,15,2,30,1,1,0,2,0,30,4,11,0,15,4,30,4,11,0,15,4,30,6,0,0,6,1,-15,3,1
2,4,27,1,30,5,10,0,15,2,30,1,1,0,2,0,30,4,11,0,15,4,30,4,11,0,15,4,30,6,0,0,6,1,-15,3,1
2,4,29,0,30,6,8,0,14,6,30,11,1,0,12,0,30,3,11,0,14,0,30,0,14,0,14,2,30,9,0,0,9,1,-15,3,1
2,2,35,0,30,8,5,0,13,4,30,2,0,0,2,1,30,6,7,0,13,2,30,9,4,0,13,6,30,8,0,0,8,1,-15,3,1
2,4,35,0,30,8,5,0,13,4,30,2,0,0,2,1,30,6,7,0,13,2,30,9,4,0,13,6,30,8,0,0,8,1,-15,3,1
2,1,37,2,30,8,3,0,11,6,30,8,0,0,8,3,30,5,6,0,11,4,30,3,8,0,11,7,30,6,0,0,6,1,-15,3,1
2,3,37,2,30,8,3,0,11,6,30,8,0,0,8,3,30,5,6,0,11,4,30,3,8,0,11,7,30,6,0,0,6,1,-15,3,1
2,3,39,0,30,7,4,0,11,7,30,6,0,0,6,0,30,4,7,0,11,0,30,3,8,0,11,1,30,5,0,0,5,1,-15,3,1
2,4,39,0,30,7,4,0,11,7,30,6,0,0,6,0,30,4,7,0,11,0,30,3,8,0,11,1,30,5,0,0,5,1,-15,3,1
2,4,41,0,30,7,5,0,12,5,30,8,0,0,8,0,30,8,4,0,12,0,30,3,9,0,12,3,30,2,5,0,7,1,-15,3,1
2,4,15,1,30,5,8,0,13,1,30,5,1,0,6,0,30,3,10,0,13,1,30,6,7,0,13,3,30,7,2,0,9,1,-15,3,1
2,1,17,3,30,10,4,0,14,2,30,6,0,0,6,0,30,5,9,0,14,0,30,5,9,0,14,1,30,4,0,0,4,1,-15,3,1
2,2,17,3,30,10,4,0,14,2,30,6,0,0,6,0,30,5,9,0,14,0,30,5,9,0,14,1,30,4,0,0,4,1,-15,3,1
2,2,21,2,30,8,2,0,10,3,30,5,1,0,6,2,30,4,6,0,10,3,30,4,6,0,10,4,30,3,1,0,4,1,-15,3,1
2,2,27,0,30,5,10,0,15,4,30,1,1,0,2,0,30,5,10,0,15,2,30,7,8,0,15,5,30,6,0,0,6,1,-15,3,1
2,3,27,0,30,5,10,0,15,4,30,1,1,0,2,0,30,5,10,0,15,2,30,7,8,0,15,5,30,6,0,0,6,1,-15,3,1
2,4,31,3,30,6,6,0,12,4,30,8,0,0,8,3,30,10,2,0,12,0,30,4,8,0,12,0,30,3,3,0,6,1,-15,3,1
2,4,32,0,30,6,3,0,9,4,30,2,0,0,2,0,30,6,3,0,9,1,30,2,7,0,9,4,30,2,0,0,2,1,-15,3,1
2,1,4,2,30,6,2,0,8,4,30,4,0,0,4,1,30,2,6,0,8,0,30,5,3,0,8,1,30,4,0,0,4,0,-27,3,0
2,3,8,2,30,7,0,0,7,4,30,2,0,0,2,0,30,3,4,0,7,1,30,7,0,0,7,0,30,3,0,0,3,0,-27,3,0
2,4,8,2,30,7,0,0,7,4,30,2,0,0,2,0,30,3,4,0,7,1,30,7,0,0,7,0,30,3,0,0,3,0,-27,3,0
2,3,17,3,30,7,7,0,14,3,30,6,0,0,6,0,30,7,7,0,14,2,30,10,4,0,14,2,30,4,0,0,4,1,-15,3,1
2,2,23,2,30,3,10,0,13,3,30,6,0,0,6,6,30,12,1,0,13,0,30,6,7,0,13,4,30,6,0,0,6,1,-15,3,1
2,4,23,2,30,3,10,0,13,3,30,6,0,0,6,6,30,12,1,0,13,0,30,6,7,0,13,4,30,6,0,0,6,1,-15,3,1
2,0,27,1,30,6,9,0,15,4,30,2,0,0,2,0,30,5,10,0,15,4,30,6,9,0,15,5,30,6,0,0,6,1,-15,3,1
2,3,27,1,30,6,9,0,15,4,30,2,0,0,2,0,30,5,10,0,15,4,30,6,9,0,15,5,30,6,0,0,6,1,-15,3,1
2,3,29,0,30,6,8,0,14,6,30,12,0,0,12,0,30,3,11,0,14,0,30,6,8,0,14,0,30,8,1,0,9,1,-15,3,1
2,4,29,0,30,6,8,0,14,6,30,12,0,0,12,0,30,3,11,0,14,0,30,6,8,0,14,0,30,8,1,0,9,1,-15,3,1
2,2,31,1,30,11,1,0,12,3,30,8,0,0,8,3,30,8,4,0,12,0,30,3,9,0,12,0,30,2,4,0,6,1,-15,3,1
2,4,35,0,30,9,4,0,13,4,30,2,0,0,2,1,30,6,7,0,13,2,30,1,12,0,13,4,30,8,0,0,8,1,-15,3,1
2,2,43,0,30,6,8,0,14,7,30,6,0,0,6,0,30,4,10,0,14,1,30,1,13,0,14,7,30,5,0,0,5,1,-15,3,1
2,3,43,0,30,6,8,0,14,7,30,6,0,0,6,0,30,4,10,0,14,1,30,1,13,0,14,7,30,5,0,0,5,1,-15,3,1
2,1,4,0,30,7,1,0,8,4,30,2,2,0,4,0,30,1,7,0,8,0,30,6,2,0,8,3,30,4,0,0,4,0,-27,3,0
2,1,13,4,30,7,0,0,7,0,30,4,0,0,4,2,30,6,1,0,7,6,30,5,2,0,7,2,30,4,0,0,4,1,-15,3,1
2,2,13,4,30,7,0,0,7,0,30,4,0,0,4,2,30,6,1,0,7,6,30,5,2,0,7,2,30,4,0,0,4,1,-15,3,1
2,3,13,4,30,7,0,0,7,0,30,4,0,0,4,2,30,6,1,0,7,6,30,5,2,0,7,2,30,4,0,0,4,1,-15,3,1
2,4,21,2,30,5,5,0,10,3,30,6,0,0,6,1,30,3,7,0,10,6,30,4,6,0,10,4,30,4,0,0,4,1,-15,3,1
2,0,4,3,30,8,0,0,8,5,30,4,0,0,4,0,30,1,7,0,8,0,30,5,3,0,8,1,30,3,1,0,4,0,-27,3,0
2,2,4,3,30,8,0,0,8,5,30,4,0,0,4,0,30,1,7,0,8,0,30,5,3,0,8,1,30,3,1,0,4,0,-27,3,0
2,3,4,3,30,8,0,0,8,5,30,4,0,0,4,0,30,1,7,0,8,0,30,5,3,0,8,1,30,3,1,0,4,0,-27,3,0
2,2,5,0,30,2,3,0,5,2,30,4,0,0,4,0,30,0,5,0,5,0,30,2,3,0,5,0,30,0,2,0,2,0,-27,3,0
2,3,5,0,30,2,3,0,5,2,30,4,0,0,4,0,30,0,5,0,5,0,30,2,3,0,5,0,30,0,2,0,2,0,-27,3,0
2,4,8,1,30,7,0,0,7,4,30,2,0,0,2,3,30,4,3,0,7,1,30,7,0,0,7,1,30,3,0,0,3,0,-27,3,0
2,2,13,1,30,3,0,0,3,0,30,2,0,0,2,0,30,3,0,0,3,11,30,2,1,0,3,4,30,2,0,0,2,1,-15,3,1
2,2,13,2,30,5,2,0,7,0,30,4,0,0,4,6,30,6,1,0,7,8,30,6,1,0,7,0,30,4,0,0,4,1,-15,3,1
2,3,17,2,30,10,4,0,14,2,30,6,0,0,6,0,30,4,10,0,14,0,30,5,9,0,14,5,30,4,0,0,4,1,-15,3,1
2,4,17,2,30,10,4,0,14,2,30,6,0,0,6,0,30,4,10,0,14,0,30,5,9,0,14,5,30,4,0,0,4,1,-15,3,1
2,1,19,0,30,4,9,0,13,1,30,6,2,0,8,0,30,7,6,0,13,1,30,5,8,0,13,1,30,9,0,0,9,1,-15,3,1
2,2,19,0,30,4,9,0,13,1,30,6,2,0,8,0,30,7,6,0,13,1,30,5,8,0,13,1,30,9,0,0,9,1,-15,3,1
2,0,27,1,30,6,9,0,15,3,30,2,0,0,2,0,30,3,12,0,15,4,30,5,10,0,15,4,30,6,0,0,6,1,-15,3,1
2,1,27,1,30,6,9,0,15,3,30,2,0,0,2,0,30,3,12,0,15,4,30,5,10,0,15,4,30,6,0,0,6,1,-15,3,1
2,3,27,1,30,6,9,0,15,3,30,2,0,0,2,0,30,3,12,0,15,4,30,5,10,0,15,4,30,6,0,0,6,1,-15,3,1
2,3,11,1,30,3,9,0,12,1,30,4,0,0,4,1,30,6,6,0,12,6,30,5,7,0,12,4,30,3,1,0,4,1,-15,3,1
2,4,11,1,30,3,9,0,12,1,30,4,0,0,4,1,30,6,6,0,12,6,30,5,7,0,12,4,30,3,1,0,4,1,-15,3,1
2,2,13,1,30,6,1,0,7,0,30,4,0,0,4,2,30,6,1,0,7,6,30,6,1,0,7,6,30,4,0,0,4,1,-15,3,1
2,2,17,4,30,9,5,0,14,3,30,6,0,0,6,0,30,5,9,0,14,1,30,6,8,0,14,4,30,4,0,0,4,1,-15,3,1
2,3,17,4,30,9,5,0,14,3,30,6,0,0,6,0,30,5,9,0,14,1,30,6,8,0,14,4,30,4,0,0,4,1,-15,3,1
2,1,19,0,30,4,9,0,13,1,30,3,5,0,8,0,30,5,8,0,13,0,30,7,6,0,13,0,30,7,2,0,9,1,-15,3,1
2,2,21,2,30,6,4,0,10,4,30,6,0,0,6,1,30,3,7,0,10,3,30,4,6,0,10,1,30,4,0,0,4,1,-15,3,1
2,2,25,0,30,6,8,0,14,3,30,6,0,0,6,0,30,9,5,0,14,1,30,5,9,0,14,5,30,5,1,0,6,1,-15,3,1
2,0,27,1,30,4,11,0,15,4,30,2,0,0,2,0,30,6,9,0,15,2,30,6,9,0,15,7,30,6,0,0,6,1,-15,3,1
2,2,35,1,30,6,7,0,13,4,30,2,0,0,2,1,30,6,7,0,13,3,30,4,9,0,13,8,30,8,0,0,8,1,-15,3,1
2,3,35,1,30,6,7,0,13,4,30,2,0,0,2,1,30,6,7,0,13,3,30,4,9,0,13,8,30,8,0,0,8,1,-15,3,1
2,1,4,2,30,7,1,0,8,5,30,4,0,0,4,1,30,2,6,0,8,0,30,8,0,0,8,2,30,4,0,0,4,0,-27,3,0
2,3,4,2,30,7,1,0,8,5,30,4,0,0,4,1,30,2,6,0,8,0,30,8,0,0,8,2,30,4,0,0,4,0,-27,3,0
2,3,6,0,30,8,1,0,9,2,30,2,0,0,2,0,30,5,4,0,9,0,30,3,6,0,9,0,30,2,3,0,5,0,-27,3,0
2,3,15,0,30,3,10,0,13,1,30,6,0,0,6,0,30,3,10,0,13,1,30,3,10,0,13,2,30,8,1,0,9,1,-15,3,1
2,3,22,1,30,8,0,0,8,3,30,2,0,0,2,0,30,3,5,0,8,5,30,6,2,0,8,1,30,1,3,0,4,1,-15,3,1
2,4,22,1,30,8,0,0,8,3,30,2,0,0,2,0,30,3,5,0,8,5,30,6,2,0,8,1,30,1,3,0,4,1,-15,3,1
2,3,25,1,30,11,3,0,14,3,30,6,0,0,6,0,30,6,8,0,14,1,30,5,9,0,14,3,30,4,2,0,6,1,-15,3,1
2,4,25,1,30,11,3,0,14,3,30,6,0,0,6,0,30,6,8,0,14,1,30,5,9,0,14,3,30,4,2,0,6,1,-15,3,1
2,1,27,1,30,6,9,0,15,4,30,2,0,0,2,7,30,6,9,0,15,0,30,4,11,0,15,1,30,3,3,0,6,1,-15,3,1
2,3,31,3,30,4,8,0,12,5,30,8,0,0,8,4,30,11,1,0,12,0,30,5,7,0,12,2,30,5,1,0,6,1,-15,3,1
2,4,31,3,30,4,8,0,12,5,30,8,0,0,8,4,30,11,1,0,12,0,30,5,7,0,12,2,30,5,1,0,6,1,-15,3,1
2,4,35,0,30,6,7,0,13,3,30,2,0,0,2,1,30,10,3,0,13,3,30,4,9,0,13,5,30,8,0,0,8,1,-15,3,1
2,3,1,0,30,7,3,0,10,4,30,2,0,0,2,1,30,4,6,0,10,0,30,6,4,0,10,2,30,6,0,0,6,0,-27,3,0
2,4,8,1,30,7,0,0,7,5,30,2,0,0,2,7,30,2,5,0,7,1,30,7,0,0,7,0,30,2,1,0,3,0,-27,3,0
2,4,15,0,30,9,4,0,13,1,30,5,1,0,6,0,30,3,10,0,13,1,30,4,9,0,13,2,30,5,4,0,9,1,-15,3,1
2,3,17,3,30,8,6,0,14,4,30,6,0,0,6,0,30,4,10,0,14,0,30,7,7,0,14,0,30,4,0,0,4,1,-15,3,1
2,4,17,3,30,8,6,0,14,4,30,6,0,0,6,0,30,4,10,0,14,0,30,7,7,0,14,0,30,4,0,0,4,1,-15,3,1
2,2,19,4,30,7,6,0,13,2,30,3,5,0,8,0,30,7,6,0,13,2,30,4,9,0,13,2,30,9,0,0,9,1,-15,3,1
2,4,19,3,30,7,6,0,13,2,30,3,5,0,8,0,30,7,6,0,13,2,30,4,9,0,13,2,30,9,0,0,9,1,-15,3,1
2,1,25,1,30,5,9,0,14,3,30,6,0,0,6,0,30,7,7,0,14,1,30,5,9,0,14,5,30,6,0,0,6,1,-15,3,1
2,3,25,1,30,5,9,0,14,3,30,6,0,0,6,0,30,7,7,0,14,0,30,5,9,0,14,5,30,6,0,0,6,1,-15,3,1
2,4,25,1,30,5,9,0,14,3,30,6,0,0,6,0,30,7,7,0,14,0,30,5,9,0,14,5,30,6,0,0,6,1,-15,3,1
2,1,27,3,30,5,10,0,15,0,30,2,0,0,2,0,30,13,2,0,15,2,30,4,11,0,15,1,30,2,4,0,6,1,-15,3,1
2,2,27,3,30,5,10,0,15,0,30,2,0,0,2,0,30,13,2,0,15,2,30,4,11,0,15,1,30,2,4,0,6,1,-15,3,1
2,3,31,1,30,4,8,0,12,7,30,8,0,0,8,3,30,4,8,0,12,0,30,7,5,0,12,7,30,6,0,0,6,1,-15,3,1
2,3,39,0,30,2,9,0,11,7,30,6,0,0,6,0,30,4,7,0,11,2,30,4,7,0,11,3,30,5,0,0,5,1,-15,3,1
2,4,39,0,30,2,9,0,11,7,30,6,0,0,6,0,30,4,7,0,11,2,30,4,7,0,11,3,30,5,0,0,5,1,-15,3,1
2,2,1,0,30,7,3,0,10,4,30,2,0,0,2,1,30,4,6,0,10,5,30,9,1,0,10,7,30,6,0,0,6,0,-27,3,0
2,3,17,1,30,9,5,0,14,0,30,6,0,0,6,0,30,8,6,0,14,2,30,6,8,0,14,4,30,4,0,0,4,1,-15,3,1
2,4,17,1,30,9,5,0,14,0,30,6,0,0,6,0,30,8,6,0,14,2,30,6,8,0,14,4,30,4,0,0,4,1,-15,3,1
2,4,23,1,30,5,8,0,13,4,30,6,0,0,6,3,30,10,3,0,13,0,30,4,9,0,13,2,30,5,1,0,6,1,-15,3,1
2,4,25,0,30,11,3,0,14,0,30,6,0,0,6,0,30,9,5,0,14,1,30,5,9,0,14,3,30,5,1,0,6,1,-15,3,1
2,4,32,0,30,5,4,0,9,4,30,2,0,0,2,0,30,9,0,0,9,0,30,4,5,0,9,3,30,2,0,0,2,1,-15,3,1
2,2,39,0,30,7,4,0,11,6,30,6,0,0,6,0,30,6,5,0,11,1,30,3,8,0,11,4,30,5,0,0,5,1,-15,3,1
2,3,43,0,30,5,9,0,14,6,30,6,0,0,6,0,30,4,10,0,14,1,30,1,13,0,14,6,30,5,0,0,5,1,-15,3,1
2,0,4,2,30,5,3,0,8,4,30,2,2,0,4,1,30,1,7,0,8,0,30,6,2,0,8,3,30,4,0,0,4,0,-27,3,0
2,2,4,2,30,5,3,0,8,4,30,2,2,0,4,1,30,1,7,0,8,0,30,6,2,0,8,3,30,4,0,0,4,0,-27,3,0
2,3,19,0,30,4,9,0,13,1,30,5,3,0,8,0,30,7,6,0,13,4,30,5,8,0,13,1,30,8,1,0,9,1,-15,3,1
2,4,19,0,30,4,9,0,13,1,30,5,3,0,8,0,30,7,6,0,13,4,30,5,8,0,13,1,30,8,1,0,9,1,-15,3,1
2,3,23,2,30,8,5,0,13,0,30,6,0,0,6,4,30,13,0,0,13,0,30,5,8,0,13,1,30,5,1,0,6,1,-15,3,1
2,4,23,2,30,8,5,0,13,0,30,6,0,0,6,4,30,13,0,0,13,0,30,5,8,0,13,1,30,5,1,0,6,1,-15,3,1
2,3,25,4,30,4,10,0,14,2,30,6,0,0,6,0,30,11,3,0,14,1,30,4,10,0,14,3,30,5,1,0,6,1,-15,3,1
2,2,29,0,30,4,10,0,14,6,30,10,2,0,12,0,30,3,11,0,14,0,30,6,8,0,14,6,30,9,0,0,9,1,-15,3,1
2,4,29,0,30,4,10,0,14,6,30,10,2,0,12,0,30,3,11,0,14,0,30,6,8,0,14,6,30,9,0,0,9,1,-15,3,1
2,3,39,0,30,5,6,0,11,7,30,6,0,0,6,0,30,4,7,0,11,2,30,3,8,0,11,4,30,5,0,0,5,1,-15,3,1
2,3,43,5,30,10,4,0,14,7,30,6,0,0,6,0,30,4,10,0,14,0,30,1,13,0,14,5,30,5,0,0,5,1,-15,3,1
2,0,4,3,30,7,1,0,8,5,30,4,0,0,4,0,30,2,6,0,8,1,30,8,0,0,8,2,30,4,0,0,4,0,-27,3,0
2,1,4,3,30,7,1,0,8,5,30,4,0,0,4,0,30,2,6,0,8,1,30,8,0,0,8,2,30,4,0,0,4,0,-27,3,0
2,2,5,0,30,2,3,0,5,3,30,1,3,0,4,2,30,1,4,0,5,0,30,1,4,0,5,0,30,0,2,0,2,0,-27,3,0
2,3,7,0,30,2,2,0,4,2,30,2,0,0,2,0,30,1,3,0,4,0,30,0,4,0,4,3,30,1,1,0,2,0,-27,3,0
2,4,7,0,30,2,2,0,4,2,30,2,0,0,2,0,30,1,3,0,4,0,30,0,4,0,4,3,30,1,1,0,2,0,-27,3,0
2,3,8,0,30,7,0,0,7,3,30,2,0,0,2,3,30,4,3,0,7,0,30,5,2,0,7,0,30,3,0,0,3,0,-27,3,0
2,1,13,2,30,6,1,0,7,0,30,4,0,0,4,2,30,5,2,0,7,9,30,6,1,0,7,4,30,4,0,0,4,1,-15,3,1
2,3,15,0,30,7,6,0,13,0,30,6,0,0,6,0,30,3,10,0,13,1,30,4,9,0,13,2,30,8,1,0,9,1,-15,3,1
2,4,15,0,30,7,6,0,13,0,30,6,0,0,6,0,30,3,10,0,13,1,30,4,9,0,13,2,30,8,1,0,9,1,-15,3,1
2,4,17,1,30,8,6,0,14,1,30,6,0,0,6,0,30,9,5,0,14,0,30,5,9,0,14,5,30,4,0,0,4,1,-15,3,1
2,1,19,0,30,3,10,0,13,2,30,5,3,0,8,0,30,5,8,0,13,0,30,5,8,0,13,1,30,9,0,0,9,1,-15,3,1
2,3,19,0,30,3,10,0,13,2,30,5,3,0,8,0,30,5,8,0,13,0,30,5,8,0,13,1,30,9,0,0,9,1,-15,3,1
2,4,19,0,30,3,10,0,13,2,30,5,3,0,8,0,30,5,8,0,13,0,30,5,8,0,13,1,30,9,0,0,9,1,-15,3,1
2,3,25,2,30,5,9,0,14,1,30,6,0,0,6,0,30,12,2,0,14,1,30,5,9,0,14,3,30,6,0,0,6,1,-15,3,1
2,0,27,1,30,7,8,0,15,4,30,2,0,0,2,0,30,2,13,0,15,1,30,5,10,0,15,7,30,6,0,0,6,1,-15,3,1
2,1,27,1,30,7,8,0,15,4,30,2,0,0,2,0,30,2,13,0,15,1,30,5,10,0,15,7,30,6,0,0,6,1,-15,3,1
2,2,27,1,30,7,8,0,15,4,30,2,0,0,2,0,30,2,13,0,15,1,30,5,10,0,15,7,30,6,0,0,6,1,-15,3,1
2,4,32,0,30,6,3,0,9,4,30,2,0,0,2,0,30,9,0,0,9,1,30,4,5,0,9,5,30,2,0,0,2,1,-15,3,1
2,2,13,2,30,6,1,0,7,1,30,4,0,0,4,2,30,6,1,0,7,5,30,7,0,0,7,0,30,3,1,0,4,1,-15,3,1
2,4,17,3,30,9,5,0,14,1,30,6,0,0,6,0,30,8,6,0,14,2,30,5,9,0,14,5,30,4,0,0,4,1,-15,3,1
2,2,23,2,30,5,8,0,13,3,30,6,0,0,6,3,30,13,0,0,13,0,30,6,7,0,13,3,30,6,0,0,6,1,-15,3,1
2,3,23,2,30,5,8,0,13,3,30,6,0,0,6,3,30,13,0,0,13,0,30,6,7,0,13,3,30,6,0,0,6,1,-15,3,1
2,0,25,1,30,4,10,0,14,5,30,6,0,0,6,0,30,6,8,0,14,3,30,9,5,0,14,6,30,6,0,0,6,1,-15,3,1
2,4,25,1,30,4,10,0,14,5,30,6,0,0,6,0,30,6,8,0,14,3,30,9,5,0,14,2,30,6,0,0,6,1,-15,3,1
2,0,27,3,30,7,8,0,15,4,30,2,0,0,2,0,30,5,10,0,15,0,30,6,9,0,15,0,30,4,2,0,6,1,-15,3,1
2,2,27,3,30,7,8,0,15,4,30,2,0,0,2,0,30,5,10,0,15,0,30,6,9,0,15,0,30,4,2,0,6,1,-15,3,1
2,3,27,3,30,7,8,0,15,4,30,2,0,0,2,0,30,5,10,0,15,0,30,6,9,0,15,0,30,4,2,0,6,1,-15,3,1
2,4,27,3,30,7,8,0,15,4,30,2,0,0,2,0,30,5,10,0,15,0,30,6,9,0,15,0,30,4,2,0,6,1,-15,3,1
2,4,31,2,30,5,7,0,12,4,30,8,0,0,8,4,30,11,1,0,12,0,30,3,9,0,12,1,30,3,3,0,6,1,-15,3,1
2,4,35,0,30,7,6,0,13,4,30,2,0,0,2,2,30,6,7,0,13,0,30,1,12,0,13,4,30,8,0,0,8,1,-15,3,1
2,4,45,0,30,2,11,0,13,9,30,10,0,0,10,0,30,5,8,0,13,5,30,8,5,0,13,6,30,5,0,0,5,1,-15,3,1
2,0,11,3,30,3,9,0,12,2,30,4,0,0,4,0,30,5,7,0,12,7,30,4,8,0,12,2,30,4,0,0,4,1,-15,3,1
2,1,11,3,30,3,9,0,12,2,30,4,0,0,4,0,30,5,7,0,12,7,30,4,8,0,12,2,30,4,0,0,4,1,-15,3,1
2,2,11,3,30,3,9,0,12,2,30,4,0,0,4,0,30,5,7,0,12,7,30,4,8,0,12,2,30,4,0,0,4,1,-15,3,1
2,1,13,4,30,7,0,0,7,1,30,4,0,0,4,2,30,5,2,0,7,2,30,6,1,0,7,5,30,4,0,0,4,1,-15,3,1
2,3,13,4,30,7,0,0,7,1,30,4,0,0,4,2,30,5,2,0,7,2,30,6,1,0,7,1,30,4,0,0,4,1,-15,3,1
2,4,19,0,30,3,10,0,13,2,30,4,4,0,8,0,30,4,9,0,13,3,30,7,6,0,13,1,30,8,1,0,9,1,-15,3,1
2,4,22,2,30,8,0,0,8,3,30,2,0,0,2,0,30,4,4,0,8,0,30,6,2,0,8,4,30,4,0,0,4,1,-15,3,1
2,4,23,2,30,6,7,0,13,1,30,6,0,0,6,5,30,9,4,0,13,0,30,5,8,0,13,3,30,6,0,0,6,1,-15,3,1
2,0,31,1,30,4,8,0,12,8,30,8,0,0,8,3,30,4,8,0,12,2,30,9,3,0,12,5,30,6,0,0,6,1,-15,3,1
2,2,33,3,30,5,6,0,11,5,30,4,0,0,4,2,30,10,1,0,11,0,30,5,6,0,11,6,30,4,0,0,4,1,-15,3,1
2,3,33,3,30,5,6,0,11,5,30,4,0,0,4,2,30,10,1,0,11,0,30,5,6,0,11,6,30,4,0,0,4,1,-15,3,1
2,3,1,0,30,9,1,0,10,4,30,2,0,0,2,1,30,4,6,0,10,3,30,5,5,0,10,6,30,6,0,0,6,0,-27,3,0
2,4,15,1,30,6,7,0,13,1,30,6,0,0,6,0,30,3,10,0,13,1,30,3,10,0,13,0,30,7,2,0,9,1,-15,3,1
2,2,19,0,30,4,9,0,13,1,30,8,0,0,8,0,30,10,3,0,13,1,30,4,9,0,13,1,30,7,2,0,9,1,-15,3,1
2,2,23,5,30,10,3,0,13,4,30,6,0,0,6,0,30,6,7,0,13,3,30,8,5,0,13,4,30,6,0,0,6,1,-15,3,1
2,3,25,1,30,4,10,0,14,4,30,6,0,0,6,0,30,9,5,0,14,1,30,9,5,0,14,2,30,5,1,0,6,1,-15,3,1
2,1,27,3,30,5,10,0,15,3,30,2,0,0,2,0,30,6,9,0,15,0,30,4,11,0,15,0,30,3,3,0,6,1,-15,3,1
2,4,27,3,30,5,10,0,15,3,30,2,0,0,2,0,30,6,9,0,15,0,30,4,11,0,15,0,30,3,3,0,6,1,-15,3,1
2,3,5,4,30,2,3,0,5,3,30,0,4,0,4,0,30,0,5,0,5,0,30,1,4,0,5,1,30,0,2,0,2,0,-27,3,0
2,3,9,0,30,2,2,0,4,2,30,2,0,0,2,0,30,1,3,0,4,4,30,1,3,0,4,3,30,1,0,0,1,0,-27,3,0
2,4,13,6,30,7,0,0,7,0,30,4,0,0,4,2,30,6,1,0,7,12,30,2,5,0,7,1,30,4,0,0,4,1,-15,3,1
2,1,17,10,30,10,4,0,14,3,30,6,0,0,6,0,30,3,11,0,14,1,30,5,9,0,14,1,30,4,0,0,4,1,-15,3,1
2,1,19,8,30,9,4,0,13,3,30,5,3,0,8,0,30,4,9,0,13,0,30,3,10,0,13,1,30,8,1,0,9,1,-15,3,1
2,2,19,8,30,9,4,0,13,3,30,5,3,0,8,0,30,4,9,0,13,0,30,3,10,0,13,1,30,8,1,0,9,1,-15,3,1
2,3,19,8,30,9,4,0,13,3,30,5,3,0,8,0,30,4,9,0,13,0,30,3,10,0,13,1,30,8,1,0,9,1,-15,3,1
2,3,23,2,30,3,10,0,13,4,30,6,0,0,6,0,30,10,3,0,13,0,30,6,7,0,13,3,30,6,0,0,6,1,-15,3,1
2,0,25,1,30,8,6,0,14,4,30,6,0,0,6,0,30,7,7,0,14,1,30,11,3,0,14,3,30,4,2,0,6,1,-15,3,1
2,2,27,1,30,6,9,0,15,4,30,2,0,0,2,0,30,3,12,0,15,0,30,7,8,0,15,6,30,6,0,0,6,1,-15,3,1
2,4,29,0,30,9,5,0,14,4,30,10,2,0,12,0,30,6,8,0,14,0,30,1,13,0,14,0,30,5,4,0,9,1,-15,3,1
2,2,1,0,30,6,4,0,10,4,30,2,0,0,2,1,30,5,5,0,10,0,30,10,0,0,10,6,30,6,0,0,6,0,-27,3,0
2,4,3,0,30,0,4,0,4,2,30,4,0,0,4,0,30,0,4,0,4,6,30,0,4,0,4,0,30,1,2,0,3,0,-27,3,0
2,2,5,0,30,2,3,0,5,3,30,0,4,0,4,0,30,1,4,0,5,0,30,1,4,0,5,1,30,1,1,0,2,0,-27,3,0
2,3,5,0,30,2,3,0,5,3,30,0,4,0,4,0,30,1,4,0,5,0,30,1,4,0,5,1,30,1,1,0,2,0,-27,3,0
2,4,5,0,30,2,3,0,5,3,30,0,4,0,4,0,30,1,4,0,5,0,30,1,4,0,5,1,30,1,1,0,2,0,-27,3,0
2,3,11,0,30,6,6,0,12,1,30,3,1,0,4,0,30,7,5,0,12,2,30,8,4,0,12,5,30,4,0,0,4,1,-15,3,1
2,4,13,2,30,7,0,0,7,0,30,4,0,0,4,2,30,6,1,0,7,14,30,5,2,0,7,1,30,4,0,0,4,1,-15,3,1
2,4,17,4,30,11,3,0,14,3,30,6,0,0,6,0,30,5,9,0,14,0,30,6,8,0,14,2,30,4,0,0,4,1,-15,3,1
2,3,19,0,30,2,11,0,13,2,30,7,1,0,8,0,30,8,5,0,13,0,30,4,9,0,13,0,30,8,1,0,9,1,-15,3,1
2,4,19,0,30,2,11,0,13,2,30,7,1,0,8,0,30,8,5,0,13,0,30,4,9,0,13,0,30,8,1,0,9,1,-15,3,1
2,1,21,2,30,7,3,0,10,4,30,6,0,0,6,1,30,3,7,0,10,4,30,5,5,0,10,0,30,4,0,0,4,1,-15,3,1
2,4,22,1,30,7,1,0,8,2,30,2,0,0,2,1,30,5,3,0,8,1,30,5,3,0,8,2,30,1,3,0,4,1,-15,3,1
2,0,25,1,30,6,8,0,14,5,30,6,0,0,6,0,30,7,7,0,14,1,30,6,8,0,14,4,30,6,0,0,6,1,-15,3,1
2,2,25,1,30,6,8,0,14,5,30,6,0,0,6,0,30,7,7,0,14,1,30,6,8,0,14,4,30,6,0,0,6,1,-15,3,1
2,4,25,1,30,6,8,0,14,5,30,6,0,0,6,0,30,7,7,0,14,1,30,6,8,0,14,4,30,6,0,0,6,1,-15,3,1
2,1,26,0,30,6,3,0,9,6,30,4,0,0,4,2,30,0,9,0,9,0,30,6,3,0,9,7,30,3,0,0,3,1,-15,3,1
2,3,35,3,30,7,6,0,13,2,30,2,0,0,2,0,30,10,3,0,13,0,30,1,12,0,13,3,30,7,1,0,8,1,-15,3,1
2,0,4,2,30,6,2,0,8,5,30,2,2,0,4,0,30,1,7,0,8,2,30,6,2,0,8,8,30,3,1,0,4,0,-27,3,0
2,1,4,2,30,6,2,0,8,5,30,2,2,0,4,0,30,1,7,0,8,2,30,6,2,0,8,8,30,3,1,0,4,0,-27,3,0
2,0,19,0,30,2,11,0,13,2,30,5,3,0,8,0,30,5,8,0,13,9,30,5,8,0,13,4,30,9,0,0,9,1,-15,3,1
2,0,21,3,30,8,2,0,10,4,30,5,1,0,6,1,30,3,7,0,10,2,30,5,5,0,10,2,30,4,0,0,4,1,-15,3,1
2,1,21,3,30,8,2,0,10,4,30,5,1,0,6,1,30,3,7,0,10,2,30,5,5,0,10,2,30,4,0,0,4,1,-15,3,1
2,3,23,2,30,5,8,0,13,3,30,6,0,0,6,1,30,9,4,0,13,0,30,6,7,0,13,1,30,5,1,0,6,1,-15,3,1
2,2,25,1,30,8,6,0,14,5,30,6,0,0,6,0,30,6,8,0,14,1,30,7,7,0,14,3,30,6,0,0,6,1,-15,3,1
2,1,31,1,30,7,5,0,12,6,30,8,0,0,8,3,30,4,8,0,12,0,30,7,5,0,12,2,30,6,0,0,6,1,-15,3,1
2,2,31,1,30,7,5,0,12,6,30,8,0,0,8,3,30,4,8,0,12,0,30,7,5,0,12,2,30,6,0,0,6,1,-15,3,1
2,3,31,1,30,7,5,0,12,6,30,8,0,0,8,3,30,4,8,0,12,0,30,7,5,0,12,2,30,6,0,0,6,1,-15,3,1
2,4,31,1,30,7,5,0,12,6,30,8,0,0,8,3,30,4,8,0,12,0,30,7,5,0,12,2,30,6,0,0,6,1,-15,3,1
2,3,32,0,30,2,7,0,9,5,30,2,0,0,2,0,30,5,4,0,9,1,30,4,5,0,9,3,30,2,0,0,2,1,-15,3,1
2,3,47,0,30,1,13,0,14,9,30,4,0,0,4,0,30,3,11,0,14,0,30,2,12,0,14,1,30,7,0,0,7,1,-15,3,1
2,4,47,0,30,1,13,0,14,9,30,4,0,0,4,0,30,3,11,0,14,0,30,2,12,0,14,1,30,7,0,0,7,1,-15,3,1
2,3,8,1,30,7,0,0,7,4,30,2,0,0,2,1,30,3,4,0,7,2,30,7,0,0,7,2,30,3,0,0,3,0,-27,3,0
2,2,13,0,30,5,2,0,7,0,30,4,0,0,4,2,30,6,1,0,7,10,30,5,2,0,7,3,30,4,0,0,4,1,-15,3,1
2,1,17,3,30,8,6,0,14,4,30,6,0,0,6,0,30,4,10,0,14,5,30,5,9,0,14,5,30,4,0,0,4,1,-15,3,1
2,3,25,1,30,5,9,0,14,5,30,6,0,0,6,0,30,8,6,0,14,1,30,5,9,0,14,5,30,6,0,0,6,1,-15,3,1
2,0,27,1,30,3,12,0,15,6,30,2,0,0,2,0,30,2,13,0,15,1,30,6,9,0,15,1,30,6,0,0,6,1,-15,3,1
2,4,29,4,30,10,4,0,14,5,30,10,2,0,12,0,30,3,11,0,14,0,30,1,13,0,14,0,30,7,2,0,9,1,-15,3,1
2,3,32,0,30,7,2,0,9,4,30,2,0,0,2,4,30,9,0,0,9,1,30,2,7,0,9,2,30,2,0,0,2,1,-15,3,1
2,3,39,0,30,3,8,0,11,6,30,6,0,0,6,5,30,7,4,0,11,0,30,2,9,0,11,1,30,5,0,0,5,1,-15,3,1
2,3,9,4,30,2,2,0,4,3,30,2,0,0,2,2,30,4,0,0,4,0,30,0,4,0,4,1,30,1,0,0,1,0,-27,3,0
2,1,13,3,30,6,1,0,7,0,30,4,0,0,4,2,30,6,1,0,7,5,30,5,2,0,7,3,30,4,0,0,4,1,-15,3,1
2,2,13,3,30,6,1,0,7,0,30,4,0,0,4,2,30,6,1,0,7,5,30,5,2,0,7,3,30,4,0,0,4,1,-15,3,1
2,4,19,0,30,4,9,0,13,1,30,7,1,0,8,0,30,7,6,0,13,1,30,4,9,0,13,0,30,8,1,0,9,1,-15,3,1
2,2,25,1,30,5,9,0,14,3,30,6,0,0,6,0,30,11,3,0,14,1,30,5,9,0,14,4,30,5,1,0,6,1,-15,3,1
2,2,27,1,30,4,11,0,15,3,30,1,1,0,2,5,30,6,9,0,15,1,30,4,11,0,15,3,30,6,0,0,6,1,-15,3,1
2,3,27,1,30,4,11,0,15,3,30,1,1,0,2,5,30,6,9,0,15,1,30,4,11,0,15,3,30,6,0,0,6,1,-15,3,1
2,4,32,0,30,4,5,0,9,4,30,2,0,0,2,0,30,9,0,0,9,1,30,6,3,0,9,3,30,2,0,0,2,1,-15,3,1
2,2,47,0,30,0,14,0,14,6,30,4,0,0,4,0,30,3,11,0,14,0,30,4,10,0,14,10,30,7,0,0,7,1,-15,3,1
2,3,3,4,30,4,0,0,4,4,30,4,0,0,4,0,30,0,4,0,4,3,30,0,4,0,4,0,30,1,2,0,3,0,-27,3,0
2,2,5,4,30,0,5,0,5,4,30,0,4,0,4,0,30,0,5,0,5,0,30,1,4,0,5,0,30,0,2,0,2,0,-27,3,0
2,3,5,4,30,0,5,0,5,4,30,0,4,0,4,0,30,0,5,0,5,0,30,1,4,0,5,0,30,0,2,0,2,0,-27,3,0
2,4,7,0,30,1,3,0,4,2,30,1,1,0,2,0,30,1,3,0,4,0,30,1,3,0,4,3,30,2,0,0,2,0,-27,3,0
2,3,9,0,30,1,3,0,4,2,30,2,0,0,2,3,30,1,3,0,4,4,30,1,3,0,4,3,30,1,0,0,1,0,-27,3,0
2,4,9,0,30,1,3,0,4,2,30,2,0,0,2,3,30,1,3,0,4,4,30,1,3,0,4,3,30,1,0,0,1,0,-27,3,0
2,0,13,3,30,7,0,0,7,2,30,4,0,0,4,2,30,6,1,0,7,5,30,7,0,0,7,4,30,4,0,0,4,1,-15,3,1
2,3,13,3,30,7,0,0,7,2,30,4,0,0,4,0,30,6,1,0,7,5,30,7,0,0,7,4,30,4,0,0,4,1,-15,3,1
2,4,13,3,30,7,0,0,7,2,30,4,0,0,4,0,30,6,1,0,7,5,30,7,0,0,7,4,30,4,0,0,4,1,-15,3,1
2,4,15,0,30,4,9,0,13,1,30,6,0,0,6,0,30,3,10,0,13,1,30,3,10,0,13,0,30,9,0,0,9,1,-15,3,1
2,1,19,0,30,3,10,0,13,0,30,5,3,0,8,0,30,12,1,0,13,7,30,5,8,0,13,2,30,8,1,0,9,1,-15,3,1
2,2,19,0,30,3,10,0,13,0,30,5,3,0,8,0,30,12,1,0,13,7,30,5,8,0,13,2,30,8,1,0,9,1,-15,3,1
2,2,27,1,30,7,8,0,15,0,30,2,0,0,2,0,30,5,10,0,15,0,30,3,12,0,15,1,30,6,0,0,6,1,-15,3,1
2,3,27,1,30,7,8,0,15,0,30,2,0,0,2,0,30,5,10,0,15,0,30,3,12,0,15,1,30,6,0,0,6,1,-15,3,1
2,4,27,1,30,7,8,0,15,0,30,2,0,0,2,0,30,5,10,0,15,0,30,3,12,0,15,1,30,6,0,0,6,1,-15,3,1
2,3,45,0,30,3,10,0,13,8,30,10,0,0,10,0,30,5,8,0,13,0,30,6,7,0,13,4,30,5,0,0,5,1,-15,3,1
2,3,8,2,30,7,0,0,7,4,30,2,0,0,2,4,30,4,3,0,7,1,30,7,0,0,7,1,30,3,0,0,3,0,-27,3,0
2,4,8,2,30,7,0,0,7,4,30,2,0,0,2,4,30,4,3,0,7,1,30,7,0,0,7,1,30,3,0,0,3,0,-27,3,0
2,0,17,3,30,9,5,0,14,2,30,6,0,0,6,0,30,4,10,0,14,5,30,5,9,0,14,8,30,4,0,0,4,1,-15,3,1
2,2,19,1,30,2,11,0,13,2,30,8,0,0,8,0,30,4,9,0,13,0,30,3,10,0,13,0,30,9,0,0,9,1,-15,3,1
2,4,19,1,30,2,11,0,13,2,30,8,0,0,8,0,30,4,9,0,13,0,30,3,10,0,13,0,30,9,0,0,9,1,-15,3,1
2,2,23,2,30,5,8,0,13,3,30,6,0,0,6,0,30,10,3,0,13,0,30,11,2,0,13,2,30,5,1,0,6,1,-15,3,1
2,3,23,2,30,5,8,0,13,3,30,6,0,0,6,0,30,10,3,0,13,0,30,11,2,0,13,2,30,5,1,0,6,1,-15,3,1
2,4,23,2,30,5,8,0,13,3,30,6,0,0,6,0,30,10,3,0,13,0,30,11,2,0,13,2,30,5,1,0,6,1,-15,3,1
2,2,25,1,30,6,8,0,14,4,30,6,0,0,6,0,30,6,8,0,14,1,30,5,9,0,14,2,30,5,1,0,6,1,-15,3,1
2,0,27,1,30,5,10,0,15,2,30,2,0,0,2,0,30,7,8,0,15,2,30,5,10,0,15,4,30,6,0,0,6,1,-15,3,1
2,2,27,1,30,5,10,0,15,2,30,2,0,0,2,0,30,7,8,0,15,2,30,5,10,0,15,4,30,6,0,0,6,1,-15,3,1
2,4,31,4,30,5,7,0,12,4,30,8,0,0,8,0,30,9,3,0,12,0,30,3,9,0,12,0,30,3,3,0,6,1,-15,3,1
2,3,35,0,30,10,3,0,13,4,30,2,0,0,2,1,30,2,11,0,13,4,30,3,10,0,13,8,30,8,0,0,8,1,-15,3,1
2,4,39,0,30,4,7,0,11,7,30,6,0,0,6,0,30,4,7,0,11,2,30,4,7,0,11,0,30,5,0,0,5,1,-15,3,1
2,4,8,4,30,7,0,0,7,3,30,2,0,0,2,4,30,3,4,0,7,3,30,7,0,0,7,0,30,3,0,0,3,0,-27,3,0
2,4,22,5,30,8,0,0,8,3,30,2,0,0,2,0,30,5,3,0,8,1,30,2,6,0,8,1,30,2,2,0,4,1,-15,3,1
2,1,25,2,30,7,7,0,14,2,30,6,0,0,6,0,30,10,4,0,14,1,30,5,9,0,14,4,30,5,1,0,6,1,-15,3,1
2,3,25,2,30,7,7,0,14,2,30,6,0,0,6,0,30,10,4,0,14,1,30,5,9,0,14,4,30,5,1,0,6,1,-15,3,1
2,3,27,1,30,4,11,0,15,2,30,2,0,0,2,0,30,2,13,0,15,0,30,6,9,0,15,1,30,5,1,0,6,1,-15,3,1
2,2,28,0,30,2,6,0,8,6,30,4,0,0,4,0,30,1,7,0,8,8,30,4,4,0,8,0,30,4,0,0,4,1,-15,3,1
2,4,29,0,30,7,7,0,14,6,30,12,0,0,12,0,30,3,11,0,14,0,30,5,9,0,14,0,30,8,1,0,9,1,-15,3,1
2,4,13,2,30,6,1,0,7,0,30,4,0,0,4,2,30,6,1,0,7,5,30,6,1,0,7,4,30,4,0,0,4,1,-15,3,1
2,1,19,0,30,3,10,0,13,2,30,4,4,0,8,0,30,5,8,0,13,8,30,5,8,0,13,5,30,9,0,0,9,1,-15,3,1
2,2,19,0,30,3,10,0,13,2,30,4,4,0,8,0,30,5,8,0,13,8,30,5,8,0,13,5,30,9,0,0,9,1,-15,3,1
2,1,21,3,30,8,2,0,10,4,30,6,0,0,6,1,30,3,7,0,10,3,30,5,5,0,10,3,30,4,0,0,4,1,-15,3,1
2,4,23,0,30,6,7,0,13,3,30,6,0,0,6,5,30,10,3,0,13,0,30,8,5,0,13,1,30,6,0,0,6,1,-15,3,1
2,2,25,2,30,8,6,0,14,3,30,6,0,0,6,0,30,5,9,0,14,1,30,5,9,0,14,3,30,5,1,0,6,1,-15,3,1
2,3,25,2,30,8,6,0,14,3,30,6,0,0,6,0,30,5,9,0,14,1,30,5,9,0,14,3,30,5,1,0,6,1,-15,3,1
2,1,27,1,30,5,10,0,15,3,30,2,0,0,2,0,30,5,10,0,15,0,30,3,12,0,15,1,30,5,1,0,6,1,-15,3,1
2,2,27,1,30,5,10,0,15,3,30,2,0,0,2,0,30,5,10,0,15,0,30,3,12,0,15,1,30,5,1,0,6,1,-15,3,1
2,3,27,1,30,5,10,0,15,3,30,2,0,0,2,0,30,5,10,0,15,0,30,3,12,0,15,1,30,5,1,0,6,1,-15,3,1
2,4,29,0,30,6,8,0,14,6,30,11,1,0,12,0,30,4,10,0,14,0,30,1,13,0,14,0,30,9,0,0,9,1,-15,3,1
2,4,47,0,30,1,13,0,14,6,30,4,0,0,4,0,30,6,8,0,14,0,30,2,12,0,14,3,30,7,0,0,7,1,-15,3,1
2,4,3,0,30,0,4,0,4,2,30,4,0,0,4,1,30,3,1,0,4,2,30,2,2,0,4,0,30,1,2,0,3,0,-27,3,0
2,3,6,0,30,8,1,0,9,4,30,2,0,0,2,0,30,2,7,0,9,0,30,4,5,0,9,2,30,5,0,0,5,0,-27,3,0
2,2,11,2,30,5,7,0,12,2,30,4,0,0,4,0,30,6,6,0,12,6,30,5,7,0,12,0,30,4,0,0,4,1,-15,3,1
2,3,11,2,30,5,7,0,12,2,30,4,0,0,4,0,30,6,6,0,12,6,30,5,7,0,12,0,30,4,0,0,4,1,-15,3,1
2,2,15,0,30,2,11,0,13,1,30,6,0,0,6,0,30,4,9,0,13,1,30,8,5,0,13,2,30,8,1,0,9,1,-15,3,1
2,1,19,0,30,5,8,0,13,2,30,8,0,0,8,4,30,4,9,0,13,1,30,4,9,0,13,3,30,6,3,0,9,1,-15,3,1
2,2,19,0,30,5,8,0,13,2,30,8,0,0,8,4,30,4,9,0,13,1,30,4,9,0,13,3,30,6,3,0,9,1,-15,3,1
2,3,19,0,30,5,8,0,13,2,30,8,0,0,8,4,30,4,9,0,13,1,30,4,9,0,13,3,30,6,3,0,9,1,-15,3,1
2,3,22,1,30,6,2,0,8,2,30,2,0,0,2,0,30,5,3,0,8,1,30,2,6,0,8,1,30,3,1,0,4,1,-15,3,1
2,4,22,1,30,6,2,0,8,2,30,2,0,0,2,0,30,5,3,0,8,1,30,2,6,0,8,1,30,3,1,0,4,1,-15,3,1
2,2,26,2,30,6,3,0,9,6,30,4,0,0,4,5,30,1,8,0,9,0,30,6,3,0,9,5,30,3,0,0,3,1,-15,3,1
2,3,26,2,30,6,3,0,9,6,30,4,0,0,4,5,30,1,8,0,9,0,30,6,3,0,9,5,30,3,0,0,3,1,-15,3,1
2,3,27,2,30,9,6,0,15,2,30,2,0,0,2,1,30,6,9,0,15,2,30,3,12,0,15,0,30,4,2,0,6,1,-15,3,1
2,2,43,4,30,10,4,0,14,8,30,6,0,0,6,0,30,5,9,0,14,1,30,1,13,0,14,5,30,5,0,0,5,1,-15,3,1
2,3,43,4,30,10,4,0,14,8,30,6,0,0,6,0,30,5,9,0,14,1,30,1,13,0,14,5,30,5,0,0,5,1,-15,3,1
2,3,1,0,30,5,5,0,10,4,30,2,0,0,2,1,30,4,6,0,10,2,30,8,2,0,10,8,30,6,0,0,6,0,-27,3,0
2,4,8,2,30,7,0,0,7,4,30,2,0,0,2,4,30,4,3,0,7,1,30,7,0,0,7,2,30,3,0,0,3,0,-27,3,0
2,2,17,3,30,10,4,0,14,3,30,6,0,0,6,0,30,6,8,0,14,1,30,6,8,0,14,0,30,3,1,0,4,1,-15,3,1
2,3,17,3,30,10,4,0,14,3,30,6,0,0,6,0,30,6,8,0,14,1,30,6,8,0,14,0,30,3,1,0,4,1,-15,3,1
2,4,17,3,30,10,4,0,14,3,30,6,0,0,6,0,30,6,8,0,14,1,30,6,8,0,14,0,30,3,1,0,4,1,-15,3,1
2,3,19,0,30,3,10,0,13,2,30,7,1,0,8,0,30,6,7,0,13,4,30,5,8,0,13,3,30,7,2,0,9,1,-15,3,1
2,4,19,0,30,3,10,0,13,2,30,7,1,0,8,0,30,6,7,0,13,4,30,5,8,0,13,3,30,7,2,0,9,1,-15,3,1
2,4,23,1,30,5,8,0,13,3,30,6,0,0,6,6,30,12,1,0,13,0,30,5,8,0,13,1,30,5,1,0,6,1,-15,3,1
2,0,25,0,30,5,9,0,14,5,30,6,0,0,6,0,30,7,7,0,14,1,30,5,9,0,14,6,30,5,1,0,6,1,-15,3,1
2,1,25,0,30,5,9,0,14,5,30,6,0,0,6,0,30,7,7,0,14,1,30,5,9,0,14,6,30,5,1,0,6,1,-15,3,1
2,2,25,0,30,5,9,0,14,5,30,6,0,0,6,0,30,7,7,0,14,1,30,5,9,0,14,6,30,5,1,0,6,1,-15,3,1
2,3,25,0,30,5,9,0,14,5,30,6,0,0,6,0,30,7,7,0,14,1,30,5,9,0,14,6,30,5,1,0,6,1,-15,3,1
2,2,30,7,30,3,2,0,5,6,30,2,0,0,2,1,30,1,4,0,5,2,30,2,3,0,5,0,30,2,1,0,3,1,-15,3,1
2,3,30,7,30,3,2,0,5,6,30,2,0,0,2,1,30,1,4,0,5,2,30,2,3,0,5,0,30,2,1,0,3,1,-15,3,1
2,4,31,5,30,9,3,0,12,6,30,8,0,0,8,3,30,5,7,0,12,0,30,3,9,0,12,1,30,2,4,0,6,1,-15,3,1
2,3,17,1,30,7,7,0,14,3,30,6,0,0,6,0,30,5,9,0,14,2,30,7,7,0,14,4,30,4,0,0,4,1,-15,3,1
2,4,17,1,30,7,7,0,14,3,30,6,0,0,6,0,30,5,9,0,14,2,30,7,7,0,14,4,30,4,0,0,4,1,-15,3,1
2,1,23,1,30,6,7,0,13,1,30,6,0,0,6,6,30,13,0,0,13,0,30,6,7,0,13,3,30,6,0,0,6,1,-15,3,1
2,3,23,1,30,6,7,0,13,1,30,6,0,0,6,0,30,13,0,0,13,0,30,6,7,0,13,3,30,6,0,0,6,1,-15,3,1
2,4,23,1,30,6,7,0,13,1,30,6,0,0,6,0,30,13,0,0,13,0,30,6,7,0,13,3,30,6,0,0,6,1,-15,3,1
2,4,27,2,30,5,10,0,15,4,30,1,1,0,2,0,30,9,6,0,15,0,30,3,12,0,15,0,30,6,0,0,6,1,-15,3,1
2,0,29,0,30,6,8,0,14,6,30,12,0,0,12,0,30,3,11,0,14,0,30,0,14,0,14,3,30,9,0,0,9,1,-15,3,1
2,4,29,0,30,6,8,0,14,6,30,12,0,0,12,0,30,3,11,0,14,0,30,0,14,0,14,3,30,9,0,0,9,1,-15,3,1
2,0,33,1,30,2,9,0,11,6,30,4,0,0,4,0,30,3,8,0,11,2,30,6,5,0,11,10,30,4,0,0,4,1,-15,3,1
2,2,33,1,30,2,9,0,11,6,30,4,0,0,4,0,30,3,8,0,11,2,30,6,5,0,11,10,30,4,0,0,4,1,-15,3,1
2,4,35,0,30,7,6,0,13,6,30,2,0,0,2,1,30,2,11,0,13,0,30,5,8,0,13,1,30,8,0,0,8,1,-15,3,1
2,3,8,0,30,7,0,0,7,4,30,2,0,0,2,3,30,2,5,0,7,2,30,6,1,0,7,7,30,3,0,0,3,0,-27,3,0
2,3,27,0,30,3,12,0,15,3,30,2,0,0,2,0,30,3,12,0,15,2,30,5,10,0,15,6,30,6,0,0,6,1,-15,3,1
2,0,29,0,30,7,7,0,14,5,30,9,3,0,12,0,30,5,9,0,14,0,30,3,11,0,14,5,30,9,0,0,9,1,-15,3,1
2,3,29,0,30,7,7,0,14,5,30,9,3,0,12,0,30,5,9,0,14,0,30,3,11,0,14,5,30,9,0,0,9,1,-15,3,1
2,4,38,0,30,2,8,0,10,7,30,6,0,0,6,0,30,1,9,0,10,2,30,1,9,0,10,3,30,6,0,0,6,1,-15,3,1
2,2,5,0,30,2,3,0,5,3,30,2,2,0,4,1,30,2,3,0,5,0,30,1,4,0,5,0,30,0,2,0,2,0,-27,3,0
2,3,5,0,30,2,3,0,5,3,30,2,2,0,4,1,30,2,3,0,5,0,30,1,4,0,5,0,30,0,2,0,2,0,-27,3,0
2,4,8,1,30,7,0,0,7,3,30,2,0,0,2,0,30,4,3,0,7,0,30,5,2,0,7,2,30,3,0,0,3,0,-27,3,0
2,0,11,1,30,3,9,0,12,1,30,4,0,0,4,0,30,5,7,0,12,7,30,5,7,0,12,4,30,4,0,0,4,1,-15,3,1
2,1,11,1,30,3,9,0,12,1,30,4,0,0,4,0,30,5,7,0,12,7,30,5,7,0,12,4,30,4,0,0,4,1,-15,3,1
2,4,11,1,30,3,9,0,12,1,30,4,0,0,4,0,30,5,7,0,12,7,30,5,7,0,12,4,30,4,0,0,4,1,-15,3,1
2,4,13,3,30,7,0,0,7,0,30,4,0,0,4,2,30,6,1,0,7,6,30,5,2,0,7,4,30,4,0,0,4,1,-15,3,1
2,2,17,3,30,8,6,0,14,3,30,6,0,0,6,1,30,7,7,0,14,5,30,6,8,0,14,7,30,4,0,0,4,1,-15,3,1
2,2,19,0,30,5,8,0,13,2,30,4,4,0,8,0,30,5,8,0,13,1,30,4,9,0,13,2,30,9,0,0,9,1,-15,3,1
2,4,19,0,30,5,8,0,13,2,30,4,4,0,8,0,30,5,8,0,13,1,30,4,9,0,13,0,30,9,0,0,9,1,-15,3,1
2,4,21,2,30,9,1,0,10,3,30,5,1,0,6,0,30,4,6,0,10,1,30,4,6,0,10,6,30,4,0,0,4,1,-15,3,1
2,3,23,1,30,4,9,0,13,3,30,6,0,0,6,7,30,10,3,0,13,0,30,6,7,0,13,4,30,6,0,0,6,1,-15,3,1
2,4,23,1,30,4,9,0,13,3,30,6,0,0,6,7,30,10,3,0,13,0,30,6,7,0,13,4,30,6,0,0,6,1,-15,3,1
2,1,25,1,30,2,12,0,14,6,30,6,0,0,6,0,30,5,9,0,14,0,30,9,5,0,14,6,30,6,0,0,6,1,-15,3,1
2,4,25,1,30,2,12,0,14,6,30,6,0,0,6,0,30,5,9,0,14,0,30,9,5,0,14,6,30,6,0,0,6,1,-15,3,1
2,0,26,1,30,8,1,0,9,5,30,4,0,0,4,2,30,0,9,0,9,3,30,3,6,0,9,8,30,3,0,0,3,1,-15,3,1
2,1,26,1,30,8,1,0,9,5,30,4,0,0,4,2,30,0,9,0,9,3,30,3,6,0,9,8,30,3,0,0,3,1,-15,3,1
2,3,26,1,30,8,1,0,9,5,30,4,0,0,4,2,30,0,9,0,9,3,30,3,6,0,9,8,30,3,0,0,3,1,-15,3,1
2,0,27,1,30,5,10,0,15,3,30,2,0,0,2,0,30,3,12,0,15,2,30,4,11,0,15,5,30,6,0,0,6,1,-15,3,1
2,3,27,1,30,5,10,0,15,3,30,2,0,0,2,0,30,3,12,0,15,2,30,4,11,0,15,5,30,6,0,0,6,1,-15,3,1
2,2,41,0,30,6,6,0,12,6,30,8,0,0,8,0,30,10,2,0,12,0,30,3,9,0,12,3,30,7,0,0,7,1,-15,3,1
2,3,1,0,30,7,3,0,10,4,30,2,0,0,2,1,30,4,6,0,10,3,30,6,4,0,10,5,30,6,0,0,6,0,-27,3,0
2,4,17,2,30,12,2,0,14,3,30,6,0,0,6,0,30,4,10,0,14,1,30,7,7,0,14,1,30,2,2,0,4,1,-15,3,1
2,2,19,1,30,4,9,0,13,0,30,8,0,0,8,0,30,12,1,0,13,2,30,4,9,0,13,1,30,7,2,0,9,1,-15,3,1
2,3,19,1,30,4,9,0,13,0,30,8,0,0,8,0,30,12,1,0,13,2,30,4,9,0,13,1,30,7,2,0,9,1,-15,3,1
2,4,19,1,30,4,9,0,13,0,30,8,0,0,8,0,30,12,1,0,13,2,30,4,9,0,13,1,30,7,2,0,9,1,-15,3,1
2,2,25,1,30,4,10,0,14,1,30,6,0,0,6,0,30,11,3,0,14,1,30,6,8,0,14,4,30,6,0,0,6,1,-15,3,1
2,4,29,0,30,2,12,0,14,6,30,12,0,0,12,0,30,6,8,0,14,0,30,0,14,0,14,4,30,9,0,0,9,1,-15,3,1
2,3,31,3,30,3,9,0,12,5,30,8,0,0,8,4,30,10,2,0,12,0,30,3,9,0,12,1,30,6,0,0,6,1,-15,3,1
2,4,31,3,30,3,9,0,12,5,30,8,0,0,8,4,30,10,2,0,12,0,30,3,9,0,12,1,30,6,0,0,6,1,-15,3,1
2,2,4,2,30,7,1,0,8,4,30,1,3,0,4,1,30,1,7,0,8,0,30,5,3,0,8,3,30,4,0,0,4,0,-27,3,0
2,4,4,2,30,7,1,0,8,4,30,1,3,0,4,0,30,1,7,0,8,0,30,5,3,0,8,3,30,4,0,0,4,0,-27,3,0
2,3,8,0,30,7,0,0,7,3,30,2,0,0,2,4,30,7,0,0,7,3,30,7,0,0,7,2,30,3,0,0,3,0,-27,3,0
2,4,8,0,30,7,0,0,7,3,30,2,0,0,2,4,30,7,0,0,7,3,30,7,0,0,7,2,30,3,0,0,3,0,-27,3,0
2,4,11,2,30,6,6,0,12,2,30,4,0,0,4,0,30,4,8,0,12,3,30,6,6,0,12,5,30,4,0,0,4,1,-15,3,1
2,3,17,0,30,11,3,0,14,2,30,6,0,0,6,2,30,5,9,0,14,2,30,5,9,0,14,1,30,2,2,0,4,1,-15,3,1
2,3,19,0,30,3,10,0,13,0,30,5,3,0,8,0,30,6,7,0,13,5,30,4,9,0,13,1,30,8,1,0,9,1,-15,3,1
2,4,25,0,30,7,7,0,14,3,30,6,0,0,6,0,30,6,8,0,14,0,30,5,9,0,14,5,30,5,1,0,6,1,-15,3,1
2,1,27,1,30,2,13,0,15,5,30,2,0,0,2,0,30,6,9,0,15,4,30,5,10,0,15,1,30,4,2,0,6,1,-15,3,1
2,3,27,1,30,2,13,0,15,3,30,2,0,0,2,0,30,6,9,0,15,4,30,5,10,0,15,1,30,4,2,0,6,1,-15,3,1
2,4,27,1,30,2,13,0,15,3,30,2,0,0,2,0,30,6,9,0,15,4,30,5,10,0,15,1,30,4,2,0,6,1,-15,3,1
2,0,29,0,30,5,9,0,14,4,30,8,4,0,12,0,30,6,8,0,14,0,30,2,12,0,14,3,30,9,0,0,9,1,-15,3,1
2,0,31,2,30,11,1,0,12,6,30,8,0,0,8,3,30,4,8,0,12,0,30,5,7,0,12,3,30,5,1,0,6,1,-15,3,1
2,2,31,2,30,11,1,0,12,6,30,8,0,0,8,3,30,4,8,0,12,0,30,5,7,0,12,3,30,5,1,0,6,1,-15,3,1
2,4,31,2,30,11,1,0,12,6,30,8,0,0,8,3,30,4,8,0,12,0,30,5,7,0,12,3,30,5,1,0,6,1,-15,3,1
2,2,38,0,30,3,7,0,10,7,30,6,0,0,6,0,30,1,9,0,10,1,30,4,6,0,10,6,30,6,0,0,6,1,-15,3,1
2,3,38,0,30,3,7,0,10,7,30,6,0,0,6,0,30,1,9,0,10,1,30,4,6,0,10,6,30,6,0,0,6,1,-15,3,1
2,4,38,0,30,3,7,0,10,7,30,6,0,0,6,0,30,1,9,0,10,1,30,4,6,0,10,6,30,6,0,0,6,1,-15,3,1
2,3,39,0,30,4,7,0,11,6,30,6,0,0,6,0,30,5,6,0,11,0,30,2,9,0,11,1,30,5,0,0,5,1,-15,3,1
2,3,43,0,30,7,7,0,14,7,30,6,0,0,6,0,30,9,5,0,14,1,30,4,10,0,14,5,30,5,0,0,5,1,-15,3,1
2,4,43,0,30,7,7,0,14,7,30,6,0,0,6,0,30,9,5,0,14,1,30,4,10,0,14,5,30,5,0,0,5,1,-15,3,1
2,2,4,2,30,7,1,0,8,4,30,4,0,0,4,0,30,2,6,0,8,0,30,4,4,0,8,2,30,3,1,0,4,0,-27,3,0
2,3,17,5,30,9,5,0,14,4,30,6,0,0,6,0,30,4,10,0,14,1,30,7,7,0,14,2,30,4,0,0,4,1,-15,3,1
2,2,19,0,30,4,9,0,13,1,30,7,1,0,8,1,30,7,6,0,13,0,30,6,7,0,13,1,30,7,2,0,9,1,-15,3,1
2,0,21,1,30,7,3,0,10,3,30,6,0,0,6,1,30,4,6,0,10,2,30,4,6,0,10,5,30,4,0,0,4,1,-15,3,1
2,1,21,1,30,7,3,0,10,3,30,6,0,0,6,1,30,4,6,0,10,2,30,4,6,0,10,5,30,4,0,0,4,1,-15,3,1
2,2,25,1,30,7,7,0,14,1,30,6,0,0,6,0,30,11,3,0,14,0,30,5,9,0,14,4,30,4,2,0,6,1,-15,3,1
2,0,27,1,30,3,12,0,15,4,30,1,1,0,2,0,30,5,10,0,15,1,30,7,8,0,15,7,30,6,0,0,6,1,-15,3,1
2,1,27,1,30,3,12,0,15,4,30,1,1,0,2,0,30,5,10,0,15,1,30,7,8,0,15,7,30,6,0,0,6,1,-15,3,1
2,1,31,1,30,6,6,0,12,5,30,8,0,0,8,4,30,9,3,0,12,0,30,5,7,0,12,2,30,6,0,0,6,1,-15,3,1
2,4,35,0,30,6,7,0,13,4,30,2,0,0,2,1,30,8,5,0,13,3,30,4,9,0,13,5,30,8,0,0,8,1,-15,3,1
2,0,43,0,30,7,7,0,14,9,30,6,0,0,6,0,30,4,10,0,14,1,30,5,9,0,14,0,30,5,0,0,5,1,-15,3,1
2,2,43,0,30,7,7,0,14,9,30,6,0,0,6,0,30,4,10,0,14,1,30,5,9,0,14,0,30,5,0,0,5,1,-15,3,1
2,4,43,0,30,7,7,0,14,9,30,6,0,0,6,0,30,4,10,0,14,1,30,5,9,0,14,0,30,5,0,0,5,1,-15,3,1
2,3,47,0,30,0,14,0,14,10,30,4,0,0,4,0,30,3,11,0,14,6,30,3,11,0,14,1,30,7,0,0,7,1,-15,3,1
2,4,47,0,30,0,14,0,14,10,30,4,0,0,4,0,30,3,11,0,14,6,30,3,11,0,14,1,30,7,0,0,7,1,-15,3,1
2,1,5,0,30,1,4,0,5,3,30,1,3,0,4,0,30,0,5,0,5,0,30,2,3,0,5,1,30,2,0,0,2,0,-27,3,0
2,4,5,0,30,1,4,0,5,3,30,1,3,0,4,0,30,0,5,0,5,0,30,2,3,0,5,1,30,2,0,0,2,0,-27,3,0
2,3,6,1,30,6,3,0,9,4,30,2,0,0,2,0,30,2,7,0,9,0,30,4,5,0,9,2,30,4,1,0,5,0,-27,3,0
2,4,11,1,30,8,4,0,12,0,30,4,0,0,4,0,30,8,4,0,12,1,30,5,7,0,12,4,30,4,0,0,4,1,-15,3,1
2,1,13,3,30,7,0,0,7,0,30,4,0,0,4,2,30,5,2,0,7,5,30,6,1,0,7,3,30,4,0,0,4,1,-15,3,1
2,2,13,3,30,7,0,0,7,0,30,4,0,0,4,2,30,5,2,0,7,5,30,6,1,0,7,3,30,4,0,0,4,1,-15,3,1
2,0,19,0,30,3,10,0,13,2,30,3,5,0,8,0,30,6,7,0,13,3,30,4,9,0,13,2,30,9,0,0,9,1,-15,3,1
2,1,19,0,30,3,10,0,13,2,30,3,5,0,8,0,30,6,7,0,13,3,30,4,9,0,13,2,30,9,0,0,9,1,-15,3,1
2,4,22,4,30,5,3,0,8,3,30,2,0,0,2,0,30,5,3,0,8,0,30,4,4,0,8,2,30,1,3,0,4,1,-15,3,1
2,3,25,1,30,6,8,0,14,4,30,6,0,0,6,1,30,7,7,0,14,3,30,6,8,0,14,2,30,6,0,0,6,1,-15,3,1
2,2,27,1,30,5,10,0,15,2,30,1,1,0,2,0,30,7,8,0,15,0,30,4,11,0,15,0,30,5,1,0,6,1,-15,3,1
2,3,29,0,30,4,10,0,14,6,30,12,0,0,12,0,30,6,8,0,14,0,30,0,14,0,14,3,30,9,0,0,9,1,-15,3,1
2,1,31,2,30,7,5,0,12,5,30,8,0,0,8,3,30,8,4,0,12,0,30,7,5,0,12,1,30,6,0,0,6,1,-15,3,1
2,4,31,2,30,7,5,0,12,5,30,8,0,0,8,3,30,8,4,0,12,0,30,7,5,0,12,0,30,6,0,0,6,1,-15,3,1
2,0,5,0,30,0,5,0,5,3,30,1,3,0,4,0,30,0,5,0,5,0,30,1,4,0,5,0,30,0,2,0,2,0,-27,3,0
2,1,5,0,30,0,5,0,5,3,30,1,3,0,4,0,30,0,5,0,5,0,30,1,4,0,5,0,30,0,2,0,2,0,-27,3,0
2,4,5,0,30,0,5,0,5,3,30,1,3,0,4,0,30,0,5,0,5,0,30,1,4,0,5,0,30,0,2,0,2,0,-27,3,0
2,1,17,3,30,9,5,0,14,3,30,6,0,0,6,0,30,4,10,0,14,5,30,5,9,0,14,8,30,4,0,0,4,1,-15,3,1
2,2,17,3,30,9,5,0,14,3,30,6,0,0,6,0,30,4,10,0,14,5,30,5,9,0,14,8,30,4,0,0,4,1,-15,3,1
2,4,21,3,30,6,4,0,10,4,30,6,0,0,6,1,30,3,7,0,10,3,30,4,6,0,10,1,30,4,0,0,4,1,-15,3,1
2,4,25,1,30,5,9,0,14,5,30,6,0,0,6,2,30,6,8,0,14,1,30,7,7,0,14,5,30,5,1,0,6,1,-15,3,1
2,2,27,1,30,4,11,0,15,2,30,2,0,0,2,0,30,3,12,0,15,5,30,5,10,0,15,6,30,6,0,0,6,1,-15,3,1
2,3,29,1,30,6,8,0,14,6,30,11,1,0,12,0,30,3,11,0,14,0,30,1,13,0,14,2,30,9,0,0,9,1,-15,3,1
2,3,37,0,30,7,4,0,11,5,30,2,6,0,8,9,30,8,3,0,11,1,30,3,8,0,11,0,30,6,0,0,6,1,-15,3,1
2,4,19,0,30,3,10,0,13,2,30,6,2,0,8,0,30,4,9,0,13,5,30,4,9,0,13,1,30,9,0,0,9,1,-15,3,1
2,3,25,1,30,4,10,0,14,5,30,6,0,0,6,0,30,7,7,0,14,2,30,8,6,0,14,4,30,6,0,0,6,1,-15,3,1
2,4,25,1,30,4,10,0,14,5,30,6,0,0,6,0,30,7,7,0,14,2,30,8,6,0,14,4,30,6,0,0,6,1,-15,3,1
2,4,27,1,30,5,10,0,15,4,30,1,1,0,2,0,30,4,11,0,15,1,30,7,8,0,15,0,30,6,0,0,6,1,-15,3,1
2,0,31,5,30,7,5,0,12,5,30,8,0,0,8,4,30,8,4,0,12,0,30,3,9,0,12,1,30,3,3,0,6,1,-15,3,1
2,1,31,5,30,7,5,0,12,5,30,8,0,0,8,4,30,8,4,0,12,0,30,3,9,0,12,1,30,3,3,0,6,1,-15,3,1
2,2,31,5,30,7,5,0,12,5,30,8,0,0,8,4,30,8,4,0,12,0,30,3,9,0,12,1,30,3,3,0,6,1,-15,3,1
2,4,31,5,30,7,5,0,12,5,30,8,0,0,8,4,30,8,4,0,12,0,30,3,9,0,12,1,30,3,3,0,6,1,-15,3,1
2,0,38,0,30,1,9,0,10,6,30,6,0,0,6,0,30,5,5,0,10,0,30,6,4,0,10,7,30,6,0,0,6,1,-15,3,1
2,3,38,0,30,1,9,0,10,6,30,6,0,0,6,0,30,5,5,0,10,0,30,6,4,0,10,6,30,6,0,0,6,1,-15,3,1
2,2,4,3,30,8,0,0,8,5,30,2,2,0,4,4,30,1,7,0,8,0,30,7,1,0,8,1,30,4,0,0,4,0,-27,3,0
2,4,4,3,30,8,0,0,8,5,30,2,2,0,4,4,30,1,7,0,8,0,30,7,1,0,8,1,30,4,0,0,4,0,-27,3,0
2,3,5,0,30,3,2,0,5,3,30,4,0,0,4,0,30,0,5,0,5,0,30,2,3,0,5,0,30,0,2,0,2,0,-27,3,0
2,4,7,0,30,3,6,0,9,3,30,4,0,0,4,2,30,5,4,0,9,6,30,3,6,0,9,1,30,5,1,0,6,0,-27,3,0
2,4,13,0,30,5,2,0,7,0,30,4,0,0,4,2,30,6,1,0,7,5,30,7,0,0,7,6,30,4,0,0,4,1,-15,3,1
2,4,15,1,30,4,9,0,13,1,30,6,0,0,6,0,30,3,10,0,13,0,30,6,7,0,13,2,30,8,1,0,9,1,-15,3,1
2,1,19,0,30,3,10,0,13,2,30,7,1,0,8,0,30,4,9,0,13,3,30,8,5,0,13,1,30,8,1,0,9,1,-15,3,1
2,2,19,0,30,3,10,0,13,2,30,7,1,0,8,0,30,4,9,0,13,3,30,8,5,0,13,1,30,8,1,0,9,1,-15,3,1
2,4,19,0,30,3,10,0,13,2,30,7,1,0,8,0,30,4,9,0,13,0,30,8,5,0,13,1,30,8,1,0,9,1,-15,3,1
2,3,22,2,30,8,0,0,8,3,30,2,0,0,2,0,30,3,5,0,8,4,30,5,3,0,8,0,30,4,0,0,4,1,-15,3,1
2,4,22,2,30,8,0,0,8,3,30,2,0,0,2,0,30,3,5,0,8,4,30,5,3,0,8,0,30,4,0,0,4,1,-15,3,1
2,0,27,3,30,4,11,0,15,4,30,2,0,0,2,0,30,5,10,0,15,1,30,5,10,0,15,1,30,4,2,0,6,1,-15,3,1
2,1,27,3,30,4,11,0,15,4,30,2,0,0,2,0,30,5,10,0,15,1,30,5,10,0,15,1,30,4,2,0,6,1,-15,3,1
2,2,27,3,30,4,11,0,15,4,30,2,0,0,2,0,30,5,10,0,15,1,30,5,10,0,15,1,30,4,2,0,6,1,-15,3,1
2,1,29,0,30,4,10,0,14,5,30,11,1,0,12,0,30,6,8,0,14,0,30,3,11,0,14,2,30,9,0,0,9,1,-15,3,1
2,3,31,2,30,7,5,0,12,4,30,8,0,0,8,3,30,9,3,0,12,0,30,3,9,0,12,0,30,4,2,0,6,1,-15,3,1
2,2,4,2,30,6,2,0,8,5,30,4,0,0,4,3,30,2,6,0,8,0,30,8,0,0,8,1,30,2,2,0,4,0,-27,3,0
2,4,15,0,30,3,10,0,13,1,30,6,0,0,6,0,30,3,10,0,13,1,30,5,8,0,13,3,30,9,0,0,9,1,-15,3,1
2,0,17,3,30,9,5,0,14,3,30,6,0,0,6,0,30,4,10,0,14,2,30,4,10,0,14,5,30,4,0,0,4,1,-15,3,1
2,1,17,3,30,9,5,0,14,3,30,6,0,0,6,0,30,4,10,0,14,2,30,4,10,0,14,5,30,4,0,0,4,1,-15,3,1
2,2,17,3,30,9,5,0,14,3,30,6,0,0,6,0,30,4,10,0,14,2,30,4,10,0,14,5,30,4,0,0,4,1,-15,3,1
2,3,17,3,30,9,5,0,14,3,30,6,0,0,6,0,30,4,10,0,14,2,30,4,10,0,14,5,30,4,0,0,4,1,-15,3,1
2,4,17,3,30,9,5,0,14,3,30,6,0,0,6,0,30,4,10,0,14,2,30,4,10,0,14,5,30,4,0,0,4,1,-15,3,1
2,0,19,0,30,1,12,0,13,3,30,7,1,0,8,0,30,4,9,0,13,6,30,4,9,0,13,3,30,9,0,0,9,1,-15,3,1
2,1,19,0,30,1,12,0,13,3,30,7,1,0,8,0,30,4,9,0,13,6,30,4,9,0,13,3,30,9,0,0,9,1,-15,3,1
2,2,19,0,30,1,12,0,13,3,30,7,1,0,8,0,30,4,9,0,13,6,30,4,9,0,13,3,30,9,0,0,9,1,-15,3,1
2,4,22,3,30,8,0,0,8,2,30,2,0,0,2,0,30,4,4,0,8,1,30,3,5,0,8,1,30,1,3,0,4,1,-15,3,1
2,1,25,1,30,6,8,0,14,2,30,6,0,0,6,0,30,9,5,0,14,1,30,5,9,0,14,5,30,5,1,0,6,1,-15,3,1
2,1,27,1,30,4,11,0,15,2,30,1,1,0,2,0,30,6,9,0,15,1,30,6,9,0,15,6,30,6,0,0,6,1,-15,3,1
2,4,31,4,30,8,4,0,12,4,30,8,0,0,8,4,30,11,1,0,12,0,30,3,9,0,12,0,30,4,2,0,6,1,-15,3,1
2,3,32,0,30,6,3,0,9,4,30,2,0,0,2,1,30,8,1,0,9,1,30,3,6,0,9,3,30,2,0,0,2,1,-15,3,1
2,1,4,4,30,8,0,0,8,3,30,4,0,0,4,0,30,5,3,0,8,1,30,4,4,0,8,1,30,4,0,0,4,0,-27,3,0
2,2,4,4,30,8,0,0,8,3,30,4,0,0,4,0,30,5,3,0,8,1,30,4,4,0,8,1,30,4,0,0,4,0,-27,3,0
2,4,4,4,30,8,0,0,8,3,30,4,0,0,4,0,30,5,3,0,8,1,30,4,4,0,8,1,30,4,0,0,4,0,-27,3,0
2,4,8,1,30,7,0,0,7,3,30,2,0,0,2,2,30,4,3,0,7,1,30,7,0,0,7,4,30,3,0,0,3,0,-27,3,0
2,1,9,0,30,2,2,0,4,2,30,2,0,0,2,0,30,0,4,0,4,0,30,1,3,0,4,3,30,1,0,0,1,0,-27,3,0
2,2,11,2,30,5,7,0,12,1,30,4,0,0,4,0,30,7,5,0,12,4,30,7,5,0,12,4,30,4,0,0,4,1,-15,3,1
2,3,11,2,30,5,7,0,12,1,30,4,0,0,4,0,30,7,5,0,12,4,30,7,5,0,12,4,30,4,0,0,4,1,-15,3,1
2,1,13,2,30,5,2,0,7,0,30,4,0,0,4,2,30,7,0,0,7,7,30,7,0,0,7,5,30,4,0,0,4,1,-15,3,1
2,2,13,2,30,5,2,0,7,0,30,4,0,0,4,2,30,7,0,0,7,7,30,7,0,0,7,5,30,4,0,0,4,1,-15,3,1
2,4,13,2,30,5,2,0,7,0,30,4,0,0,4,2,30,7,0,0,7,7,30,7,0,0,7,5,30,4,0,0,4,1,-15,3,1
2,4,15,0,30,6,7,0,13,0,30,6,0,0,6,0,30,3,10,0,13,1,30,3,10,0,13,3,30,9,0,0,9,1,-15,3,1
2,4,19,0,30,5,8,0,13,2,30,6,2,0,8,0,30,6,7,0,13,0,30,7,6,0,13,2,30,8,1,0,9,1,-15,3,1
2,3,21,4,30,10,0,0,10,4,30,6,0,0,6,1,30,3,7,0,10,3,30,5,5,0,10,1,30,4,0,0,4,1,-15,3,1
2,3,25,2,30,6,8,0,14,0,30,6,0,0,6,0,30,14,0,0,14,1,30,5,9,0,14,3,30,5,1,0,6,1,-15,3,1
2,3,27,0,30,4,11,0,15,2,30,2,0,0,2,0,30,7,8,0,15,1,30,3,12,0,15,3,30,6,0,0,6,1,-15,3,1
2,4,27,0,30,4,11,0,15,2,30,2,0,0,2,0,30,7,8,0,15,1,30,3,12,0,15,3,30,6,0,0,6,1,-15,3,1
2,1,13,1,30,6,1,0,7,0,30,4,0,0,4,2,30,6,1,0,7,6,30,6,1,0,7,6,30,4,0,0,4,1,-15,3,1
2,1,17,3,30,11,3,0,14,3,30,6,0,0,6,0,30,5,9,0,14,1,30,6,8,0,14,3,30,4,0,0,4,1,-15,3,1
2,1,19,0,30,7,6,0,13,1,30,5,3,0,8,0,30,4,9,0,13,2,30,6,7,0,13,0,30,7,2,0,9,1,-15,3,1
2,3,21,3,30,7,3,0,10,4,30,6,0,0,6,1,30,3,7,0,10,3,30,4,6,0,10,1,30,4,0,0,4,1,-15,3,1
2,4,23,4,30,6,7,0,13,3,30,6,0,0,6,5,30,11,2,0,13,0,30,5,8,0,13,0,30,5,1,0,6,1,-15,3,1
2,2,26,2,30,7,2,0,9,5,30,4,0,0,4,5,30,1,8,0,9,0,30,2,7,0,9,4,30,3,0,0,3,1,-15,3,1
2,0,27,1,30,4,11,0,15,2,30,1,1,0,2,0,30,8,7,0,15,1,30,5,10,0,15,1,30,5,1,0,6,1,-15,3,1
2,2,27,0,30,4,11,0,15,2,30,1,1,0,2,0,30,8,7,0,15,1,30,5,10,0,15,1,30,5,1,0,6,1,-15,3,1
2,4,27,0,30,4,11,0,15,0,30,1,1,0,2,0,30,8,7,0,15,1,30,5,10,0,15,1,30,5,1,0,6,1,-15,3,1
2,2,35,3,30,7,6,0,13,3,30,2,0,0,2,1,30,11,2,0,13,0,30,1,12,0,13,3,30,8,0,0,8,1,-15,3,1
2,4,35,3,30,7,6,0,13,3,30,2,0,0,2,1,30,11,2,0,13,0,30,1,12,0,13,3,30,8,0,0,8,1,-15,3,1
2,3,38,0,30,1,9,0,10,7,30,6,0,0,6,0,30,1,9,0,10,0,30,5,5,0,10,8,30,6,0,0,6,1,-15,3,1
2,4,3,2,30,2,2,0,4,3,30,4,0,0,4,0,30,0,4,0,4,0,30,0,4,0,4,0,30,1,2,0,3,0,-27,3,0
2,2,4,2,30,6,2,0,8,4,30,4,0,0,4,0,30,2,6,0,8,0,30,4,4,0,8,2,30,4,0,0,4,0,-27,3,0
2,4,4,2,30,6,2,0,8,4,30,4,0,0,4,0,30,2,6,0,8,0,30,4,4,0,8,2,30,4,0,0,4,0,-27,3,0
2,0,5,0,30,1,4,0,5,3,30,3,1,0,4,0,30,0,5,0,5,1,30,2,3,0,5,0,30,0,2,0,2,0,-27,3,0
2,2,5,0,30,1,4,0,5,3,30,3,1,0,4,0,30,0,5,0,5,1,30,2,3,0,5,0,30,0,2,0,2,0,-27,3,0
2,4,6,0,30,4,5,0,9,4,30,2,0,0,2,0,30,2,7,0,9,0,30,5,4,0,9,1,30,5,0,0,5,0,-27,3,0
2,4,13,0,30,7,0,0,7,0,30,4,0,0,4,2,30,5,2,0,7,9,30,6,1,0,7,2,30,4,0,0,4,1,-15,3,1
2,4,15,0,30,3,10,0,13,1,30,5,1,0,6,0,30,5,8,0,13,1,30,8,5,0,13,2,30,8,1,0,9,1,-15,3,1
2,1,17,4,30,9,5,0,14,2,30,6,0,0,6,0,30,7,7,0,14,1,30,6,8,0,14,6,30,4,0,0,4,1,-15,3,1
2,4,17,4,30,9,5,0,14,2,30,6,0,0,6,0,30,7,7,0,14,1,30,6,8,0,14,6,30,4,0,0,4,1,-15,3,1
2,2,19,0,30,3,10,0,13,2,30,6,2,0,8,0,30,4,9,0,13,5,30,4,9,0,13,0,30,8,1,0,9,1,-15,3,1
2,1,23,1,30,5,8,0,13,2,30,6,0,0,6,5,30,13,0,0,13,0,30,5,8,0,13,4,30,6,0,0,6,1,-15,3,1
2,3,23,1,30,5,8,0,13,2,30,6,0,0,6,5,30,13,0,0,13,0,30,5,8,0,13,4,30,6,0,0,6,1,-15,3,1
2,4,23,1,30,5,8,0,13,2,30,6,0,0,6,5,30,13,0,0,13,0,30,5,8,0,13,4,30,6,0,0,6,1,-15,3,1
2,0,25,1,30,5,9,0,14,3,30,6,0,0,6,0,30,8,6,0,14,1,30,9,5,0,14,6,30,6,0,0,6,1,-15,3,1
2,4,25,0,30,5,9,0,14,3,30,6,0,0,6,0,30,8,6,0,14,1,30,9,5,0,14,0,30,6,0,0,6,1,-15,3,1
2,0,27,1,30,9,6,0,15,4,30,2,0,0,2,0,30,5,10,0,15,0,30,4,11,0,15,3,30,5,1,0,6,1,-15,3,1
2,1,27,1,30,9,6,0,15,4,30,2,0,0,2,0,30,5,10,0,15,0,30,4,11,0,15,3,30,5,1,0,6,1,-15,3,1
2,0,5,0,30,3,2,0,5,3,30,0,4,0,4,1,30,3,2,0,5,0,30,1,4,0,5,0,30,2,0,0,2,0,-27,3,0
2,2,5,0,30,3,2,0,5,3,30,0,4,0,4,0,30,3,2,0,5,0,30,1,4,0,5,0,30,2,0,0,2,0,-27,3,0
2,3,5,0,30,3,2,0,5,3,30,0,4,0,4,0,30,3,2,0,5,0,30,1,4,0,5,0,30,2,0,0,2,0,-27,3,0
2,4,5,0,30,3,2,0,5,3,30,0,4,0,4,0,30,3,2,0,5,0,30,1,4,0,5,0,30,2,0,0,2,0,-27,3,0
2,4,8,0,30,7,0,0,7,4,30,2,0,0,2,3,30,2,5,0,7,0,30,4,3,0,7,5,30,3,0,0,3,0,-27,3,0
2,1,13,2,30,7,0,0,7,1,30,4,0,0,4,2,30,6,1,0,7,9,30,6,1,0,7,4,30,4,0,0,4,1,-15,3,1
2,4,13,2,30,7,0,0,7,1,30,4,0,0,4,2,30,6,1,0,7,9,30,6,1,0,7,4,30,4,0,0,4,1,-15,3,1
2,2,19,0,30,2,11,0,13,2,30,7,1,0,8,0,30,4,9,0,13,0,30,6,7,0,13,2,30,7,2,0,9,1,-15,3,1
2,4,25,1,30,9,5,0,14,3,30,6,0,0,6,0,30,5,9,0,14,0,30,4,10,0,14,3,30,5,1,0,6,1,-15,3,1
2,0,26,0,30,8,1,0,9,5,30,4,0,0,4,2,30,3,6,0,9,0,30,2,7,0,9,6,30,3,0,0,3,1,-15,3,1
2,1,26,0,30,8,1,0,9,5,30,4,0,0,4,2,30,3,6,0,9,0,30,2,7,0,9,6,30,3,0,0,3,1,-15,3,1
2,2,27,1,30,3,12,0,15,5,30,1,1,0,2,0,30,3,12,0,15,1,30,5,10,0,15,3,30,6,0,0,6,1,-15,3,1
2,4,27,1,30,3,12,0,15,5,30,1,1,0,2,0,30,3,12,0,15,1,30,5,10,0,15,0,30,6,0,0,6,1,-15,3,1
2,4,32,0,30,4,5,0,9,4,30,2,0,0,2,0,30,8,1,0,9,0,30,3,6,0,9,3,30,1,1,0,2,1,-15,3,1
2,2,33,2,30,6,5,0,11,5,30,4,0,0,4,0,30,4,7,0,11,4,30,5,6,0,11,10,30,4,0,0,4,1,-15,3,1
2,3,33,2,30,6,5,0,11,5,30,4,0,0,4,0,30,4,7,0,11,4,30,5,6,0,11,10,30,4,0,0,4,1,-15,3,1
2,3,35,0,30,13,0,0,13,6,30,2,0,0,2,5,30,2,11,0,13,0,30,4,9,0,13,1,30,6,2,0,8,1,-15,3,1
2,0,37,1,30,6,5,0,11,4,30,5,3,0,8,2,30,9,2,0,11,8,30,3,8,0,11,4,30,6,0,0,6,1,-15,3,1
2,1,37,1,30,6,5,0,11,4,30,5,3,0,8,2,30,9,2,0,11,8,30,3,8,0,11,4,30,6,0,0,6,1,-15,3,1
2,4,37,0,30,6,5,0,11,4,30,5,3,0,8,2,30,9,2,0,11,8,30,3,8,0,11,4,30,6,0,0,6,1,-15,3,1
2,0,5,2,30,2,3,0,5,3,30,2,2,0,4,0,30,1,4,0,5,0,30,1,4,0,5,0,30,1,1,0,2,0,-27,3,0
2,2,5,2,30,2,3,0,5,3,30,2,2,0,4,0,30,1,4,0,5,0,30,1,4,0,5,0,30,1,1,0,2,0,-27,3,0
2,2,13,5,30,7,0,0,7,0,30,4,0,0,4,2,30,5,2,0,7,12,30,3,4,0,7,3,30,4,0,0,4,1,-15,3,1
2,4,13,5,30,7,0,0,7,0,30,4,0,0,4,2,30,5,2,0,7,12,30,3,4,0,7,3,30,4,0,0,4,1,-15,3,1
2,3,17,6,30,10,4,0,14,4,30,6,0,0,6,0,30,3,11,0,14,1,30,6,8,0,14,3,30,4,0,0,4,1,-15,3,1
2,4,17,6,30,10,4,0,14,4,30,6,0,0,6,0,30,3,11,0,14,1,30,6,8,0,14,3,30,4,0,0,4,1,-15,3,1
2,1,19,0,30,5,8,0,13,1,30,8,0,0,8,0,30,7,6,0,13,0,30,4,9,0,13,0,30,6,3,0,9,1,-15,3,1
2,2,19,0,30,5,8,0,13,1,30,8,0,0,8,0,30,7,6,0,13,0,30,4,9,0,13,0,30,6,3,0,9,1,-15,3,1
2,3,19,0,30,5,8,0,13,1,30,8,0,0,8,0,30,7,6,0,13,0,30,4,9,0,13,0,30,6,3,0,9,1,-15,3,1
2,3,21,3,30,7,3,0,10,4,30,4,2,0,6,0,30,3,7,0,10,2,30,6,4,0,10,2,30,4,0,0,4,1,-15,3,1
2,0,26,0,30,9,0,0,9,4,30,4,0,0,4,2,30,0,9,0,9,0,30,2,7,0,9,7,30,3,0,0,3,1,-15,3,1
2,2,27,1,30,4,11,0,15,1,30,1,1,0,2,0,30,6,9,0,15,2,30,4,11,0,15,4,30,6,0,0,6,1,-15,3,1
2,4,3,0,30,1,3,0,4,2,30,4,0,0,4,0,30,2,2,0,4,3,30,0,4,0,4,0,30,1,2,0,3,0,-27,3,0
2,1,4,2,30,8,0,0,8,5,30,4,0,0,4,0,30,2,6,0,8,0,30,8,0,0,8,2,30,3,1,0,4,0,-27,3,0
2,4,7,0,30,4,5,0,9,2,30,4,0,0,4,2,30,7,2,0,9,9,30,3,6,0,9,1,30,4,2,0,6,0,-27,3,0
2,3,8,0,30,7,0,0,7,3,30,2,0,0,2,6,30,5,2,0,7,2,30,7,0,0,7,0,30,3,0,0,3,0,-27,3,0
2,4,15,0,30,3,10,0,13,1,30,5,1,0,6,0,30,3,10,0,13,1,30,4,9,0,13,0,30,6,3,0,9,1,-15,3,1
2,1,19,0,30,4,9,0,13,1,30,6,2,0,8,0,30,9,4,0,13,10,30,4,9,0,13,0,30,7,2,0,9,1,-15,3,1
2,2,19,0,30,4,9,0,13,1,30,6,2,0,8,0,30,9,4,0,13,10,30,4,9,0,13,0,30,7,2,0,9,1,-15,3,1
2,2,23,1,30,4,9,0,13,3,30,6,0,0,6,6,30,12,1,0,13,0,30,6,7,0,13,4,30,6,0,0,6,1,-15,3,1
2,3,23,1,30,4,9,0,13,3,30,6,0,0,6,6,30,12,1,0,13,0,30,6,7,0,13,4,30,6,0,0,6,1,-15,3,1
2,4,25,2,30,3,11,0,14,4,30,6,0,0,6,0,30,6,8,0,14,3,30,7,7,0,14,3,30,6,0,0,6,1,-15,3,1
2,2,27,1,30,5,10,0,15,4,30,1,1,0,2,0,30,6,9,0,15,2,30,4,11,0,15,1,30,6,0,0,6,1,-15,3,1
2,3,27,1,30,5,10,0,15,4,30,1,1,0,2,0,30,6,9,0,15,2,30,4,11,0,15,1,30,6,0,0,6,1,-15,3,1
2,4,27,1,30,5,10,0,15,4,30,1,1,0,2,0,30,6,9,0,15,2,30,4,11,0,15,1,30,6,0,0,6,1,-15,3,1
2,3,29,0,30,4,10,0,14,6,30,12,0,0,12,0,30,4,10,0,14,0,30,0,14,0,14,2,30,9,0,0,9,1,-15,3,1
2,4,29,0,30,4,10,0,14,6,30,12,0,0,12,0,30,4,10,0,14,0,30,0,14,0,14,2,30,9,0,0,9,1,-15,3,1
2,3,43,1,30,13,1,0,14,8,30,6,0,0,6,0,30,4,10,0,14,1,30,1,13,0,14,3,30,5,0,0,5,1,-15,3,1
2,3,6,0,30,8,1,0,9,3,30,2,0,0,2,0,30,4,5,0,9,0,30,3,6,0,9,5,30,5,0,0,5,0,-27,3,0
2,2,13,1,30,6,1,0,7,0,30,4,0,0,4,2,30,6,1,0,7,12,30,6,1,0,7,4,30,4,0,0,4,1,-15,3,1
2,0,19,1,30,5,8,0,13,2,30,6,2,0,8,4,30,6,7,0,13,0,30,5,8,0,13,2,30,7,2,0,9,1,-15,3,1
2,2,21,2,30,6,4,0,10,4,30,6,0,0,6,1,30,3,7,0,10,3,30,5,5,0,10,2,30,4,0,0,4,1,-15,3,1
2,2,23,1,30,5,8,0,13,3,30,6,0,0,6,6,30,9,4,0,13,0,30,6,7,0,13,5,30,6,0,0,6,1,-15,3,1
2,3,23,1,30,5,8,0,13,3,30,6,0,0,6,6,30,9,4,0,13,0,30,6,7,0,13,5,30,6,0,0,6,1,-15,3,1
2,4,23,1,30,5,8,0,13,3,30,6,0,0,6,6,30,9,4,0,13,0,30,6,7,0,13,5,30,6,0,0,6,1,-15,3,1
2,2,25,1,30,8,6,0,14,3,30,6,0,0,6,0,30,7,7,0,14,0,30,10,4,0,14,3,30,5,1,0,6,1,-15,3,1
2,3,25,1,30,8,6,0,14,3,30,6,0,0,6,0,30,7,7,0,14,0,30,10,4,0,14,3,30,5,1,0,6,1,-15,3,1
2,4,25,1,30,8,6,0,14,3,30,6,0,0,6,0,30,7,7,0,14,0,30,10,4,0,14,3,30,5,1,0,6,1,-15,3,1
2,2,27,1,30,7,8,0,15,2,30,1,1,0,2,0,30,6,9,0,15,0,30,4,11,0,15,0,30,5,1,0,6,1,-15,3,1
2,3,27,1,30,7,8,0,15,2,30,1,1,0,2,0,30,6,9,0,15,0,30,4,11,0,15,0,30,5,1,0,6,1,-15,3,1
2,4,27,1,30,7,8,0,15,2,30,1,1,0,2,0,30,6,9,0,15,0,30,4,11,0,15,0,30,5,1,0,6,1,-15,3,1
2,2,31,2,30,8,4,0,12,3,30,8,0,0,8,3,30,11,1,0,12,0,30,3,9,0,12,1,30,3,3,0,6,1,-15,3,1
2,4,31,2,30,8,4,0,12,3,30,8,0,0,8,3,30,11,1,0,12,0,30,3,9,0,12,1,30,3,3,0,6,1,-15,3,1
2,3,17,5,30,10,4,0,14,2,30,6,0,0,6,0,30,6,8,0,14,1,30,7,7,0,14,2,30,4,0,0,4,1,-15,3,1
2,4,22,1,30,6,2,0,8,3,30,2,0,0,2,4,30,4,4,0,8,1,30,1,7,0,8,2,30,2,2,0,4,1,-15,3,1
2,1,23,1,30,4,9,0,13,4,30,6,0,0,6,1,30,10,3,0,13,0,30,5,8,0,13,4,30,6,0,0,6,1,-15,3,1
2,3,23,1,30,4,9,0,13,4,30,6,0,0,6,1,30,10,3,0,13,0,30,5,8,0,13,4,30,6,0,0,6,1,-15,3,1
2,2,25,1,30,2,12,0,14,6,30,6,0,0,6,5,30,6,8,0,14,1,30,6,8,0,14,5,30,6,0,0,6,1,-15,3,1
2,4,25,1,30,2,12,0,14,6,30,6,0,0,6,5,30,6,8,0,14,1,30,6,8,0,14,5,30,6,0,0,6,1,-15,3,1
2,4,27,0,30,5,10,0,15,4,30,1,1,0,2,0,30,8,7,0,15,1,30,3,12,0,15,2,30,6,0,0,6,1,-15,3,1
2,0,31,1,30,4,8,0,12,7,30,8,0,0,8,3,30,6,6,0,12,5,30,8,4,0,12,5,30,6,0,0,6,1,-15,3,1
2,3,31,1,30,4,8,0,12,7,30,8,0,0,8,3,30,6,6,0,12,2,30,8,4,0,12,5,30,6,0,0,6,1,-15,3,1
2,4,4,0,30,7,1,0,8,4,30,2,2,0,4,0,30,1,7,0,8,0,30,1,7,0,8,2,30,4,0,0,4,0,-27,3,0
2,1,13,2,30,6,1,0,7,0,30,4,0,0,4,2,30,6,1,0,7,7,30,6,1,0,7,6,30,4,0,0,4,1,-15,3,1
2,2,13,2,30,6,1,0,7,0,30,4,0,0,4,2,30,6,1,0,7,7,30,6,1,0,7,6,30,4,0,0,4,1,-15,3,1
2,3,15,0,30,4,9,0,13,1,30,6,0,0,6,0,30,3,10,0,13,1,30,4,9,0,13,3,30,9,0,0,9,1,-15,3,1
2,4,17,3,30,9,5,0,14,2,30,6,0,0,6,0,30,7,7,0,14,2,30,5,9,0,14,1,30,3,1,0,4,1,-15,3,1
2,4,19,0,30,3,10,0,13,2,30,6,2,0,8,0,30,5,8,0,13,0,30,3,10,0,13,1,30,8,1,0,9,1,-15,3,1
2,4,23,3,30,6,7,0,13,3,30,6,0,0,6,4,30,11,2,0,13,0,30,4,9,0,13,0,30,6,0,0,6,1,-15,3,1
2,1,33,6,30,5,6,0,11,6,30,4,0,0,4,5,30,9,2,0,11,0,30,3,8,0,11,3,30,4,0,0,4,1,-15,3,1
2,2,33,6,30,5,6,0,11,6,30,4,0,0,4,5,30,9,2,0,11,0,30,3,8,0,11,3,30,4,0,0,4,1,-15,3,1
2,4,17,1,30,8,6,0,14,3,30,6,0,0,6,0,30,3,11,0,14,1,30,5,9,0,14,2,30,4,0,0,4,1,-15,3,1
2,4,19,3,30,6,7,0,13,0,30,5,3,0,8,0,30,7,6,0,13,0,30,6,7,0,13,1,30,6,3,0,9,1,-15,3,1
2,3,23,2,30,5,8,0,13,2,30,6,0,0,6,2,30,13,0,0,13,2,30,5,8,0,13,2,30,6,0,0,6,1,-15,3,1
2,4,23,2,30,5,8,0,13,2,30,6,0,0,6,2,30,13,0,0,13,2,30,5,8,0,13,2,30,6,0,0,6,1,-15,3,1
2,0,27,1,30,6,9,0,15,5,30,2,0,0,2,0,30,4,11,0,15,3,30,7,8,0,15,6,30,6,0,0,6,1,-15,3,1
2,3,39,0,30,3,8,0,11,5,30,6,0,0,6,0,30,8,3,0,11,0,30,4,7,0,11,6,30,5,0,0,5,1,-15,3,1
2,4,8,0,30,7,0,0,7,4,30,2,0,0,2,1,30,1,6,0,7,0,30,3,4,0,7,3,30,3,0,0,3,0,-27,3,0
2,4,11,1,30,4,8,0,12,0,30,4,0,0,4,1,30,7,5,0,12,8,30,2,10,0,12,5,30,4,0,0,4,1,-15,3,1
2,1,13,1,30,6,1,0,7,0,30,4,0,0,4,2,30,6,1,0,7,5,30,7,0,0,7,7,30,4,0,0,4,1,-15,3,1
2,3,13,1,30,6,1,0,7,0,30,4,0,0,4,2,30,6,1,0,7,5,30,7,0,0,7,3,30,4,0,0,4,1,-15,3,1
2,4,15,0,30,5,8,0,13,1,30,6,0,0,6,0,30,3,10,0,13,1,30,5,8,0,13,2,30,5,4,0,9,1,-15,3,1
2,3,17,2,30,10,4,0,14,2,30,6,0,0,6,0,30,4,10,0,14,1,30,2,12,0,14,5,30,4,0,0,4,1,-15,3,1
2,4,23,1,30,6,7,0,13,4,30,6,0,0,6,7,30,7,6,0,13,3,30,6,7,0,13,4,30,6,0,0,6,1,-15,3,1
2,2,25,1,30,7,7,0,14,4,30,6,0,0,6,0,30,8,6,0,14,1,30,10,4,0,14,3,30,4,2,0,6,1,-15,3,1
2,0,27,1,30,7,8,0,15,3,30,2,0,0,2,0,30,2,13,0,15,1,30,5,10,0,15,1,30,4,2,0,6,1,-15,3,1
2,3,27,0,30,7,8,0,15,3,30,2,0,0,2,0,30,2,13,0,15,1,30,5,10,0,15,1,30,4,2,0,6,1,-15,3,1
2,4,27,0,30,7,8,0,15,3,30,2,0,0,2,0,30,2,13,0,15,1,30,5,10,0,15,1,30,4,2,0,6,1,-15,3,1
2,1,31,7,30,7,5,0,12,5,30,8,0,0,8,3,30,9,3,0,12,0,30,3,9,0,12,1,30,3,3,0,6,1,-15,3,1
2,3,31,7,30,7,5,0,12,5,30,8,0,0,8,3,30,9,3,0,12,0,30,3,9,0,12,1,30,3,3,0,6,1,-15,3,1
2,4,31,7,30,7,5,0,12,5,30,8,0,0,8,3,30,9,3,0,12,0,30,3,9,0,12,1,30,3,3,0,6,1,-15,3,1
2,4,8,1,30,7,0,0,7,3,30,2,0,0,2,0,30,6,1,0,7,0,30,7,0,0,7,1,30,3,0,0,3,0,-27,3,0
2,2,11,0,30,1,3,0,4,0,30,0,0,0,0,0,30,2,2,0,4,4,30,4,0,0,4,2,30,1,0,0,1,1,-15,3,1
2,1,13,4,30,5,2,0,7,0,30,4,0,0,4,2,30,6,1,0,7,8,30,7,0,0,7,3,30,4,0,0,4,1,-15,3,1
2,4,13,4,30,5,2,0,7,0,30,4,0,0,4,2,30,6,1,0,7,8,30,7,0,0,7,3,30,4,0,0,4,1,-15,3,1
2,3,15,1,30,4,9,0,13,1,30,6,0,0,6,0,30,3,10,0,13,1,30,7,6,0,13,2,30,6,3,0,9,1,-15,3,1
2,4,17,4,30,10,4,0,14,3,30,6,0,0,6,0,30,5,9,0,14,1,30,5,9,0,14,3,30,4,0,0,4,1,-15,3,1
2,4,19,0,30,3,10,0,13,2,30,6,2,0,8,0,30,7,6,0,13,1,30,4,9,0,13,1,30,9,0,0,9,1,-15,3,1
2,4,25,1,30,8,6,0,14,1,30,6,0,0,6,0,30,8,6,0,14,1,30,5,9,0,14,3,30,6,0,0,6,1,-15,3,1
2,3,27,1,30,5,10,0,15,1,30,2,0,0,2,0,30,8,7,0,15,5,30,4,11,0,15,1,30,6,0,0,6,1,-15,3,1
2,4,27,1,30,5,10,0,15,1,30,2,0,0,2,0,30,8,7,0,15,5,30,4,11,0,15,1,30,6,0,0,6,1,-15,3,1
2,4,29,0,30,5,9,0,14,5,30,10,2,0,12,0,30,7,7,0,14,0,30,1,13,0,14,3,30,9,0,0,9,1,-15,3,1
2,3,35,0,30,11,2,0,13,4,30,2,0,0,2,6,30,4,9,0,13,2,30,1,12,0,13,3,30,8,0,0,8,1,-15,3,1
2,4,35,0,30,11,2,0,13,4,30,2,0,0,2,6,30,4,9,0,13,2,30,1,12,0,13,3,30,8,0,0,8,1,-15,3,1
2,4,11,1,30,6,6,0,12,0,30,4,0,0,4,0,30,7,5,0,12,3,30,3,9,0,12,0,30,4,0,0,4,1,-15,3,1
2,4,15,1,30,6,7,0,13,0,30,6,0,0,6,0,30,3,10,0,13,1,30,2,11,0,13,2,30,5,4,0,9,1,-15,3,1
2,4,17,2,30,9,5,0,14,3,30,6,0,0,6,0,30,5,9,0,14,2,30,5,9,0,14,0,30,4,0,0,4,1,-15,3,1
2,2,19,0,30,5,8,0,13,2,30,3,5,0,8,0,30,4,9,0,13,6,30,8,5,0,13,4,30,9,0,0,9,1,-15,3,1
2,4,19,0,30,5,8,0,13,2,30,3,5,0,8,0,30,4,9,0,13,6,30,8,5,0,13,4,30,9,0,0,9,1,-15,3,1
2,0,27,2,30,7,8,0,15,2,30,2,0,0,2,0,30,2,13,0,15,0,30,6,9,0,15,5,30,6,0,0,6,1,-15,3,1
2,0,29,1,30,4,10,0,14,5,30,12,0,0,12,0,30,4,10,0,14,0,30,1,13,0,14,3,30,9,0,0,9,1,-15,3,1
2,4,29,1,30,4,10,0,14,5,30,12,0,0,12,0,30,4,10,0,14,0,30,1,13,0,14,3,30,9,0,0,9,1,-15,3,1
2,3,31,5,30,5,7,0,12,4,30,8,0,0,8,3,30,12,0,0,12,0,30,3,9,0,12,0,30,3,3,0,6,1,-15,3,1
2,1,1,0,30,7,3,0,10,4,30,2,0,0,2,1,30,4,6,0,10,3,30,7,3,0,10,3,30,6,0,0,6,0,-27,3,0
2,2,1,0,30,7,3,0,10,4,30,2,0,0,2,1,30,4,6,0,10,3,30,7,3,0,10,3,30,6,0,0,6,0,-27,3,0
2,4,13,4,30,7,0,0,7,0,30,4,0,0,4,1,30,6,1,0,7,7,30,5,2,0,7,3,30,4,0,0,4,1,-15,3,1
2,2,17,3,30,7,7,0,14,4,30,6,0,0,6,0,30,5,9,0,14,4,30,5,9,0,14,1,30,4,0,0,4,1,-15,3,1
2,2,25,1,30,6,8,0,14,6,30,6,0,0,6,0,30,3,11,0,14,3,30,7,7,0,14,8,30,6,0,0,6,1,-15,3,1
2,1,27,1,30,4,11,0,15,3,30,2,0,0,2,0,30,7,8,0,15,0,30,4,11,0,15,3,30,6,0,0,6,1,-15,3,1
2,2,27,1,30,4,11,0,15,3,30,2,0,0,2,0,30,7,8,0,15,0,30,4,11,0,15,3,30,6,0,0,6,1,-15,3,1
2,4,27,1,30,4,11,0,15,3,30,2,0,0,2,0,30,7,8,0,15,0,30,4,11,0,15,3,30,6,0,0,6,1,-15,3,1
2,3,31,2,30,8,4,0,12,3,30,8,0,0,8,3,30,12,0,0,12,0,30,3,9,0,12,0,30,2,4,0,6,1,-15,3,1
2,4,39,1,30,5,6,0,11,6,30,6,0,0,6,0,30,5,6,0,11,0,30,2,9,0,11,2,30,5,0,0,5,1,-15,3,1
2,4,43,0,30,6,8,0,14,10,30,6,0,0,6,0,30,4,10,0,14,1,30,8,6,0,14,5,30,5,0,0,5,1,-15,3,1
2,1,11,0,30,4,8,0,12,1,30,4,0,0,4,0,30,5,7,0,12,8,30,2,10,0,12,4,30,4,0,0,4,1,-15,3,1
2,2,11,0,30,4,8,0,12,1,30,4,0,0,4,0,30,5,7,0,12,8,30,2,10,0,12,4,30,4,0,0,4,1,-15,3,1
2,3,13,1,30,3,0,0,3,0,30,2,0,0,2,0,30,3,0,0,3,6,30,3,0,0,3,4,30,2,0,0,2,1,-15,3,1
2,2,13,1,30,6,1,0,7,0,30,4,0,0,4,2,30,6,1,0,7,11,30,7,0,0,7,4,30,4,0,0,4,1,-15,3,1
2,4,13,1,30,6,1,0,7,0,30,4,0,0,4,2,30,6,1,0,7,11,30,7,0,0,7,4,30,4,0,0,4,1,-15,3,1
2,4,15,0,30,4,9,0,13,0,30,6,0,0,6,0,30,5,8,0,13,1,30,4,9,0,13,2,30,8,1,0,9,1,-15,3,1
2,2,17,4,30,9,5,0,14,3,30,6,0,0,6,0,30,6,8,0,14,1,30,6,8,0,14,0,30,4,0,0,4,1,-15,3,1
2,3,17,4,30,9,5,0,14,3,30,6,0,0,6,0,30,6,8,0,14,1,30,6,8,0,14,0,30,4,0,0,4,1,-15,3,1
2,2,19,0,30,4,9,0,13,2,30,6,2,0,8,2,30,7,6,0,13,7,30,4,9,0,13,0,30,7,2,0,9,1,-15,3,1
2,2,21,2,30,6,4,0,10,3,30,4,2,0,6,0,30,3,7,0,10,6,30,5,5,0,10,3,30,4,0,0,4,1,-15,3,1
2,3,21,2,30,6,4,0,10,3,30,4,2,0,6,0,30,3,7,0,10,6,30,5,5,0,10,3,30,4,0,0,4,1,-15,3,1
2,2,25,2,30,5,9,0,14,3,30,6,0,0,6,0,30,11,3,0,14,1,30,4,10,0,14,4,30,6,0,0,6,1,-15,3,1
2,4,25,2,30,5,9,0,14,3,30,6,0,0,6,0,30,11,3,0,14,0,30,4,10,0,14,4,30,6,0,0,6,1,-15,3,1
2,3,47,0,30,0,14,0,14,5,30,4,0,0,4,0,30,5,9,0,14,1,30,2,12,0,14,8,30,7,0,0,7,1,-15,3,1
2,3,13,3,30,7,0,0,7,0,30,4,0,0,4,2,30,5,2,0,7,4,30,6,1,0,7,4,30,4,0,0,4,1,-15,3,1
2,4,13,3,30,7,0,0,7,0,30,4,0,0,4,2,30,5,2,0,7,4,30,6,1,0,7,4,30,4,0,0,4,1,-15,3,1
2,4,15,2,30,5,8,0,13,1,30,6,0,0,6,0,30,4,9,0,13,1,30,3,10,0,13,2,30,8,1,0,9,1,-15,3,1
2,4,23,2,30,6,7,0,13,1,30,6,0,0,6,3,30,12,1,0,13,0,30,5,8,0,13,2,30,5,1,0,6,1,-15,3,1
2,1,25,1,30,5,9,0,14,2,30,6,0,0,6,0,30,12,2,0,14,1,30,5,9,0,14,4,30,5,1,0,6,1,-15,3,1
2,3,25,1,30,5,9,0,14,2,30,6,0,0,6,0,30,12,2,0,14,1,30,5,9,0,14,4,30,5,1,0,6,1,-15,3,1
2,4,25,1,30,5,9,0,14,2,30,6,0,0,6,0,30,12,2,0,14,1,30,5,9,0,14,4,30,5,1,0,6,1,-15,3,1
2,2,27,1,30,6,9,0,15,5,30,2,0,0,2,0,30,3,12,0,15,3,30,4,11,0,15,5,30,6,0,0,6,1,-15,3,1
2,4,13,3,30,7,0,0,7,0,30,4,0,0,4,1,30,6,1,0,7,7,30,6,1,0,7,3,30,4,0,0,4,1,-15,3,1
2,4,15,0,30,6,7,0,13,0,30,6,0,0,6,0,30,3,10,0,13,1,30,4,9,0,13,1,30,7,2,0,9,1,-15,3,1
2,4,23,1,30,10,3,0,13,1,30,6,0,0,6,0,30,13,0,0,13,0,30,5,8,0,13,2,30,5,1,0,6,1,-15,3,1
2,0,27,1,30,5,10,0,15,2,30,2,0,0,2,0,30,3,12,0,15,5,30,5,10,0,15,4,30,6,0,0,6,1,-15,3,1
2,2,30,11,30,3,2,0,5,6,30,2,0,0,2,1,30,2,3,0,5,2,30,1,4,0,5,0,30,2,1,0,3,1,-15,3,1
2,3,30,11,30,3,2,0,5,6,30,2,0,0,2,1,30,2,3,0,5,2,30,1,4,0,5,0,30,2,1,0,3,1,-15,3,1
2,4,30,11,30,3,2,0,5,6,30,2,0,0,2,1,30,2,3,0,5,2,30,1,4,0,5,0,30,2,1,0,3,1,-15,3,1
2,3,31,1,30,12,0,0,12,5,30,8,0,0,8,3,30,4,8,0,12,0,30,3,9,0,12,0,30,1,5,0,6,1,-15,3,1
2,2,1,0,30,6,4,0,10,4,30,2,0,0,2,1,30,4,6,0,10,7,30,7,3,0,10,6,30,6,0,0,6,0,-27,3,0
2,3,7,0,30,5,4,0,9,2,30,4,0,0,4,0,30,6,3,0,9,4,30,2,7,0,9,1,30,4,2,0,6,0,-27,3,0
2,4,9,0,30,2,2,0,4,2,30,2,0,0,2,1,30,4,0,0,4,3,30,1,3,0,4,0,30,0,1,0,1,0,-27,3,0
2,3,13,4,30,6,1,0,7,2,30,4,0,0,4,2,30,6,1,0,7,2,30,5,2,0,7,2,30,4,0,0,4,1,-15,3,1
2,4,17,3,30,11,3,0,14,3,30,6,0,0,6,0,30,4,10,0,14,1,30,6,8,0,14,4,30,4,0,0,4,1,-15,3,1
2,3,22,1,30,7,1,0,8,3,30,2,0,0,2,0,30,6,2,0,8,2,30,3,5,0,8,3,30,4,0,0,4,1,-15,3,1
2,4,23,1,30,2,11,0,13,2,30,6,0,0,6,0,30,12,1,0,13,1,30,6,7,0,13,0,30,6,0,0,6,1,-15,3,1
2,2,27,3,30,7,8,0,15,0,30,1,1,0,2,0,30,9,6,0,15,0,30,3,12,0,15,2,30,2,4,0,6,1,-15,3,1
2,3,31,2,30,4,8,0,12,7,30,8,0,0,8,3,30,4,8,0,12,0,30,9,3,0,12,2,30,6,0,0,6,1,-15,3,1
2,4,39,0,30,4,7,0,11,7,30,6,0,0,6,0,30,5,6,0,11,1,30,5,6,0,11,0,30,5,0,0,5,1,-15,3,1
2,2,9,0,30,7,4,0,11,3,30,6,0,0,6,1,30,6,5,0,11,2,30,3,8,0,11,2,30,4,0,0,4,0,-27,3,0
2,4,9,0,30,7,4,0,11,3,30,6,0,0,6,1,30,6,5,0,11,2,30,3,8,0,11,2,30,4,0,0,4,0,-27,3,0
2,1,13,1,30,6,1,0,7,0,30,4,0,0,4,2,30,6,1,0,7,8,30,5,2,0,7,4,30,4,0,0,4,1,-15,3,1
2,2,13,1,30,6,1,0,7,0,30,4,0,0,4,2,30,6,1,0,7,8,30,5,2,0,7,4,30,4,0,0,4,1,-15,3,1
2,4,13,1,30,6,1,0,7,0,30,4,0,0,4,2,30,6,1,0,7,8,30,5,2,0,7,4,30,4,0,0,4,1,-15,3,1
2,3,15,0,30,3,10,0,13,0,30,6,0,0,6,0,30,4,9,0,13,1,30,6,7,0,13,0,30,8,1,0,9,1,-15,3,1
2,0,17,4,30,8,6,0,14,4,30,6,0,0,6,0,30,5,9,0,14,5,30,6,8,0,14,5,30,4,0,0,4,1,-15,3,1
2,1,17,4,30,8,6,0,14,4,30,6,0,0,6,0,30,5,9,0,14,5,30,6,8,0,14,5,30,4,0,0,4,1,-15,3,1
2,1,19,1,30,2,11,0,13,3,30,8,0,0,8,0,30,4,9,0,13,4,30,8,5,0,13,0,30,7,2,0,9,1,-15,3,1
2,2,19,1,30,2,11,0,13,3,30,8,0,0,8,0,30,4,9,0,13,4,30,8,5,0,13,0,30,7,2,0,9,1,-15,3,1
2,4,19,1,30,2,11,0,13,3,30,8,0,0,8,0,30,4,9,0,13,4,30,8,5,0,13,0,30,7,2,0,9,1,-15,3,1
2,2,25,1,30,6,8,0,14,4,30,6,0,0,6,0,30,6,8,0,14,1,30,5,9,0,14,5,30,5,1,0,6,1,-15,3,1
2,0,27,1,30,4,11,0,15,5,30,2,0,0,2,0,30,5,10,0,15,1,30,5,10,0,15,3,30,6,0,0,6,1,-15,3,1
2,1,27,1,30,4,11,0,15,5,30,2,0,0,2,0,30,5,10,0,15,1,30,5,10,0,15,3,30,6,0,0,6,1,-15,3,1
2,2,27,1,30,4,11,0,15,5,30,2,0,0,2,0,30,5,10,0,15,1,30,5,10,0,15,3,30,6,0,0,6,1,-15,3,1
2,3,29,1,30,6,8,0,14,6,30,12,0,0,12,0,30,4,10,0,14,2,30,2,12,0,14,0,30,7,2,0,9,1,-15,3,1
2,4,29,1,30,6,8,0,14,6,30,12,0,0,12,0,30,4,10,0,14,2,30,2,12,0,14,0,30,7,2,0,9,1,-15,3,1
2,2,31,6,30,8,4,0,12,4,30,8,0,0,8,5,30,10,2,0,12,0,30,3,9,0,12,0,30,2,4,0,6,1,-15,3,1
2,3,31,6,30,8,4,0,12,4,30,8,0,0,8,5,30,10,2,0,12,0,30,3,9,0,12,0,30,2,4,0,6,1,-15,3,1
2,4,31,6,30,8,4,0,12,4,30,8,0,0,8,5,30,10,2,0,12,0,30,3,9,0,12,0,30,2,4,0,6,1,-15,3,1
2,1,6,0,30,8,1,0,9,3,30,2,0,0,2,0,30,2,7,0,9,0,30,3,6,0,9,3,30,5,0,0,5,0,-27,3,0
2,2,6,0,30,8,1,0,9,3,30,2,0,0,2,0,30,2,7,0,9,0,30,3,6,0,9,3,30,5,0,0,5,0,-27,3,0
2,3,8,3,30,7,0,0,7,3,30,2,0,0,2,0,30,1,6,0,7,0,30,6,1,0,7,5,30,3,0,0,3,0,-27,3,0
2,4,8,3,30,7,0,0,7,3,30,2,0,0,2,0,30,1,6,0,7,0,30,6,1,0,7,5,30,3,0,0,3,0,-27,3,0
2,2,17,3,30,10,4,0,14,3,30,6,0,0,6,0,30,5,9,0,14,0,30,7,7,0,14,2,30,4,0,0,4,1,-15,3,1
2,3,17,3,30,10,4,0,14,3,30,6,0,0,6,0,30,5,9,0,14,0,30,7,7,0,14,2,30,4,0,0,4,1,-15,3,1
2,4,17,3,30,10,4,0,14,3,30,6,0,0,6,0,30,5,9,0,14,0,30,7,7,0,14,2,30,4,0,0,4,1,-15,3,1
2,4,19,0,30,3,10,0,13,2,30,8,0,0,8,0,30,4,9,0,13,4,30,4,9,0,13,0,30,7,2,0,9,1,-15,3,1
2,4,23,2,30,7,6,0,13,0,30,6,0,0,6,3,30,13,0,0,13,0,30,6,7,0,13,2,30,5,1,0,6,1,-15,3,1
2,0,25,1,30,4,10,0,14,6,30,6,0,0,6,0,30,3,11,0,14,3,30,5,9,0,14,5,30,6,0,0,6,1,-15,3,1
2,2,25,1,30,4,10,0,14,3,30,6,0,0,6,0,30,3,11,0,14,3,30,5,9,0,14,5,30,6,0,0,6,1,-15,3,1
2,3,25,1,30,4,10,0,14,3,30,6,0,0,6,0,30,3,11,0,14,3,30,5,9,0,14,5,30,6,0,0,6,1,-15,3,1
2,4,25,1,30,4,10,0,14,3,30,6,0,0,6,0,30,3,11,0,14,3,30,5,9,0,14,5,30,6,0,0,6,1,-15,3,1
2,1,27,2,30,7,8,0,15,5,30,2,0,0,2,0,30,2,13,0,15,2,30,6,9,0,15,2,30,6,0,0,6,1,-15,3,1
2,2,27,2,30,7,8,0,15,5,30,2,0,0,2,0,30,2,13,0,15,2,30,6,9,0,15,2,30,6,0,0,6,1,-15,3,1
2,3,27,2,30,7,8,0,15,5,30,2,0,0,2,0,30,2,13,0,15,2,30,6,9,0,15,2,30,6,0,0,6,1,-15,3,1
2,4,27,2,30,7,8,0,15,5,30,2,0,0,2,0,30,2,13,0,15,2,30,6,9,0,15,2,30,6,0,0,6,1,-15,3,1
2,2,31,3,30,6,6,0,12,5,30,8,0,0,8,3,30,9,3,0,12,0,30,3,9,0,12,1,30,5,1,0,6,1,-15,3,1
2,0,43,0,30,4,10,0,14,8,30,6,0,0,6,0,30,4,10,0,14,1,30,8,6,0,14,10,30,5,0,0,5,1,-15,3,1
2,3,43,0,30,4,10,0,14,8,30,6,0,0,6,0,30,4,10,0,14,1,30,8,6,0,14,10,30,5,0,0,5,1,-15,3,1
2,2,47,0,30,1,13,0,14,8,30,4,0,0,4,0,30,3,11,0,14,0,30,6,8,0,14,7,30,7,0,0,7,1,-15,3,1
2,4,1,0,30,7,3,0,10,4,30,2,0,0,2,1,30,4,6,0,10,7,30,8,2,0,10,6,30,6,0,0,6,0,-27,3,0
2,3,13,1,30,5,2,0,7,0,30,4,0,0,4,0,30,6,1,0,7,5,30,6,1,0,7,7,30,4,0,0,4,1,-15,3,1
2,4,15,0,30,3,10,0,13,1,30,6,0,0,6,0,30,3,10,0,13,1,30,7,6,0,13,1,30,9,0,0,9,1,-15,3,1
2,2,25,2,30,5,9,0,14,4,30,6,0,0,6,0,30,8,6,0,14,1,30,5,9,0,14,3,30,6,0,0,6,1,-15,3,1
2,0,27,1,30,3,12,0,15,5,30,2,0,0,2,0,30,3,12,0,15,0,30,4,11,0,15,3,30,6,0,0,6,1,-15,3,1
2,3,27,0,30,3,12,0,15,5,30,2,0,0,2,0,30,3,12,0,15,0,30,4,11,0,15,3,30,6,0,0,6,1,-15,3,1
2,4,31,1,30,8,4,0,12,5,30,8,0,0,8,3,30,4,8,0,12,0,30,6,6,0,12,4,30,2,4,0,6,1,-15,3,1
2,4,39,0,30,6,5,0,11,6,30,6,0,0,6,0,30,7,4,0,11,2,30,4,7,0,11,0,30,2,3,0,5,1,-15,3,1
2,0,4,3,30,8,0,0,8,5,30,4,0,0,4,0,30,2,6,0,8,0,30,4,4,0,8,3,30,2,2,0,4,0,-27,3,0
2,1,5,0,30,1,4,0,5,2,30,3,1,0,4,0,30,1,4,0,5,0,30,1,4,0,5,3,30,0,2,0,2,0,-27,3,0
2,4,6,0,30,7,2,0,9,3,30,2,0,0,2,0,30,2,7,0,9,0,30,3,6,0,9,4,30,5,0,0,5,0,-27,3,0
2,1,11,1,30,3,9,0,12,0,30,4,0,0,4,0,30,8,4,0,12,7,30,5,7,0,12,5,30,4,0,0,4,1,-15,3,1
2,1,13,3,30,5,2,0,7,0,30,4,0,0,4,2,30,5,2,0,7,9,30,7,0,0,7,4,30,4,0,0,4,1,-15,3,1
2,2,13,3,30,5,2,0,7,0,30,4,0,0,4,2,30,5,2,0,7,9,30,7,0,0,7,4,30,4,0,0,4,1,-15,3,1
2,4,13,3,30,5,2,0,7,0,30,4,0,0,4,2,30,5,2,0,7,9,30,7,0,0,7,4,30,4,0,0,4,1,-15,3,1
2,2,17,2,30,11,3,0,14,1,30,6,0,0,6,0,30,10,4,0,14,1,30,6,8,0,14,5,30,4,0,0,4,1,-15,3,1
2,4,19,0,30,3,10,0,13,2,30,5,3,0,8,0,30,5,8,0,13,3,30,7,6,0,13,1,30,9,0,0,9,1,-15,3,1
2,2,23,3,30,5,8,0,13,2,30,6,0,0,6,4,30,13,0,0,13,0,30,6,7,0,13,4,30,6,0,0,6,1,-15,3,1
2,4,23,3,30,5,8,0,13,2,30,6,0,0,6,4,30,13,0,0,13,0,30,6,7,0,13,4,30,6,0,0,6,1,-15,3,1
2,0,27,1,30,5,10,0,15,4,30,2,0,0,2,0,30,6,9,0,15,1,30,4,11,0,15,4,30,6,0,0,6,1,-15,3,1
2,3,27,1,30,5,10,0,15,4,30,2,0,0,2,0,30,6,9,0,15,1,30,4,11,0,15,4,30,6,0,0,6,1,-15,3,1
2,4,27,1,30,5,10,0,15,4,30,2,0,0,2,0,30,6,9,0,15,1,30,4,11,0,15,4,30,6,0,0,6,1,-15,3,1
2,4,29,0,30,4,10,0,14,6,30,10,2,0,12,0,30,2,12,0,14,0,30,5,9,0,14,5,30,9,0,0,9,1,-15,3,1
2,3,35,0,30,6,7,0,13,2,30,2,0,0,2,1,30,7,6,0,13,3,30,4,9,0,13,1,30,8,0,0,8,1,-15,3,1
2,2,37,1,30,7,4,0,11,4,30,6,2,0,8,0,30,9,2,0,11,6,30,3,8,0,11,5,30,6,0,0,6,1,-15,3,1
2,3,37,1,30,7,4,0,11,4,30,6,2,0,8,0,30,9,2,0,11,6,30,3,8,0,11,5,30,6,0,0,6,1,-15,3,1
2,3,13,2,30,6,1,0,7,0,30,4,0,0,4,0,30,6,1,0,7,4,30,6,1,0,7,2,30,4,0,0,4,1,-15,3,1
2,4,13,2,30,6,1,0,7,0,30,4,0,0,4,0,30,6,1,0,7,4,30,6,1,0,7,2,30,4,0,0,4,1,-15,3,1
2,2,17,5,30,11,3,0,14,3,30,6,0,0,6,0,30,4,10,0,14,2,30,7,7,0,14,0,30,2,2,0,4,1,-15,3,1
2,4,17,5,30,11,3,0,14,3,30,6,0,0,6,0,30,4,10,0,14,2,30,7,7,0,14,0,30,2,2,0,4,1,-15,3,1
2,4,19,0,30,6,7,0,13,1,30,7,1,0,8,0,30,7,6,0,13,4,30,4,9,0,13,1,30,8,1,0,9,1,-15,3,1
2,2,23,2,30,5,8,0,13,1,30,6,0,0,6,0,30,13,0,0,13,3,30,6,7,0,13,4,30,6,0,0,6,1,-15,3,1
2,3,23,2,30,5,8,0,13,1,30,6,0,0,6,0,30,13,0,0,13,3,30,6,7,0,13,4,30,6,0,0,6,1,-15,3,1
2,3,25,1,30,7,7,0,14,5,30,6,0,0,6,0,30,5,9,0,14,0,30,8,6,0,14,6,30,6,0,0,6,1,-15,3,1
2,1,27,1,30,7,8,0,15,5,30,1,1,0,2,0,30,4,11,0,15,0,30,8,7,0,15,2,30,6,0,0,6,1,-15,3,1
2,2,31,2,30,7,5,0,12,3,30,8,0,0,8,3,30,11,1,0,12,0,30,3,9,0,12,0,30,3,3,0,6,1,-15,3,1
2,2,39,0,30,6,5,0,11,7,30,6,0,0,6,0,30,4,7,0,11,1,30,3,8,0,11,5,30,5,0,0,5,1,-15,3,1
2,4,39,0,30,6,5,0,11,7,30,6,0,0,6,0,30,4,7,0,11,1,30,3,8,0,11,5,30,5,0,0,5,1,-15,3,1
2,3,7,0,30,3,1,0,4,2,30,2,0,0,2,0,30,1,3,0,4,0,30,1,3,0,4,3,30,2,0,0,2,0,-27,3,0
2,3,7,1,30,5,4,0,9,3,30,4,0,0,4,0,30,4,5,0,9,4,30,2,7,0,9,3,30,6,0,0,6,0,-27,3,0
2,1,13,2,30,7,0,0,7,0,30,4,0,0,4,5,30,7,0,0,7,6,30,5,2,0,7,4,30,4,0,0,4,1,-15,3,1
2,2,19,1,30,4,9,0,13,2,30,7,1,0,8,0,30,7,6,0,13,5,30,4,9,0,13,0,30,8,1,0,9,1,-15,3,1
2,4,19,1,30,4,9,0,13,2,30,7,1,0,8,0,30,7,6,0,13,0,30,4,9,0,13,0,30,8,1,0,9,1,-15,3,1
2,3,23,2,30,3,10,0,13,2,30,6,0,0,6,8,30,13,0,0,13,0,30,8,5,0,13,4,30,6,0,0,6,1,-15,3,1
2,4,23,2,30,3,10,0,13,2,30,6,0,0,6,8,30,13,0,0,13,0,30,8,5,0,13,4,30,6,0,0,6,1,-15,3,1
2,2,25,1,30,10,4,0,14,2,30,6,0,0,6,0,30,7,7,0,14,1,30,5,9,0,14,0,30,5,1,0,6,1,-15,3,1
2,3,25,1,30,10,4,0,14,2,30,6,0,0,6,0,30,7,7,0,14,1,30,5,9,0,14,0,30,5,1,0,6,1,-15,3,1
2,4,25,1,30,10,4,0,14,2,30,6,0,0,6,0,30,7,7,0,14,1,30,5,9,0,14,0,30,5,1,0,6,1,-15,3,1
2,2,27,1,30,4,11,0,15,4,30,1,1,0,2,0,30,2,13,0,15,2,30,7,8,0,15,5,30,6,0,0,6,1,-15,3,1
2,4,27,1,30,4,11,0,15,4,30,1,1,0,2,0,30,2,13,0,15,0,30,7,8,0,15,5,30,6,0,0,6,1,-15,3,1
2,4,29,1,30,8,6,0,14,6,30,8,4,0,12,2,30,3,11,0,14,0,30,0,14,0,14,0,30,6,3,0,9,1,-15,3,1
2,1,31,3,30,3,9,0,12,5,30,8,0,0,8,3,30,7,5,0,12,0,30,3,9,0,12,3,30,6,0,0,6,1,-15,3,1
2,2,31,3,30,3,9,0,12,5,30,8,0,0,8,3,30,7,5,0,12,0,30,3,9,0,12,3,30,6,0,0,6,1,-15,3,1
2,3,31,3,30,3,9,0,12,5,30,8,0,0,8,3,30,7,5,0,12,0,30,3,9,0,12,3,30,6,0,0,6,1,-15,3,1
2,4,31,3,30,3,9,0,12,5,30,8,0,0,8,3,30,7,5,0,12,0,30,3,9,0,12,3,30,6,0,0,6,1,-15,3,1
2,2,39,0,30,2,9,0,11,5,30,6,0,0,6,0,30,4,7,0,11,0,30,1,10,0,11,4,30,5,0,0,5,1,-15,3,1
2,3,39,0,30,2,9,0,11,5,30,6,0,0,6,0,30,4,7,0,11,0,30,1,10,0,11,4,30,5,0,0,5,1,-15,3,1
2,4,39,0,30,2,9,0,11,5,30,6,0,0,6,0,30,4,7,0,11,0,30,1,10,0,11,4,30,5,0,0,5,1,-15,3,1
2,3,5,0,30,2,3,0,5,3,30,0,4,0,4,0,30,0,5,0,5,3,30,2,3,0,5,0,30,0,2,0,2,0,-27,3,0
2,4,7,0,30,2,2,0,4,2,30,2,0,0,2,0,30,3,1,0,4,0,30,1,3,0,4,2,30,2,0,0,2,0,-27,3,0
2,2,13,1,30,5,2,0,7,1,30,4,0,0,4,2,30,6,1,0,7,3,30,7,0,0,7,4,30,4,0,0,4,1,-15,3,1
2,3,15,1,30,8,5,0,13,0,30,6,0,0,6,0,30,3,10,0,13,1,30,4,9,0,13,2,30,4,5,0,9,1,-15,3,1
2,1,19,0,30,4,9,0,13,2,30,7,1,0,8,0,30,7,6,0,13,9,30,4,9,0,13,4,30,8,1,0,9,1,-15,3,1
2,2,19,0,30,4,9,0,13,2,30,7,1,0,8,0,30,7,6,0,13,9,30,4,9,0,13,4,30,8,1,0,9,1,-15,3,1
2,4,19,0,30,4,9,0,13,2,30,7,1,0,8,0,30,7,6,0,13,9,30,4,9,0,13,4,30,8,1,0,9,1,-15,3,1
2,4,23,2,30,6,7,0,13,3,30,6,0,0,6,7,30,11,2,0,13,0,30,4,9,0,13,1,30,5,1,0,6,1,-15,3,1
2,3,25,1,30,10,4,0,14,3,30,6,0,0,6,0,30,6,8,0,14,1,30,5,9,0,14,4,30,5,1,0,6,1,-15,3,1
2,4,25,1,30,10,4,0,14,3,30,6,0,0,6,0,30,6,8,0,14,1,30,5,9,0,14,4,30,5,1,0,6,1,-15,3,1
2,3,27,1,30,3,12,0,15,1,30,2,0,0,2,0,30,5,10,0,15,2,30,5,10,0,15,5,30,6,0,0,6,1,-15,3,1
2,0,29,0,30,5,9,0,14,6,30,12,0,0,12,0,30,3,11,0,14,0,30,1,13,0,14,4,30,9,0,0,9,1,-15,3,1
2,1,29,0,30,5,9,0,14,6,30,12,0,0,12,0,30,3,11,0,14,0,30,1,13,0,14,4,30,9,0,0,9,1,-15,3,1
2,2,29,0,30,5,9,0,14,6,30,12,0,0,12,0,30,3,11,0,14,0,30,1,13,0,14,4,30,9,0,0,9,1,-15,3,1
2,2,19,1,30,4,9,0,13,1,30,8,0,0,8,0,30,11,2,0,13,6,30,4,9,0,13,1,30,8,1,0,9,1,-15,3,1
2,4,22,1,30,8,0,0,8,3,30,2,0,0,2,0,30,3,5,0,8,1,30,3,5,0,8,2,30,2,2,0,4,1,-15,3,1
2,2,23,1,30,5,8,0,13,3,30,6,0,0,6,3,30,12,1,0,13,0,30,5,8,0,13,1,30,6,0,0,6,1,-15,3,1
2,4,23,1,30,5,8,0,13,3,30,6,0,0,6,3,30,12,1,0,13,0,30,5,8,0,13,1,30,6,0,0,6,1,-15,3,1
2,4,25,1,30,7,7,0,14,3,30,6,0,0,6,0,30,6,8,0,14,1,30,7,7,0,14,4,30,5,1,0,6,1,-15,3,1
2,0,26,0,30,9,0,0,9,4,30,3,1,0,4,5,30,0,9,0,9,0,30,2,7,0,9,6,30,3,0,0,3,1,-15,3,1
2,2,27,3,30,8,7,0,15,3,30,1,1,0,2,0,30,8,7,0,15,2,30,3,12,0,15,3,30,6,0,0,6,1,-15,3,1
2,3,27,3,30,8,7,0,15,3,30,1,1,0,2,0,30,8,7,0,15,2,30,3,12,0,15,3,30,6,0,0,6,1,-15,3,1
2,4,27,3,30,8,7,0,15,3,30,1,1,0,2,0,30,8,7,0,15,2,30,3,12,0,15,3,30,6,0,0,6,1,-15,3,1
2,4,39,0,30,2,9,0,11,6,30,6,0,0,6,0,30,6,5,0,11,2,30,2,9,0,11,4,30,5,0,0,5,1,-15,3,1
2,0,11,1,30,4,8,0,12,1,30,4,0,0,4,0,30,7,5,0,12,4,30,9,3,0,12,7,30,4,0,0,4,1,-15,3,1
2,1,11,1,30,4,8,0,12,1,30,4,0,0,4,0,30,7,5,0,12,4,30,9,3,0,12,7,30,4,0,0,4,1,-15,3,1
2,1,13,3,30,5,2,0,7,1,30,4,0,0,4,2,30,6,1,0,7,4,30,5,2,0,7,2,30,4,0,0,4,1,-15,3,1
2,2,13,3,30,5,2,0,7,1,30,4,0,0,4,2,30,6,1,0,7,4,30,5,2,0,7,2,30,4,0,0,4,1,-15,3,1
2,3,13,3,30,5,2,0,7,1,30,4,0,0,4,2,30,6,1,0,7,4,30,5,2,0,7,2,30,4,0,0,4,1,-15,3,1
2,4,13,3,30,5,2,0,7,1,30,4,0,0,4,2,30,6,1,0,7,4,30,5,2,0,7,2,30,4,0,0,4,1,-15,3,1
2,1,17,4,30,9,5,0,14,3,30,6,0,0,6,0,30,6,8,0,14,2,30,7,7,0,14,4,30,4,0,0,4,1,-15,3,1
2,2,17,4,30,9,5,0,14,3,30,6,0,0,6,0,30,6,8,0,14,2,30,7,7,0,14,4,30,4,0,0,4,1,-15,3,1
2,4,19,0,30,4,9,0,13,1,30,8,0,0,8,0,30,7,6,0,13,0,30,2,11,0,13,1,30,7,2,0,9,1,-15,3,1
2,4,23,1,30,5,8,0,13,3,30,6,0,0,6,10,30,10,3,0,13,0,30,4,9,0,13,0,30,6,0,0,6,1,-15,3,1
2,4,25,0,30,11,3,0,14,3,30,6,0,0,6,0,30,5,9,0,14,1,30,5,9,0,14,4,30,5,1,0,6,1,-15,3,1
2,3,27,1,30,4,11,0,15,1,30,2,0,0,2,0,30,6,9,0,15,0,30,7,8,0,15,5,30,6,0,0,6,1,-15,3,1
2,4,27,1,30,4,11,0,15,1,30,2,0,0,2,0,30,6,9,0,15,0,30,7,8,0,15,5,30,6,0,0,6,1,-15,3,1
2,0,29,0,30,8,6,0,14,6,30,11,1,0,12,0,30,3,11,0,14,0,30,2,12,0,14,5,30,9,0,0,9,1,-15,3,1
2,2,29,0,30,8,6,0,14,6,30,11,1,0,12,0,30,3,11,0,14,0,30,2,12,0,14,5,30,9,0,0,9,1,-15,3,1
2,3,29,0,30,8,6,0,14,6,30,11,1,0,12,0,30,3,11,0,14,0,30,2,12,0,14,5,30,9,0,0,9,1,-15,3,1
2,4,29,0,30,8,6,0,14,6,30,11,1,0,12,0,30,3,11,0,14,0,30,2,12,0,14,5,30,9,0,0,9,1,-15,3,1
2,3,31,2,30,3,9,0,12,6,30,8,0,0,8,3,30,8,4,0,12,0,30,9,3,0,12,0,30,5,1,0,6,1,-15,3,1
2,4,31,2,30,3,9,0,12,6,30,8,0,0,8,3,30,8,4,0,12,0,30,9,3,0,12,0,30,5,1,0,6,1,-15,3,1
2,2,39,4,30,4,7,0,11,5,30,6,0,0,6,3,30,10,1,0,11,0,30,2,9,0,11,0,30,2,3,0,5,1,-15,3,1
2,3,39,4,30,4,7,0,11,5,30,6,0,0,6,3,30,10,1,0,11,0,30,2,9,0,11,0,30,2,3,0,5,1,-15,3,1
2,4,39,4,30,4,7,0,11,5,30,6,0,0,6,3,30,10,1,0,11,0,30,2,9,0,11,0,30,2,3,0,5,1,-15,3,1
2,2,17,1,30,7,7,0,14,2,30,6,0,0,6,0,30,8,6,0,14,6,30,6,8,0,14,8,30,4,0,0,4,1,-15,3,1
2,2,19,0,30,3,10,0,13,1,30,8,0,0,8,0,30,7,6,0,13,8,30,4,9,0,13,1,30,9,0,0,9,1,-15,3,1
2,3,25,2,30,7,7,0,14,3,30,6,0,0,6,0,30,10,4,0,14,1,30,4,10,0,14,4,30,5,1,0,6,1,-15,3,1
2,4,25,2,30,7,7,0,14,3,30,6,0,0,6,0,30,10,4,0,14,1,30,4,10,0,14,4,30,5,1,0,6,1,-15,3,1
2,2,33,1,30,3,8,0,11,4,30,4,0,0,4,1,30,10,1,0,11,4,30,3,8,0,11,8,30,4,0,0,4,1,-15,3,1
2,3,33,1,30,3,8,0,11,4,30,4,0,0,4,1,30,10,1,0,11,4,30,3,8,0,11,8,30,4,0,0,4,1,-15,3,1
2,1,41,0,30,12,0,0,12,4,30,7,1,0,8,0,30,9,3,0,12,0,30,3,9,0,12,5,30,2,5,0,7,1,-15,3,1
2,2,41,0,30,12,0,0,12,4,30,7,1,0,8,0,30,9,3,0,12,0,30,3,9,0,12,5,30,2,5,0,7,1,-15,3,1
2,4,3,0,30,0,4,0,4,2,30,4,0,0,4,0,30,0,4,0,4,3,30,3,1,0,4,1,30,2,1,0,3,0,-27,3,0
2,1,5,0,30,1,4,0,5,2,30,3,1,0,4,0,30,0,5,0,5,0,30,1,4,0,5,2,30,0,2,0,2,0,-27,3,0
2,3,5,0,30,1,4,0,5,2,30,3,1,0,4,0,30,0,5,0,5,0,30,1,4,0,5,2,30,0,2,0,2,0,-27,3,0
2,1,13,2,30,7,0,0,7,0,30,4,0,0,4,2,30,6,1,0,7,11,30,7,0,0,7,5,30,4,0,0,4,1,-15,3,1
2,2,13,2,30,7,0,0,7,0,30,4,0,0,4,2,30,6,1,0,7,11,30,7,0,0,7,5,30,4,0,0,4,1,-15,3,1
2,4,13,2,30,7,0,0,7,0,30,4,0,0,4,2,30,6,1,0,7,11,30,7,0,0,7,5,30,4,0,0,4,1,-15,3,1
2,3,15,1,30,3,10,0,13,0,30,6,0,0,6,0,30,4,9,0,13,1,30,4,9,0,13,2,30,7,2,0,9,1,-15,3,1
2,4,15,1,30,3,10,0,13,0,30,6,0,0,6,0,30,4,9,0,13,1,30,4,9,0,13,2,30,7,2,0,9,1,-15,3,1
2,4,19,0,30,4,9,0,13,2,30,5,3,0,8,0,30,4,9,0,13,9,30,4,9,0,13,2,30,8,1,0,9,1,-15,3,1
2,4,22,5,30,8,0,0,8,3,30,2,0,0,2,0,30,3,5,0,8,0,30,4,4,0,8,0,30,1,3,0,4,1,-15,3,1
2,2,25,2,30,6,8,0,14,4,30,6,0,0,6,0,30,6,8,0,14,1,30,4,10,0,14,0,30,5,1,0,6,1,-15,3,1
2,4,25,2,30,6,8,0,14,4,30,6,0,0,6,0,30,6,8,0,14,1,30,4,10,0,14,0,30,5,1,0,6,1,-15,3,1
2,3,31,1,30,6,6,0,12,6,30,8,0,0,8,3,30,4,8,0,12,0,30,6,6,0,12,5,30,6,0,0,6,1,-15,3,1
2,2,39,0,30,4,7,0,11,6,30,6,0,0,6,0,30,8,3,0,11,0,30,3,8,0,11,6,30,5,0,0,5,1,-15,3,1
2,3,39,0,30,4,7,0,11,6,30,6,0,0,6,0,30,8,3,0,11,0,30,3,8,0,11,6,30,5,0,0,5,1,-15,3,1
2,4,5,0,30,4,1,0,5,3,30,4,0,0,4,0,30,0,5,0,5,0,30,1,4,0,5,0,30,0,2,0,2,0,-27,3,0
2,4,17,1,30,3,11,0,14,2,30,6,0,0,6,0,30,10,4,0,14,5,30,5,9,0,14,2,30,4,0,0,4,1,-15,3,1
2,1,19,0,30,3,10,0,13,2,30,5,3,0,8,0,30,5,8,0,13,1,30,5,8,0,13,1,30,9,0,0,9,1,-15,3,1
2,2,19,0,30,3,10,0,13,2,30,5,3,0,8,0,30,5,8,0,13,1,30,5,8,0,13,1,30,9,0,0,9,1,-15,3,1
2,4,19,0,30,3,10,0,13,2,30,5,3,0,8,0,30,5,8,0,13,1,30,5,8,0,13,0,30,9,0,0,9,1,-15,3,1
2,3,27,1,30,3,12,0,15,4,30,2,0,0,2,0,30,5,10,0,15,0,30,2,13,0,15,1,30,6,0,0,6,1,-15,3,1
2,4,29,2,30,8,6,0,14,5,30,11,1,0,12,0,30,3,11,0,14,0,30,1,13,0,14,0,30,5,4,0,9,1,-15,3,1
2,3,39,0,30,1,10,0,11,6,30,6,0,0,6,0,30,4,7,0,11,0,30,2,9,0,11,6,30,5,0,0,5,1,-15,3,1
2,3,41,0,30,9,3,0,12,7,30,8,0,0,8,0,30,3,9,0,12,3,30,4,8,0,12,3,30,7,0,0,7,1,-15,3,1
2,4,41,0,30,9,3,0,12,7,30,8,0,0,8,0,30,3,9,0,12,3,30,4,8,0,12,3,30,7,0,0,7,1,-15,3,1
2,4,8,0,30,7,0,0,7,3,30,2,0,0,2,2,30,5,2,0,7,0,30,5,2,0,7,0,30,2,1,0,3,0,-27,3,0
2,1,13,2,30,7,0,0,7,0,30,4,0,0,4,1,30,7,0,0,7,5,30,5,2,0,7,4,30,4,0,0,4,1,-15,3,1
2,2,13,2,30,7,0,0,7,0,30,4,0,0,4,1,30,7,0,0,7,5,30,5,2,0,7,4,30,4,0,0,4,1,-15,3,1
2,3,13,2,30,7,0,0,7,0,30,4,0,0,4,1,30,7,0,0,7,5,30,5,2,0,7,4,30,4,0,0,4,1,-15,3,1
2,2,17,1,30,11,3,0,14,3,30,6,0,0,6,0,30,4,10,0,14,4,30,4,10,0,14,2,30,4,0,0,4,1,-15,3,1
2,4,17,1,30,11,3,0,14,3,30,6,0,0,6,0,30,4,10,0,14,4,30,4,10,0,14,2,30,4,0,0,4,1,-15,3,1
2,4,22,1,30,6,2,0,8,3,30,2,0,0,2,0,30,4,4,0,8,0,30,2,6,0,8,4,30,3,1,0,4,1,-15,3,1
2,3,23,1,30,6,7,0,13,3,30,6,0,0,6,3,30,11,2,0,13,1,30,6,7,0,13,0,30,6,0,0,6,1,-15,3,1
2,4,23,1,30,6,7,0,13,3,30,6,0,0,6,3,30,11,2,0,13,1,30,6,7,0,13,0,30,6,0,0,6,1,-15,3,1
2,1,27,2,30,6,9,0,15,3,30,2,0,0,2,0,30,2,13,0,15,3,30,4,11,0,15,5,30,6,0,0,6,1,-15,3,1
2,2,27,2,30,6,9,0,15,3,30,2,0,0,2,0,30,2,13,0,15,3,30,4,11,0,15,5,30,6,0,0,6,1,-15,3,1
2,4,31,1,30,9,3,0,12,5,30,8,0,0,8,3,30,4,8,0,12,0,30,5,7,0,12,1,30,4,2,0,6,1,-15,3,1
2,3,35,8,30,9,4,0,13,6,30,2,0,0,2,1,30,2,11,0,13,0,30,1,12,0,13,7,30,8,0,0,8,1,-15,3,1
2,3,39,0,30,1,10,0,11,5,30,6,0,0,6,0,30,7,4,0,11,2,30,2,9,0,11,6,30,5,0,0,5,1,-15,3,1
2,2,13,0,30,3,0,0,3,0,30,2,0,0,2,2,30,3,0,0,3,8,30,2,1,0,3,5,30,2,0,0,2,1,-15,3,1
2,2,13,0,30,4,3,0,7,0,30,4,0,0,4,3,30,7,0,0,7,8,30,6,1,0,7,4,30,4,0,0,4,1,-15,3,1
2,4,13,0,30,4,3,0,7,0,30,4,0,0,4,3,30,7,0,0,7,8,30,6,1,0,7,4,30,4,0,0,4,1,-15,3,1
2,0,17,4,30,9,5,0,14,3,30,6,0,0,6,0,30,3,11,0,14,6,30,6,8,0,14,5,30,4,0,0,4,1,-15,3,1
2,3,23,2,30,5,8,0,13,0,30,6,0,0,6,4,30,13,0,0,13,0,30,5,8,0,13,2,30,6,0,0,6,1,-15,3,1
2,4,23,2,30,5,8,0,13,0,30,6,0,0,6,4,30,13,0,0,13,0,30,5,8,0,13,2,30,6,0,0,6,1,-15,3,1
2,3,25,1,30,5,9,0,14,5,30,6,0,0,6,0,30,8,6,0,14,1,30,4,10,0,14,4,30,5,1,0,6,1,-15,3,1
2,0,27,1,30,4,11,0,15,3,30,1,1,0,2,0,30,6,9,0,15,2,30,6,9,0,15,5,30,6,0,0,6,1,-15,3,1
2,1,27,1,30,4,11,0,15,3,30,1,1,0,2,0,30,6,9,0,15,2,30,6,9,0,15,5,30,6,0,0,6,1,-15,3,1
2,3,27,1,30,4,11,0,15,3,30,1,1,0,2,0,30,6,9,0,15,2,30,6,9,0,15,5,30,6,0,0,6,1,-15,3,1
2,4,29,0,30,4,10,0,14,5,30,12,0,0,12,0,30,3,11,0,14,0,30,5,9,0,14,0,30,7,2,0,9,1,-15,3,1
2,4,37,1,30,7,4,0,11,5,30,5,3,0,8,6,30,11,0,0,11,2,30,2,9,0,11,0,30,6,0,0,6,1,-15,3,1
2,1,5,0,30,2,3,0,5,2,30,2,2,0,4,0,30,4,1,0,5,0,30,1,4,0,5,0,30,0,2,0,2,0,-27,3,0
2,2,9,0,30,1,3,0,4,2,30,2,0,0,2,0,30,0,4,0,4,1,30,1,3,0,4,0,30,1,0,0,1,0,-27,3,0
2,3,9,0,30,1,3,0,4,2,30,2,0,0,2,0,30,0,4,0,4,1,30,1,3,0,4,0,30,1,0,0,1,0,-27,3,0
2,2,13,2,30,7,0,0,7,0,30,4,0,0,4,2,30,6,1,0,7,6,30,6,1,0,7,3,30,4,0,0,4,1,-15,3,1
2,3,13,2,30,7,0,0,7,0,30,4,0,0,4,2,30,6,1,0,7,6,30,6,1,0,7,3,30,4,0,0,4,1,-15,3,1
2,3,15,1,30,6,7,0,13,0,30,6,0,0,6,0,30,5,8,0,13,1,30,2,11,0,13,2,30,5,4,0,9,1,-15,3,1
2,1,17,2,30,9,5,0,14,4,30,6,0,0,6,0,30,4,10,0,14,2,30,8,6,0,14,4,30,4,0,0,4,1,-15,3,1
2,4,17,2,30,9,5,0,14,4,30,6,0,0,6,0,30,4,10,0,14,2,30,8,6,0,14,4,30,4,0,0,4,1,-15,3,1
2,3,19,0,30,4,9,0,13,2,30,6,2,0,8,0,30,4,9,0,13,4,30,6,7,0,13,1,30,8,1,0,9,1,-15,3,1
2,4,19,0,30,4,9,0,13,2,30,6,2,0,8,0,30,4,9,0,13,4,30,6,7,0,13,1,30,8,1,0,9,1,-15,3,1
2,4,25,0,30,4,10,0,14,3,30,6,0,0,6,0,30,9,5,0,14,1,30,5,9,0,14,3,30,5,1,0,6,1,-15,3,1
2,3,31,6,30,6,6,0,12,6,30,8,0,0,8,3,30,4,8,0,12,0,30,3,9,0,12,2,30,4,2,0,6,1,-15,3,1
2,2,1,0,30,7,3,0,10,4,30,2,0,0,2,3,30,4,6,0,10,0,30,8,2,0,10,6,30,6,0,0,6,0,-27,3,0
2,3,1,0,30,7,3,0,10,4,30,2,0,0,2,3,30,4,6,0,10,0,30,8,2,0,10,6,30,6,0,0,6,0,-27,3,0
2,3,4,4,30,8,0,0,8,5,30,4,0,0,4,0,30,2,6,0,8,0,30,4,4,0,8,0,30,4,0,0,4,0,-27,3,0
2,4,4,4,30,8,0,0,8,5,30,4,0,0,4,0,30,2,6,0,8,0,30,4,4,0,8,0,30,4,0,0,4,0,-27,3,0
2,3,6,0,30,7,2,0,9,3,30,2,0,0,2,0,30,3,6,0,9,0,30,3,6,0,9,1,30,5,0,0,5,0,-27,3,0
2,4,8,1,30,7,0,0,7,4,30,2,0,0,2,7,30,3,4,0,7,0,30,7,0,0,7,3,30,3,0,0,3,0,-27,3,0
2,4,13,7,30,7,0,0,7,0,30,4,0,0,4,2,30,6,1,0,7,4,30,3,4,0,7,3,30,4,0,0,4,1,-15,3,1
2,3,15,0,30,3,10,0,13,0,30,6,0,0,6,1,30,12,1,0,13,1,30,4,9,0,13,3,30,8,1,0,9,1,-15,3,1
2,2,17,1,30,8,6,0,14,2,30,6,0,0,6,0,30,6,8,0,14,5,30,5,9,0,14,7,30,4,0,0,4,1,-15,3,1
2,3,38,0,30,3,7,0,10,6,30,6,0,0,6,0,30,1,9,0,10,0,30,2,8,0,10,7,30,6,0,0,6,1,-15,3,1
2,2,41,0,30,6,6,0,12,8,30,7,1,0,8,0,30,3,9,0,12,0,30,3,9,0,12,3,30,7,0,0,7,1,-15,3,1
2,3,41,0,30,6,6,0,12,8,30,7,1,0,8,0,30,3,9,0,12,0,30,3,9,0,12,3,30,7,0,0,7,1,-15,3,1
2,4,41,0,30,6,6,0,12,8,30,7,1,0,8,0,30,3,9,0,12,0,30,3,9,0,12,3,30,7,0,0,7,1,-15,3,1
2,4,4,2,30,6,2,0,8,4,30,4,0,0,4,0,30,1,7,0,8,1,30,0,8,0,8,0,30,3,1,0,4,0,-27,3,0
2,4,7,10,30,3,6,0,9,4,30,2,2,0,4,0,30,5,4,0,9,1,30,2,7,0,9,1,30,6,0,0,6,0,-27,3,0
2,4,8,8,30,7,0,0,7,4,30,2,0,0,2,2,30,2,5,0,7,0,30,1,6,0,7,3,30,3,0,0,3,0,-27,3,0
2,3,11,2,30,5,7,0,12,2,30,4,0,0,4,2,30,4,8,0,12,0,30,4,8,0,12,0,30,3,1,0,4,1,-15,3,1
2,4,11,2,30,5,7,0,12,2,30,4,0,0,4,2,30,4,8,0,12,0,30,4,8,0,12,0,30,3,1,0,4,1,-15,3,1
2,4,13,3,30,7,0,0,7,0,30,4,0,0,4,2,30,6,1,0,7,6,30,6,1,0,7,4,30,4,0,0,4,1,-15,3,1
2,0,21,3,30,7,3,0,10,4,30,5,1,0,6,1,30,3,7,0,10,4,30,6,4,0,10,2,30,4,0,0,4,1,-15,3,1
2,3,25,1,30,4,10,0,14,4,30,6,0,0,6,1,30,13,1,0,14,1,30,5,9,0,14,2,30,3,3,0,6,1,-15,3,1
2,4,25,1,30,4,10,0,14,4,30,6,0,0,6,1,30,13,1,0,14,1,30,5,9,0,14,2,30,3,3,0,6,1,-15,3,1
2,2,31,1,30,6,6,0,12,7,30,8,0,0,8,3,30,4,8,0,12,0,30,9,3,0,12,4,30,6,0,0,6,1,-15,3,1
2,3,31,1,30,6,6,0,12,7,30,8,0,0,8,3,30,4,8,0,12,0,30,9,3,0,12,4,30,6,0,0,6,1,-15,3,1
2,4,31,1,30,6,6,0,12,7,30,8,0,0,8,3,30,4,8,0,12,0,30,9,3,0,12,4,30,6,0,0,6,1,-15,3,1
2,2,1,0,30,7,3,0,10,3,30,2,0,0,2,1,30,7,3,0,10,0,30,6,4,0,10,6,30,6,0,0,6,0,-27,3,0
2,3,1,0,30,7,3,0,10,3,30,2,0,0,2,1,30,7,3,0,10,0,30,6,4,0,10,6,30,6,0,0,6,0,-27,3,0
2,1,4,2,30,7,1,0,8,5,30,4,0,0,4,0,30,1,7,0,8,2,30,6,2,0,8,3,30,4,0,0,4,0,-27,3,0
2,2,4,2,30,7,1,0,8,5,30,4,0,0,4,0,30,1,7,0,8,2,30,6,2,0,8,3,30,4,0,0,4,0,-27,3,0
2,4,4,2,30,7,1,0,8,5,30,4,0,0,4,0,30,1,7,0,8,2,30,6,2,0,8,3,30,4,0,0,4,0,-27,3,0
2,3,6,0,30,9,0,0,9,4,30,2,0,0,2,0,30,2,7,0,9,0,30,4,5,0,9,0,30,2,3,0,5,0,-27,3,0
2,1,13,2,30,6,1,0,7,1,30,4,0,0,4,1,30,6,1,0,7,6,30,6,1,0,7,6,30,4,0,0,4,1,-15,3,1
2,4,13,2,30,6,1,0,7,0,30,4,0,0,4,1,30,6,1,0,7,6,30,6,1,0,7,6,30,4,0,0,4,1,-15,3,1
2,4,17,2,30,10,4,0,14,2,30,6,0,0,6,0,30,5,9,0,14,1,30,3,11,0,14,1,30,4,0,0,4,1,-15,3,1
2,1,19,0,30,4,9,0,13,3,30,7,1,0,8,0,30,4,9,0,13,7,30,7,6,0,13,0,30,9,0,0,9,1,-15,3,1
2,3,23,3,30,7,6,0,13,3,30,6,0,0,6,5,30,11,2,0,13,3,30,6,7,0,13,1,30,5,1,0,6,1,-15,3,1
2,1,27,1,30,3,12,0,15,4,30,1,1,0,2,0,30,5,10,0,15,4,30,6,9,0,15,3,30,6,0,0,6,1,-15,3,1
2,2,29,0,30,9,5,0,14,5,30,11,1,0,12,0,30,4,10,0,14,0,30,0,14,0,14,0,30,8,1,0,9,1,-15,3,1
2,3,37,1,30,4,7,0,11,7,30,8,0,0,8,0,30,2,9,0,11,2,30,3,8,0,11,7,30,6,0,0,6,1,-15,3,1
2,4,1,0,30,7,3,0,10,4,30,2,0,0,2,1,30,3,7,0,10,0,30,5,5,0,10,5,30,6,0,0,6,0,-27,3,0
2,3,7,0,30,6,3,0,9,2,30,4,0,0,4,0,30,8,1,0,9,4,30,1,8,0,9,1,30,5,1,0,6,0,-27,3,0
2,2,17,4,30,10,4,0,14,0,30,6,0,0,6,0,30,6,8,0,14,1,30,4,10,0,14,3,30,4,0,0,4,1,-15,3,1
2,3,19,0,30,3,10,0,13,2,30,5,3,0,8,0,30,5,8,0,13,4,30,5,8,0,13,2,30,9,0,0,9,1,-15,3,1
2,0,31,1,30,8,4,0,12,3,30,8,0,0,8,3,30,10,2,0,12,0,30,3,9,0,12,0,30,6,0,0,6,1,-15,3,1
2,1,31,1,30,8,4,0,12,3,30,8,0,0,8,3,30,10,2,0,12,0,30,3,9,0,12,0,30,6,0,0,6,1,-15,3,1
2,3,31,1,30,8,4,0,12,3,30,8,0,0,8,3,30,10,2,0,12,0,30,3,9,0,12,0,30,6,0,0,6,1,-15,3,1
2,2,35,0,30,5,8,0,13,2,30,2,0,0,2,1,30,10,3,0,13,4,30,5,8,0,13,0,30,8,0,0,8,1,-15,3,1
2,2,4,2,30,8,0,0,8,4,30,4,0,0,4,1,30,5,3,0,8,0,30,5,3,0,8,1,30,4,0,0,4,0,-27,3,0
2,4,4,2,30,8,0,0,8,4,30,4,0,0,4,1,30,5,3,0,8,0,30,5,3,0,8,1,30,4,0,0,4,0,-27,3,0
2,3,8,2,30,7,0,0,7,3,30,2,0,0,2,0,30,3,4,0,7,2,30,6,1,0,7,3,30,3,0,0,3,0,-27,3,0
2,2,11,5,30,5,7,0,12,1,30,4,0,0,4,0,30,6,6,0,12,0,30,4,8,0,12,2,30,4,0,0,4,1,-15,3,1
2,3,13,0,30,6,1,0,7,0,30,4,0,0,4,2,30,7,0,0,7,5,30,6,1,0,7,4,30,4,0,0,4,1,-15,3,1
2,4,13,0,30,6,1,0,7,0,30,4,0,0,4,2,30,7,0,0,7,5,30,6,1,0,7,4,30,4,0,0,4,1,-15,3,1
2,3,17,2,30,10,4,0,14,2,30,6,0,0,6,0,30,6,8,0,14,2,30,7,7,0,14,2,30,4,0,0,4,1,-15,3,1
2,4,23,1,30,6,7,0,13,3,30,6,0,0,6,0,30,11,2,0,13,2,30,4,9,0,13,5,30,6,0,0,6,1,-15,3,1
2,1,27,1,30,5,10,0,15,2,30,2,0,0,2,0,30,8,7,0,15,0,30,4,11,0,15,0,30,5,1,0,6,1,-15,3,1
2,3,27,1,30,5,10,0,15,2,30,2,0,0,2,0,30,8,7,0,15,0,30,4,11,0,15,0,30,5,1,0,6,1,-15,3,1
2,1,29,2,30,6,8,0,14,5,30,8,4,0,12,0,30,7,7,0,14,0,30,1,13,0,14,4,30,9,0,0,9,1,-15,3,1
2,4,39,0,30,4,7,0,11,5,30,6,0,0,6,0,30,9,2,0,11,1,30,3,8,0,11,1,30,4,1,0,5,1,-15,3,1
2,3,8,1,30,7,0,0,7,3,30,2,0,0,2,6,30,5,2,0,7,2,30,7,0,0,7,3,30,3,0,0,3,0,-27,3,0
2,1,19,0,30,2,11,0,13,2,30,4,4,0,8,0,30,4,9,0,13,11,30,4,9,0,13,0,30,9,0,0,9,1,-15,3,1
2,2,25,2,30,8,6,0,14,1,30,6,0,0,6,0,30,9,5,0,14,1,30,5,9,0,14,4,30,5,1,0,6,1,-15,3,1
2,1,27,0,30,4,11,0,15,2,30,2,0,0,2,0,30,6,9,0,15,1,30,6,9,0,15,5,30,6,0,0,6,1,-15,3,1
2,3,32,3,30,8,1,0,9,4,30,2,0,0,2,0,30,9,0,0,9,1,30,2,7,0,9,3,30,2,0,0,2,1,-15,3,1
2,4,32,3,30,8,1,0,9,4,30,2,0,0,2,0,30,9,0,0,9,1,30,2,7,0,9,3,30,2,0,0,2,1,-15,3,1
2,2,11,0,30,4,8,0,12,1,30,4,0,0,4,0,30,6,6,0,12,2,30,7,5,0,12,2,30,4,0,0,4,1,-15,3,1
2,3,17,3,30,9,5,0,14,2,30,6,0,0,6,0,30,6,8,0,14,1,30,5,9,0,14,3,30,4,0,0,4,1,-15,3,1
2,4,25,0,30,6,8,0,14,2,30,6,0,0,6,0,30,8,6,0,14,1,30,5,9,0,14,4,30,6,0,0,6,1,-15,3,1
2,1,27,1,30,4,11,0,15,1,30,2,0,0,2,0,30,7,8,0,15,2,30,4,11,0,15,4,30,6,0,0,6,1,-15,3,1
2,3,27,1,30,4,11,0,15,1,30,2,0,0,2,0,30,7,8,0,15,2,30,4,11,0,15,4,30,6,0,0,6,1,-15,3,1
2,2,13,2,30,7,0,0,7,0,30,4,0,0,4,2,30,5,2,0,7,7,30,5,2,0,7,5,30,4,0,0,4,1,-15,3,1
2,4,13,2,30,7,0,0,7,0,30,4,0,0,4,2,30,5,2,0,7,7,30,5,2,0,7,5,30,4,0,0,4,1,-15,3,1
2,2,17,3,30,8,6,0,14,3,30,6,0,0,6,0,30,8,6,0,14,5,30,6,8,0,14,3,30,4,0,0,4,1,-15,3,1
2,3,17,3,30,8,6,0,14,3,30,6,0,0,6,0,30,8,6,0,14,5,30,6,8,0,14,3,30,4,0,0,4,1,-15,3,1
2,4,17,3,30,8,6,0,14,3,30,6,0,0,6,0,30,8,6,0,14,5,30,6,8,0,14,3,30,4,0,0,4,1,-15,3,1
2,0,19,0,30,5,8,0,13,2,30,4,4,0,8,3,30,7,6,0,13,4,30,7,6,0,13,0,30,7,2,0,9,1,-15,3,1
2,3,19,0,30,5,8,0,13,2,30,4,4,0,8,3,30,7,6,0,13,4,30,7,6,0,13,0,30,7,2,0,9,1,-15,3,1
2,4,23,3,30,6,7,0,13,3,30,6,0,0,6,5,30,12,1,0,13,0,30,5,8,0,13,0,30,6,0,0,6,1,-15,3,1
2,2,25,1,30,4,10,0,14,1,30,6,0,0,6,0,30,10,4,0,14,2,30,6,8,0,14,5,30,5,1,0,6,1,-15,3,1
2,4,31,1,30,7,5,0,12,4,30,8,0,0,8,7,30,12,0,0,12,0,30,3,9,0,12,0,30,4,2,0,6,1,-15,3,1
2,0,5,0,30,4,1,0,5,3,30,1,3,0,4,2,30,1,4,0,5,0,30,1,4,0,5,0,30,0,2,0,2,0,-27,3,0
2,2,5,0,30,4,1,0,5,3,30,1,3,0,4,0,30,1,4,0,5,0,30,1,4,0,5,0,30,0,2,0,2,0,-27,3,0
2,3,5,0,30,4,1,0,5,3,30,1,3,0,4,0,30,1,4,0,5,0,30,1,4,0,5,0,30,0,2,0,2,0,-27,3,0
2,1,13,3,30,7,0,0,7,0,30,4,0,0,4,4,30,7,0,0,7,5,30,5,2,0,7,4,30,4,0,0,4,1,-15,3,1
2,3,17,1,30,5,9,0,14,3,30,6,0,0,6,0,30,6,8,0,14,3,30,4,10,0,14,6,30,4,0,0,4,1,-15,3,1
2,1,19,0,30,2,11,0,13,2,30,3,5,0,8,0,30,7,6,0,13,11,30,7,6,0,13,3,30,9,0,0,9,1,-15,3,1
2,2,19,0,30,2,11,0,13,2,30,3,5,0,8,0,30,7,6,0,13,11,30,7,6,0,13,3,30,9,0,0,9,1,-15,3,1
2,4,19,0,30,2,11,0,13,2,30,3,5,0,8,0,30,7,6,0,13,11,30,7,6,0,13,3,30,9,0,0,9,1,-15,3,1
2,3,23,1,30,5,8,0,13,2,30,6,0,0,6,0,30,7,6,0,13,2,30,5,8,0,13,5,30,6,0,0,6,1,-15,3,1
2,4,23,1,30,5,8,0,13,2,30,6,0,0,6,0,30,7,6,0,13,2,30,5,8,0,13,5,30,6,0,0,6,1,-15,3,1
2,1,27,1,30,7,8,0,15,1,30,1,1,0,2,0,30,10,5,0,15,4,30,4,11,0,15,0,30,6,0,0,6,1,-15,3,1
2,2,27,1,30,7,8,0,15,1,30,1,1,0,2,0,30,10,5,0,15,4,30,4,11,0,15,0,30,6,0,0,6,1,-15,3,1
2,3,35,0,30,6,7,0,13,5,30,2,0,0,2,1,30,6,7,0,13,0,30,3,10,0,13,5,30,8,0,0,8,1,-15,3,1
2,4,35,0,30,6,7,0,13,5,30,2,0,0,2,1,30,6,7,0,13,0,30,3,10,0,13,5,30,8,0,0,8,1,-15,3,1
2,3,7,1,30,4,5,0,9,3,30,4,0,0,4,0,30,5,4,0,9,4,30,2,7,0,9,1,30,5,1,0,6,0,-27,3,0
2,4,15,0,30,5,8,0,13,0,30,6,0,0,6,0,30,3,10,0,13,1,30,4,9,0,13,3,30,7,2,0,9,1,-15,3,1
2,2,17,3,30,10,4,0,14,3,30,6,0,0,6,0,30,6,8,0,14,3,30,7,7,0,14,5,30,4,0,0,4,1,-15,3,1
2,2,19,0,30,4,9,0,13,2,30,5,3,0,8,0,30,4,9,0,13,3,30,6,7,0,13,1,30,9,0,0,9,1,-15,3,1
2,3,19,0,30,4,9,0,13,2,30,5,3,0,8,0,30,4,9,0,13,3,30,6,7,0,13,1,30,9,0,0,9,1,-15,3,1
2,4,29,0,30,6,8,0,14,6,30,12,0,0,12,0,30,6,8,0,14,0,30,3,11,0,14,0,30,9,0,0,9,1,-15,3,1
2,2,31,1,30,5,7,0,12,5,30,8,0,0,8,4,30,9,3,0,12,0,30,3,9,0,12,1,30,5,1,0,6,1,-15,3,1
2,0,5,1,30,3,2,0,5,3,30,1,3,0,4,1,30,2,3,0,5,0,30,1,4,0,5,0,30,0,2,0,2,0,-27,3,0
2,1,5,1,30,3,2,0,5,3,30,1,3,0,4,1,30,2,3,0,5,0,30,1,4,0,5,0,30,0,2,0,2,0,-27,3,0
2,4,5,1,30,3,2,0,5,3,30,1,3,0,4,0,30,2,3,0,5,0,30,1,4,0,5,0,30,0,2,0,2,0,-27,3,0
2,4,19,0,30,6,7,0,13,2,30,8,0,0,8,0,30,4,9,0,13,4,30,4,9,0,13,0,30,9,0,0,9,1,-15,3,1
2,4,23,1,30,6,7,0,13,3,30,5,1,0,6,8,30,13,0,0,13,0,30,5,8,0,13,2,30,5,1,0,6,1,-15,3,1
2,0,25,1,30,9,5,0,14,3,30,6,0,0,6,0,30,7,7,0,14,1,30,5,9,0,14,4,30,6,0,0,6,1,-15,3,1
2,1,26,0,30,9,0,0,9,4,30,1,3,0,4,1,30,0,9,0,9,3,30,2,7,0,9,1,30,3,0,0,3,1,-15,3,1
2,2,27,1,30,7,8,0,15,3,30,2,0,0,2,0,30,9,6,0,15,0,30,3,12,0,15,1,30,3,3,0,6,1,-15,3,1
2,2,6,1,30,8,1,0,9,4,30,2,0,0,2,0,30,3,6,0,9,0,30,4,5,0,9,0,30,3,2,0,5,0,-27,3,0
2,2,13,4,30,7,0,0,7,1,30,4,0,0,4,2,30,6,1,0,7,5,30,6,1,0,7,5,30,4,0,0,4,1,-15,3,1
2,3,13,4,30,7,0,0,7,1,30,4,0,0,4,2,30,6,1,0,7,5,30,6,1,0,7,5,30,4,0,0,4,1,-15,3,1
2,1,17,3,30,9,5,0,14,3,30,6,0,0,6,0,30,6,8,0,14,4,30,7,7,0,14,6,30,4,0,0,4,1,-15,3,1
2,4,19,0,30,6,7,0,13,0,30,8,0,0,8,3,30,7,6,0,13,0,30,3,10,0,13,1,30,8,1,0,9,1,-15,3,1
2,3,25,0,30,8,6,0,14,3,30,6,0,0,6,0,30,4,10,0,14,3,30,8,6,0,14,5,30,6,0,0,6,1,-15,3,1
2,4,25,0,30,8,6,0,14,3,30,6,0,0,6,0,30,4,10,0,14,3,30,8,6,0,14,5,30,6,0,0,6,1,-15,3,1
2,4,32,0,30,5,4,0,9,5,30,2,0,0,2,4,30,8,1,0,9,1,30,5,4,0,9,3,30,2,0,0,2,1,-15,3,1
2,3,43,0,30,6,8,0,14,8,30,6,0,0,6,0,30,4,10,0,14,2,30,1,13,0,14,1,30,5,0,0,5,1,-15,3,1
2,2,4,2,30,4,4,0,8,5,30,4,0,0,4,1,30,1,7,0,8,2,30,7,1,0,8,3,30,4,0,0,4,0,-27,3,0
2,3,4,2,30,4,4,0,8,5,30,4,0,0,4,1,30,1,7,0,8,2,30,7,1,0,8,3,30,4,0,0,4,0,-27,3,0
2,3,7,0,30,2,2,0,4,2,30,2,0,0,2,0,30,2,2,0,4,0,30,1,3,0,4,0,30,2,0,0,2,0,-27,3,0
2,4,12,4,30,3,4,0,7,2,30,5,1,0,6,0,30,2,5,0,7,4,30,6,1,0,7,5,30,3,0,0,3,1,-15,3,1
2,2,17,2,30,8,6,0,14,2,30,6,0,0,6,0,30,5,9,0,14,8,30,4,10,0,14,3,30,4,0,0,4,1,-15,3,1
2,2,27,0,30,4,11,0,15,3,30,2,0,0,2,0,30,3,12,0,15,2,30,6,9,0,15,4,30,6,0,0,6,1,-15,3,1
2,4,27,0,30,4,11,0,15,3,30,2,0,0,2,0,30,3,12,0,15,1,30,6,9,0,15,4,30,6,0,0,6,1,-15,3,1
2,1,29,0,30,6,8,0,14,5,30,11,1,0,12,0,30,6,8,0,14,0,30,2,12,0,14,1,30,9,0,0,9,1,-15,3,1
2,4,38,0,30,2,8,0,10,6,30,6,0,0,6,0,30,4,6,0,10,0,30,4,6,0,10,6,30,6,0,0,6,1,-15,3,1
2,1,5,0,30,2,3,0,5,3,30,1,3,0,4,0,30,2,3,0,5,0,30,1,4,0,5,1,30,2,0,0,2,0,-27,3,0
2,3,5,0,30,2,3,0,5,3,30,1,3,0,4,0,30,2,3,0,5,0,30,1,4,0,5,1,30,2,0,0,2,0,-27,3,0
2,4,5,0,30,2,3,0,5,3,30,1,3,0,4,0,30,2,3,0,5,0,30,1,4,0,5,1,30,2,0,0,2,0,-27,3,0
2,1,17,5,30,9,5,0,14,3,30,6,0,0,6,0,30,5,9,0,14,2,30,5,9,0,14,2,30,4,0,0,4,1,-15,3,1
2,2,17,5,30,9,5,0,14,3,30,6,0,0,6,0,30,5,9,0,14,2,30,5,9,0,14,2,30,4,0,0,4,1,-15,3,1
2,3,17,5,30,9,5,0,14,3,30,6,0,0,6,0,30,5,9,0,14,2,30,5,9,0,14,2,30,4,0,0,4,1,-15,3,1
2,4,17,5,30,9,5,0,14,3,30,6,0,0,6,0,30,5,9,0,14,2,30,5,9,0,14,2,30,4,0,0,4,1,-15,3,1
2,0,27,1,30,4,11,0,15,1,30,1,1,0,2,0,30,5,10,0,15,4,30,6,9,0,15,2,30,6,0,0,6,1,-15,3,1
2,2,27,1,30,4,11,0,15,1,30,1,1,0,2,0,30,5,10,0,15,4,30,6,9,0,15,2,30,6,0,0,6,1,-15,3,1
2,4,31,1,30,9,3,0,12,3,30,8,0,0,8,3,30,12,0,0,12,0,30,3,9,0,12,0,30,3,3,0,6,1,-15,3,1
2,3,4,1,30,6,2,0,8,4,30,4,0,0,4,0,30,2,6,0,8,0,30,3,5,0,8,3,30,4,0,0,4,0,-27,3,0
2,4,7,0,30,1,8,0,9,1,30,4,0,0,4,0,30,9,0,0,9,9,30,3,6,0,9,2,30,6,0,0,6,0,-27,3,0
2,3,8,1,30,7,0,0,7,4,30,2,0,0,2,6,30,3,4,0,7,2,30,7,0,0,7,1,30,3,0,0,3,0,-27,3,0
2,2,13,3,30,6,1,0,7,0,30,4,0,0,4,2,30,6,1,0,7,11,30,5,2,0,7,0,30,4,0,0,4,1,-15,3,1
2,1,17,5,30,11,3,0,14,3,30,6,0,0,6,0,30,6,8,0,14,3,30,5,9,0,14,5,30,4,0,0,4,1,-15,3,1
2,2,17,5,30,11,3,0,14,3,30,6,0,0,6,0,30,6,8,0,14,3,30,5,9,0,14,5,30,4,0,0,4,1,-15,3,1
2,3,17,5,30,11,3,0,14,3,30,6,0,0,6,0,30,6,8,0,14,3,30,5,9,0,14,5,30,4,0,0,4,1,-15,3,1
2,1,19,0,30,4,9,0,13,1,30,6,2,0,8,1,30,4,9,0,13,0,30,6,7,0,13,1,30,6,3,0,9,1,-15,3,1
2,3,19,0,30,4,9,0,13,1,30,6,2,0,8,1,30,4,9,0,13,0,30,6,7,0,13,1,30,6,3,0,9,1,-15,3,1
2,4,19,0,30,4,9,0,13,1,30,6,2,0,8,1,30,4,9,0,13,0,30,6,7,0,13,1,30,6,3,0,9,1,-15,3,1
2,4,23,1,30,4,9,0,13,3,30,6,0,0,6,0,30,13,0,0,13,0,30,5,8,0,13,2,30,6,0,0,6,1,-15,3,1
2,1,27,1,30,3,12,0,15,4,30,2,0,0,2,0,30,2,13,0,15,0,30,8,7,0,15,4,30,6,0,0,6,1,-15,3,1
2,0,29,0,30,7,7,0,14,5,30,11,1,0,12,0,30,5,9,0,14,0,30,2,12,0,14,4,30,9,0,0,9,1,-15,3,1
2,1,29,0,30,7,7,0,14,5,30,11,1,0,12,0,30,5,9,0,14,0,30,2,12,0,14,4,30,9,0,0,9,1,-15,3,1
2,2,29,0,30,7,7,0,14,5,30,11,1,0,12,0,30,5,9,0,14,0,30,2,12,0,14,4,30,9,0,0,9,1,-15,3,1
2,3,29,0,30,7,7,0,14,5,30,11,1,0,12,0,30,5,9,0,14,0,30,2,12,0,14,4,30,9,0,0,9,1,-15,3,1
2,4,29,0,30,7,7,0,14,5,30,11,1,0,12,0,30,5,9,0,14,0,30,2,12,0,14,4,30,9,0,0,9,1,-15,3,1
2,3,5,1,30,3,2,0,5,3,30,3,1,0,4,0,30,0,5,0,5,0,30,4,1,0,5,0,30,0,2,0,2,0,-27,3,0
2,4,5,1,30,3,2,0,5,3,30,3,1,0,4,0,30,0,5,0,5,0,30,4,1,0,5,0,30,0,2,0,2,0,-27,3,0
2,1,7,0,30,3,1,0,4,2,30,2,0,0,2,2,30,2,2,0,4,0,30,1,3,0,4,1,30,1,1,0,2,0,-27,3,0
2,2,7,0,30,3,1,0,4,2,30,2,0,0,2,2,30,2,2,0,4,0,30,1,3,0,4,1,30,1,1,0,2,0,-27,3,0
2,3,8,4,30,7,0,0,7,5,30,2,0,0,2,0,30,3,4,0,7,0,30,4,3,0,7,0,30,3,0,0,3,0,-27,3,0
2,4,8,4,30,7,0,0,7,5,30,2,0,0,2,0,30,3,4,0,7,0,30,4,3,0,7,0,30,3,0,0,3,0,-27,3,0
2,4,15,1,30,3,10,0,13,1,30,6,0,0,6,0,30,3,10,0,13,1,30,6,7,0,13,3,30,9,0,0,9,1,-15,3,1
2,3,21,2,30,5,5,0,10,3,30,6,0,0,6,1,30,5,5,0,10,3,30,5,5,0,10,2,30,4,0,0,4,1,-15,3,1
2,0,27,1,30,5,10,0,15,4,30,2,0,0,2,0,30,8,7,0,15,0,30,5,10,0,15,2,30,6,0,0,6,1,-15,3,1
2,3,27,1,30,5,10,0,15,4,30,2,0,0,2,0,30,8,7,0,15,0,30,5,10,0,15,2,30,6,0,0,6,1,-15,3,1
2,4,27,1,30,5,10,0,15,4,30,2,0,0,2,0,30,8,7,0,15,0,30,5,10,0,15,2,30,6,0,0,6,1,-15,3,1
2,3,32,3,30,7,2,0,9,4,30,2,0,0,2,1,30,9,0,0,9,1,30,3,6,0,9,5,30,1,1,0,2,1,-15,3,1
2,4,32,3,30,7,2,0,9,4,30,2,0,0,2,1,30,9,0,0,9,1,30,3,6,0,9,5,30,1,1,0,2,1,-15,3,1
2,2,1,0,30,8,2,0,10,5,30,2,0,0,2,1,30,3,7,0,10,3,30,7,3,0,10,5,30,6,0,0,6,0,-27,3,0
2,3,1,0,30,8,2,0,10,5,30,2,0,0,2,1,30,3,7,0,10,3,30,7,3,0,10,5,30,6,0,0,6,0,-27,3,0
2,0,4,2,30,6,2,0,8,5,30,4,0,0,4,1,30,2,6,0,8,2,30,8,0,0,8,2,30,4,0,0,4,0,-27,3,0
2,1,4,2,30,6,2,0,8,5,30,4,0,0,4,1,30,2,6,0,8,2,30,8,0,0,8,2,30,4,0,0,4,0,-27,3,0
2,1,5,0,30,2,3,0,5,2,30,4,0,0,4,0,30,0,5,0,5,0,30,1,4,0,5,1,30,0,2,0,2,0,-27,3,0
2,2,5,0,30,2,3,0,5,2,30,4,0,0,4,0,30,0,5,0,5,0,30,1,4,0,5,1,30,0,2,0,2,0,-27,3,0
2,3,5,0,30,2,3,0,5,2,30,4,0,0,4,0,30,0,5,0,5,0,30,1,4,0,5,1,30,0,2,0,2,0,-27,3,0
2,3,6,0,30,7,2,0,9,4,30,2,0,0,2,0,30,3,6,0,9,0,30,4,5,0,9,1,30,4,1,0,5,0,-27,3,0
2,4,6,0,30,7,2,0,9,4,30,2,0,0,2,0,30,3,6,0,9,0,30,4,5,0,9,1,30,4,1,0,5,0,-27,3,0
2,0,11,0,30,3,9,0,12,0,30,4,0,0,4,0,30,7,5,0,12,9,30,4,8,0,12,4,30,4,0,0,4,1,-15,3,1
2,1,11,0,30,3,9,0,12,0,30,4,0,0,4,0,30,7,5,0,12,9,30,4,8,0,12,4,30,4,0,0,4,1,-15,3,1
2,4,11,0,30,3,9,0,12,0,30,4,0,0,4,0,30,7,5,0,12,9,30,4,8,0,12,4,30,4,0,0,4,1,-15,3,1
2,3,17,1,30,10,4,0,14,1,30,6,0,0,6,0,30,7,7,0,14,3,30,4,10,0,14,5,30,4,0,0,4,1,-15,3,1
2,4,17,1,30,10,4,0,14,1,30,6,0,0,6,0,30,7,7,0,14,3,30,4,10,0,14,5,30,4,0,0,4,1,-15,3,1
2,3,19,0,30,2,11,0,13,2,30,7,1,0,8,0,30,7,6,0,13,3,30,5,8,0,13,1,30,8,1,0,9,1,-15,3,1
2,2,25,1,30,6,8,0,14,3,30,6,0,0,6,0,30,8,6,0,14,3,30,4,10,0,14,5,30,6,0,0,6,1,-15,3,1
2,3,25,1,30,6,8,0,14,3,30,6,0,0,6,0,30,8,6,0,14,3,30,4,10,0,14,5,30,6,0,0,6,1,-15,3,1
2,0,27,1,30,6,9,0,15,5,30,2,0,0,2,0,30,1,14,0,15,6,30,4,11,0,15,0,30,4,2,0,6,1,-15,3,1
2,1,27,1,30,6,9,0,15,5,30,2,0,0,2,0,30,1,14,0,15,6,30,4,11,0,15,0,30,4,2,0,6,1,-15,3,1
2,4,27,1,30,6,9,0,15,5,30,2,0,0,2,0,30,1,14,0,15,6,30,4,11,0,15,0,30,4,2,0,6,1,-15,3,1
2,3,5,0,30,2,3,0,5,3,30,0,4,0,4,0,30,0,5,0,5,6,30,1,4,0,5,0,30,0,2,0,2,0,-27,3,0
2,2,11,1,30,5,7,0,12,0,30,4,0,0,4,0,30,6,6,0,12,6,30,5,7,0,12,5,30,4,0,0,4,1,-15,3,1
2,4,17,2,30,8,6,0,14,1,30,6,0,0,6,0,30,10,4,0,14,1,30,6,8,0,14,5,30,4,0,0,4,1,-15,3,1
2,3,19,0,30,2,11,0,13,2,30,6,2,0,8,1,30,5,8,0,13,3,30,6,7,0,13,0,30,8,1,0,9,1,-15,3,1
2,2,23,2,30,5,8,0,13,4,30,6,0,0,6,5,30,9,4,0,13,0,30,5,8,0,13,4,30,5,1,0,6,1,-15,3,1
2,0,26,2,30,7,2,0,9,4,30,4,0,0,4,2,30,3,6,0,9,0,30,3,6,0,9,4,30,2,1,0,3,1,-15,3,1
2,1,26,2,30,7,2,0,9,4,30,4,0,0,4,2,30,3,6,0,9,0,30,3,6,0,9,4,30,2,1,0,3,1,-15,3,1
2,2,26,2,30,7,2,0,9,4,30,4,0,0,4,2,30,3,6,0,9,0,30,3,6,0,9,4,30,2,1,0,3,1,-15,3,1
2,4,26,0,30,7,2,0,9,4,30,4,0,0,4,2,30,3,6,0,9,0,30,3,6,0,9,4,30,2,1,0,3,1,-15,3,1
2,3,35,0,30,8,5,0,13,3,30,2,0,0,2,1,30,2,11,0,13,3,30,3,10,0,13,0,30,8,0,0,8,1,-15,3,1
2,3,19,0,30,4,9,0,13,1,30,7,1,0,8,0,30,6,7,0,13,0,30,3,10,0,13,1,30,5,4,0,9,1,-15,3,1
2,4,22,1,30,6,2,0,8,3,30,2,0,0,2,1,30,5,3,0,8,1,30,4,4,0,8,4,30,4,0,0,4,1,-15,3,1
2,2,23,1,30,3,10,0,13,4,30,6,0,0,6,4,30,11,2,0,13,0,30,5,8,0,13,4,30,6,0,0,6,1,-15,3,1
2,4,23,1,30,3,10,0,13,4,30,6,0,0,6,4,30,11,2,0,13,0,30,5,8,0,13,4,30,6,0,0,6,1,-15,3,1
2,0,27,1,30,6,9,0,15,2,30,2,0,0,2,0,30,9,6,0,15,0,30,6,9,0,15,0,30,5,1,0,6,1,-15,3,1
2,1,27,1,30,6,9,0,15,2,30,2,0,0,2,0,30,9,6,0,15,0,30,6,9,0,15,0,30,5,1,0,6,1,-15,3,1
2,2,27,1,30,6,9,0,15,2,30,2,0,0,2,0,30,9,6,0,15,0,30,6,9,0,15,0,30,5,1,0,6,1,-15,3,1
2,3,27,1,30,6,9,0,15,2,30,2,0,0,2,0,30,9,6,0,15,0,30,6,9,0,15,0,30,5,1,0,6,1,-15,3,1
2,4,27,1,30,6,9,0,15,2,30,2,0,0,2,0,30,9,6,0,15,0,30,6,9,0,15,0,30,5,1,0,6,1,-15,3,1
2,2,31,5,30,7,5,0,12,5,30,8,0,0,8,3,30,9,3,0,12,0,30,3,9,0,12,2,30,2,4,0,6,1,-15,3,1
2,3,31,5,30,7,5,0,12,5,30,8,0,0,8,3,30,9,3,0,12,0,30,3,9,0,12,2,30,2,4,0,6,1,-15,3,1
2,2,37,1,30,8,3,0,11,5,30,8,0,0,8,0,30,10,1,0,11,0,30,3,8,0,11,3,30,6,0,0,6,1,-15,3,1
2,0,38,0,30,5,5,0,10,7,30,6,0,0,6,0,30,1,9,0,10,0,30,2,8,0,10,2,30,6,0,0,6,1,-15,3,1
2,2,38,0,30,5,5,0,10,7,30,6,0,0,6,0,30,1,9,0,10,0,30,2,8,0,10,2,30,6,0,0,6,1,-15,3,1
2,4,38,0,30,5,5,0,10,7,30,6,0,0,6,0,30,1,9,0,10,0,30,2,8,0,10,2,30,6,0,0,6,1,-15,3,1
2,2,4,2,30,7,1,0,8,5,30,4,0,0,4,0,30,1,7,0,8,0,30,7,1,0,8,2,30,3,1,0,4,0,-27,3,0
2,0,6,1,30,7,2,0,9,4,30,2,0,0,2,0,30,2,7,0,9,0,30,4,5,0,9,1,30,4,1,0,5,0,-27,3,0
2,2,6,1,30,7,2,0,9,4,30,2,0,0,2,0,30,2,7,0,9,0,30,4,5,0,9,1,30,4,1,0,5,0,-27,3,0
2,4,8,1,30,7,0,0,7,4,30,2,0,0,2,3,30,4,3,0,7,0,30,6,1,0,7,0,30,3,0,0,3,0,-27,3,0
2,4,17,3,30,8,6,0,14,3,30,6,0,0,6,0,30,5,9,0,14,3,30,4,10,0,14,4,30,4,0,0,4,1,-15,3,1
2,2,19,0,30,1,12,0,13,2,30,6,2,0,8,0,30,5,8,0,13,3,30,4,9,0,13,1,30,9,0,0,9,1,-15,3,1
2,4,19,0,30,1,12,0,13,2,30,6,2,0,8,0,30,5,8,0,13,3,30,4,9,0,13,1,30,9,0,0,9,1,-15,3,1
2,1,21,2,30,9,1,0,10,3,30,5,1,0,6,1,30,4,6,0,10,7,30,4,6,0,10,3,30,4,0,0,4,1,-15,3,1
2,4,21,2,30,9,1,0,10,3,30,5,1,0,6,1,30,4,6,0,10,7,30,4,6,0,10,3,30,4,0,0,4,1,-15,3,1
2,3,25,1,30,7,7,0,14,1,30,6,0,0,6,0,30,10,4,0,14,1,30,4,10,0,14,1,30,5,1,0,6,1,-15,3,1
2,4,25,1,30,7,7,0,14,1,30,6,0,0,6,0,30,10,4,0,14,1,30,4,10,0,14,1,30,5,1,0,6,1,-15,3,1
2,0,27,1,30,4,11,0,15,4,30,1,1,0,2,0,30,8,7,0,15,2,30,6,9,0,15,5,30,5,1,0,6,1,-15,3,1
2,1,27,1,30,4,11,0,15,4,30,1,1,0,2,0,30,8,7,0,15,2,30,6,9,0,15,5,30,5,1,0,6,1,-15,3,1
2,3,27,1,30,4,11,0,15,4,30,1,1,0,2,0,30,8,7,0,15,2,30,6,9,0,15,5,30,5,1,0,6,1,-15,3,1
2,4,27,1,30,4,11,0,15,4,30,1,1,0,2,0,30,8,7,0,15,2,30,6,9,0,15,5,30,5,1,0,6,1,-15,3,1
2,2,4,2,30,6,2,0,8,4,30,4,0,0,4,0,30,1,7,0,8,0,30,3,5,0,8,1,30,3,1,0,4,0,-27,3,0
2,3,4,2,30,6,2,0,8,4,30,4,0,0,4,0,30,1,7,0,8,0,30,3,5,0,8,1,30,3,1,0,4,0,-27,3,0
2,0,5,0,30,1,4,0,5,3,30,2,2,0,4,0,30,1,4,0,5,0,30,3,2,0,5,1,30,0,2,0,2,0,-27,3,0
2,1,5,0,30,1,4,0,5,3,30,2,2,0,4,0,30,1,4,0,5,0,30,3,2,0,5,1,30,0,2,0,2,0,-27,3,0
2,2,5,0,30,1,4,0,5,3,30,2,2,0,4,0,30,1,4,0,5,0,30,3,2,0,5,1,30,0,2,0,2,0,-27,3,0
2,3,5,0,30,1,4,0,5,3,30,2,2,0,4,0,30,1,4,0,5,0,30,3,2,0,5,1,30,0,2,0,2,0,-27,3,0
2,4,5,0,30,1,4,0,5,3,30,2,2,0,4,0,30,1,4,0,5,0,30,3,2,0,5,1,30,0,2,0,2,0,-27,3,0
2,0,6,0,30,9,0,0,9,4,30,2,0,0,2,0,30,2,7,0,9,0,30,4,5,0,9,1,30,5,0,0,5,0,-27,3,0
2,1,6,0,30,9,0,0,9,4,30,2,0,0,2,0,30,2,7,0,9,0,30,4,5,0,9,1,30,5,0,0,5,0,-27,3,0
2,2,6,0,30,9,0,0,9,4,30,2,0,0,2,0,30,2,7,0,9,0,30,4,5,0,9,1,30,5,0,0,5,0,-27,3,0
2,3,8,2,30,7,0,0,7,4,30,2,0,0,2,3,30,4,3,0,7,0,30,3,4,0,7,2,30,3,0,0,3,0,-27,3,0
2,4,19,0,30,3,10,0,13,2,30,6,2,0,8,1,30,4,9,0,13,4,30,7,6,0,13,0,30,7,2,0,9,1,-15,3,1
2,4,22,3,30,8,0,0,8,3,30,2,0,0,2,0,30,3,5,0,8,1,30,4,4,0,8,0,30,4,0,0,4,1,-15,3,1
2,4,23,2,30,8,5,0,13,1,30,6,0,0,6,2,30,11,2,0,13,0,30,6,7,0,13,3,30,6,0,0,6,1,-15,3,1
2,2,26,0,30,9,0,0,9,4,30,4,0,0,4,5,30,1,8,0,9,0,30,1,8,0,9,6,30,3,0,0,3,1,-15,3,1
2,4,26,0,30,9,0,0,9,4,30,4,0,0,4,5,30,1,8,0,9,0,30,1,8,0,9,6,30,3,0,0,3,1,-15,3,1
2,0,27,1,30,3,12,0,15,3,30,2,0,0,2,0,30,6,9,0,15,0,30,4,11,0,15,3,30,6,0,0,6,1,-15,3,1
2,1,27,1,30,3,12,0,15,3,30,2,0,0,2,0,30,6,9,0,15,0,30,4,11,0,15,3,30,6,0,0,6,1,-15,3,1
2,2,27,1,30,3,12,0,15,3,30,2,0,0,2,0,30,6,9,0,15,0,30,4,11,0,15,3,30,6,0,0,6,1,-15,3,1
2,4,27,1,30,3,12,0,15,3,30,2,0,0,2,0,30,6,9,0,15,0,30,4,11,0,15,3,30,6,0,0,6,1,-15,3,1
2,4,35,1,30,8,5,0,13,2,30,2,0,0,2,1,30,12,1,0,13,4,30,1,12,0,13,6,30,8,0,0,8,1,-15,3,1
2,2,13,3,30,7,0,0,7,1,30,4,0,0,4,3,30,7,0,0,7,3,30,7,0,0,7,5,30,4,0,0,4,1,-15,3,1
2,4,13,3,30,7,0,0,7,0,30,4,0,0,4,3,30,7,0,0,7,3,30,7,0,0,7,5,30,4,0,0,4,1,-15,3,1
2,3,17,2,30,9,5,0,14,1,30,6,0,0,6,0,30,8,6,0,14,1,30,6,8,0,14,5,30,4,0,0,4,1,-15,3,1
2,4,17,2,30,9,5,0,14,1,30,6,0,0,6,0,30,8,6,0,14,1,30,6,8,0,14,5,30,4,0,0,4,1,-15,3,1
2,1,19,0,30,4,9,0,13,2,30,4,4,0,8,0,30,7,6,0,13,0,30,3,10,0,13,0,30,9,0,0,9,1,-15,3,1
2,2,27,1,30,6,9,0,15,3,30,1,1,0,2,0,30,12,3,0,15,1,30,5,10,0,15,2,30,6,0,0,6,1,-15,3,1
2,3,27,1,30,6,9,0,15,3,30,1,1,0,2,0,30,12,3,0,15,1,30,5,10,0,15,2,30,6,0,0,6,1,-15,3,1
2,3,33,1,30,4,7,0,11,5,30,4,0,0,4,2,30,9,2,0,11,4,30,3,8,0,11,6,30,4,0,0,4,1,-15,3,1
2,4,13,2,30,6,1,0,7,0,30,4,0,0,4,0,30,6,1,0,7,2,30,7,0,0,7,4,30,4,0,0,4,1,-15,3,1
2,4,15,0,30,3,10,0,13,1,30,6,0,0,6,0,30,3,10,0,13,1,30,5,8,0,13,0,30,7,2,0,9,1,-15,3,1
2,2,17,3,30,9,5,0,14,3,30,6,0,0,6,0,30,7,7,0,14,2,30,8,6,0,14,0,30,4,0,0,4,1,-15,3,1
2,4,17,3,30,9,5,0,14,3,30,6,0,0,6,0,30,7,7,0,14,2,30,8,6,0,14,0,30,4,0,0,4,1,-15,3,1
2,4,19,0,30,5,8,0,13,1,30,3,5,0,8,0,30,8,5,0,13,3,30,4,9,0,13,0,30,8,1,0,9,1,-15,3,1
2,4,25,3,30,8,6,0,14,4,30,6,0,0,6,0,30,6,8,0,14,3,30,10,4,0,14,2,30,6,0,0,6,1,-15,3,1
2,0,27,1,30,6,9,0,15,5,30,1,1,0,2,0,30,2,13,0,15,2,30,4,11,0,15,2,30,6,0,0,6,1,-15,3,1
2,1,27,1,30,6,9,0,15,5,30,1,1,0,2,0,30,2,13,0,15,2,30,4,11,0,15,2,30,6,0,0,6,1,-15,3,1
2,3,27,1,30,6,9,0,15,5,30,1,1,0,2,0,30,2,13,0,15,2,30,4,11,0,15,2,30,6,0,0,6,1,-15,3,1
2,4,27,1,30,6,9,0,15,5,30,1,1,0,2,0,30,2,13,0,15,2,30,4,11,0,15,2,30,6,0,0,6,1,-15,3,1
2,3,31,3,30,8,4,0,12,3,30,8,0,0,8,2,30,12,0,0,12,0,30,5,7,0,12,1,30,2,4,0,6,1,-15,3,1
2,4,31,3,30,8,4,0,12,3,30,8,0,0,8,2,30,12,0,0,12,0,30,5,7,0,12,1,30,2,4,0,6,1,-15,3,1
2,3,33,1,30,4,7,0,11,5,30,4,0,0,4,1,30,9,2,0,11,0,30,3,8,0,11,4,30,4,0,0,4,1,-15,3,1
2,0,5,0,30,2,3,0,5,4,30,0,4,0,4,0,30,0,5,0,5,2,30,2,3,0,5,0,30,2,0,0,2,0,-27,3,0
2,1,13,3,30,7,0,0,7,0,30,4,0,0,4,4,30,7,0,0,7,11,30,4,3,0,7,3,30,4,0,0,4,1,-15,3,1
2,2,13,3,30,7,0,0,7,0,30,4,0,0,4,4,30,7,0,0,7,11,30,4,3,0,7,3,30,4,0,0,4,1,-15,3,1
2,3,17,2,30,9,5,0,14,2,30,6,0,0,6,0,30,7,7,0,14,1,30,7,7,0,14,6,30,4,0,0,4,1,-15,3,1
2,4,17,2,30,9,5,0,14,2,30,6,0,0,6,0,30,7,7,0,14,1,30,7,7,0,14,6,30,4,0,0,4,1,-15,3,1
2,4,23,3,30,6,7,0,13,3,30,6,0,0,6,5,30,13,0,0,13,0,30,6,7,0,13,2,30,5,1,0,6,1,-15,3,1
2,1,25,1,30,4,10,0,14,4,30,6,0,0,6,0,30,8,6,0,14,1,30,7,7,0,14,6,30,6,0,0,6,1,-15,3,1
2,0,26,0,30,8,1,0,9,4,30,4,0,0,4,5,30,1,8,0,9,0,30,1,8,0,9,6,30,2,1,0,3,1,-15,3,1
2,3,26,0,30,8,1,0,9,4,30,4,0,0,4,5,30,1,8,0,9,0,30,1,8,0,9,6,30,2,1,0,3,1,-15,3,1
2,4,26,0,30,8,1,0,9,4,30,4,0,0,4,5,30,1,8,0,9,0,30,1,8,0,9,6,30,2,1,0,3,1,-15,3,1
2,0,37,1,30,7,4,0,11,7,30,8,0,0,8,0,30,3,8,0,11,2,30,3,8,0,11,5,30,6,0,0,6,1,-15,3,1
2,0,4,2,30,7,1,0,8,5,30,4,0,0,4,0,30,1,7,0,8,2,30,8,0,0,8,2,30,3,1,0,4,0,-27,3,0
2,3,6,1,30,9,0,0,9,4,30,2,0,0,2,0,30,2,7,0,9,0,30,4,5,0,9,0,30,3,2,0,5,0,-27,3,0
2,4,6,1,30,9,0,0,9,4,30,2,0,0,2,0,30,2,7,0,9,0,30,4,5,0,9,0,30,3,2,0,5,0,-27,3,0
2,3,8,2,30,7,0,0,7,4,30,2,0,0,2,4,30,4,3,0,7,0,30,6,1,0,7,0,30,3,0,0,3,0,-27,3,0
2,4,8,2,30,7,0,0,7,4,30,2,0,0,2,4,30,4,3,0,7,0,30,6,1,0,7,0,30,3,0,0,3,0,-27,3,0
2,3,17,1,30,11,3,0,14,3,30,6,0,0,6,0,30,3,11,0,14,2,30,8,6,0,14,4,30,4,0,0,4,1,-15,3,1
2,3,19,0,30,5,8,0,13,2,30,8,0,0,8,0,30,6,7,0,13,4,30,6,7,0,13,0,30,6,3,0,9,1,-15,3,1
2,3,27,9,30,8,7,0,15,2,30,1,1,0,2,0,30,6,9,0,15,0,30,4,11,0,15,1,30,2,4,0,6,1,-15,3,1
2,3,11,2,30,4,8,0,12,0,30,4,0,0,4,0,30,8,4,0,12,2,30,5,7,0,12,1,30,4,0,0,4,1,-15,3,1
2,4,11,2,30,4,8,0,12,0,30,4,0,0,4,0,30,8,4,0,12,2,30,5,7,0,12,1,30,4,0,0,4,1,-15,3,1
2,2,13,0,30,7,0,0,7,0,30,4,0,0,4,2,30,5,2,0,7,5,30,6,1,0,7,3,30,4,0,0,4,1,-15,3,1
2,3,13,0,30,7,0,0,7,0,30,4,0,0,4,2,30,5,2,0,7,5,30,6,1,0,7,3,30,4,0,0,4,1,-15,3,1
2,3,17,3,30,9,5,0,14,3,30,6,0,0,6,0,30,4,10,0,14,1,30,6,8,0,14,0,30,4,0,0,4,1,-15,3,1
2,2,19,0,30,6,7,0,13,1,30,7,1,0,8,0,30,7,6,0,13,4,30,4,9,0,13,1,30,8,1,0,9,1,-15,3,1
2,4,22,2,30,7,1,0,8,2,30,2,0,0,2,1,30,4,4,0,8,1,30,3,5,0,8,1,30,1,3,0,4,1,-15,3,1
2,1,27,1,30,4,11,0,15,5,30,2,0,0,2,0,30,2,13,0,15,6,30,4,11,0,15,5,30,6,0,0,6,1,-15,3,1
2,4,8,1,30,7,0,0,7,4,30,2,0,0,2,0,30,3,4,0,7,2,30,7,0,0,7,0,30,3,0,0,3,0,-27,3,0
2,3,15,2,30,5,8,0,13,0,30,6,0,0,6,0,30,4,9,0,13,1,30,4,9,0,13,0,30,5,4,0,9,1,-15,3,1
2,4,15,2,30,5,8,0,13,0,30,6,0,0,6,0,30,4,9,0,13,1,30,4,9,0,13,0,30,5,4,0,9,1,-15,3,1
2,4,23,1,30,7,6,0,13,2,30,6,0,0,6,3,30,12,1,0,13,0,30,5,8,0,13,2,30,6,0,0,6,1,-15,3,1
2,4,25,3,30,7,7,0,14,4,30,6,0,0,6,0,30,7,7,0,14,2,30,6,8,0,14,3,30,5,1,0,6,1,-15,3,1
2,0,27,1,30,5,10,0,15,1,30,2,0,0,2,0,30,7,8,0,15,4,30,4,11,0,15,1,30,6,0,0,6,1,-15,3,1
2,2,27,1,30,5,10,0,15,1,30,2,0,0,2,0,30,7,8,0,15,4,30,4,11,0,15,1,30,6,0,0,6,1,-15,3,1
2,4,1,0,30,7,3,0,10,4,30,2,0,0,2,0,30,4,6,0,10,11,30,7,3,0,10,6,30,6,0,0,6,0,-27,3,0
2,0,4,2,30,6,2,0,8,5,30,4,0,0,4,1,30,1,7,0,8,1,30,8,0,0,8,1,30,3,1,0,4,0,-27,3,0
2,4,5,0,30,2,3,0,5,3,30,2,2,0,4,0,30,0,5,0,5,0,30,3,2,0,5,0,30,1,1,0,2,0,-27,3,0
2,2,13,1,30,5,2,0,7,0,30,4,0,0,4,2,30,6,1,0,7,12,30,5,2,0,7,3,30,4,0,0,4,1,-15,3,1
2,4,13,1,30,5,2,0,7,0,30,4,0,0,4,2,30,6,1,0,7,12,30,5,2,0,7,3,30,4,0,0,4,1,-15,3,1
2,1,23,1,30,5,8,0,13,2,30,6,0,0,6,6,30,12,1,0,13,0,30,5,8,0,13,3,30,5,1,0,6,1,-15,3,1
2,3,23,1,30,5,8,0,13,2,30,6,0,0,6,6,30,12,1,0,13,0,30,5,8,0,13,0,30,5,1,0,6,1,-15,3,1
2,4,23,1,30,5,8,0,13,2,30,6,0,0,6,6,30,12,1,0,13,0,30,5,8,0,13,0,30,5,1,0,6,1,-15,3,1
2,0,27,1,30,5,10,0,15,4,30,1,1,0,2,0,30,2,13,0,15,1,30,7,8,0,15,6,30,6,0,0,6,1,-15,3,1
2,2,27,0,30,5,10,0,15,4,30,1,1,0,2,0,30,2,13,0,15,1,30,7,8,0,15,6,30,6,0,0,6,1,-15,3,1
2,0,4,2,30,6,2,0,8,5,30,4,0,0,4,1,30,1,7,0,8,0,30,7,1,0,8,3,30,4,0,0,4,0,-27,3,0
2,2,4,2,30,6,2,0,8,5,30,4,0,0,4,1,30,1,7,0,8,0,30,7,1,0,8,3,30,4,0,0,4,0,-27,3,0
2,3,4,2,30,6,2,0,8,5,30,4,0,0,4,1,30,1,7,0,8,0,30,7,1,0,8,3,30,4,0,0,4,0,-27,3,0
2,4,13,1,30,5,2,0,7,0,30,4,0,0,4,2,30,6,1,0,7,9,30,6,1,0,7,3,30,4,0,0,4,1,-15,3,1
2,2,17,4,30,8,6,0,14,4,30,6,0,0,6,0,30,3,11,0,14,1,30,7,7,0,14,3,30,4,0,0,4,1,-15,3,1
2,3,17,4,30,8,6,0,14,4,30,6,0,0,6,0,30,3,11,0,14,1,30,7,7,0,14,3,30,4,0,0,4,1,-15,3,1
2,3,19,0,30,4,9,0,13,2,30,8,0,0,8,3,30,7,6,0,13,0,30,3,10,0,13,1,30,8,1,0,9,1,-15,3,1
2,1,27,1,30,6,9,0,15,5,30,1,1,0,2,0,30,4,11,0,15,0,30,6,9,0,15,1,30,6,0,0,6,1,-15,3,1
2,4,27,0,30,6,9,0,15,5,30,1,1,0,2,0,30,4,11,0,15,0,30,6,9,0,15,1,30,6,0,0,6,1,-15,3,1
2,0,31,1,30,6,6,0,12,7,30,8,0,0,8,3,30,4,8,0,12,0,30,7,5,0,12,3,30,6,0,0,6,1,-15,3,1
2,4,32,0,30,2,7,0,9,4,30,2,0,0,2,0,30,7,2,0,9,1,30,3,6,0,9,4,30,2,0,0,2,1,-15,3,1
2,1,33,2,30,4,7,0,11,5,30,4,0,0,4,3,30,11,0,0,11,1,30,4,7,0,11,6,30,4,0,0,4,1,-15,3,1
2,0,35,0,30,7,6,0,13,4,30,2,0,0,2,1,30,4,9,0,13,2,30,1,12,0,13,7,30,8,0,0,8,1,-15,3,1
2,3,8,3,30,7,0,0,7,5,30,2,0,0,2,0,30,1,6,0,7,1,30,7,0,0,7,2,30,3,0,0,3,0,-27,3,0
2,4,8,3,30,7,0,0,7,5,30,2,0,0,2,0,30,1,6,0,7,1,30,7,0,0,7,2,30,3,0,0,3,0,-27,3,0
2,2,9,0,30,6,5,0,11,3,30,6,0,0,6,4,30,6,5,0,11,5,30,3,8,0,11,1,30,4,0,0,4,0,-27,3,0
2,4,17,2,30,8,6,0,14,3,30,6,0,0,6,0,30,3,11,0,14,1,30,7,7,0,14,5,30,4,0,0,4,1,-15,3,1
2,1,19,1,30,4,9,0,13,2,30,4,4,0,8,0,30,7,6,0,13,5,30,2,11,0,13,3,30,9,0,0,9,1,-15,3,1
2,2,25,1,30,8,6,0,14,4,30,6,0,0,6,0,30,4,10,0,14,1,30,9,5,0,14,4,30,6,0,0,6,1,-15,3,1
2,3,25,1,30,8,6,0,14,4,30,6,0,0,6,0,30,4,10,0,14,1,30,9,5,0,14,4,30,6,0,0,6,1,-15,3,1
2,3,27,1,30,6,9,0,15,3,30,1,1,0,2,0,30,5,10,0,15,0,30,6,9,0,15,4,30,6,0,0,6,1,-15,3,1
2,4,35,0,30,5,8,0,13,5,30,2,0,0,2,3,30,2,11,0,13,0,30,3,10,0,13,4,30,8,0,0,8,1,-15,3,1
2,1,4,3,30,5,3,0,8,4,30,4,0,0,4,0,30,1,7,0,8,0,30,6,2,0,8,4,30,4,0,0,4,0,-27,3,0
2,1,11,1,30,5,7,0,12,1,30,4,0,0,4,0,30,7,5,0,12,6,30,7,5,0,12,3,30,4,0,0,4,1,-15,3,1
2,4,11,1,30,5,7,0,12,1,30,4,0,0,4,0,30,7,5,0,12,2,30,7,5,0,12,3,30,4,0,0,4,1,-15,3,1
2,2,13,1,30,5,2,0,7,0,30,4,0,0,4,2,30,6,1,0,7,11,30,5,2,0,7,3,30,4,0,0,4,1,-15,3,1
2,2,17,4,30,11,3,0,14,2,30,6,0,0,6,0,30,6,8,0,14,1,30,4,10,0,14,2,30,4,0,0,4,1,-15,3,1
2,3,17,4,30,11,3,0,14,2,30,6,0,0,6,0,30,6,8,0,14,1,30,4,10,0,14,2,30,4,0,0,4,1,-15,3,1
2,4,17,4,30,11,3,0,14,2,30,6,0,0,6,0,30,6,8,0,14,1,30,4,10,0,14,2,30,4,0,0,4,1,-15,3,1
2,4,19,0,30,4,9,0,13,2,30,8,0,0,8,3,30,7,6,0,13,0,30,4,9,0,13,0,30,6,3,0,9,1,-15,3,1
2,3,25,1,30,6,8,0,14,3,30,6,0,0,6,0,30,4,10,0,14,2,30,5,9,0,14,3,30,6,0,0,6,1,-15,3,1
2,4,25,1,30,6,8,0,14,3,30,6,0,0,6,0,30,4,10,0,14,2,30,5,9,0,14,3,30,6,0,0,6,1,-15,3,1
2,3,27,1,30,3,12,0,15,4,30,1,1,0,2,0,30,8,7,0,15,0,30,3,12,0,15,0,30,4,2,0,6,1,-15,3,1
2,2,4,2,30,6,2,0,8,5,30,4,0,0,4,1,30,1,7,0,8,0,30,6,2,0,8,1,30,3,1,0,4,0,-27,3,0
2,3,4,2,30,6,2,0,8,5,30,4,0,0,4,1,30,1,7,0,8,0,30,6,2,0,8,1,30,3,1,0,4,0,-27,3,0
2,4,4,2,30,6,2,0,8,5,30,4,0,0,4,1,30,1,7,0,8,0,30,6,2,0,8,1,30,3,1,0,4,0,-27,3,0
2,4,11,0,30,1,3,0,4,0,30,0,0,0,0,0,30,3,1,0,4,7,30,2,2,0,4,2,30,1,0,0,1,1,-15,3,1
2,4,15,0,30,6,7,0,13,1,30,6,0,0,6,0,30,3,10,0,13,1,30,4,9,0,13,0,30,9,0,0,9,1,-15,3,1
2,4,19,0,30,5,8,0,13,2,30,6,2,0,8,4,30,4,9,0,13,0,30,4,9,0,13,0,30,8,1,0,9,1,-15,3,1
2,4,23,1,30,4,9,0,13,4,30,6,0,0,6,8,30,11,2,0,13,0,30,5,8,0,13,2,30,6,0,0,6,1,-15,3,1
2,4,25,1,30,3,11,0,14,5,30,6,0,0,6,1,30,8,6,0,14,1,30,7,7,0,14,5,30,6,0,0,6,1,-15,3,1
2,2,27,1,30,5,10,0,15,0,30,2,0,0,2,0,30,3,12,0,15,4,30,4,11,0,15,5,30,6,0,0,6,1,-15,3,1
2,4,29,0,30,6,8,0,14,6,30,10,2,0,12,0,30,3,11,0,14,0,30,1,13,0,14,0,30,9,0,0,9,1,-15,3,1
2,2,4,2,30,6,2,0,8,4,30,4,0,0,4,1,30,3,5,0,8,0,30,0,8,0,8,2,30,4,0,0,4,0,-27,3,0
2,3,4,2,30,6,2,0,8,4,30,4,0,0,4,1,30,3,5,0,8,0,30,0,8,0,8,2,30,4,0,0,4,0,-27,3,0
2,4,11,3,30,4,8,0,12,1,30,4,0,0,4,0,30,6,6,0,12,8,30,4,8,0,12,4,30,4,0,0,4,1,-15,3,1
2,1,17,3,30,9,5,0,14,3,30,6,0,0,6,0,30,6,8,0,14,5,30,6,8,0,14,4,30,4,0,0,4,1,-15,3,1
2,2,27,1,30,6,9,0,15,3,30,2,0,0,2,0,30,5,10,0,15,0,30,4,11,0,15,2,30,5,1,0,6,1,-15,3,1
2,4,27,1,30,6,9,0,15,3,30,2,0,0,2,0,30,5,10,0,15,0,30,4,11,0,15,0,30,5,1,0,6,1,-15,3,1
2,4,29,0,30,6,8,0,14,6,30,9,3,0,12,0,30,4,10,0,14,0,30,1,13,0,14,4,30,9,0,0,9,1,-15,3,1
2,3,33,1,30,2,9,0,11,5,30,4,0,0,4,3,30,9,2,0,11,1,30,5,6,0,11,8,30,4,0,0,4,1,-15,3,1
2,4,4,2,30,7,1,0,8,5,30,4,0,0,4,0,30,2,6,0,8,0,30,4,4,0,8,2,30,4,0,0,4,0,-27,3,0
2,1,9,0,30,1,3,0,4,2,30,2,0,0,2,0,30,0,4,0,4,4,30,4,0,0,4,4,30,1,0,0,1,0,-27,3,0
2,2,9,0,30,1,3,0,4,2,30,2,0,0,2,0,30,0,4,0,4,4,30,4,0,0,4,4,30,1,0,0,1,0,-27,3,0
2,4,13,2,30,6,1,0,7,0,30,4,0,0,4,2,30,7,0,0,7,8,30,6,1,0,7,3,30,4,0,0,4,1,-15,3,1
2,4,17,3,30,8,6,0,14,3,30,6,0,0,6,0,30,6,8,0,14,1,30,4,10,0,14,1,30,4,0,0,4,1,-15,3,1
2,2,19,0,30,2,11,0,13,2,30,8,0,0,8,0,30,7,6,0,13,5,30,4,9,0,13,2,30,8,1,0,9,1,-15,3,1
2,0,21,2,30,6,4,0,10,4,30,4,2,0,6,0,30,3,7,0,10,4,30,6,4,0,10,4,30,4,0,0,4,1,-15,3,1
2,1,21,2,30,6,4,0,10,4,30,4,2,0,6,0,30,3,7,0,10,4,30,6,4,0,10,4,30,4,0,0,4,1,-15,3,1
2,2,21,2,30,6,4,0,10,4,30,4,2,0,6,0,30,3,7,0,10,4,30,6,4,0,10,4,30,4,0,0,4,1,-15,3,1
2,4,21,2,30,6,4,0,10,4,30,4,2,0,6,0,30,3,7,0,10,4,30,6,4,0,10,4,30,4,0,0,4,1,-15,3,1
2,2,25,2,30,6,8,0,14,5,30,6,0,0,6,0,30,8,6,0,14,1,30,4,10,0,14,4,30,6,0,0,6,1,-15,3,1
2,3,25,2,30,6,8,0,14,5,30,6,0,0,6,0,30,8,6,0,14,1,30,4,10,0,14,4,30,6,0,0,6,1,-15,3,1
2,4,25,2,30,6,8,0,14,5,30,6,0,0,6,0,30,8,6,0,14,1,30,4,10,0,14,4,30,6,0,0,6,1,-15,3,1
2,3,29,0,30,6,8,0,14,6,30,10,2,0,12,0,30,5,9,0,14,0,30,4,10,0,14,2,30,9,0,0,9,1,-15,3,1
2,0,37,1,30,8,3,0,11,6,30,8,0,0,8,0,30,3,8,0,11,6,30,3,8,0,11,9,30,6,0,0,6,1,-15,3,1
2,3,4,2,30,8,0,0,8,3,30,4,0,0,4,0,30,7,1,0,8,0,30,4,4,0,8,0,30,2,2,0,4,0,-27,3,0
2,1,5,0,30,2,3,0,5,2,30,2,2,0,4,0,30,1,4,0,5,0,30,1,4,0,5,0,30,0,2,0,2,0,-27,3,0
2,3,8,2,30,7,0,0,7,3,30,2,0,0,2,0,30,2,5,0,7,0,30,5,2,0,7,4,30,3,0,0,3,0,-27,3,0
2,3,15,1,30,4,9,0,13,0,30,6,0,0,6,0,30,4,9,0,13,1,30,4,9,0,13,2,30,8,1,0,9,1,-15,3,1
2,4,15,1,30,4,9,0,13,0,30,6,0,0,6,0,30,4,9,0,13,1,30,4,9,0,13,2,30,8,1,0,9,1,-15,3,1
2,4,17,0,30,9,5,0,14,3,30,6,0,0,6,0,30,5,9,0,14,4,30,5,9,0,14,1,30,3,1,0,4,1,-15,3,1
2,3,19,0,30,8,5,0,13,1,30,6,2,0,8,0,30,6,7,0,13,0,30,6,7,0,13,0,30,8,1,0,9,1,-15,3,1
2,4,19,0,30,8,5,0,13,1,30,6,2,0,8,0,30,6,7,0,13,0,30,6,7,0,13,0,30,8,1,0,9,1,-15,3,1
2,3,25,1,30,7,7,0,14,5,30,6,0,0,6,0,30,6,8,0,14,0,30,6,8,0,14,5,30,5,1,0,6,1,-15,3,1
2,4,25,1,30,7,7,0,14,5,30,6,0,0,6,0,30,6,8,0,14,0,30,6,8,0,14,5,30,5,1,0,6,1,-15,3,1
2,1,27,1,30,4,11,0,15,4,30,1,1,0,2,0,30,6,9,0,15,2,30,6,9,0,15,3,30,6,0,0,6,1,-15,3,1
2,2,27,1,30,4,11,0,15,4,30,1,1,0,2,0,30,6,9,0,15,2,30,6,9,0,15,3,30,6,0,0,6,1,-15,3,1
2,3,27,1,30,4,11,0,15,4,30,1,1,0,2,0,30,6,9,0,15,2,30,6,9,0,15,3,30,6,0,0,6,1,-15,3,1
2,4,27,1,30,4,11,0,15,4,30,1,1,0,2,0,30,6,9,0,15,2,30,6,9,0,15,3,30,6,0,0,6,1,-15,3,1
2,3,29,0,30,6,8,0,14,6,30,11,1,0,12,0,30,4,10,0,14,0,30,0,14,0,14,2,30,9,0,0,9,1,-15,3,1
2,4,29,0,30,6,8,0,14,6,30,11,1,0,12,0,30,4,10,0,14,0,30,0,14,0,14,2,30,9,0,0,9,1,-15,3,1
2,4,31,5,30,8,4,0,12,4,30,8,0,0,8,0,30,7,5,0,12,0,30,3,9,0,12,0,30,2,4,0,6,1,-15,3,1
2,0,43,0,30,5,9,0,14,7,30,6,0,0,6,0,30,5,9,0,14,1,30,1,13,0,14,6,30,5,0,0,5,1,-15,3,1
2,3,43,0,30,5,9,0,14,7,30,6,0,0,6,0,30,5,9,0,14,1,30,1,13,0,14,6,30,5,0,0,5,1,-15,3,1
2,4,13,1,30,6,1,0,7,0,30,4,0,0,4,2,30,6,1,0,7,5,30,6,1,0,7,3,30,4,0,0,4,1,-15,3,1
2,3,17,2,30,9,5,0,14,2,30,6,0,0,6,0,30,5,9,0,14,1,30,4,10,0,14,5,30,4,0,0,4,1,-15,3,1
2,4,19,0,30,3,10,0,13,0,30,4,4,0,8,0,30,4,9,0,13,0,30,5,8,0,13,1,30,9,0,0,9,1,-15,3,1
2,4,23,1,30,5,8,0,13,0,30,6,0,0,6,4,30,11,2,0,13,0,30,5,8,0,13,2,30,5,1,0,6,1,-15,3,1
2,4,25,0,30,4,10,0,14,5,30,6,0,0,6,0,30,4,10,0,14,1,30,4,10,0,14,4,30,5,1,0,6,1,-15,3,1
2,3,26,0,30,6,3,0,9,5,30,4,0,0,4,2,30,0,9,0,9,0,30,4,5,0,9,6,30,3,0,0,3,1,-15,3,1
2,3,27,0,30,4,11,0,15,1,30,2,0,0,2,0,30,9,6,0,15,1,30,5,10,0,15,1,30,6,0,0,6,1,-15,3,1
2,4,27,0,30,4,11,0,15,1,30,2,0,0,2,0,30,9,6,0,15,1,30,5,10,0,15,1,30,6,0,0,6,1,-15,3,1
2,3,33,6,30,4,7,0,11,6,30,4,0,0,4,4,30,10,1,0,11,0,30,3,8,0,11,3,30,4,0,0,4,1,-15,3,1
2,4,33,6,30,4,7,0,11,6,30,4,0,0,4,4,30,10,1,0,11,0,30,3,8,0,11,3,30,4,0,0,4,1,-15,3,1
2,1,35,0,30,6,7,0,13,6,30,2,0,0,2,1,30,2,11,0,13,0,30,3,10,0,13,8,30,8,0,0,8,1,-15,3,1
2,3,35,0,30,6,7,0,13,6,30,2,0,0,2,1,30,2,11,0,13,0,30,3,10,0,13,8,30,8,0,0,8,1,-15,3,1
2,3,39,0,30,5,6,0,11,7,30,6,0,0,6,0,30,6,5,0,11,3,30,3,8,0,11,4,30,5,0,0,5,1,-15,3,1
2,4,39,0,30,5,6,0,11,7,30,6,0,0,6,0,30,6,5,0,11,3,30,3,8,0,11,4,30,5,0,0,5,1,-15,3,1
2,1,5,0,30,2,3,0,5,3,30,0,4,0,4,0,30,0,5,0,5,0,30,1,4,0,5,2,30,0,2,0,2,0,-27,3,0
2,2,5,0,30,2,3,0,5,3,30,0,4,0,4,0,30,0,5,0,5,0,30,1,4,0,5,2,30,0,2,0,2,0,-27,3,0
2,3,5,0,30,2,3,0,5,3,30,0,4,0,4,0,30,0,5,0,5,0,30,1,4,0,5,2,30,0,2,0,2,0,-27,3,0
2,4,5,0,30,2,3,0,5,3,30,0,4,0,4,0,30,0,5,0,5,0,30,1,4,0,5,2,30,0,2,0,2,0,-27,3,0
2,0,13,3,30,7,0,0,7,1,30,4,0,0,4,2,30,7,0,0,7,6,30,7,0,0,7,6,30,4,0,0,4,1,-15,3,1
2,4,13,3,30,7,0,0,7,1,30,4,0,0,4,1,30,7,0,0,7,6,30,7,0,0,7,6,30,4,0,0,4,1,-15,3,1
2,2,17,3,30,9,5,0,14,2,30,6,0,0,6,0,30,6,8,0,14,0,30,4,10,0,14,0,30,4,0,0,4,1,-15,3,1
2,3,17,3,30,9,5,0,14,2,30,6,0,0,6,0,30,6,8,0,14,0,30,4,10,0,14,0,30,4,0,0,4,1,-15,3,1
2,1,25,0,30,5,9,0,14,2,30,6,0,0,6,0,30,12,2,0,14,1,30,7,7,0,14,3,30,5,1,0,6,1,-15,3,1
2,2,25,0,30,5,9,0,14,2,30,6,0,0,6,0,30,12,2,0,14,1,30,7,7,0,14,3,30,5,1,0,6,1,-15,3,1
2,4,25,0,30,5,9,0,14,2,30,6,0,0,6,0,30,12,2,0,14,1,30,7,7,0,14,3,30,5,1,0,6,1,-15,3,1
2,1,27,1,30,5,10,0,15,1,30,2,0,0,2,2,30,7,8,0,15,2,30,3,12,0,15,2,30,6,0,0,6,1,-15,3,1
2,2,27,1,30,5,10,0,15,1,30,2,0,0,2,2,30,7,8,0,15,2,30,3,12,0,15,2,30,6,0,0,6,1,-15,3,1
2,0,31,1,30,4,8,0,12,8,30,8,0,0,8,3,30,4,8,0,12,7,30,9,3,0,12,3,30,6,0,0,6,1,-15,3,1
2,2,31,1,30,4,8,0,12,8,30,8,0,0,8,3,30,4,8,0,12,7,30,9,3,0,12,3,30,6,0,0,6,1,-15,3,1
2,4,47,0,30,0,14,0,14,6,30,4,0,0,4,0,30,10,4,0,14,0,30,2,12,0,14,2,30,7,0,0,7,1,-15,3,1
2,3,1,0,30,7,3,0,10,4,30,2,0,0,2,1,30,3,7,0,10,0,30,6,4,0,10,6,30,6,0,0,6,0,-27,3,0
2,1,13,2,30,6,1,0,7,0,30,4,0,0,4,2,30,7,0,0,7,8,30,3,4,0,7,2,30,4,0,0,4,1,-15,3,1
2,2,13,2,30,6,1,0,7,0,30,4,0,0,4,2,30,7,0,0,7,8,30,3,4,0,7,2,30,4,0,0,4,1,-15,3,1
2,4,17,4,30,10,4,0,14,2,30,6,0,0,6,0,30,4,10,0,14,1,30,5,9,0,14,4,30,4,0,0,4,1,-15,3,1
2,3,23,1,30,6,7,0,13,3,30,6,0,0,6,0,30,10,3,0,13,0,30,6,7,0,13,3,30,6,0,0,6,1,-15,3,1
2,3,25,0,30,8,6,0,14,5,30,6,0,0,6,0,30,4,10,0,14,2,30,11,3,0,14,4,30,6,0,0,6,1,-15,3,1
2,4,25,0,30,8,6,0,14,5,30,6,0,0,6,0,30,4,10,0,14,2,30,11,3,0,14,4,30,6,0,0,6,1,-15,3,1
2,0,27,1,30,6,9,0,15,4,30,1,1,0,2,0,30,8,7,0,15,5,30,4,11,0,15,1,30,6,0,0,6,1,-15,3,1
2,1,27,1,30,6,9,0,15,4,30,1,1,0,2,0,30,8,7,0,15,5,30,4,11,0,15,1,30,6,0,0,6,1,-15,3,1
2,2,31,1,30,9,3,0,12,4,30,8,0,0,8,6,30,10,2,0,12,0,30,3,9,0,12,0,30,3,3,0,6,1,-15,3,1
2,3,31,1,30,9,3,0,12,4,30,8,0,0,8,6,30,10,2,0,12,0,30,3,9,0,12,0,30,3,3,0,6,1,-15,3,1
2,4,32,0,30,7,2,0,9,4,30,2,0,0,2,2,30,9,0,0,9,0,30,3,6,0,9,2,30,2,0,0,2,1,-15,3,1
2,2,33,0,30,2,9,0,11,5,30,4,0,0,4,1,30,10,1,0,11,1,30,5,6,0,11,6,30,4,0,0,4,1,-15,3,1
2,3,33,0,30,2,9,0,11,5,30,4,0,0,4,1,30,10,1,0,11,1,30,5,6,0,11,6,30,4,0,0,4,1,-15,3,1
2,2,13,2,30,3,0,0,3,1,30,2,0,0,2,0,30,3,0,0,3,5,30,3,0,0,3,3,30,2,0,0,2,1,-15,3,1
2,3,15,2,30,4,9,0,13,1,30,6,0,0,6,0,30,4,9,0,13,1,30,2,11,0,13,0,30,5,4,0,9,1,-15,3,1
2,4,15,2,30,4,9,0,13,1,30,6,0,0,6,0,30,4,9,0,13,1,30,2,11,0,13,0,30,5,4,0,9,1,-15,3,1
2,3,17,2,30,9,5,0,14,3,30,6,0,0,6,0,30,6,8,0,14,1,30,7,7,0,14,0,30,4,0,0,4,1,-15,3,1
2,0,25,1,30,3,11,0,14,5,30,6,0,0,6,1,30,10,4,0,14,1,30,7,7,0,14,5,30,6,0,0,6,1,-15,3,1
2,1,27,2,30,6,9,0,15,3,30,2,0,0,2,0,30,7,8,0,15,2,30,4,11,0,15,2,30,6,0,0,6,1,-15,3,1
2,2,27,2,30,6,9,0,15,3,30,2,0,0,2,0,30,7,8,0,15,2,30,4,11,0,15,2,30,6,0,0,6,1,-15,3,1
2,3,27,2,30,6,9,0,15,3,30,2,0,0,2,0,30,7,8,0,15,2,30,4,11,0,15,2,30,6,0,0,6,1,-15,3,1
2,4,29,0,30,6,8,0,14,6,30,11,1,0,12,0,30,3,11,0,14,0,30,1,13,0,14,5,30,9,0,0,9,1,-15,3,1
2,3,32,0,30,6,3,0,9,4,30,2,0,0,2,0,30,7,2,0,9,1,30,3,6,0,9,5,30,2,0,0,2,1,-15,3,1
2,4,32,0,30,6,3,0,9,4,30,2,0,0,2,0,30,7,2,0,9,1,30,3,6,0,9,5,30,2,0,0,2,1,-15,3,1
2,3,39,0,30,1,10,0,11,6,30,6,0,0,6,0,30,4,7,0,11,0,30,2,9,0,11,5,30,5,0,0,5,1,-15,3,1
2,0,47,0,30,7,7,0,14,7,30,4,0,0,4,0,30,3,11,0,14,0,30,2,12,0,14,5,30,7,0,0,7,1,-15,3,1
2,3,47,0,30,7,7,0,14,7,30,4,0,0,4,0,30,3,11,0,14,0,30,2,12,0,14,5,30,7,0,0,7,1,-15,3,1
2,4,8,0,30,7,0,0,7,3,30,2,0,0,2,0,30,2,5,0,7,0,30,6,1,0,7,5,30,3,0,0,3,0,-27,3,0
2,4,13,6,30,7,0,0,7,0,30,4,0,0,4,2,30,6,1,0,7,4,30,7,0,0,7,4,30,4,0,0,4,1,-15,3,1
2,3,17,2,30,8,6,0,14,2,30,6,0,0,6,0,30,9,5,0,14,0,30,7,7,0,14,6,30,4,0,0,4,1,-15,3,1
2,4,17,2,30,9,5,0,14,4,30,6,0,0,6,0,30,2,12,0,14,5,30,7,7,0,14,5,30,4,0,0,4,1,-15,3,1
2,2,25,1,30,4,10,0,14,4,30,6,0,0,6,0,30,11,3,0,14,1,30,6,8,0,14,3,30,5,1,0,6,1,-15,3,1
2,3,25,1,30,4,10,0,14,4,30,6,0,0,6,0,30,11,3,0,14,1,30,6,8,0,14,3,30,5,1,0,6,1,-15,3,1
2,1,27,1,30,5,10,0,15,4,30,1,1,0,2,0,30,4,11,0,15,0,30,3,12,0,15,4,30,6,0,0,6,1,-15,3,1
2,4,27,1,30,5,10,0,15,4,30,1,1,0,2,0,30,4,11,0,15,0,30,3,12,0,15,4,30,6,0,0,6,1,-15,3,1
2,3,3,0,30,0,4,0,4,0,30,4,0,0,4,0,30,2,2,0,4,5,30,4,0,0,4,0,30,2,1,0,3,0,-27,3,0
2,4,3,0,30,0,4,0,4,0,30,4,0,0,4,0,30,2,2,0,4,5,30,4,0,0,4,0,30,2,1,0,3,0,-27,3,0
2,3,5,0,30,1,4,0,5,3,30,1,3,0,4,3,30,0,5,0,5,0,30,1,4,0,5,1,30,2,0,0,2,0,-27,3,0
2,4,5,0,30,1,4,0,5,3,30,1,3,0,4,3,30,0,5,0,5,0,30,1,4,0,5,1,30,2,0,0,2,0,-27,3,0
2,0,13,2,30,7,0,0,7,1,30,4,0,0,4,2,30,6,1,0,7,5,30,7,0,0,7,7,30,4,0,0,4,1,-15,3,1
2,1,13,2,30,7,0,0,7,1,30,4,0,0,4,2,30,6,1,0,7,5,30,7,0,0,7,7,30,4,0,0,4,1,-15,3,1
2,2,13,2,30,7,0,0,7,1,30,4,0,0,4,2,30,6,1,0,7,5,30,7,0,0,7,7,30,4,0,0,4,1,-15,3,1
2,3,13,2,30,7,0,0,7,1,30,4,0,0,4,2,30,6,1,0,7,5,30,7,0,0,7,7,30,4,0,0,4,1,-15,3,1
2,1,19,1,30,5,8,0,13,2,30,8,0,0,8,4,30,9,4,0,13,0,30,4,9,0,13,1,30,6,3,0,9,1,-15,3,1
2,3,19,1,30,5,8,0,13,2,30,8,0,0,8,4,30,9,4,0,13,0,30,4,9,0,13,1,30,6,3,0,9,1,-15,3,1
2,4,22,1,30,5,3,0,8,3,30,2,0,0,2,0,30,4,4,0,8,1,30,4,4,0,8,3,30,4,0,0,4,1,-15,3,1
2,0,27,1,30,4,11,0,15,4,30,1,1,0,2,0,30,4,11,0,15,4,30,5,10,0,15,6,30,6,0,0,6,1,-15,3,1
2,2,27,1,30,4,11,0,15,4,30,1,1,0,2,0,30,4,11,0,15,4,30,5,10,0,15,6,30,6,0,0,6,1,-15,3,1
2,3,27,1,30,4,11,0,15,4,30,1,1,0,2,0,30,4,11,0,15,4,30,5,10,0,15,6,30,6,0,0,6,1,-15,3,1
2,3,39,0,30,3,8,0,11,6,30,6,0,0,6,1,30,7,4,0,11,2,30,2,9,0,11,4,30,5,0,0,5,1,-15,3,1
2,0,6,0,30,7,2,0,9,4,30,2,0,0,2,0,30,2,7,0,9,0,30,4,5,0,9,0,30,4,1,0,5,0,-27,3,0
2,2,9,0,30,8,3,0,11,3,30,6,0,0,6,1,30,6,5,0,11,9,30,3,8,0,11,2,30,2,2,0,4,0,-27,3,0
2,2,25,0,30,9,5,0,14,2,30,6,0,0,6,0,30,12,2,0,14,1,30,5,9,0,14,0,30,5,1,0,6,1,-15,3,1
2,4,25,0,30,9,5,0,14,2,30,6,0,0,6,0,30,12,2,0,14,1,30,5,9,0,14,0,30,5,1,0,6,1,-15,3,1
2,0,26,0,30,4,5,0,9,4,30,2,2,0,4,1,30,0,9,0,9,2,30,2,7,0,9,3,30,2,1,0,3,1,-15,3,1
2,1,26,0,30,4,5,0,9,4,30,2,2,0,4,1,30,0,9,0,9,2,30,2,7,0,9,3,30,2,1,0,3,1,-15,3,1
2,3,26,0,30,4,5,0,9,4,30,2,2,0,4,1,30,0,9,0,9,2,30,2,7,0,9,3,30,2,1,0,3,1,-15,3,1
2,1,27,1,30,8,7,0,15,4,30,2,0,0,2,1,30,7,8,0,15,0,30,4,11,0,15,2,30,3,3,0,6,1,-15,3,1
2,4,27,1,30,8,7,0,15,4,30,2,0,0,2,1,30,7,8,0,15,0,30,4,11,0,15,2,30,3,3,0,6,1,-15,3,1
2,4,29,0,30,4,10,0,14,6,30,12,0,0,12,0,30,5,9,0,14,0,30,1,13,0,14,2,30,9,0,0,9,1,-15,3,1
2,4,1,0,30,7,3,0,10,4,30,2,0,0,2,0,30,4,6,0,10,0,30,5,5,0,10,6,30,6,0,0,6,0,-27,3,0
2,2,5,0,30,1,4,0,5,3,30,0,4,0,4,0,30,1,4,0,5,0,30,1,4,0,5,0,30,2,0,0,2,0,-27,3,0
2,4,5,0,30,1,4,0,5,3,30,0,4,0,4,0,30,1,4,0,5,0,30,1,4,0,5,0,30,2,0,0,2,0,-27,3,0
2,4,13,2,30,3,0,0,3,0,30,2,0,0,2,1,30,3,0,0,3,7,30,2,1,0,3,3,30,2,0,0,2,1,-15,3,1
2,2,13,3,30,7,0,0,7,0,30,4,0,0,4,3,30,7,0,0,7,7,30,6,1,0,7,3,30,4,0,0,4,1,-15,3,1
2,2,17,3,30,8,6,0,14,2,30,6,0,0,6,0,30,9,5,0,14,2,30,8,6,0,14,5,30,4,0,0,4,1,-15,3,1
2,1,19,0,30,5,8,0,13,2,30,6,2,0,8,0,30,4,9,0,13,3,30,4,9,0,13,0,30,9,0,0,9,1,-15,3,1
2,0,27,1,30,6,9,0,15,4,30,2,0,0,2,0,30,3,12,0,15,0,30,4,11,0,15,4,30,6,0,0,6,1,-15,3,1
2,1,27,1,30,6,9,0,15,4,30,2,0,0,2,0,30,3,12,0,15,0,30,4,11,0,15,4,30,6,0,0,6,1,-15,3,1
2,2,27,1,30,6,9,0,15,4,30,2,0,0,2,0,30,3,12,0,15,0,30,4,11,0,15,4,30,6,0,0,6,1,-15,3,1
2,3,27,1,30,6,9,0,15,4,30,2,0,0,2,0,30,3,12,0,15,0,30,4,11,0,15,4,30,6,0,0,6,1,-15,3,1
2,4,29,0,30,7,7,0,14,4,30,12,0,0,12,0,30,4,10,0,14,0,30,3,11,0,14,0,30,9,0,0,9,1,-15,3,1
2,2,38,0,30,1,9,0,10,7,30,6,0,0,6,0,30,1,9,0,10,0,30,4,6,0,10,4,30,6,0,0,6,1,-15,3,1
2,3,38,0,30,1,9,0,10,7,30,6,0,0,6,0,30,1,9,0,10,0,30,4,6,0,10,4,30,6,0,0,6,1,-15,3,1
2,2,13,3,30,5,2,0,7,1,30,4,0,0,4,2,30,5,2,0,7,9,30,6,1,0,7,0,30,4,0,0,4,1,-15,3,1
2,4,13,3,30,5,2,0,7,1,30,4,0,0,4,2,30,5,2,0,7,9,30,6,1,0,7,0,30,4,0,0,4,1,-15,3,1
2,2,19,0,30,4,9,0,13,1,30,7,1,0,8,0,30,9,4,0,13,0,30,2,11,0,13,1,30,8,1,0,9,1,-15,3,1
2,3,23,2,30,4,9,0,13,1,30,6,0,0,6,0,30,13,0,0,13,0,30,3,10,0,13,2,30,6,0,0,6,1,-15,3,1
2,2,27,3,30,4,11,0,15,0,30,2,0,0,2,0,30,11,4,0,15,1,30,4,11,0,15,1,30,4,2,0,6,1,-15,3,1
2,3,31,1,30,6,6,0,12,7,30,8,0,0,8,3,30,4,8,0,12,4,30,7,5,0,12,3,30,6,0,0,6,1,-15,3,1
2,4,31,1,30,6,6,0,12,7,30,8,0,0,8,3,30,4,8,0,12,4,30,7,5,0,12,3,30,6,0,0,6,1,-15,3,1
2,4,1,0,30,5,5,0,10,4,30,2,0,0,2,1,30,4,6,0,10,1,30,9,1,0,10,6,30,6,0,0,6,0,-27,3,0
2,0,4,2,30,8,0,0,8,4,30,4,0,0,4,2,30,4,4,0,8,0,30,1,7,0,8,4,30,4,0,0,4,0,-27,3,0
2,3,8,4,30,7,0,0,7,4,30,2,0,0,2,3,30,2,5,0,7,2,30,7,0,0,7,0,30,3,0,0,3,0,-27,3,0
2,4,22,1,30,8,0,0,8,2,30,2,0,0,2,0,30,5,3,0,8,1,30,3,5,0,8,1,30,1,3,0,4,1,-15,3,1
2,1,25,1,30,6,8,0,14,2,30,6,0,0,6,0,30,7,7,0,14,3,30,5,9,0,14,6,30,6,0,0,6,1,-15,3,1
2,2,25,1,30,6,8,0,14,2,30,6,0,0,6,0,30,7,7,0,14,3,30,5,9,0,14,6,30,6,0,0,6,1,-15,3,1
2,3,32,0,30,6,3,0,9,4,30,2,0,0,2,0,30,9,0,0,9,1,30,3,6,0,9,4,30,2,0,0,2,1,-15,3,1
2,4,32,0,30,6,3,0,9,4,30,2,0,0,2,0,30,9,0,0,9,1,30,3,6,0,9,4,30,2,0,0,2,1,-15,3,1
2,4,6,1,30,8,1,0,9,4,30,2,0,0,2,0,30,2,7,0,9,0,30,4,5,0,9,1,30,2,3,0,5,0,-27,3,0
2,3,13,3,30,6,1,0,7,0,30,4,0,0,4,2,30,5,2,0,7,6,30,6,1,0,7,3,30,4,0,0,4,1,-15,3,1
2,4,13,3,30,6,1,0,7,0,30,4,0,0,4,2,30,5,2,0,7,6,30,6,1,0,7,3,30,4,0,0,4,1,-15,3,1
2,3,17,4,30,8,6,0,14,2,30,6,0,0,6,0,30,7,7,0,14,1,30,6,8,0,14,1,30,4,0,0,4,1,-15,3,1
2,4,17,4,30,8,6,0,14,2,30,6,0,0,6,0,30,7,7,0,14,1,30,6,8,0,14,1,30,4,0,0,4,1,-15,3,1
2,2,19,0,30,2,11,0,13,2,30,7,1,0,8,0,30,4,9,0,13,2,30,5,8,0,13,2,30,9,0,0,9,1,-15,3,1
2,3,25,3,30,5,9,0,14,4,30,6,0,0,6,0,30,8,6,0,14,1,30,5,9,0,14,5,30,5,1,0,6,1,-15,3,1
2,4,25,3,30,5,9,0,14,4,30,6,0,0,6,0,30,8,6,0,14,1,30,5,9,0,14,5,30,5,1,0,6,1,-15,3,1
2,3,43,0,30,4,10,0,14,8,30,6,0,0,6,0,30,4,10,0,14,1,30,5,9,0,14,7,30,5,0,0,5,1,-15,3,1
2,4,15,0,30,4,9,0,13,0,30,6,0,0,6,0,30,6,7,0,13,1,30,2,11,0,13,0,30,7,2,0,9,1,-15,3,1
2,2,19,0,30,2,11,0,13,1,30,5,3,0,8,0,30,8,5,0,13,4,30,4,9,0,13,1,30,8,1,0,9,1,-15,3,1
2,4,19,0,30,2,11,0,13,0,30,5,3,0,8,0,30,8,5,0,13,4,30,4,9,0,13,1,30,8,1,0,9,1,-15,3,1
2,2,22,3,30,8,0,0,8,3,30,2,0,0,2,4,30,3,5,0,8,0,30,5,3,0,8,3,30,4,0,0,4,1,-15,3,1
2,3,22,3,30,8,0,0,8,3,30,2,0,0,2,4,30,3,5,0,8,0,30,5,3,0,8,3,30,4,0,0,4,1,-15,3,1
2,0,29,0,30,7,7,0,14,6,30,8,4,0,12,0,30,6,8,0,14,0,30,1,13,0,14,1,30,9,0,0,9,1,-15,3,1
2,1,29,0,30,7,7,0,14,6,30,8,4,0,12,0,30,6,8,0,14,0,30,1,13,0,14,1,30,9,0,0,9,1,-15,3,1
2,2,29,0,30,7,7,0,14,6,30,8,4,0,12,0,30,6,8,0,14,0,30,1,13,0,14,1,30,9,0,0,9,1,-15,3,1
2,3,1,0,30,7,3,0,10,4,30,2,0,0,2,1,30,4,6,0,10,4,30,6,4,0,10,2,30,6,0,0,6,0,-27,3,0
2,4,1,0,30,7,3,0,10,4,30,2,0,0,2,1,30,4,6,0,10,4,30,6,4,0,10,2,30,6,0,0,6,0,-27,3,0
2,3,6,0,30,9,0,0,9,4,30,2,0,0,2,0,30,2,7,0,9,0,30,3,6,0,9,0,30,4,1,0,5,0,-27,3,0
2,4,8,1,30,7,0,0,7,5,30,2,0,0,2,3,30,2,5,0,7,1,30,7,0,0,7,1,30,3,0,0,3,0,-27,3,0
2,1,11,3,30,5,7,0,12,2,30,4,0,0,4,2,30,5,7,0,12,3,30,6,6,0,12,4,30,3,1,0,4,1,-15,3,1
2,3,13,6,30,7,0,0,7,0,30,4,0,0,4,2,30,6,1,0,7,5,30,6,1,0,7,3,30,4,0,0,4,1,-15,3,1
2,3,19,0,30,6,7,0,13,2,30,7,1,0,8,0,30,4,9,0,13,4,30,7,6,0,13,0,30,7,2,0,9,1,-15,3,1
2,3,21,3,30,7,3,0,10,4,30,6,0,0,6,1,30,3,7,0,10,0,30,4,6,0,10,1,30,4,0,0,4,1,-15,3,1
2,4,21,3,30,7,3,0,10,4,30,6,0,0,6,1,30,3,7,0,10,0,30,4,6,0,10,1,30,4,0,0,4,1,-15,3,1
2,4,25,2,30,6,8,0,14,4,30,6,0,0,6,0,30,9,5,0,14,1,30,5,9,0,14,0,30,6,0,0,6,1,-15,3,1
2,1,31,3,30,3,9,0,12,5,30,8,0,0,8,8,30,12,0,0,12,0,30,3,9,0,12,0,30,5,1,0,6,1,-15,3,1
2,3,31,3,30,3,9,0,12,5,30,8,0,0,8,8,30,12,0,0,12,0,30,3,9,0,12,0,30,5,1,0,6,1,-15,3,1
2,4,31,3,30,3,9,0,12,5,30,8,0,0,8,8,30,12,0,0,12,0,30,3,9,0,12,0,30,5,1,0,6,1,-15,3,1
2,2,37,1,30,5,6,0,11,6,30,8,0,0,8,0,30,7,4,0,11,2,30,7,4,0,11,4,30,6,0,0,6,1,-15,3,1
2,3,4,3,30,8,0,0,8,4,30,4,0,0,4,0,30,2,6,0,8,0,30,1,7,0,8,1,30,3,1,0,4,0,-27,3,0
2,2,5,0,30,0,5,0,5,3,30,3,1,0,4,0,30,0,5,0,5,0,30,2,3,0,5,1,30,0,2,0,2,0,-27,3,0
2,1,13,1,30,4,3,0,7,0,30,4,0,0,4,2,30,6,1,0,7,8,30,6,1,0,7,7,30,4,0,0,4,1,-15,3,1
2,2,13,1,30,4,3,0,7,0,30,4,0,0,4,2,30,6,1,0,7,8,30,6,1,0,7,7,30,4,0,0,4,1,-15,3,1
2,1,19,1,30,6,7,0,13,3,30,8,0,0,8,4,30,4,9,0,13,3,30,3,10,0,13,0,30,7,2,0,9,1,-15,3,1
2,2,19,1,30,6,7,0,13,3,30,8,0,0,8,4,30,4,9,0,13,3,30,3,10,0,13,0,30,7,2,0,9,1,-15,3,1
2,3,19,1,30,6,7,0,13,3,30,8,0,0,8,4,30,4,9,0,13,3,30,3,10,0,13,0,30,7,2,0,9,1,-15,3,1
2,1,27,1,30,5,10,0,15,4,30,2,0,0,2,0,30,4,11,0,15,2,30,3,12,0,15,1,30,4,2,0,6,1,-15,3,1
2,2,27,1,30,5,10,0,15,4,30,2,0,0,2,0,30,4,11,0,15,2,30,3,12,0,15,1,30,4,2,0,6,1,-15,3,1
2,3,27,1,30,5,10,0,15,4,30,2,0,0,2,0,30,4,11,0,15,2,30,3,12,0,15,1,30,4,2,0,6,1,-15,3,1
2,4,27,1,30,5,10,0,15,4,30,2,0,0,2,0,30,4,11,0,15,2,30,3,12,0,15,1,30,4,2,0,6,1,-15,3,1
2,4,29,0,30,6,8,0,14,5,30,10,2,0,12,0,30,4,10,0,14,0,30,1,13,0,14,2,30,7,2,0,9,1,-15,3,1
2,3,31,5,30,5,7,0,12,5,30,8,0,0,8,5,30,8,4,0,12,0,30,4,8,0,12,2,30,3,3,0,6,1,-15,3,1
2,3,35,2,30,9,4,0,13,3,30,2,0,0,2,1,30,12,1,0,13,0,30,1,12,0,13,4,30,8,0,0,8,1,-15,3,1
2,4,35,2,30,9,4,0,13,3,30,2,0,0,2,1,30,12,1,0,13,0,30,1,12,0,13,4,30,8,0,0,8,1,-15,3,1
2,0,41,0,30,7,5,0,12,8,30,8,0,0,8,0,30,3,9,0,12,0,30,5,7,0,12,2,30,7,0,0,7,1,-15,3,1
2,2,41,0,30,7,5,0,12,8,30,8,0,0,8,0,30,3,9,0,12,0,30,5,7,0,12,2,30,7,0,0,7,1,-15,3,1
2,3,8,1,30,7,0,0,7,4,30,2,0,0,2,2,30,3,4,0,7,0,30,7,0,0,7,3,30,3,0,0,3,0,-27,3,0
2,1,11,1,30,4,8,0,12,1,30,4,0,0,4,0,30,7,5,0,12,7,30,8,4,0,12,5,30,4,0,0,4,1,-15,3,1
2,2,17,3,30,10,4,0,14,3,30,6,0,0,6,0,30,5,9,0,14,2,30,5,9,0,14,3,30,4,0,0,4,1,-15,3,1
2,4,17,3,30,10,4,0,14,3,30,6,0,0,6,0,30,5,9,0,14,2,30,5,9,0,14,3,30,4,0,0,4,1,-15,3,1
2,3,23,2,30,5,8,0,13,3,30,6,0,0,6,3,30,10,3,0,13,0,30,7,6,0,13,3,30,6,0,0,6,1,-15,3,1
2,0,25,4,30,10,4,0,14,3,30,6,0,0,6,0,30,3,11,0,14,1,30,6,8,0,14,4,30,6,0,0,6,1,-15,3,1
2,0,4,2,30,7,1,0,8,5,30,4,0,0,4,1,30,2,6,0,8,1,30,8,0,0,8,1,30,3,1,0,4,0,-27,3,0
2,1,4,2,30,7,1,0,8,5,30,4,0,0,4,1,30,2,6,0,8,1,30,8,0,0,8,1,30,3,1,0,4,0,-27,3,0
2,2,4,2,30,7,1,0,8,5,30,4,0,0,4,1,30,2,6,0,8,1,30,8,0,0,8,1,30,3,1,0,4,0,-27,3,0
2,3,8,1,30,7,0,0,7,4,30,2,0,0,2,3,30,3,4,0,7,2,30,7,0,0,7,0,30,3,0,0,3,0,-27,3,0
2,4,13,1,30,3,4,0,7,0,30,4,0,0,4,2,30,7,0,0,7,5,30,7,0,0,7,0,30,4,0,0,4,1,-15,3,1
2,3,19,0,30,4,9,0,13,1,30,8,0,0,8,0,30,5,8,0,13,3,30,3,10,0,13,0,30,7,2,0,9,1,-15,3,1
2,4,23,1,30,7,6,0,13,0,30,6,0,0,6,0,30,13,0,0,13,0,30,5,8,0,13,2,30,6,0,0,6,1,-15,3,1
2,2,25,0,30,5,9,0,14,2,30,6,0,0,6,0,30,13,1,0,14,1,30,4,10,0,14,2,30,6,0,0,6,1,-15,3,1
2,1,27,0,30,4,11,0,15,3,30,2,0,0,2,0,30,6,9,0,15,2,30,6,9,0,15,1,30,6,0,0,6,1,-15,3,1
2,3,27,0,30,4,11,0,15,3,30,2,0,0,2,0,30,6,9,0,15,2,30,6,9,0,15,1,30,6,0,0,6,1,-15,3,1
2,4,27,0,30,4,11,0,15,3,30,2,0,0,2,0,30,6,9,0,15,2,30,6,9,0,15,1,30,6,0,0,6,1,-15,3,1
2,2,29,0,30,6,8,0,14,5,30,8,4,0,12,0,30,3,11,0,14,0,30,5,9,0,14,5,30,9,0,0,9,1,-15,3,1
2,3,29,0,30,6,8,0,14,5,30,8,4,0,12,0,30,3,11,0,14,0,30,5,9,0,14,5,30,9,0,0,9,1,-15,3,1
2,4,29,0,30,6,8,0,14,5,30,8,4,0,12,0,30,3,11,0,14,0,30,5,9,0,14,5,30,9,0,0,9,1,-15,3,1
2,3,17,2,30,11,3,0,14,2,30,6,0,0,6,0,30,8,6,0,14,1,30,10,4,0,14,6,30,4,0,0,4,1,-15,3,1
2,1,19,0,30,6,7,0,13,1,30,5,3,0,8,0,30,4,9,0,13,7,30,5,8,0,13,0,30,8,1,0,9,1,-15,3,1
2,2,19,0,30,6,7,0,13,1,30,5,3,0,8,0,30,4,9,0,13,7,30,5,8,0,13,0,30,8,1,0,9,1,-15,3,1
2,4,19,0,30,6,7,0,13,1,30,5,3,0,8,0,30,4,9,0,13,7,30,5,8,0,13,0,30,8,1,0,9,1,-15,3,1
2,4,22,8,30,8,0,0,8,4,30,2,0,0,2,0,30,4,4,0,8,0,30,3,5,0,8,1,30,3,1,0,4,1,-15,3,1
2,4,23,2,30,10,3,0,13,1,30,6,0,0,6,0,30,13,0,0,13,0,30,4,9,0,13,3,30,6,0,0,6,1,-15,3,1
2,0,26,0,30,6,3,0,9,5,30,4,0,0,4,4,30,2,7,0,9,0,30,1,8,0,9,4,30,3,0,0,3,1,-15,3,1
2,2,26,0,30,6,3,0,9,5,30,4,0,0,4,4,30,2,7,0,9,0,30,1,8,0,9,4,30,3,0,0,3,1,-15,3,1
2,4,26,0,30,6,3,0,9,5,30,4,0,0,4,4,30,2,7,0,9,0,30,1,8,0,9,4,30,3,0,0,3,1,-15,3,1
2,0,27,1,30,5,10,0,15,3,30,1,1,0,2,0,30,5,10,0,15,2,30,6,9,0,15,2,30,6,0,0,6,1,-15,3,1
2,1,27,1,30,5,10,0,15,3,30,1,1,0,2,0,30,5,10,0,15,2,30,6,9,0,15,2,30,6,0,0,6,1,-15,3,1
2,2,27,1,30,5,10,0,15,3,30,1,1,0,2,0,30,5,10,0,15,2,30,6,9,0,15,2,30,6,0,0,6,1,-15,3,1
2,3,27,1,30,5,10,0,15,3,30,1,1,0,2,0,30,5,10,0,15,2,30,6,9,0,15,2,30,6,0,0,6,1,-15,3,1
2,4,31,0,30,7,5,0,12,4,30,8,0,0,8,7,30,12,0,0,12,0,30,3,9,0,12,0,30,6,0,0,6,1,-15,3,1
2,4,39,0,30,4,7,0,11,7,30,6,0,0,6,0,30,4,7,0,11,0,30,5,6,0,11,5,30,5,0,0,5,1,-15,3,1
2,4,13,2,30,3,0,0,3,0,30,2,0,0,2,0,30,3,0,0,3,7,30,2,1,0,3,4,30,2,0,0,2,1,-15,3,1
2,2,17,1,30,8,6,0,14,2,30,6,0,0,6,0,30,6,8,0,14,0,30,5,9,0,14,4,30,4,0,0,4,1,-15,3,1
2,3,25,3,30,6,8,0,14,5,30,6,0,0,6,0,30,8,6,0,14,1,30,5,9,0,14,2,30,5,1,0,6,1,-15,3,1
2,4,25,3,30,6,8,0,14,5,30,6,0,0,6,0,30,8,6,0,14,1,30,5,9,0,14,2,30,5,1,0,6,1,-15,3,1
2,2,27,1,30,5,10,0,15,3,30,2,0,0,2,0,30,6,9,0,15,2,30,4,11,0,15,1,30,5,1,0,6,1,-15,3,1
2,2,29,1,30,8,6,0,14,6,30,11,1,0,12,0,30,4,10,0,14,0,30,1,13,0,14,3,30,9,0,0,9,1,-15,3,1
2,4,29,1,30,8,6,0,14,6,30,11,1,0,12,0,30,4,10,0,14,0,30,1,13,0,14,3,30,9,0,0,9,1,-15,3,1
2,4,32,0,30,6,3,0,9,4,30,2,0,0,2,2,30,9,0,0,9,1,30,3,6,0,9,3,30,2,0,0,2,1,-15,3,1
2,0,37,1,30,6,5,0,11,7,30,8,0,0,8,0,30,2,9,0,11,4,30,5,6,0,11,9,30,6,0,0,6,1,-15,3,1
2,2,37,1,30,6,5,0,11,7,30,8,0,0,8,0,30,2,9,0,11,4,30,5,6,0,11,9,30,6,0,0,6,1,-15,3,1
2,3,37,1,30,6,5,0,11,7,30,8,0,0,8,0,30,2,9,0,11,4,30,5,6,0,11,9,30,6,0,0,6,1,-15,3,1
2,4,39,0,30,3,8,0,11,6,30,6,0,0,6,0,30,5,6,0,11,3,30,3,8,0,11,3,30,5,0,0,5,1,-15,3,1
2,3,8,1,30,7,0,0,7,4,30,2,0,0,2,0,30,2,5,0,7,0,30,7,0,0,7,8,30,3,0,0,3,0,-27,3,0
2,2,13,3,30,7,0,0,7,0,30,4,0,0,4,2,30,5,2,0,7,7,30,6,1,0,7,3,30,4,0,0,4,1,-15,3,1
2,4,13,3,30,7,0,0,7,0,30,4,0,0,4,2,30,5,2,0,7,7,30,6,1,0,7,3,30,4,0,0,4,1,-15,3,1
2,4,15,0,30,3,10,0,13,1,30,6,0,0,6,0,30,3,10,0,13,1,30,4,9,0,13,2,30,7,2,0,9,1,-15,3,1
2,2,19,0,30,3,10,0,13,3,30,7,1,0,8,0,30,4,9,0,13,3,30,4,9,0,13,3,30,9,0,0,9,1,-15,3,1
2,4,19,0,30,3,10,0,13,3,30,7,1,0,8,0,30,4,9,0,13,3,30,4,9,0,13,3,30,9,0,0,9,1,-15,3,1
2,2,21,4,30,9,1,0,10,4,30,5,1,0,6,3,30,4,6,0,10,2,30,6,4,0,10,0,30,3,1,0,4,1,-15,3,1
2,4,21,4,30,9,1,0,10,4,30,5,1,0,6,3,30,4,6,0,10,2,30,6,4,0,10,0,30,3,1,0,4,1,-15,3,1
2,0,25,1,30,2,12,0,14,5,30,6,0,0,6,0,30,8,6,0,14,1,30,6,8,0,14,5,30,6,0,0,6,1,-15,3,1
2,1,25,1,30,2,12,0,14,5,30,6,0,0,6,0,30,8,6,0,14,1,30,6,8,0,14,5,30,6,0,0,6,1,-15,3,1
2,2,25,1,30,2,12,0,14,5,30,6,0,0,6,0,30,8,6,0,14,1,30,6,8,0,14,5,30,6,0,0,6,1,-15,3,1
2,3,30,7,30,3,2,0,5,5,30,2,0,0,2,1,30,2,3,0,5,3,30,1,4,0,5,1,30,2,1,0,3,1,-15,3,1
2,4,30,7,30,3,2,0,5,5,30,2,0,0,2,1,30,2,3,0,5,3,30,1,4,0,5,1,30,2,1,0,3,1,-15,3,1
2,0,4,2,30,7,1,0,8,4,30,2,2,0,4,0,30,2,6,0,8,4,30,7,1,0,8,3,30,3,1,0,4,0,-27,3,0
2,0,5,0,30,2,3,0,5,3,30,1,3,0,4,0,30,2,3,0,5,0,30,1,4,0,5,0,30,1,1,0,2,0,-27,3,0
2,3,5,0,30,2,3,0,5,3,30,1,3,0,4,0,30,2,3,0,5,0,30,1,4,0,5,0,30,1,1,0,2,0,-27,3,0
2,4,8,3,30,7,0,0,7,5,30,2,0,0,2,3,30,3,4,0,7,0,30,6,1,0,7,1,30,3,0,0,3,0,-27,3,0
2,3,11,1,30,6,6,0,12,0,30,4,0,0,4,0,30,8,4,0,12,2,30,5,7,0,12,4,30,4,0,0,4,1,-15,3,1
2,4,11,1,30,6,6,0,12,0,30,4,0,0,4,0,30,8,4,0,12,2,30,5,7,0,12,4,30,4,0,0,4,1,-15,3,1
2,2,13,1,30,6,1,0,7,0,30,4,0,0,4,2,30,6,1,0,7,9,30,6,1,0,7,5,30,4,0,0,4,1,-15,3,1
2,4,15,0,30,4,9,0,13,1,30,6,0,0,6,0,30,3,10,0,13,1,30,5,8,0,13,2,30,7,2,0,9,1,-15,3,1
2,2,17,4,30,9,5,0,14,3,30,6,0,0,6,0,30,5,9,0,14,2,30,5,9,0,14,0,30,4,0,0,4,1,-15,3,1
2,3,17,4,30,9,5,0,14,3,30,6,0,0,6,0,30,5,9,0,14,2,30,5,9,0,14,0,30,4,0,0,4,1,-15,3,1
2,1,25,1,30,4,10,0,14,5,30,6,0,0,6,0,30,8,6,0,14,3,30,9,5,0,14,7,30,6,0,0,6,1,-15,3,1
2,2,25,1,30,4,10,0,14,5,30,6,0,0,6,0,30,8,6,0,14,3,30,9,5,0,14,7,30,6,0,0,6,1,-15,3,1
2,0,27,1,30,5,10,0,15,5,30,2,0,0,2,0,30,6,9,0,15,2,30,6,9,0,15,3,30,6,0,0,6,1,-15,3,1
2,3,27,1,30,5,10,0,15,5,30,2,0,0,2,0,30,6,9,0,15,2,30,6,9,0,15,3,30,6,0,0,6,1,-15,3,1
2,4,27,1,30,5,10,0,15,5,30,2,0,0,2,0,30,6,9,0,15,2,30,6,9,0,15,3,30,6,0,0,6,1,-15,3,1
2,3,8,8,30,7,0,0,7,5,30,2,0,0,2,0,30,3,4,0,7,0,30,5,2,0,7,1,30,3,0,0,3,0,-27,3,0
2,4,9,3,30,4,0,0,4,3,30,2,0,0,2,2,30,3,1,0,4,0,30,1,3,0,4,1,30,1,0,0,1,0,-27,3,0
2,3,9,0,30,9,2,0,11,3,30,6,0,0,6,1,30,7,4,0,11,1,30,3,8,0,11,2,30,4,0,0,4,0,-27,3,0
2,4,9,0,30,9,2,0,11,3,30,6,0,0,6,1,30,7,4,0,11,1,30,3,8,0,11,2,30,4,0,0,4,0,-27,3,0
2,2,17,3,30,9,5,0,14,2,30,6,0,0,6,0,30,5,9,0,14,2,30,4,10,0,14,5,30,4,0,0,4,1,-15,3,1
2,3,17,3,30,9,5,0,14,2,30,6,0,0,6,0,30,5,9,0,14,2,30,4,10,0,14,5,30,4,0,0,4,1,-15,3,1
2,0,33,3,30,5,6,0,11,5,30,4,0,0,4,3,30,11,0,0,11,0,30,3,8,0,11,5,30,4,0,0,4,1,-15,3,1
2,1,33,3,30,5,6,0,11,5,30,4,0,0,4,3,30,11,0,0,11,0,30,3,8,0,11,5,30,4,0,0,4,1,-15,3,1
2,3,33,0,30,5,6,0,11,5,30,4,0,0,4,3,30,11,0,0,11,0,30,3,8,0,11,5,30,4,0,0,4,1,-15,3,1
2,4,33,0,30,5,6,0,11,5,30,4,0,0,4,3,30,11,0,0,11,0,30,3,8,0,11,5,30,4,0,0,4,1,-15,3,1
2,3,35,0,30,7,6,0,13,6,30,2,0,0,2,5,30,2,11,0,13,0,30,1,12,0,13,3,30,8,0,0,8,1,-15,3,1
2,4,39,0,30,1,10,0,11,5,30,6,0,0,6,0,30,4,7,0,11,0,30,2,9,0,11,5,30,5,0,0,5,1,-15,3,1
2,4,8,5,30,6,1,0,7,5,30,2,0,0,2,7,30,2,5,0,7,0,30,2,5,0,7,3,30,3,0,0,3,0,-27,3,0
2,1,19,0,30,3,10,0,13,2,30,4,4,0,8,0,30,9,4,0,13,5,30,5,8,0,13,3,30,9,0,0,9,1,-15,3,1
2,2,19,0,30,3,10,0,13,2,30,4,4,0,8,0,30,9,4,0,13,5,30,5,8,0,13,3,30,9,0,0,9,1,-15,3,1
2,1,25,1,30,3,11,0,14,2,30,6,0,0,6,1,30,14,0,0,14,1,30,5,9,0,14,3,30,5,1,0,6,1,-15,3,1
2,3,27,1,30,4,11,0,15,4,30,2,0,0,2,0,30,2,13,0,15,3,30,4,11,0,15,3,30,6,0,0,6,1,-15,3,1
2,4,31,1,30,4,8,0,12,7,30,8,0,0,8,3,30,5,7,0,12,0,30,7,5,0,12,6,30,6,0,0,6,1,-15,3,1
2,2,13,2,30,7,0,0,7,0,30,4,0,0,4,2,30,5,2,0,7,8,30,7,0,0,7,4,30,4,0,0,4,1,-15,3,1
2,4,15,0,30,4,9,0,13,0,30,6,0,0,6,0,30,3,10,0,13,3,30,4,9,0,13,3,30,9,0,0,9,1,-15,3,1
2,3,17,0,30,9,5,0,14,3,30,6,0,0,6,0,30,4,10,0,14,0,30,9,5,0,14,1,30,4,0,0,4,1,-15,3,1
2,4,19,1,30,5,8,0,13,1,30,7,1,0,8,0,30,7,6,0,13,0,30,7,6,0,13,0,30,6,3,0,9,1,-15,3,1
2,2,23,2,30,5,8,0,13,4,30,6,0,0,6,5,30,10,3,0,13,1,30,4,9,0,13,3,30,6,0,0,6,1,-15,3,1
2,3,23,2,30,5,8,0,13,4,30,6,0,0,6,5,30,10,3,0,13,1,30,4,9,0,13,3,30,6,0,0,6,1,-15,3,1
2,3,25,2,30,9,5,0,14,4,30,6,0,0,6,0,30,6,8,0,14,1,30,5,9,0,14,5,30,5,1,0,6,1,-15,3,1
2,1,27,1,30,5,10,0,15,3,30,1,1,0,2,0,30,3,12,0,15,3,30,7,8,0,15,0,30,6,0,0,6,1,-15,3,1
2,3,27,1,30,5,10,0,15,3,30,1,1,0,2,0,30,3,12,0,15,3,30,7,8,0,15,0,30,6,0,0,6,1,-15,3,1
2,4,27,1,30,5,10,0,15,3,30,1,1,0,2,0,30,3,12,0,15,3,30,7,8,0,15,0,30,6,0,0,6,1,-15,3,1
2,2,29,0,30,9,5,0,14,5,30,10,2,0,12,0,30,3,11,0,14,1,30,1,13,0,14,0,30,8,1,0,9,1,-15,3,1
2,3,29,0,30,9,5,0,14,5,30,10,2,0,12,0,30,3,11,0,14,1,30,1,13,0,14,0,30,8,1,0,9,1,-15,3,1
2,4,39,0,30,7,4,0,11,6,30,6,0,0,6,4,30,8,3,0,11,0,30,4,7,0,11,0,30,2,3,0,5,1,-15,3,1
2,2,5,0,30,1,4,0,5,3,30,0,4,0,4,0,30,0,5,0,5,1,30,3,2,0,5,0,30,0,2,0,2,0,-27,3,0
2,1,13,3,30,6,1,0,7,0,30,4,0,0,4,2,30,6,1,0,7,8,30,7,0,0,7,6,30,4,0,0,4,1,-15,3,1
2,2,13,3,30,6,1,0,7,0,30,4,0,0,4,2,30,6,1,0,7,8,30,7,0,0,7,6,30,4,0,0,4,1,-15,3,1
2,4,17,3,30,8,6,0,14,2,30,6,0,0,6,0,30,7,7,0,14,1,30,5,9,0,14,4,30,4,0,0,4,1,-15,3,1
2,1,19,0,30,3,10,0,13,2,30,5,3,0,8,0,30,5,8,0,13,9,30,5,8,0,13,2,30,8,1,0,9,1,-15,3,1
2,1,27,1,30,6,9,0,15,4,30,1,1,0,2,0,30,6,9,0,15,2,30,6,9,0,15,2,30,6,0,0,6,1,-15,3,1
2,4,27,1,30,6,9,0,15,4,30,1,1,0,2,0,30,6,9,0,15,2,30,6,9,0,15,2,30,6,0,0,6,1,-15,3,1
2,3,29,0,30,6,8,0,14,6,30,12,0,0,12,0,30,4,10,0,14,0,30,0,14,0,14,1,30,9,0,0,9,1,-15,3,1
2,4,29,0,30,6,8,0,14,6,30,12,0,0,12,0,30,4,10,0,14,0,30,0,14,0,14,1,30,9,0,0,9,1,-15,3,1
2,3,7,1,30,3,6,0,9,3,30,4,0,0,4,0,30,5,4,0,9,2,30,5,4,0,9,1,30,4,2,0,6,0,-27,3,0
2,3,19,0,30,7,6,0,13,1,30,6,2,0,8,0,30,9,4,0,13,0,30,7,6,0,13,0,30,8,1,0,9,1,-15,3,1
2,1,27,1,30,6,9,0,15,5,30,2,0,0,2,0,30,5,10,0,15,1,30,5,10,0,15,0,30,6,0,0,6,1,-15,3,1
2,2,27,1,30,6,9,0,15,5,30,2,0,0,2,0,30,5,10,0,15,1,30,5,10,0,15,0,30,6,0,0,6,1,-15,3,1
2,3,27,1,30,6,9,0,15,5,30,2,0,0,2,0,30,5,10,0,15,1,30,5,10,0,15,0,30,6,0,0,6,1,-15,3,1
2,1,6,0,30,8,1,0,9,3,30,2,0,0,2,0,30,3,6,0,9,0,30,4,5,0,9,1,30,1,4,0,5,0,-27,3,0
2,2,6,0,30,8,1,0,9,3,30,2,0,0,2,0,30,3,6,0,9,0,30,4,5,0,9,1,30,1,4,0,5,0,-27,3,0
2,3,6,0,30,8,1,0,9,3,30,2,0,0,2,0,30,3,6,0,9,0,30,4,5,0,9,1,30,1,4,0,5,0,-27,3,0
2,4,6,0,30,8,1,0,9,3,30,2,0,0,2,0,30,3,6,0,9,0,30,4,5,0,9,1,30,1,4,0,5,0,-27,3,0
2,4,19,0,30,3,10,0,13,2,30,5,3,0,8,0,30,4,9,0,13,1,30,6,7,0,13,0,30,9,0,0,9,1,-15,3,1
2,2,26,1,30,4,5,0,9,5,30,4,0,0,4,5,30,4,5,0,9,0,30,1,8,0,9,4,30,3,0,0,3,1,-15,3,1
2,1,27,2,30,3,12,0,15,2,30,1,1,0,2,0,30,12,3,0,15,0,30,3,12,0,15,0,30,6,0,0,6,1,-15,3,1
2,4,27,2,30,3,12,0,15,2,30,1,1,0,2,0,30,12,3,0,15,0,30,3,12,0,15,0,30,6,0,0,6,1,-15,3,1
2,0,31,3,30,4,8,0,12,6,30,8,0,0,8,3,30,6,6,0,12,0,30,7,5,0,12,1,30,6,0,0,6,1,-15,3,1
2,2,31,3,30,4,8,0,12,6,30,8,0,0,8,3,30,6,6,0,12,0,30,7,5,0,12,1,30,6,0,0,6,1,-15,3,1
2,4,31,3,30,4,8,0,12,6,30,8,0,0,8,3,30,6,6,0,12,0,30,7,5,0,12,0,30,6,0,0,6,1,-15,3,1
2,0,33,2,30,3,8,0,11,6,30,4,0,0,4,7,30,9,2,0,11,0,30,3,8,0,11,7,30,4,0,0,4,1,-15,3,1
2,3,33,2,30,3,8,0,11,6,30,4,0,0,4,7,30,9,2,0,11,0,30,3,8,0,11,7,30,4,0,0,4,1,-15,3,1
2,2,45,1,30,11,2,0,13,10,30,10,0,0,10,0,30,0,13,0,13,0,30,4,9,0,13,8,30,5,0,0,5,1,-15,3,1
2,2,47,0,30,2,12,0,14,5,30,4,0,0,4,0,30,5,9,0,14,0,30,2,12,0,14,6,30,7,0,0,7,1,-15,3,1
2,3,47,0,30,2,12,0,14,5,30,4,0,0,4,0,30,5,9,0,14,0,30,2,12,0,14,6,30,7,0,0,7,1,-15,3,1
2,4,47,0,30,2,12,0,14,5,30,4,0,0,4,0,30,5,9,0,14,0,30,2,12,0,14,6,30,7,0,0,7,1,-15,3,1
2,2,5,0,30,3,2,0,5,3,30,3,1,0,4,2,30,1,4,0,5,0,30,1,4,0,5,0,30,0,2,0,2,0,-27,3,0
2,3,5,0,30,3,2,0,5,3,30,3,1,0,4,2,30,1,4,0,5,0,30,1,4,0,5,0,30,0,2,0,2,0,-27,3,0
2,3,7,0,30,3,6,0,9,2,30,4,0,0,4,0,30,5,4,0,9,6,30,3,6,0,9,1,30,5,1,0,6,0,-27,3,0
2,4,8,1,30,7,0,0,7,4,30,2,0,0,2,0,30,2,5,0,7,0,30,7,0,0,7,1,30,3,0,0,3,0,-27,3,0
2,2,13,1,30,7,0,0,7,0,30,4,0,0,4,2,30,7,0,0,7,9,30,6,1,0,7,3,30,4,0,0,4,1,-15,3,1
2,4,13,1,30,7,0,0,7,0,30,4,0,0,4,2,30,7,0,0,7,9,30,6,1,0,7,3,30,4,0,0,4,1,-15,3,1
2,1,17,3,30,8,6,0,14,2,30,6,0,0,6,0,30,8,6,0,14,5,30,5,9,0,14,2,30,4,0,0,4,1,-15,3,1
2,0,19,0,30,3,10,0,13,1,30,8,0,0,8,0,30,5,8,0,13,3,30,5,8,0,13,0,30,7,2,0,9,1,-15,3,1
2,1,19,0,30,3,10,0,13,1,30,8,0,0,8,0,30,5,8,0,13,3,30,5,8,0,13,0,30,7,2,0,9,1,-15,3,1
2,3,19,0,30,3,10,0,13,0,30,8,0,0,8,0,30,5,8,0,13,3,30,5,8,0,13,0,30,7,2,0,9,1,-15,3,1
2,4,19,0,30,3,10,0,13,0,30,8,0,0,8,0,30,5,8,0,13,3,30,5,8,0,13,0,30,7,2,0,9,1,-15,3,1
2,2,23,1,30,5,8,0,13,1,30,6,0,0,6,6,30,12,1,0,13,0,30,5,8,0,13,2,30,6,0,0,6,1,-15,3,1
2,3,23,1,30,5,8,0,13,1,30,6,0,0,6,6,30,12,1,0,13,0,30,5,8,0,13,2,30,6,0,0,6,1,-15,3,1
2,4,23,1,30,5,8,0,13,1,30,6,0,0,6,6,30,12,1,0,13,0,30,5,8,0,13,2,30,6,0,0,6,1,-15,3,1
2,1,25,0,30,7,7,0,14,3,30,6,0,0,6,0,30,7,7,0,14,1,30,5,9,0,14,6,30,6,0,0,6,1,-15,3,1
2,1,27,0,30,2,13,0,15,4,30,2,0,0,2,0,30,5,10,0,15,4,30,3,12,0,15,5,30,6,0,0,6,1,-15,3,1
2,2,31,4,30,4,8,0,12,7,30,8,0,0,8,3,30,4,8,0,12,0,30,8,4,0,12,2,30,6,0,0,6,1,-15,3,1
2,2,4,0,30,8,0,0,8,4,30,4,0,0,4,0,30,3,5,0,8,0,30,6,2,0,8,2,30,4,0,0,4,0,-27,3,0
2,1,5,0,30,2,3,0,5,4,30,0,4,0,4,0,30,0,5,0,5,2,30,3,2,0,5,0,30,1,1,0,2,0,-27,3,0
2,4,5,0,30,2,3,0,5,4,30,0,4,0,4,0,30,0,5,0,5,2,30,3,2,0,5,0,30,1,1,0,2,0,-27,3,0
2,3,22,3,30,4,4,0,8,3,30,2,0,0,2,4,30,4,4,0,8,3,30,3,5,0,8,0,30,2,2,0,4,1,-15,3,1
2,0,27,1,30,3,12,0,15,4,30,2,0,0,2,0,30,5,10,0,15,0,30,5,10,0,15,1,30,6,0,0,6,1,-15,3,1
2,2,27,1,30,3,12,0,15,4,30,2,0,0,2,0,30,5,10,0,15,0,30,5,10,0,15,1,30,6,0,0,6,1,-15,3,1
2,3,27,1,30,3,12,0,15,4,30,2,0,0,2,0,30,5,10,0,15,0,30,5,10,0,15,1,30,6,0,0,6,1,-15,3,1
2,4,27,1,30,3,12,0,15,4,30,2,0,0,2,0,30,5,10,0,15,0,30,5,10,0,15,1,30,6,0,0,6,1,-15,3,1
2,2,33,8,30,7,4,0,11,4,30,4,0,0,4,1,30,11,0,0,11,0,30,3,8,0,11,5,30,4,0,0,4,1,-15,3,1
2,4,35,0,30,10,3,0,13,4,30,2,0,0,2,1,30,2,11,0,13,0,30,5,8,0,13,3,30,8,0,0,8,1,-15,3,1
2,2,4,2,30,7,1,0,8,5,30,4,0,0,4,0,30,2,6,0,8,1,30,8,0,0,8,2,30,3,1,0,4,0,-27,3,0
2,3,15,1,30,5,8,0,13,0,30,6,0,0,6,0,30,3,10,0,13,1,30,2,11,0,13,2,30,9,0,0,9,1,-15,3,1
2,4,15,1,30,5,8,0,13,0,30,6,0,0,6,0,30,3,10,0,13,1,30,2,11,0,13,2,30,9,0,0,9,1,-15,3,1
2,2,19,0,30,3,10,0,13,0,30,7,1,0,8,0,30,6,7,0,13,1,30,6,7,0,13,3,30,7,2,0,9,1,-15,3,1
2,4,19,0,30,3,10,0,13,0,30,7,1,0,8,0,30,6,7,0,13,1,30,6,7,0,13,3,30,7,2,0,9,1,-15,3,1
2,4,25,5,30,8,6,0,14,1,30,6,0,0,6,0,30,11,3,0,14,0,30,5,9,0,14,4,30,5,1,0,6,1,-15,3,1
2,1,41,0,30,10,2,0,12,6,30,7,1,0,8,0,30,7,5,0,12,0,30,3,9,0,12,3,30,6,1,0,7,1,-15,3,1
2,4,8,0,30,7,0,0,7,4,30,2,0,0,2,3,30,3,4,0,7,0,30,6,1,0,7,0,30,3,0,0,3,0,-27,3,0
2,1,11,1,30,8,4,0,12,2,30,4,0,0,4,0,30,5,7,0,12,7,30,7,5,0,12,6,30,4,0,0,4,1,-15,3,1
2,4,17,0,30,8,6,0,14,2,30,6,0,0,6,0,30,6,8,0,14,2,30,6,8,0,14,4,30,4,0,0,4,1,-15,3,1
2,3,23,1,30,6,7,0,13,3,30,6,0,0,6,3,30,13,0,0,13,0,30,4,9,0,13,5,30,6,0,0,6,1,-15,3,1
2,3,25,1,30,3,11,0,14,4,30,6,0,0,6,0,30,5,9,0,14,4,30,10,4,0,14,9,30,6,0,0,6,1,-15,3,1
2,0,27,1,30,6,9,0,15,5,30,1,1,0,2,0,30,2,13,0,15,6,30,5,10,0,15,5,30,6,0,0,6,1,-15,3,1
2,1,27,1,30,6,9,0,15,5,30,1,1,0,2,0,30,2,13,0,15,6,30,5,10,0,15,5,30,6,0,0,6,1,-15,3,1
2,3,27,1,30,6,9,0,15,5,30,1,1,0,2,0,30,2,13,0,15,6,30,5,10,0,15,5,30,6,0,0,6,1,-15,3,1
2,4,27,1,30,6,9,0,15,5,30,1,1,0,2,0,30,2,13,0,15,6,30,5,10,0,15,5,30,6,0,0,6,1,-15,3,1
2,3,31,5,30,7,5,0,12,3,30,8,0,0,8,3,30,12,0,0,12,0,30,3,9,0,12,0,30,2,4,0,6,1,-15,3,1
2,1,37,0,30,8,3,0,11,6,30,8,0,0,8,0,30,5,6,0,11,4,30,3,8,0,11,8,30,6,0,0,6,1,-15,3,1
2,2,37,0,30,8,3,0,11,6,30,8,0,0,8,0,30,5,6,0,11,4,30,3,8,0,11,8,30,6,0,0,6,1,-15,3,1
2,1,4,3,30,5,3,0,8,4,30,4,0,0,4,0,30,4,4,0,8,0,30,8,0,0,8,2,30,4,0,0,4,0,-27,3,0
2,3,8,2,30,7,0,0,7,5,30,2,0,0,2,0,30,2,5,0,7,0,30,6,1,0,7,3,30,3,0,0,3,0,-27,3,0
2,4,11,0,30,3,9,0,12,0,30,4,0,0,4,0,30,7,5,0,12,3,30,4,8,0,12,3,30,4,0,0,4,1,-15,3,1
2,0,13,3,30,7,0,0,7,1,30,4,0,0,4,2,30,5,2,0,7,7,30,7,0,0,7,4,30,4,0,0,4,1,-15,3,1
2,2,25,2,30,6,8,0,14,3,30,6,0,0,6,0,30,7,7,0,14,1,30,4,10,0,14,0,30,5,1,0,6,1,-15,3,1
2,2,27,1,30,4,11,0,15,0,30,1,1,0,2,0,30,11,4,0,15,4,30,5,10,0,15,4,30,6,0,0,6,1,-15,3,1
2,3,27,1,30,4,11,0,15,0,30,1,1,0,2,0,30,11,4,0,15,4,30,5,10,0,15,4,30,6,0,0,6,1,-15,3,1
2,3,35,1,30,9,4,0,13,4,30,2,0,0,2,1,30,7,6,0,13,2,30,2,11,0,13,6,30,8,0,0,8,1,-15,3,1
2,4,35,1,30,9,4,0,13,4,30,2,0,0,2,1,30,7,6,0,13,2,30,2,11,0,13,6,30,8,0,0,8,1,-15,3,1
2,1,37,0,30,6,5,0,11,5,30,8,0,0,8,2,30,8,3,0,11,2,30,3,8,0,11,3,30,6,0,0,6,1,-15,3,1
2,3,37,0,30,6,5,0,11,5,30,8,0,0,8,2,30,8,3,0,11,2,30,3,8,0,11,3,30,6,0,0,6,1,-15,3,1
2,3,13,11,30,7,0,0,7,2,30,4,0,0,4,5,30,7,0,0,7,0,30,6,1,0,7,0,30,4,0,0,4,1,-15,3,1
2,3,14,5,30,9,0,0,9,2,30,6,0,0,6,0,30,5,4,0,9,0,30,1,8,0,9,0,30,3,1,0,4,1,-15,3,1
2,0,21,1,30,6,4,0,10,3,30,6,0,0,6,1,30,2,8,0,10,5,30,3,7,0,10,7,30,4,0,0,4,1,-15,3,1
2,1,21,1,30,6,4,0,10,3,30,6,0,0,6,1,30,2,8,0,10,5,30,3,7,0,10,7,30,4,0,0,4,1,-15,3,1
2,2,21,1,30,6,4,0,10,3,30,6,0,0,6,1,30,2,8,0,10,5,30,3,7,0,10,7,30,4,0,0,4,1,-15,3,1
2,2,23,1,30,5,8,0,13,4,30,6,0,0,6,0,30,5,8,0,13,6,30,8,5,0,13,4,30,6,0,0,6,1,-15,3,1
2,2,29,0,30,8,6,0,14,6,30,12,0,0,12,0,30,5,9,0,14,0,30,1,13,0,14,2,30,9,0,0,9,1,-15,3,1
2,4,29,0,30,8,6,0,14,6,30,12,0,0,12,0,30,5,9,0,14,0,30,1,13,0,14,2,30,9,0,0,9,1,-15,3,1
2,2,5,0,30,1,4,0,5,3,30,0,4,0,4,0,30,1,4,0,5,0,30,1,4,0,5,1,30,1,1,0,2,0,-27,3,0
2,1,13,1,30,7,0,0,7,2,30,4,0,0,4,2,30,5,2,0,7,6,30,7,0,0,7,2,30,4,0,0,4,1,-15,3,1
2,1,19,0,30,5,8,0,13,2,30,5,3,0,8,0,30,5,8,0,13,3,30,4,9,0,13,1,30,9,0,0,9,1,-15,3,1
2,2,19,0,30,5,8,0,13,2,30,5,3,0,8,0,30,5,8,0,13,3,30,4,9,0,13,1,30,9,0,0,9,1,-15,3,1
2,1,25,1,30,9,5,0,14,2,30,6,0,0,6,0,30,11,3,0,14,1,30,4,10,0,14,4,30,5,1,0,6,1,-15,3,1
2,3,25,1,30,9,5,0,14,2,30,6,0,0,6,0,30,11,3,0,14,1,30,4,10,0,14,4,30,5,1,0,6,1,-15,3,1
2,4,25,1,30,9,5,0,14,2,30,6,0,0,6,0,30,11,3,0,14,1,30,4,10,0,14,4,30,5,1,0,6,1,-15,3,1
2,0,27,1,30,4,11,0,15,5,30,1,1,0,2,0,30,6,9,0,15,2,30,5,10,0,15,5,30,6,0,0,6,1,-15,3,1
2,2,27,1,30,4,11,0,15,5,30,1,1,0,2,0,30,6,9,0,15,2,30,5,10,0,15,5,30,6,0,0,6,1,-15,3,1
2,3,27,1,30,4,11,0,15,5,30,1,1,0,2,0,30,6,9,0,15,2,30,5,10,0,15,5,30,6,0,0,6,1,-15,3,1
2,1,6,1,30,7,2,0,9,4,30,2,0,0,2,0,30,2,7,0,9,0,30,4,5,0,9,0,30,3,2,0,5,0,-27,3,0
2,3,7,1,30,4,5,0,9,3,30,4,0,0,4,1,30,5,4,0,9,2,30,3,6,0,9,1,30,5,1,0,6,0,-27,3,0
2,4,15,1,30,4,9,0,13,1,30,6,0,0,6,0,30,6,7,0,13,1,30,4,9,0,13,3,30,9,0,0,9,1,-15,3,1
2,3,19,0,30,4,9,0,13,2,30,4,4,0,8,0,30,4,9,0,13,1,30,5,8,0,13,0,30,9,0,0,9,1,-15,3,1
2,4,19,0,30,4,9,0,13,2,30,4,4,0,8,0,30,4,9,0,13,1,30,5,8,0,13,0,30,9,0,0,9,1,-15,3,1
2,1,25,1,30,6,8,0,14,4,30,6,0,0,6,0,30,9,5,0,14,1,30,5,9,0,14,4,30,6,0,0,6,1,-15,3,1
2,4,25,1,30,6,8,0,14,4,30,6,0,0,6,0,30,9,5,0,14,0,30,5,9,0,14,4,30,6,0,0,6,1,-15,3,1
2,3,27,2,30,9,6,0,15,4,30,2,0,0,2,2,30,3,12,0,15,0,30,4,11,0,15,2,30,2,4,0,6,1,-15,3,1
2,4,27,2,30,9,6,0,15,4,30,2,0,0,2,2,30,3,12,0,15,0,30,4,11,0,15,2,30,2,4,0,6,1,-15,3,1
2,4,29,0,30,5,9,0,14,6,30,10,2,0,12,0,30,4,10,0,14,0,30,3,11,0,14,2,30,9,0,0,9,1,-15,3,1
2,0,31,1,30,4,8,0,12,5,30,8,0,0,8,13,30,9,3,0,12,0,30,3,9,0,12,0,30,5,1,0,6,1,-15,3,1
2,1,31,1,30,4,8,0,12,5,30,8,0,0,8,13,30,9,3,0,12,0,30,3,9,0,12,0,30,5,1,0,6,1,-15,3,1
2,3,31,1,30,4,8,0,12,5,30,8,0,0,8,13,30,9,3,0,12,0,30,3,9,0,12,0,30,5,1,0,6,1,-15,3,1
2,4,31,1,30,4,8,0,12,5,30,8,0,0,8,13,30,9,3,0,12,0,30,3,9,0,12,0,30,5,1,0,6,1,-15,3,1
2,1,4,3,30,8,0,0,8,4,30,4,0,0,4,1,30,4,4,0,8,0,30,4,4,0,8,1,30,4,0,0,4,0,-27,3,0
2,2,4,3,30,8,0,0,8,4,30,4,0,0,4,1,30,4,4,0,8,0,30,4,4,0,8,1,30,4,0,0,4,0,-27,3,0
2,3,4,3,30,8,0,0,8,4,30,4,0,0,4,1,30,4,4,0,8,0,30,4,4,0,8,1,30,4,0,0,4,0,-27,3,0
2,4,4,3,30,8,0,0,8,4,30,4,0,0,4,1,30,4,4,0,8,0,30,4,4,0,8,1,30,4,0,0,4,0,-27,3,0
2,4,8,1,30,7,0,0,7,3,30,2,0,0,2,2,30,4,3,0,7,0,30,4,3,0,7,1,30,3,0,0,3,0,-27,3,0
2,1,9,0,30,4,0,0,4,2,30,2,0,0,2,0,30,0,4,0,4,0,30,1,3,0,4,0,30,1,0,0,1,0,-27,3,0
2,3,9,0,30,4,0,0,4,2,30,2,0,0,2,0,30,0,4,0,4,0,30,1,3,0,4,0,30,1,0,0,1,0,-27,3,0
2,1,13,2,30,7,0,0,7,2,30,4,0,0,4,7,30,5,2,0,7,5,30,6,1,0,7,3,30,4,0,0,4,1,-15,3,1
2,3,13,2,30,7,0,0,7,2,30,4,0,0,4,7,30,5,2,0,7,5,30,6,1,0,7,3,30,4,0,0,4,1,-15,3,1
2,4,13,2,30,7,0,0,7,2,30,4,0,0,4,7,30,5,2,0,7,5,30,6,1,0,7,3,30,4,0,0,4,1,-15,3,1
2,3,23,3,30,4,9,0,13,3,30,6,0,0,6,3,30,13,0,0,13,0,30,4,9,0,13,2,30,6,0,0,6,1,-15,3,1
2,0,25,1,30,5,9,0,14,5,30,6,0,0,6,0,30,5,9,0,14,3,30,7,7,0,14,5,30,5,1,0,6,1,-15,3,1
2,1,25,1,30,5,9,0,14,5,30,6,0,0,6,0,30,5,9,0,14,3,30,7,7,0,14,5,30,5,1,0,6,1,-15,3,1
2,0,27,1,30,5,10,0,15,4,30,2,0,0,2,0,30,7,8,0,15,2,30,6,9,0,15,2,30,6,0,0,6,1,-15,3,1
2,2,27,1,30,5,10,0,15,2,30,2,0,0,2,0,30,7,8,0,15,2,30,6,9,0,15,2,30,6,0,0,6,1,-15,3,1
2,3,27,1,30,5,10,0,15,2,30,2,0,0,2,0,30,7,8,0,15,2,30,6,9,0,15,2,30,6,0,0,6,1,-15,3,1
2,2,30,2,30,3,2,0,5,3,30,2,0,0,2,1,30,2,3,0,5,11,30,1,4,0,5,0,30,2,1,0,3,1,-15,3,1
2,1,35,7,30,6,7,0,13,6,30,2,0,0,2,1,30,2,11,0,13,2,30,3,10,0,13,4,30,8,0,0,8,1,-15,3,1
2,2,35,7,30,6,7,0,13,6,30,2,0,0,2,1,30,2,11,0,13,2,30,3,10,0,13,4,30,8,0,0,8,1,-15,3,1
2,3,35,7,30,6,7,0,13,6,30,2,0,0,2,1,30,2,11,0,13,2,30,3,10,0,13,4,30,8,0,0,8,1,-15,3,1
2,3,5,0,30,4,1,0,5,3,30,3,1,0,4,0,30,0,5,0,5,0,30,1,4,0,5,0,30,1,1,0,2,0,-27,3,0
2,2,6,0,30,7,2,0,9,3,30,2,0,0,2,1,30,4,5,0,9,0,30,4,5,0,9,0,30,3,2,0,5,0,-27,3,0
2,2,8,1,30,7,0,0,7,5,30,2,0,0,2,0,30,2,5,0,7,0,30,6,1,0,7,3,30,3,0,0,3,0,-27,3,0
2,4,8,1,30,7,0,0,7,5,30,2,0,0,2,0,30,2,5,0,7,0,30,6,1,0,7,3,30,3,0,0,3,0,-27,3,0
2,1,17,2,30,9,5,0,14,2,30,6,0,0,6,0,30,5,9,0,14,6,30,6,8,0,14,6,30,4,0,0,4,1,-15,3,1
2,4,17,2,30,9,5,0,14,2,30,6,0,0,6,0,30,5,9,0,14,6,30,6,8,0,14,6,30,4,0,0,4,1,-15,3,1
2,3,23,1,30,4,9,0,13,2,30,6,0,0,6,2,30,13,0,0,13,0,30,5,8,0,13,2,30,5,1,0,6,1,-15,3,1
2,3,25,3,30,7,7,0,14,5,30,6,0,0,6,0,30,4,10,0,14,1,30,5,9,0,14,4,30,5,1,0,6,1,-15,3,1
2,4,25,3,30,7,7,0,14,5,30,6,0,0,6,0,30,4,10,0,14,1,30,5,9,0,14,4,30,5,1,0,6,1,-15,3,1
2,3,41,0,30,8,4,0,12,6,30,8,0,0,8,0,30,5,7,0,12,3,30,3,9,0,12,2,30,7,0,0,7,1,-15,3,1
2,0,43,0,30,7,7,0,14,7,30,6,0,0,6,0,30,4,10,0,14,7,30,2,12,0,14,9,30,5,0,0,5,1,-15,3,1
2,3,47,0,30,1,13,0,14,9,30,4,0,0,4,0,30,3,11,0,14,0,30,2,12,0,14,0,30,7,0,0,7,1,-15,3,1
2,2,4,2,30,6,2,0,8,5,30,4,0,0,4,6,30,2,6,0,8,0,30,4,4,0,8,2,30,4,0,0,4,0,-27,3,0
2,1,6,0,30,6,3,0,9,3,30,2,0,0,2,0,30,5,4,0,9,0,30,4,5,0,9,1,30,5,0,0,5,0,-27,3,0
2,4,6,0,30,6,3,0,9,3,30,2,0,0,2,0,30,5,4,0,9,0,30,4,5,0,9,1,30,5,0,0,5,0,-27,3,0
2,3,8,1,30,7,0,0,7,3,30,2,0,0,2,3,30,2,5,0,7,0,30,5,2,0,7,7,30,3,0,0,3,0,-27,3,0
2,2,13,3,30,7,0,0,7,1,30,4,0,0,4,0,30,5,2,0,7,9,30,5,2,0,7,2,30,4,0,0,4,1,-15,3,1
2,3,17,3,30,8,6,0,14,2,30,6,0,0,6,0,30,7,7,0,14,2,30,3,11,0,14,3,30,4,0,0,4,1,-15,3,1
2,4,23,1,30,6,7,0,13,4,30,6,0,0,6,10,30,10,3,0,13,0,30,5,8,0,13,0,30,6,0,0,6,1,-15,3,1
2,0,27,1,30,3,12,0,15,3,30,1,1,0,2,0,30,7,8,0,15,1,30,12,3,0,15,5,30,6,0,0,6,1,-15,3,1
2,1,27,1,30,3,12,0,15,3,30,1,1,0,2,0,30,7,8,0,15,1,30,12,3,0,15,5,30,6,0,0,6,1,-15,3,1
2,2,27,1,30,3,12,0,15,3,30,1,1,0,2,0,30,7,8,0,15,1,30,12,3,0,15,5,30,6,0,0,6,1,-15,3,1
2,3,31,1,30,3,9,0,12,7,30,8,0,0,8,3,30,4,8,0,12,0,30,9,3,0,12,2,30,6,0,0,6,1,-15,3,1
2,4,31,1,30,3,9,0,12,7,30,8,0,0,8,3,30,4,8,0,12,0,30,9,3,0,12,2,30,6,0,0,6,1,-15,3,1
2,0,5,1,30,5,0,0,5,3,30,3,1,0,4,1,30,2,3,0,5,0,30,1,4,0,5,0,30,0,2,0,2,0,-27,3,0
2,2,5,1,30,5,0,0,5,3,30,3,1,0,4,1,30,2,3,0,5,0,30,1,4,0,5,0,30,0,2,0,2,0,-27,3,0
2,3,5,1,30,5,0,0,5,3,30,3,1,0,4,1,30,2,3,0,5,0,30,1,4,0,5,0,30,0,2,0,2,0,-27,3,0
2,4,11,0,30,5,7,0,12,2,30,4,0,0,4,0,30,7,5,0,12,5,30,9,3,0,12,3,30,4,0,0,4,1,-15,3,1
2,2,13,3,30,7,0,0,7,0,30,4,0,0,4,2,30,6,1,0,7,6,30,3,4,0,7,5,30,4,0,0,4,1,-15,3,1
2,1,17,4,30,7,7,0,14,3,30,6,0,0,6,0,30,6,8,0,14,2,30,8,6,0,14,4,30,4,0,0,4,1,-15,3,1
2,3,17,4,30,7,7,0,14,3,30,6,0,0,6,0,30,6,8,0,14,2,30,8,6,0,14,4,30,4,0,0,4,1,-15,3,1
2,4,17,4,30,7,7,0,14,3,30,6,0,0,6,0,30,6,8,0,14,2,30,8,6,0,14,4,30,4,0,0,4,1,-15,3,1
2,3,23,2,30,6,7,0,13,3,30,6,0,0,6,6,30,12,1,0,13,0,30,4,9,0,13,0,30,6,0,0,6,1,-15,3,1
2,1,25,1,30,9,5,0,14,3,30,6,0,0,6,0,30,8,6,0,14,1,30,8,6,0,14,4,30,5,1,0,6,1,-15,3,1
2,2,25,1,30,9,5,0,14,3,30,6,0,0,6,0,30,8,6,0,14,1,30,8,6,0,14,4,30,5,1,0,6,1,-15,3,1
2,3,27,0,30,4,11,0,15,2,30,2,0,0,2,0,30,8,7,0,15,0,30,7,8,0,15,2,30,6,0,0,6,1,-15,3,1
2,4,27,0,30,4,11,0,15,2,30,2,0,0,2,0,30,8,7,0,15,0,30,7,8,0,15,2,30,6,0,0,6,1,-15,3,1
2,2,29,0,30,10,4,0,14,4,30,11,1,0,12,0,30,3,11,0,14,0,30,1,13,0,14,0,30,8,1,0,9,1,-15,3,1
2,3,29,0,30,10,4,0,14,4,30,11,1,0,12,0,30,3,11,0,14,0,30,1,13,0,14,0,30,8,1,0,9,1,-15,3,1
2,4,29,0,30,10,4,0,14,4,30,11,1,0,12,0,30,3,11,0,14,0,30,1,13,0,14,0,30,8,1,0,9,1,-15,3,1
2,1,13,4,30,6,1,0,7,1,30,4,0,0,4,2,30,6,1,0,7,8,30,5,2,0,7,3,30,4,0,0,4,1,-15,3,1
2,4,13,4,30,6,1,0,7,1,30,4,0,0,4,2,30,6,1,0,7,8,30,5,2,0,7,0,30,4,0,0,4,1,-15,3,1
2,3,17,3,30,9,5,0,14,2,30,6,0,0,6,0,30,6,8,0,14,1,30,5,9,0,14,2,30,3,1,0,4,1,-15,3,1
2,2,19,0,30,4,9,0,13,2,30,2,6,0,8,0,30,4,9,0,13,4,30,4,9,0,13,3,30,8,1,0,9,1,-15,3,1
2,3,19,0,30,4,9,0,13,2,30,2,6,0,8,0,30,4,9,0,13,4,30,4,9,0,13,3,30,8,1,0,9,1,-15,3,1
2,4,19,0,30,4,9,0,13,2,30,2,6,0,8,0,30,4,9,0,13,4,30,4,9,0,13,3,30,8,1,0,9,1,-15,3,1
2,3,23,1,30,5,8,0,13,4,30,6,0,0,6,7,30,11,2,0,13,0,30,5,8,0,13,3,30,6,0,0,6,1,-15,3,1
2,4,25,1,30,6,8,0,14,4,30,6,0,0,6,0,30,6,8,0,14,1,30,9,5,0,14,3,30,6,0,0,6,1,-15,3,1
2,1,27,1,30,5,10,0,15,3,30,1,1,0,2,0,30,5,10,0,15,3,30,5,10,0,15,2,30,6,0,0,6,1,-15,3,1
2,2,27,1,30,5,10,0,15,3,30,1,1,0,2,0,30,5,10,0,15,3,30,5,10,0,15,2,30,6,0,0,6,1,-15,3,1
2,4,4,2,30,8,0,0,8,4,30,4,0,0,4,0,30,4,4,0,8,0,30,6,2,0,8,3,30,4,0,0,4,0,-27,3,0
2,1,5,0,30,2,3,0,5,3,30,3,1,0,4,0,30,1,4,0,5,0,30,1,4,0,5,0,30,2,0,0,2,0,-27,3,0
2,3,5,0,30,2,3,0,5,3,30,3,1,0,4,0,30,1,4,0,5,0,30,1,4,0,5,0,30,2,0,0,2,0,-27,3,0
2,4,5,0,30,2,3,0,5,3,30,3,1,0,4,0,30,1,4,0,5,0,30,1,4,0,5,0,30,2,0,0,2,0,-27,3,0
2,4,8,2,30,7,0,0,7,5,30,2,0,0,2,3,30,2,5,0,7,0,30,7,0,0,7,2,30,3,0,0,3,0,-27,3,0
2,4,11,1,30,4,8,0,12,0,30,4,0,0,4,0,30,10,2,0,12,6,30,5,7,0,12,4,30,4,0,0,4,1,-15,3,1
2,4,17,3,30,7,7,0,14,3,30,6,0,0,6,0,30,6,8,0,14,4,30,7,7,0,14,1,30,4,0,0,4,1,-15,3,1
2,4,23,1,30,6,7,0,13,2,30,6,0,0,6,5,30,11,2,0,13,0,30,6,7,0,13,0,30,6,0,0,6,1,-15,3,1
2,1,25,1,30,4,10,0,14,2,30,6,0,0,6,0,30,9,5,0,14,1,30,5,9,0,14,4,30,6,0,0,6,1,-15,3,1
2,4,25,0,30,4,10,0,14,2,30,6,0,0,6,0,30,9,5,0,14,1,30,5,9,0,14,4,30,6,0,0,6,1,-15,3,1
2,4,27,1,30,3,12,0,15,4,30,2,0,0,2,0,30,4,11,0,15,2,30,9,6,0,15,6,30,6,0,0,6,1,-15,3,1
2,3,29,0,30,9,5,0,14,5,30,11,1,0,12,0,30,4,10,0,14,0,30,1,13,0,14,2,30,9,0,0,9,1,-15,3,1
2,4,8,0,30,7,0,0,7,4,30,2,0,0,2,2,30,2,5,0,7,1,30,7,0,0,7,5,30,3,0,0,3,0,-27,3,0
2,4,17,2,30,9,5,0,14,2,30,6,0,0,6,0,30,6,8,0,14,3,30,8,6,0,14,5,30,4,0,0,4,1,-15,3,1
2,4,23,3,30,8,5,0,13,2,30,6,0,0,6,4,30,8,5,0,13,0,30,4,9,0,13,0,30,3,3,0,6,1,-15,3,1
2,1,27,1,30,3,12,0,15,3,30,2,0,0,2,0,30,11,4,0,15,0,30,2,13,0,15,2,30,6,0,0,6,1,-15,3,1
2,2,27,1,30,3,12,0,15,3,30,2,0,0,2,0,30,11,4,0,15,0,30,2,13,0,15,2,30,6,0,0,6,1,-15,3,1
2,4,27,1,30,3,12,0,15,3,30,2,0,0,2,0,30,11,4,0,15,0,30,2,13,0,15,2,30,6,0,0,6,1,-15,3,1
2,4,31,3,30,3,9,0,12,7,30,8,0,0,8,3,30,4,8,0,12,0,30,9,3,0,12,0,30,4,2,0,6,1,-15,3,1
2,4,33,8,30,7,4,0,11,6,30,4,0,0,4,3,30,7,4,0,11,0,30,3,8,0,11,4,30,4,0,0,4,1,-15,3,1
2,3,41,0,30,7,5,0,12,5,30,8,0,0,8,0,30,8,4,0,12,0,30,4,8,0,12,4,30,7,0,0,7,1,-15,3,1
2,2,47,0,30,0,14,0,14,6,30,4,0,0,4,0,30,3,11,0,14,0,30,2,12,0,14,7,30,7,0,0,7,1,-15,3,1
2,4,13,3,30,7,0,0,7,2,30,4,0,0,4,2,30,6,1,0,7,1,30,6,1,0,7,2,30,4,0,0,4,1,-15,3,1
2,4,15,0,30,3,10,0,13,0,30,6,0,0,6,0,30,7,6,0,13,1,30,6,7,0,13,3,30,6,3,0,9,1,-15,3,1
2,4,17,3,30,9,5,0,14,2,30,6,0,0,6,0,30,6,8,0,14,2,30,6,8,0,14,6,30,4,0,0,4,1,-15,3,1
2,3,19,0,30,4,9,0,13,2,30,7,1,0,8,0,30,4,9,0,13,0,30,5,8,0,13,0,30,9,0,0,9,1,-15,3,1
2,4,19,0,30,4,9,0,13,2,30,7,1,0,8,0,30,4,9,0,13,0,30,5,8,0,13,0,30,9,0,0,9,1,-15,3,1
2,3,25,1,30,7,7,0,14,4,30,5,1,0,6,0,30,9,5,0,14,1,30,4,10,0,14,4,30,5,1,0,6,1,-15,3,1
2,4,25,1,30,7,7,0,14,4,30,5,1,0,6,0,30,9,5,0,14,1,30,4,10,0,14,4,30,5,1,0,6,1,-15,3,1
2,3,27,0,30,4,11,0,15,4,30,2,0,0,2,0,30,6,9,0,15,0,30,4,11,0,15,1,30,6,0,0,6,1,-15,3,1
2,2,8,0,30,7,0,0,7,4,30,2,0,0,2,3,30,2,5,0,7,0,30,5,2,0,7,4,30,3,0,0,3,0,-27,3,0
2,3,8,0,30,7,0,0,7,4,30,2,0,0,2,3,30,2,5,0,7,0,30,5,2,0,7,4,30,3,0,0,3,0,-27,3,0
2,3,19,0,30,6,7,0,13,1,30,8,0,0,8,0,30,7,6,0,13,3,30,3,10,0,13,1,30,6,3,0,9,1,-15,3,1
2,4,19,0,30,6,7,0,13,1,30,8,0,0,8,0,30,7,6,0,13,3,30,3,10,0,13,1,30,6,3,0,9,1,-15,3,1
2,3,25,0,30,5,9,0,14,4,30,6,0,0,6,0,30,9,5,0,14,1,30,5,9,0,14,4,30,5,1,0,6,1,-15,3,1
2,4,25,0,30,5,9,0,14,4,30,6,0,0,6,0,30,9,5,0,14,1,30,5,9,0,14,4,30,5,1,0,6,1,-15,3,1
2,1,27,1,30,4,11,0,15,2,30,2,0,0,2,0,30,4,11,0,15,0,30,4,11,0,15,5,30,6,0,0,6,1,-15,3,1
2,3,27,1,30,4,11,0,15,2,30,2,0,0,2,0,30,4,11,0,15,0,30,4,11,0,15,5,30,6,0,0,6,1,-15,3,1
2,3,30,6,30,5,0,0,5,5,30,2,0,0,2,2,30,2,3,0,5,2,30,1,4,0,5,0,30,2,1,0,3,1,-15,3,1
2,0,37,1,30,7,4,0,11,6,30,8,0,0,8,0,30,8,3,0,11,4,30,3,8,0,11,6,30,6,0,0,6,1,-15,3,1
2,3,37,1,30,7,4,0,11,6,30,8,0,0,8,0,30,8,3,0,11,4,30,3,8,0,11,6,30,6,0,0,6,1,-15,3,1
2,4,37,1,30,7,4,0,11,6,30,8,0,0,8,0,30,8,3,0,11,4,30,3,8,0,11,6,30,6,0,0,6,1,-15,3,1
2,3,39,0,30,3,8,0,11,5,30,4,2,0,6,0,30,5,6,0,11,0,30,2,9,0,11,4,30,5,0,0,5,1,-15,3,1
2,3,4,0,30,8,0,0,8,3,30,4,0,0,4,0,30,6,2,0,8,0,30,4,4,0,8,1,30,3,1,0,4,0,-27,3,0
2,2,13,2,30,7,0,0,7,1,30,4,0,0,4,2,30,7,0,0,7,2,30,6,1,0,7,4,30,4,0,0,4,1,-15,3,1
2,4,13,2,30,7,0,0,7,1,30,4,0,0,4,2,30,7,0,0,7,2,30,6,1,0,7,4,30,4,0,0,4,1,-15,3,1
2,4,17,0,30,9,5,0,14,2,30,6,0,0,6,0,30,6,8,0,14,2,30,6,8,0,14,3,30,4,0,0,4,1,-15,3,1
2,2,19,0,30,5,8,0,13,1,30,7,1,0,8,0,30,7,6,0,13,4,30,4,9,0,13,0,30,6,3,0,9,1,-15,3,1
2,3,19,0,30,5,8,0,13,1,30,7,1,0,8,0,30,7,6,0,13,4,30,4,9,0,13,0,30,6,3,0,9,1,-15,3,1
2,3,23,1,30,6,7,0,13,0,30,6,0,0,6,1,30,13,0,0,13,0,30,4,9,0,13,2,30,6,0,0,6,1,-15,3,1
2,4,23,1,30,6,7,0,13,0,30,6,0,0,6,1,30,13,0,0,13,0,30,4,9,0,13,2,30,6,0,0,6,1,-15,3,1
2,4,25,1,30,3,11,0,14,4,30,6,0,0,6,0,30,11,3,0,14,1,30,4,10,0,14,0,30,5,1,0,6,1,-15,3,1
2,3,27,1,30,4,11,0,15,4,30,2,0,0,2,0,30,9,6,0,15,2,30,4,11,0,15,1,30,5,1,0,6,1,-15,3,1
2,4,29,0,30,7,7,0,14,6,30,10,2,0,12,0,30,3,11,0,14,0,30,1,13,0,14,4,30,9,0,0,9,1,-15,3,1
2,2,31,2,30,3,9,0,12,8,30,8,0,0,8,3,30,4,8,0,12,2,30,9,3,0,12,1,30,6,0,0,6,1,-15,3,1
2,3,31,2,30,3,9,0,12,8,30,8,0,0,8,3,30,4,8,0,12,2,30,9,3,0,12,1,30,6,0,0,6,1,-15,3,1
2,4,31,2,30,3,9,0,12,8,30,8,0,0,8,3,30,4,8,0,12,2,30,9,3,0,12,1,30,6,0,0,6,1,-15,3,1
2,0,35,1,30,10,3,0,13,6,30,2,0,0,2,1,30,2,11,0,13,3,30,2,11,0,13,8,30,8,0,0,8,1,-15,3,1
2,1,35,1,30,10,3,0,13,6,30,2,0,0,2,1,30,2,11,0,13,3,30,2,11,0,13,8,30,8,0,0,8,1,-15,3,1
2,3,35,1,30,10,3,0,13,6,30,2,0,0,2,1,30,2,11,0,13,3,30,2,11,0,13,4,30,8,0,0,8,1,-15,3,1
2,1,4,2,30,7,1,0,8,3,30,4,0,0,4,0,30,2,6,0,8,4,30,2,6,0,8,1,30,4,0,0,4,0,-27,3,0
2,2,4,2,30,7,1,0,8,3,30,4,0,0,4,0,30,2,6,0,8,4,30,2,6,0,8,1,30,4,0,0,4,0,-27,3,0
2,4,4,2,30,7,1,0,8,3,30,4,0,0,4,0,30,2,6,0,8,4,30,2,6,0,8,1,30,4,0,0,4,0,-27,3,0
2,3,6,1,30,9,0,0,9,4,30,2,0,0,2,0,30,2,7,0,9,0,30,5,4,0,9,0,30,1,4,0,5,0,-27,3,0
2,1,11,2,30,3,9,0,12,0,30,4,0,0,4,0,30,8,4,0,12,3,30,4,8,0,12,2,30,4,0,0,4,1,-15,3,1
2,3,13,0,30,6,1,0,7,0,30,4,0,0,4,0,30,6,1,0,7,4,30,6,1,0,7,5,30,4,0,0,4,1,-15,3,1
2,4,17,2,30,10,4,0,14,2,30,6,0,0,6,0,30,6,8,0,14,0,30,6,8,0,14,4,30,4,0,0,4,1,-15,3,1
2,0,21,3,30,7,3,0,10,4,30,4,2,0,6,0,30,3,7,0,10,3,30,6,4,0,10,3,30,4,0,0,4,1,-15,3,1
2,1,21,3,30,7,3,0,10,4,30,4,2,0,6,0,30,3,7,0,10,3,30,6,4,0,10,3,30,4,0,0,4,1,-15,3,1
2,4,21,3,30,7,3,0,10,4,30,4,2,0,6,0,30,3,7,0,10,3,30,6,4,0,10,3,30,4,0,0,4,1,-15,3,1
2,3,25,1,30,4,10,0,14,4,30,6,0,0,6,0,30,7,7,0,14,2,30,6,8,0,14,6,30,6,0,0,6,1,-15,3,1
2,2,13,2,30,6,1,0,7,1,30,4,0,0,4,0,30,6,1,0,7,3,30,7,0,0,7,5,30,4,0,0,4,1,-15,3,1
2,4,13,2,30,6,1,0,7,1,30,4,0,0,4,0,30,6,1,0,7,3,30,7,0,0,7,5,30,4,0,0,4,1,-15,3,1
2,4,17,0,30,11,3,0,14,2,30,6,0,0,6,0,30,6,8,0,14,2,30,7,7,0,14,0,30,4,0,0,4,1,-15,3,1
2,3,19,0,30,5,8,0,13,1,30,6,2,0,8,0,30,7,6,0,13,3,30,6,7,0,13,1,30,8,1,0,9,1,-15,3,1
2,4,19,0,30,5,8,0,13,1,30,6,2,0,8,0,30,7,6,0,13,3,30,6,7,0,13,1,30,8,1,0,9,1,-15,3,1
2,4,22,0,30,7,1,0,8,3,30,2,0,0,2,1,30,3,5,0,8,1,30,3,5,0,8,1,30,4,0,0,4,1,-15,3,1
2,4,23,3,30,6,7,0,13,3,30,6,0,0,6,0,30,10,3,0,13,1,30,6,7,0,13,1,30,5,1,0,6,1,-15,3,1
2,3,27,1,30,6,9,0,15,3,30,2,0,0,2,0,30,5,10,0,15,3,30,5,10,0,15,0,30,6,0,0,6,1,-15,3,1
2,0,31,3,30,5,7,0,12,6,30,8,0,0,8,7,30,8,4,0,12,0,30,3,9,0,12,2,30,5,1,0,6,1,-15,3,1
2,1,31,3,30,5,7,0,12,6,30,8,0,0,8,7,30,8,4,0,12,0,30,3,9,0,12,2,30,5,1,0,6,1,-15,3,1
2,3,31,3,30,5,7,0,12,6,30,8,0,0,8,7,30,8,4,0,12,0,30,3,9,0,12,2,30,5,1,0,6,1,-15,3,1
2,3,8,1,30,7,0,0,7,4,30,2,0,0,2,3,30,3,4,0,7,1,30,7,0,0,7,0,30,3,0,0,3,0,-27,3,0
2,2,13,1,30,5,2,0,7,0,30,4,0,0,4,0,30,6,1,0,7,8,30,7,0,0,7,5,30,4,0,0,4,1,-15,3,1
2,4,15,0,30,5,8,0,13,0,30,6,0,0,6,0,30,4,9,0,13,1,30,4,9,0,13,0,30,8,1,0,9,1,-15,3,1
2,2,17,3,30,9,5,0,14,3,30,6,0,0,6,0,30,5,9,0,14,1,30,5,9,0,14,1,30,4,0,0,4,1,-15,3,1
2,0,21,3,30,7,3,0,10,4,30,4,2,0,6,1,30,3,7,0,10,2,30,5,5,0,10,3,30,4,0,0,4,1,-15,3,1
2,2,21,3,30,7,3,0,10,4,30,4,2,0,6,1,30,3,7,0,10,2,30,5,5,0,10,3,30,4,0,0,4,1,-15,3,1
2,3,21,3,30,7,3,0,10,4,30,4,2,0,6,1,30,3,7,0,10,2,30,5,5,0,10,3,30,4,0,0,4,1,-15,3,1
2,4,22,1,30,8,0,0,8,3,30,2,0,0,2,0,30,4,4,0,8,1,30,3,5,0,8,4,30,4,0,0,4,1,-15,3,1
2,1,27,2,30,6,9,0,15,0,30,2,0,0,2,0,30,12,3,0,15,0,30,3,12,0,15,1,30,4,2,0,6,1,-15,3,1
2,3,27,2,30,6,9,0,15,0,30,2,0,0,2,0,30,12,3,0,15,0,30,3,12,0,15,1,30,4,2,0,6,1,-15,3,1
2,3,31,1,30,4,8,0,12,7,30,8,0,0,8,3,30,4,8,0,12,2,30,7,5,0,12,0,30,5,1,0,6,1,-15,3,1
2,4,31,1,30,4,8,0,12,7,30,8,0,0,8,3,30,4,8,0,12,2,30,7,5,0,12,0,30,5,1,0,6,1,-15,3,1
2,4,32,0,30,4,5,0,9,5,30,2,0,0,2,1,30,7,2,0,9,1,30,4,5,0,9,1,30,2,0,0,2,1,-15,3,1
2,2,39,7,30,5,6,0,11,8,30,6,0,0,6,0,30,4,7,0,11,0,30,2,9,0,11,8,30,5,0,0,5,1,-15,3,1
2,2,4,3,30,8,0,0,8,5,30,4,0,0,4,1,30,2,6,0,8,4,30,8,0,0,8,1,30,3,1,0,4,0,-27,3,0
2,3,4,3,30,8,0,0,8,5,30,4,0,0,4,1,30,2,6,0,8,4,30,8,0,0,8,1,30,3,1,0,4,0,-27,3,0
2,4,4,3,30,8,0,0,8,5,30,4,0,0,4,1,30,2,6,0,8,4,30,8,0,0,8,1,30,3,1,0,4,0,-27,3,0
2,2,13,2,30,5,2,0,7,0,30,4,0,0,4,4,30,7,0,0,7,10,30,4,3,0,7,6,30,4,0,0,4,1,-15,3,1
2,4,13,2,30,5,2,0,7,0,30,4,0,0,4,4,30,7,0,0,7,10,30,4,3,0,7,6,30,4,0,0,4,1,-15,3,1
2,1,19,0,30,6,7,0,13,0,30,5,3,0,8,3,30,7,6,0,13,0,30,6,7,0,13,1,30,6,3,0,9,1,-15,3,1
2,2,19,0,30,6,7,0,13,0,30,5,3,0,8,3,30,7,6,0,13,0,30,6,7,0,13,1,30,6,3,0,9,1,-15,3,1
2,3,23,1,30,5,8,0,13,3,30,6,0,0,6,2,30,13,0,0,13,0,30,6,7,0,13,5,30,6,0,0,6,1,-15,3,1
2,2,27,1,30,3,12,0,15,5,30,2,0,0,2,0,30,3,12,0,15,0,30,4,11,0,15,5,30,6,0,0,6,1,-15,3,1
2,3,27,1,30,3,12,0,15,5,30,2,0,0,2,0,30,3,12,0,15,0,30,4,11,0,15,5,30,6,0,0,6,1,-15,3,1
2,4,27,1,30,3,12,0,15,5,30,2,0,0,2,0,30,3,12,0,15,0,30,4,11,0,15,5,30,6,0,0,6,1,-15,3,1
2,2,29,0,30,7,7,0,14,6,30,12,0,0,12,0,30,4,10,0,14,0,30,2,12,0,14,0,30,9,0,0,9,1,-15,3,1
2,3,29,0,30,7,7,0,14,6,30,12,0,0,12,0,30,4,10,0,14,0,30,2,12,0,14,0,30,9,0,0,9,1,-15,3,1
2,4,29,0,30,7,7,0,14,6,30,12,0,0,12,0,30,4,10,0,14,0,30,2,12,0,14,0,30,9,0,0,9,1,-15,3,1
2,1,33,3,30,5,6,0,11,5,30,4,0,0,4,0,30,6,5,0,11,5,30,4,7,0,11,9,30,4,0,0,4,1,-15,3,1
2,2,33,3,30,5,6,0,11,5,30,4,0,0,4,0,30,6,5,0,11,5,30,4,7,0,11,9,30,4,0,0,4,1,-15,3,1
2,2,4,2,30,8,0,0,8,5,30,4,0,0,4,0,30,1,7,0,8,0,30,5,3,0,8,4,30,4,0,0,4,0,-27,3,0
2,3,4,2,30,8,0,0,8,5,30,4,0,0,4,0,30,1,7,0,8,0,30,5,3,0,8,4,30,4,0,0,4,0,-27,3,0
2,3,8,1,30,7,0,0,7,3,30,2,0,0,2,3,30,5,2,0,7,2,30,7,0,0,7,0,30,3,0,0,3,0,-27,3,0
2,1,13,2,30,6,1,0,7,0,30,4,0,0,4,2,30,7,0,0,7,8,30,4,3,0,7,3,30,4,0,0,4,1,-15,3,1
2,0,17,3,30,9,5,0,14,3,30,6,0,0,6,0,30,5,9,0,14,1,30,8,6,0,14,5,30,4,0,0,4,1,-15,3,1
2,3,17,0,30,9,5,0,14,2,30,6,0,0,6,0,30,5,9,0,14,1,30,8,6,0,14,5,30,4,0,0,4,1,-15,3,1
2,0,19,1,30,6,7,0,13,2,30,8,0,0,8,0,30,4,9,0,13,2,30,2,11,0,13,0,30,8,1,0,9,1,-15,3,1
2,1,19,1,30,6,7,0,13,2,30,8,0,0,8,0,30,4,9,0,13,2,30,2,11,0,13,0,30,8,1,0,9,1,-15,3,1
2,2,19,1,30,6,7,0,13,2,30,8,0,0,8,0,30,4,9,0,13,2,30,2,11,0,13,0,30,8,1,0,9,1,-15,3,1
2,2,23,4,30,9,4,0,13,2,30,6,0,0,6,5,30,11,2,0,13,0,30,6,7,0,13,0,30,6,0,0,6,1,-15,3,1
2,2,25,1,30,7,7,0,14,5,30,6,0,0,6,0,30,5,9,0,14,1,30,7,7,0,14,4,30,6,0,0,6,1,-15,3,1
2,0,26,3,30,6,3,0,9,6,30,4,0,0,4,5,30,0,9,0,9,0,30,2,7,0,9,4,30,2,1,0,3,1,-15,3,1
2,3,26,3,30,6,3,0,9,6,30,4,0,0,4,5,30,0,9,0,9,0,30,2,7,0,9,1,30,2,1,0,3,1,-15,3,1
2,4,26,3,30,6,3,0,9,6,30,4,0,0,4,5,30,0,9,0,9,0,30,2,7,0,9,1,30,2,1,0,3,1,-15,3,1
2,2,27,3,30,7,8,0,15,1,30,2,0,0,2,0,30,9,6,0,15,0,30,4,11,0,15,1,30,2,4,0,6,1,-15,3,1
2,3,32,0,30,4,5,0,9,4,30,2,0,0,2,1,30,5,4,0,9,1,30,2,7,0,9,5,30,2,0,0,2,1,-15,3,1
2,1,7,2,30,4,0,0,4,2,30,2,0,0,2,0,30,1,3,0,4,0,30,1,3,0,4,1,30,1,1,0,2,0,-27,3,0
2,2,7,2,30,4,0,0,4,2,30,2,0,0,2,0,30,1,3,0,4,0,30,1,3,0,4,1,30,1,1,0,2,0,-27,3,0
2,4,13,2,30,5,2,0,7,0,30,4,0,0,4,2,30,6,1,0,7,10,30,6,1,0,7,3,30,4,0,0,4,1,-15,3,1
2,2,19,0,30,5,8,0,13,2,30,7,1,0,8,4,30,4,9,0,13,0,30,4,9,0,13,0,30,7,2,0,9,1,-15,3,1
2,3,19,0,30,5,8,0,13,2,30,7,1,0,8,4,30,4,9,0,13,0,30,4,9,0,13,0,30,7,2,0,9,1,-15,3,1
2,4,19,0,30,5,8,0,13,2,30,7,1,0,8,4,30,4,9,0,13,0,30,4,9,0,13,0,30,7,2,0,9,1,-15,3,1
2,3,25,1,30,7,7,0,14,4,30,6,0,0,6,0,30,6,8,0,14,0,30,10,4,0,14,2,30,6,0,0,6,1,-15,3,1
2,4,25,1,30,7,7,0,14,4,30,6,0,0,6,0,30,6,8,0,14,0,30,10,4,0,14,2,30,6,0,0,6,1,-15,3,1
2,2,27,2,30,6,9,0,15,3,30,2,0,0,2,0,30,5,10,0,15,4,30,3,12,0,15,0,30,4,2,0,6,1,-15,3,1
2,4,27,2,30,6,9,0,15,3,30,2,0,0,2,0,30,5,10,0,15,4,30,3,12,0,15,0,30,4,2,0,6,1,-15,3,1
2,3,47,0,30,0,14,0,14,7,30,4,0,0,4,0,30,8,6,0,14,0,30,2,12,0,14,8,30,7,0,0,7,1,-15,3,1
2,2,3,0,30,0,4,0,4,1,30,4,0,0,4,2,30,4,0,0,4,5,30,1,3,0,4,0,30,1,2,0,3,0,-27,3,0
2,4,3,0,30,0,4,0,4,1,30,4,0,0,4,0,30,4,0,0,4,5,30,1,3,0,4,0,30,1,2,0,3,0,-27,3,0
2,1,5,0,30,4,1,0,5,3,30,0,4,0,4,0,30,0,5,0,5,0,30,1,4,0,5,0,30,1,1,0,2,0,-27,3,0
2,1,13,4,30,7,0,0,7,0,30,4,0,0,4,2,30,5,2,0,7,4,30,5,2,0,7,4,30,4,0,0,4,1,-15,3,1
2,2,13,4,30,7,0,0,7,0,30,4,0,0,4,2,30,5,2,0,7,4,30,5,2,0,7,4,30,4,0,0,4,1,-15,3,1
2,3,25,1,30,5,9,0,14,4,30,6,0,0,6,0,30,7,7,0,14,4,30,10,4,0,14,5,30,5,1,0,6,1,-15,3,1
2,2,31,1,30,5,7,0,12,7,30,8,0,0,8,3,30,4,8,0,12,1,30,6,6,0,12,6,30,6,0,0,6,1,-15,3,1
2,0,47,1,30,5,9,0,14,8,30,4,0,0,4,0,30,3,11,0,14,5,30,3,11,0,14,3,30,7,0,0,7,1,-15,3,1
2,1,19,0,30,3,10,0,13,2,30,4,4,0,8,0,30,6,7,0,13,4,30,5,8,0,13,4,30,9,0,0,9,1,-15,3,1
2,3,23,2,30,5,8,0,13,4,30,6,0,0,6,2,30,10,3,0,13,0,30,5,8,0,13,5,30,5,1,0,6,1,-15,3,1
2,4,23,2,30,5,8,0,13,4,30,6,0,0,6,2,30,10,3,0,13,0,30,5,8,0,13,5,30,5,1,0,6,1,-15,3,1
2,2,25,3,30,9,5,0,14,4,30,6,0,0,6,0,30,5,9,0,14,1,30,5,9,0,14,3,30,5,1,0,6,1,-15,3,1
2,2,26,0,30,9,0,0,9,4,30,4,0,0,4,2,30,3,6,0,9,0,30,2,7,0,9,5,30,1,2,0,3,1,-15,3,1
2,1,31,6,30,8,4,0,12,4,30,8,0,0,8,0,30,9,3,0,12,0,30,3,9,0,12,0,30,2,4,0,6,1,-15,3,1
2,3,31,6,30,8,4,0,12,4,30,8,0,0,8,0,30,9,3,0,12,0,30,3,9,0,12,0,30,2,4,0,6,1,-15,3,1
2,4,31,6,30,8,4,0,12,4,30,8,0,0,8,0,30,9,3,0,12,0,30,3,9,0,12,0,30,2,4,0,6,1,-15,3,1
2,3,35,5,30,8,5,0,13,5,30,2,0,0,2,1,30,2,11,0,13,0,30,1,12,0,13,2,30,7,1,0,8,1,-15,3,1
2,4,35,5,30,8,5,0,13,5,30,2,0,0,2,1,30,2,11,0,13,0,30,1,12,0,13,2,30,7,1,0,8,1,-15,3,1
2,3,36,0,30,8,1,0,9,4,30,2,0,0,2,1,30,9,0,0,9,1,30,1,8,0,9,7,30,3,0,0,3,1,-15,3,1
2,3,39,0,30,1,10,0,11,6,30,6,0,0,6,0,30,6,5,0,11,1,30,3,8,0,11,7,30,5,0,0,5,1,-15,3,1
2,1,1,0,30,7,3,0,10,4,30,2,0,0,2,1,30,4,6,0,10,3,30,8,2,0,10,6,30,6,0,0,6,0,-27,3,0
2,2,1,0,30,7,3,0,10,4,30,2,0,0,2,1,30,4,6,0,10,3,30,8,2,0,10,6,30,6,0,0,6,0,-27,3,0
2,0,4,2,30,6,2,0,8,5,30,4,0,0,4,0,30,1,7,0,8,0,30,8,0,0,8,1,30,3,1,0,4,0,-27,3,0
2,4,7,0,30,2,2,0,4,2,30,2,0,0,2,1,30,3,1,0,4,0,30,1,3,0,4,0,30,1,1,0,2,0,-27,3,0
2,4,8,0,30,7,0,0,7,3,30,2,0,0,2,2,30,4,3,0,7,0,30,4,3,0,7,1,30,3,0,0,3,0,-27,3,0
2,0,13,4,30,6,1,0,7,2,30,4,0,0,4,2,30,5,2,0,7,6,30,7,0,0,7,5,30,4,0,0,4,1,-15,3,1
2,3,13,4,30,6,1,0,7,2,30,4,0,0,4,2,30,5,2,0,7,6,30,7,0,0,7,5,30,4,0,0,4,1,-15,3,1
2,4,15,0,30,10,3,0,13,0,30,6,0,0,6,0,30,3,10,0,13,1,30,4,9,0,13,2,30,8,1,0,9,1,-15,3,1
2,4,19,0,30,4,9,0,13,3,30,8,0,0,8,7,30,6,7,0,13,3,30,4,9,0,13,0,30,6,3,0,9,1,-15,3,1
2,4,23,1,30,8,5,0,13,2,30,6,0,0,6,0,30,10,3,0,13,0,30,5,8,0,13,3,30,6,0,0,6,1,-15,3,1
2,1,26,0,30,9,0,0,9,5,30,4,0,0,4,2,30,0,9,0,9,0,30,2,7,0,9,4,30,3,0,0,3,1,-15,3,1
2,4,27,1,30,3,12,0,15,4,30,2,0,0,2,0,30,5,10,0,15,1,30,4,11,0,15,1,30,3,3,0,6,1,-15,3,1
2,2,29,0,30,6,8,0,14,6,30,9,3,0,12,0,30,5,9,0,14,0,30,2,12,0,14,4,30,9,0,0,9,1,-15,3,1
2,1,4,2,30,6,2,0,8,4,30,2,2,0,4,0,30,1,7,0,8,4,30,8,0,0,8,8,30,3,1,0,4,0,-27,3,0
2,4,5,0,30,2,3,0,5,3,30,2,2,0,4,0,30,0,5,0,5,0,30,1,4,0,5,4,30,2,0,0,2,0,-27,3,0
2,0,9,0,30,2,2,0,4,2,30,2,0,0,2,0,30,1,3,0,4,0,30,1,3,0,4,2,30,1,0,0,1,0,-27,3,0
2,3,23,2,30,6,7,0,13,1,30,6,0,0,6,4,30,10,3,0,13,0,30,5,8,0,13,3,30,6,0,0,6,1,-15,3,1
2,1,27,1,30,3,12,0,15,4,30,2,0,0,2,0,30,3,12,0,15,4,30,3,12,0,15,0,30,6,0,0,6,1,-15,3,1
2,4,27,1,30,3,12,0,15,4,30,2,0,0,2,0,30,3,12,0,15,2,30,3,12,0,15,0,30,6,0,0,6,1,-15,3,1
2,4,35,0,30,9,4,0,13,3,30,2,0,0,2,1,30,10,3,0,13,0,30,1,12,0,13,4,30,8,0,0,8,1,-15,3,1
2,0,37,1,30,7,4,0,11,6,30,8,0,0,8,0,30,2,9,0,11,6,30,3,8,0,11,6,30,6,0,0,6,1,-15,3,1
2,3,39,0,30,4,7,0,11,6,30,6,0,0,6,0,30,8,3,0,11,4,30,4,7,0,11,1,30,4,1,0,5,1,-15,3,1
2,4,39,0,30,4,7,0,11,6,30,6,0,0,6,0,30,8,3,0,11,4,30,4,7,0,11,1,30,4,1,0,5,1,-15,3,1
2,3,47,0,30,1,13,0,14,7,30,4,0,0,4,0,30,3,11,0,14,0,30,2,12,0,14,3,30,7,0,0,7,1,-15,3,1
2,2,1,0,30,5,5,0,10,4,30,2,0,0,2,1,30,4,6,0,10,1,30,9,1,0,10,6,30,6,0,0,6,0,-27,3,0
2,3,1,0,30,5,5,0,10,4,30,2,0,0,2,1,30,4,6,0,10,1,30,9,1,0,10,6,30,6,0,0,6,0,-27,3,0
2,2,6,1,30,9,0,0,9,4,30,2,0,0,2,0,30,3,6,0,9,0,30,4,5,0,9,0,30,3,2,0,5,0,-27,3,0
2,4,6,1,30,9,0,0,9,4,30,2,0,0,2,0,30,3,6,0,9,0,30,4,5,0,9,0,30,3,2,0,5,0,-27,3,0
2,4,13,4,30,5,2,0,7,0,30,4,0,0,4,2,30,6,1,0,7,6,30,7,0,0,7,4,30,4,0,0,4,1,-15,3,1
2,3,25,0,30,6,8,0,14,3,30,6,0,0,6,0,30,10,4,0,14,1,30,6,8,0,14,5,30,5,1,0,6,1,-15,3,1
2,1,27,1,30,4,11,0,15,4,30,2,0,0,2,0,30,6,9,0,15,3,30,5,10,0,15,2,30,6,0,0,6,1,-15,3,1
2,2,27,1,30,4,11,0,15,4,30,2,0,0,2,0,30,6,9,0,15,3,30,5,10,0,15,2,30,6,0,0,6,1,-15,3,1
2,4,27,1,30,4,11,0,15,4,30,2,0,0,2,0,30,6,9,0,15,3,30,5,10,0,15,2,30,6,0,0,6,1,-15,3,1
2,1,29,0,30,7,7,0,14,6,30,12,0,0,12,0,30,3,11,0,14,0,30,1,13,0,14,4,30,9,0,0,9,1,-15,3,1
2,2,29,0,30,7,7,0,14,6,30,12,0,0,12,0,30,3,11,0,14,0,30,1,13,0,14,4,30,9,0,0,9,1,-15,3,1
2,3,29,0,30,7,7,0,14,6,30,12,0,0,12,0,30,3,11,0,14,0,30,1,13,0,14,4,30,9,0,0,9,1,-15,3,1
2,4,29,0,30,7,7,0,14,6,30,12,0,0,12,0,30,3,11,0,14,0,30,1,13,0,14,4,30,9,0,0,9,1,-15,3,1
2,3,33,1,30,2,9,0,11,4,30,4,0,0,4,2,30,9,2,0,11,0,30,3,8,0,11,4,30,4,0,0,4,1,-15,3,1
2,1,5,0,30,2,3,0,5,3,30,2,2,0,4,3,30,0,5,0,5,0,30,1,4,0,5,0,30,0,2,0,2,0,-27,3,0
2,1,13,1,30,6,1,0,7,0,30,4,0,0,4,1,30,7,0,0,7,9,30,6,1,0,7,4,30,4,0,0,4,1,-15,3,1
2,2,13,1,30,6,1,0,7,0,30,4,0,0,4,1,30,7,0,0,7,9,30,6,1,0,7,4,30,4,0,0,4,1,-15,3,1
2,4,13,1,30,6,1,0,7,0,30,4,0,0,4,1,30,7,0,0,7,9,30,6,1,0,7,4,30,4,0,0,4,1,-15,3,1
2,4,17,0,30,9,5,0,14,3,30,6,0,0,6,0,30,3,11,0,14,2,30,6,8,0,14,4,30,4,0,0,4,1,-15,3,1
2,2,19,1,30,4,9,0,13,2,30,6,2,0,8,0,30,7,6,0,13,4,30,2,11,0,13,2,30,8,1,0,9,1,-15,3,1
2,3,19,1,30,4,9,0,13,2,30,6,2,0,8,0,30,7,6,0,13,4,30,2,11,0,13,2,30,8,1,0,9,1,-15,3,1
2,4,19,1,30,4,9,0,13,2,30,6,2,0,8,0,30,7,6,0,13,4,30,2,11,0,13,2,30,8,1,0,9,1,-15,3,1
2,1,27,1,30,5,10,0,15,1,30,2,0,0,2,0,30,7,8,0,15,3,30,5,10,0,15,4,30,6,0,0,6,1,-15,3,1
2,4,27,1,30,5,10,0,15,1,30,2,0,0,2,0,30,7,8,0,15,3,30,5,10,0,15,4,30,6,0,0,6,1,-15,3,1
2,2,31,2,30,7,5,0,12,7,30,8,0,0,8,3,30,4,8,0,12,0,30,7,5,0,12,0,30,5,1,0,6,1,-15,3,1
2,1,35,0,30,9,4,0,13,6,30,2,0,0,2,1,30,2,11,0,13,0,30,5,8,0,13,10,30,8,0,0,8,1,-15,3,1
2,3,35,0,30,9,4,0,13,6,30,2,0,0,2,1,30,2,11,0,13,0,30,5,8,0,13,10,30,8,0,0,8,1,-15,3,1
2,3,3,0,30,0,4,0,4,2,30,4,0,0,4,0,30,1,3,0,4,0,30,3,1,0,4,0,30,2,1,0,3,0,-27,3,0
2,4,3,0,30,0,4,0,4,2,30,4,0,0,4,0,30,1,3,0,4,0,30,3,1,0,4,0,30,2,1,0,3,0,-27,3,0
2,3,6,1,30,7,2,0,9,4,30,2,0,0,2,0,30,2,7,0,9,0,30,4,5,0,9,0,30,2,3,0,5,0,-27,3,0
2,4,6,1,30,7,2,0,9,4,30,2,0,0,2,0,30,2,7,0,9,0,30,4,5,0,9,0,30,2,3,0,5,0,-27,3,0
2,4,15,0,30,3,10,0,13,0,30,5,1,0,6,0,30,5,8,0,13,1,30,5,8,0,13,2,30,9,0,0,9,1,-15,3,1
2,3,17,2,30,10,4,0,14,4,30,6,0,0,6,0,30,3,11,0,14,2,30,8,6,0,14,4,30,4,0,0,4,1,-15,3,1
2,4,17,2,30,10,4,0,14,4,30,6,0,0,6,0,30,3,11,0,14,2,30,8,6,0,14,4,30,4,0,0,4,1,-15,3,1
2,2,19,0,30,7,6,0,13,2,30,4,4,0,8,0,30,4,9,0,13,6,30,5,8,0,13,0,30,8,1,0,9,1,-15,3,1
2,2,23,4,30,5,8,0,13,1,30,6,0,0,6,4,30,11,2,0,13,2,30,6,7,0,13,1,30,5,1,0,6,1,-15,3,1
2,3,23,4,30,5,8,0,13,1,30,6,0,0,6,4,30,11,2,0,13,2,30,6,7,0,13,1,30,5,1,0,6,1,-15,3,1
2,4,23,4,30,5,8,0,13,1,30,6,0,0,6,4,30,11,2,0,13,2,30,6,7,0,13,1,30,5,1,0,6,1,-15,3,1
2,1,27,1,30,4,11,0,15,3,30,2,0,0,2,0,30,3,12,0,15,1,30,7,8,0,15,2,30,6,0,0,6,1,-15,3,1
2,2,27,1,30,4,11,0,15,3,30,2,0,0,2,0,30,3,12,0,15,1,30,7,8,0,15,2,30,6,0,0,6,1,-15,3,1
2,4,29,0,30,6,8,0,14,5,30,12,0,0,12,0,30,6,8,0,14,0,30,3,11,0,14,0,30,6,3,0,9,1,-15,3,1
2,4,31,1,30,8,4,0,12,5,30,8,0,0,8,4,30,7,5,0,12,0,30,3,9,0,12,1,30,3,3,0,6,1,-15,3,1
2,4,8,4,30,7,0,0,7,5,30,2,0,0,2,4,30,2,5,0,7,0,30,4,3,0,7,1,30,3,0,0,3,0,-27,3,0
2,3,11,1,30,5,7,0,12,1,30,4,0,0,4,2,30,4,8,0,12,4,30,3,9,0,12,3,30,4,0,0,4,1,-15,3,1
2,3,15,0,30,4,9,0,13,0,30,6,0,0,6,0,30,4,9,0,13,1,30,4,9,0,13,2,30,9,0,0,9,1,-15,3,1
2,4,15,0,30,4,9,0,13,0,30,6,0,0,6,0,30,4,9,0,13,1,30,4,9,0,13,2,30,9,0,0,9,1,-15,3,1
2,3,27,0,30,8,7,0,15,2,30,1,1,0,2,0,30,10,5,0,15,0,30,3,12,0,15,2,30,6,0,0,6,1,-15,3,1
2,4,27,0,30,8,7,0,15,2,30,1,1,0,2,0,30,10,5,0,15,0,30,3,12,0,15,2,30,6,0,0,6,1,-15,3,1
2,2,35,1,30,8,5,0,13,6,30,2,0,0,2,1,30,2,11,0,13,0,30,1,12,0,13,6,30,8,0,0,8,1,-15,3,1
2,3,1,0,30,7,3,0,10,4,30,2,0,0,2,1,30,4,6,0,10,0,30,7,3,0,10,5,30,6,0,0,6,0,-27,3,0
2,4,7,0,30,2,2,0,4,2,30,2,0,0,2,0,30,1,3,0,4,0,30,1,3,0,4,0,30,2,0,0,2,0,-27,3,0
2,1,13,1,30,5,2,0,7,0,30,4,0,0,4,4,30,7,0,0,7,6,30,7,0,0,7,6,30,4,0,0,4,1,-15,3,1
2,0,19,0,30,4,9,0,13,2,30,5,3,0,8,3,30,4,9,0,13,4,30,3,10,0,13,1,30,8,1,0,9,1,-15,3,1
2,3,19,0,30,4,9,0,13,2,30,5,3,0,8,0,30,4,9,0,13,4,30,3,10,0,13,1,30,8,1,0,9,1,-15,3,1
2,4,19,0,30,4,9,0,13,2,30,5,3,0,8,0,30,4,9,0,13,4,30,3,10,0,13,1,30,8,1,0,9,1,-15,3,1
2,4,25,1,30,3,11,0,14,5,30,6,0,0,6,0,30,7,7,0,14,1,30,6,8,0,14,4,30,6,0,0,6,1,-15,3,1
2,1,27,1,30,5,10,0,15,1,30,2,0,0,2,0,30,6,9,0,15,2,30,5,10,0,15,5,30,6,0,0,6,1,-15,3,1
2,3,29,0,30,6,8,0,14,6,30,9,3,0,12,0,30,3,11,0,14,0,30,1,13,0,14,0,30,9,0,0,9,1,-15,3,1
2,3,31,0,30,2,10,0,12,7,30,8,0,0,8,3,30,4,8,0,12,0,30,8,4,0,12,4,30,6,0,0,6,1,-15,3,1
2,2,38,0,30,2,8,0,10,6,30,6,0,0,6,2,30,4,6,0,10,0,30,4,6,0,10,6,30,6,0,0,6,1,-15,3,1
2,2,39,0,30,6,5,0,11,6,30,6,0,0,6,0,30,5,6,0,11,0,30,2,9,0,11,2,30,5,0,0,5,1,-15,3,1
2,4,39,0,30,6,5,0,11,6,30,6,0,0,6,0,30,5,6,0,11,0,30,2,9,0,11,2,30,5,0,0,5,1,-15,3,1
2,0,47,0,30,2,12,0,14,6,30,4,0,0,4,0,30,3,11,0,14,0,30,6,8,0,14,11,30,7,0,0,7,1,-15,3,1
2,1,47,0,30,2,12,0,14,6,30,4,0,0,4,0,30,3,11,0,14,0,30,6,8,0,14,11,30,7,0,0,7,1,-15,3,1
2,2,47,0,30,2,12,0,14,6,30,4,0,0,4,0,30,3,11,0,14,0,30,6,8,0,14,11,30,7,0,0,7,1,-15,3,1
2,1,5,0,30,3,2,0,5,3,30,3,1,0,4,0,30,0,5,0,5,0,30,1,4,0,5,0,30,1,1,0,2,0,-27,3,0
2,3,8,1,30,7,0,0,7,3,30,2,0,0,2,3,30,4,3,0,7,0,30,5,2,0,7,1,30,3,0,0,3,0,-27,3,0
2,2,9,0,30,2,2,0,4,2,30,2,0,0,2,1,30,4,0,0,4,2,30,4,0,0,4,0,30,1,0,0,1,0,-27,3,0
2,3,9,0,30,2,2,0,4,2,30,2,0,0,2,1,30,4,0,0,4,2,30,4,0,0,4,0,30,1,0,0,1,0,-27,3,0
2,2,17,3,30,10,4,0,14,4,30,6,0,0,6,0,30,3,11,0,14,1,30,6,8,0,14,2,30,4,0,0,4,1,-15,3,1
2,4,17,3,30,10,4,0,14,4,30,6,0,0,6,0,30,3,11,0,14,1,30,6,8,0,14,2,30,4,0,0,4,1,-15,3,1
2,1,19,0,30,3,10,0,13,3,30,6,2,0,8,4,30,4,9,0,13,2,30,9,4,0,13,2,30,8,1,0,9,1,-15,3,1
2,3,19,0,30,3,10,0,13,3,30,6,2,0,8,4,30,4,9,0,13,2,30,9,4,0,13,2,30,8,1,0,9,1,-15,3,1
2,2,23,2,30,5,8,0,13,4,30,6,0,0,6,5,30,11,2,0,13,0,30,6,7,0,13,4,30,6,0,0,6,1,-15,3,1
2,3,23,2,30,5,8,0,13,4,30,6,0,0,6,5,30,11,2,0,13,0,30,6,7,0,13,4,30,6,0,0,6,1,-15,3,1
2,1,27,1,30,4,11,0,15,3,30,2,0,0,2,0,30,8,7,0,15,0,30,3,12,0,15,3,30,6,0,0,6,1,-15,3,1
2,4,27,1,30,4,11,0,15,3,30,2,0,0,2,0,30,8,7,0,15,0,30,3,12,0,15,3,30,6,0,0,6,1,-15,3,1
2,2,29,0,30,5,9,0,14,6,30,12,0,0,12,0,30,3,11,0,14,0,30,1,13,0,14,2,30,9,0,0,9,1,-15,3,1
2,2,35,0,30,5,8,0,13,3,30,2,0,0,2,5,30,13,0,0,13,2,30,1,12,0,13,2,30,8,0,0,8,1,-15,3,1
2,3,35,0,30,5,8,0,13,3,30,2,0,0,2,5,30,13,0,0,13,2,30,1,12,0,13,2,30,8,0,0,8,1,-15,3,1
2,4,35,0,30,5,8,0,13,3,30,2,0,0,2,5,30,13,0,0,13,2,30,1,12,0,13,2,30,8,0,0,8,1,-15,3,1
2,4,5,0,30,2,3,0,5,3,30,2,2,0,4,0,30,0,5,0,5,0,30,1,4,0,5,1,30,0,2,0,2,0,-27,3,0
2,4,8,3,30,7,0,0,7,3,30,2,0,0,2,0,30,6,1,0,7,0,30,5,2,0,7,0,30,3,0,0,3,0,-27,3,0
2,4,15,0,30,3,10,0,13,1,30,6,0,0,6,0,30,4,9,0,13,1,30,6,7,0,13,1,30,6,3,0,9,1,-15,3,1
2,1,17,4,30,10,4,0,14,3,30,6,0,0,6,0,30,3,11,0,14,1,30,5,9,0,14,2,30,4,0,0,4,1,-15,3,1
2,3,19,0,30,3,10,0,13,1,30,8,0,0,8,0,30,10,3,0,13,5,30,4,9,0,13,2,30,8,1,0,9,1,-15,3,1
2,3,27,1,30,6,9,0,15,3,30,1,1,0,2,0,30,5,10,0,15,0,30,5,10,0,15,4,30,6,0,0,6,1,-15,3,1
2,4,27,1,30,6,9,0,15,3,30,1,1,0,2,0,30,5,10,0,15,0,30,5,10,0,15,4,30,6,0,0,6,1,-15,3,1
2,3,31,2,30,8,4,0,12,3,30,8,0,0,8,4,30,12,0,0,12,0,30,3,9,0,12,1,30,2,4,0,6,1,-15,3,1
2,4,31,2,30,8,4,0,12,3,30,8,0,0,8,4,30,12,0,0,12,0,30,3,9,0,12,1,30,2,4,0,6,1,-15,3,1
2,3,43,0,30,11,3,0,14,6,30,6,0,0,6,0,30,4,10,0,14,1,30,1,13,0,14,3,30,5,0,0,5,1,-15,3,1
2,4,43,0,30,11,3,0,14,6,30,6,0,0,6,0,30,4,10,0,14,1,30,1,13,0,14,3,30,5,0,0,5,1,-15,3,1
2,0,4,2,30,5,3,0,8,5,30,4,0,0,4,3,30,2,6,0,8,1,30,7,1,0,8,1,30,4,0,0,4,0,-27,3,0
2,4,4,2,30,5,3,0,8,5,30,4,0,0,4,3,30,2,6,0,8,1,30,7,1,0,8,1,30,4,0,0,4,0,-27,3,0
2,3,11,0,30,1,3,0,4,0,30,0,0,0,0,0,30,1,3,0,4,5,30,3,1,0,4,3,30,1,0,0,1,1,-15,3,1
2,2,13,4,30,7,0,0,7,0,30,4,0,0,4,2,30,7,0,0,7,5,30,5,2,0,7,4,30,4,0,0,4,1,-15,3,1
2,3,13,4,30,7,0,0,7,0,30,4,0,0,4,2,30,7,0,0,7,5,30,5,2,0,7,4,30,4,0,0,4,1,-15,3,1
2,4,17,2,30,9,5,0,14,2,30,6,0,0,6,0,30,7,7,0,14,5,30,4,10,0,14,4,30,4,0,0,4,1,-15,3,1
2,3,19,0,30,3,10,0,13,0,30,8,0,0,8,0,30,4,9,0,13,3,30,4,9,0,13,3,30,8,1,0,9,1,-15,3,1
2,1,25,0,30,7,7,0,14,3,30,6,0,0,6,0,30,8,6,0,14,1,30,5,9,0,14,5,30,5,1,0,6,1,-15,3,1
2,2,25,0,30,7,7,0,14,3,30,6,0,0,6,0,30,8,6,0,14,1,30,5,9,0,14,5,30,5,1,0,6,1,-15,3,1
2,3,25,0,30,7,7,0,14,3,30,6,0,0,6,0,30,8,6,0,14,1,30,5,9,0,14,5,30,5,1,0,6,1,-15,3,1
2,4,25,0,30,7,7,0,14,3,30,6,0,0,6,0,30,8,6,0,14,1,30,5,9,0,14,5,30,5,1,0,6,1,-15,3,1
2,0,27,1,30,4,11,0,15,2,30,2,0,0,2,0,30,2,13,0,15,3,30,5,10,0,15,5,30,6,0,0,6,1,-15,3,1
2,1,27,1,30,4,11,0,15,2,30,2,0,0,2,0,30,2,13,0,15,3,30,5,10,0,15,5,30,6,0,0,6,1,-15,3,1
2,3,27,1,30,4,11,0,15,2,30,2,0,0,2,0,30,2,13,0,15,3,30,5,10,0,15,5,30,6,0,0,6,1,-15,3,1
2,4,27,1,30,4,11,0,15,2,30,2,0,0,2,0,30,2,13,0,15,3,30,5,10,0,15,5,30,6,0,0,6,1,-15,3,1
2,1,31,6,30,7,5,0,12,5,30,8,0,0,8,5,30,8,4,0,12,0,30,3,9,0,12,0,30,3,3,0,6,1,-15,3,1
2,0,37,1,30,8,3,0,11,5,30,7,1,0,8,0,30,11,0,0,11,4,30,3,8,0,11,6,30,6,0,0,6,1,-15,3,1
2,1,37,1,30,8,3,0,11,5,30,7,1,0,8,0,30,11,0,0,11,4,30,3,8,0,11,6,30,6,0,0,6,1,-15,3,1
2,2,37,1,30,8,3,0,11,5,30,7,1,0,8,0,30,11,0,0,11,4,30,3,8,0,11,6,30,6,0,0,6,1,-15,3,1
2,4,37,1,30,8,3,0,11,5,30,7,1,0,8,0,30,11,0,0,11,4,30,3,8,0,11,6,30,6,0,0,6,1,-15,3,1
2,0,4,2,30,8,0,0,8,5,30,4,0,0,4,1,30,1,7,0,8,0,30,5,3,0,8,4,30,4,0,0,4,0,-27,3,0
2,2,4,2,30,8,0,0,8,5,30,4,0,0,4,1,30,1,7,0,8,0,30,5,3,0,8,4,30,4,0,0,4,0,-27,3,0
2,4,8,3,30,7,0,0,7,3,30,2,0,0,2,3,30,7,0,0,7,0,30,5,2,0,7,2,30,3,0,0,3,0,-27,3,0
2,1,19,1,30,3,10,0,13,2,30,6,2,0,8,0,30,7,6,0,13,5,30,5,8,0,13,0,30,8,1,0,9,1,-15,3,1
2,2,19,1,30,3,10,0,13,2,30,6,2,0,8,0,30,7,6,0,13,5,30,5,8,0,13,0,30,8,1,0,9,1,-15,3,1
2,1,26,1,30,9,0,0,9,5,30,4,0,0,4,2,30,0,9,0,9,0,30,2,7,0,9,4,30,2,1,0,3,1,-15,3,1
2,2,26,1,30,9,0,0,9,5,30,4,0,0,4,2,30,0,9,0,9,0,30,2,7,0,9,4,30,2,1,0,3,1,-15,3,1
2,0,27,1,30,5,10,0,15,2,30,2,0,0,2,0,30,6,9,0,15,2,30,4,11,0,15,3,30,6,0,0,6,1,-15,3,1
2,1,27,1,30,5,10,0,15,2,30,2,0,0,2,0,30,6,9,0,15,2,30,4,11,0,15,3,30,6,0,0,6,1,-15,3,1
2,2,27,1,30,5,10,0,15,2,30,2,0,0,2,0,30,6,9,0,15,2,30,4,11,0,15,3,30,6,0,0,6,1,-15,3,1
2,3,27,1,30,5,10,0,15,2,30,2,0,0,2,0,30,6,9,0,15,2,30,4,11,0,15,3,30,6,0,0,6,1,-15,3,1
2,4,32,0,30,7,2,0,9,4,30,2,0,0,2,3,30,8,1,0,9,1,30,3,6,0,9,2,30,2,0,0,2,1,-15,3,1
2,4,8,7,30,7,0,0,7,5,30,2,0,0,2,0,30,4,3,0,7,0,30,0,7,0,7,2,30,3,0,0,3,0,-27,3,0
2,1,13,3,30,6,1,0,7,0,30,4,0,0,4,2,30,6,1,0,7,6,30,6,1,0,7,5,30,4,0,0,4,1,-15,3,1
2,2,13,3,30,6,1,0,7,0,30,4,0,0,4,2,30,6,1,0,7,6,30,6,1,0,7,5,30,4,0,0,4,1,-15,3,1
2,4,13,3,30,6,1,0,7,0,30,4,0,0,4,2,30,6,1,0,7,6,30,6,1,0,7,5,30,4,0,0,4,1,-15,3,1
2,4,17,2,30,9,5,0,14,2,30,6,0,0,6,0,30,6,8,0,14,1,30,5,9,0,14,2,30,4,0,0,4,1,-15,3,1
2,4,22,1,30,6,2,0,8,3,30,2,0,0,2,0,30,3,5,0,8,1,30,0,8,0,8,4,30,4,0,0,4,1,-15,3,1
2,3,23,1,30,8,5,0,13,0,30,6,0,0,6,3,30,13,0,0,13,0,30,4,9,0,13,4,30,6,0,0,6,1,-15,3,1
2,2,25,1,30,6,8,0,14,4,30,6,0,0,6,0,30,6,8,0,14,1,30,5,9,0,14,4,30,6,0,0,6,1,-15,3,1
2,2,27,2,30,6,9,0,15,4,30,2,0,0,2,0,30,5,10,0,15,2,30,8,7,0,15,0,30,6,0,0,6,1,-15,3,1
2,3,27,2,30,6,9,0,15,4,30,2,0,0,2,0,30,5,10,0,15,2,30,8,7,0,15,0,30,6,0,0,6,1,-15,3,1
2,4,29,0,30,8,6,0,14,6,30,9,3,0,12,0,30,3,11,0,14,0,30,2,12,0,14,0,30,8,1,0,9,1,-15,3,1
2,3,9,0,30,6,5,0,11,2,30,6,0,0,6,1,30,8,3,0,11,5,30,3,8,0,11,4,30,4,0,0,4,0,-27,3,0
2,3,13,0,30,7,0,0,7,1,30,4,0,0,4,2,30,6,1,0,7,4,30,4,3,0,7,2,30,4,0,0,4,1,-15,3,1
2,3,17,3,30,9,5,0,14,3,30,6,0,0,6,0,30,5,9,0,14,1,30,6,8,0,14,2,30,4,0,0,4,1,-15,3,1
2,2,19,0,30,3,10,0,13,2,30,5,3,0,8,0,30,6,7,0,13,5,30,7,6,0,13,0,30,8,1,0,9,1,-15,3,1
2,3,19,0,30,3,10,0,13,2,30,5,3,0,8,0,30,6,7,0,13,5,30,7,6,0,13,0,30,8,1,0,9,1,-15,3,1
2,3,23,5,30,5,8,0,13,1,30,6,0,0,6,5,30,13,0,0,13,0,30,4,9,0,13,2,30,5,1,0,6,1,-15,3,1
2,4,23,5,30,5,8,0,13,1,30,6,0,0,6,5,30,13,0,0,13,0,30,4,9,0,13,2,30,5,1,0,6,1,-15,3,1
2,0,25,0,30,4,10,0,14,4,30,6,0,0,6,0,30,10,4,0,14,1,30,5,9,0,14,5,30,6,0,0,6,1,-15,3,1
2,1,25,0,30,4,10,0,14,4,30,6,0,0,6,0,30,10,4,0,14,1,30,5,9,0,14,5,30,6,0,0,6,1,-15,3,1
2,2,25,0,30,4,10,0,14,4,30,6,0,0,6,0,30,10,4,0,14,1,30,5,9,0,14,5,30,6,0,0,6,1,-15,3,1
2,4,25,0,30,4,10,0,14,4,30,6,0,0,6,0,30,10,4,0,14,1,30,5,9,0,14,5,30,6,0,0,6,1,-15,3,1
2,1,29,0,30,7,7,0,14,5,30,12,0,0,12,0,30,3,11,0,14,1,30,5,9,0,14,0,30,6,3,0,9,1,-15,3,1
2,2,29,0,30,7,7,0,14,5,30,12,0,0,12,0,30,3,11,0,14,1,30,5,9,0,14,0,30,6,3,0,9,1,-15,3,1
2,2,15,0,30,4,9,0,13,0,30,6,0,0,6,0,30,3,10,0,13,1,30,3,10,0,13,2,30,9,0,0,9,1,-15,3,1
2,2,17,2,30,8,6,0,14,4,30,6,0,0,6,0,30,3,11,0,14,5,30,7,7,0,14,3,30,4,0,0,4,1,-15,3,1
2,3,17,2,30,8,6,0,14,4,30,6,0,0,6,0,30,3,11,0,14,5,30,7,7,0,14,3,30,4,0,0,4,1,-15,3,1
2,4,17,2,30,8,6,0,14,4,30,6,0,0,6,0,30,3,11,0,14,5,30,7,7,0,14,3,30,4,0,0,4,1,-15,3,1
2,0,25,3,30,6,8,0,14,5,30,6,0,0,6,0,30,8,6,0,14,1,30,4,10,0,14,4,30,5,1,0,6,1,-15,3,1
2,2,26,1,30,8,1,0,9,5,30,4,0,0,4,2,30,0,9,0,9,0,30,4,5,0,9,7,30,3,0,0,3,1,-15,3,1
2,2,27,1,30,4,11,0,15,3,30,2,0,0,2,0,30,3,12,0,15,0,30,4,11,0,15,2,30,6,0,0,6,1,-15,3,1
2,3,29,0,30,8,6,0,14,6,30,11,1,0,12,0,30,3,11,0,14,0,30,1,13,0,14,0,30,8,1,0,9,1,-15,3,1
2,4,29,0,30,8,6,0,14,6,30,11,1,0,12,0,30,3,11,0,14,0,30,1,13,0,14,0,30,8,1,0,9,1,-15,3,1
2,2,35,0,30,10,3,0,13,6,30,2,0,0,2,1,30,2,11,0,13,0,30,1,12,0,13,9,30,8,0,0,8,1,-15,3,1
2,4,17,1,30,9,5,0,14,2,30,6,0,0,6,0,30,7,7,0,14,2,30,3,11,0,14,4,30,4,0,0,4,1,-15,3,1
2,4,19,0,30,2,11,0,13,0,30,5,3,0,8,0,30,6,7,0,13,9,30,6,7,0,13,0,30,8,1,0,9,1,-15,3,1
2,4,23,1,30,6,7,0,13,2,30,6,0,0,6,0,30,11,2,0,13,4,30,5,8,0,13,6,30,6,0,0,6,1,-15,3,1
2,4,25,0,30,5,9,0,14,4,30,6,0,0,6,0,30,10,4,0,14,1,30,7,7,0,14,3,30,6,0,0,6,1,-15,3,1
2,1,27,1,30,5,10,0,15,2,30,1,1,0,2,0,30,6,9,0,15,0,30,4,11,0,15,2,30,4,2,0,6,1,-15,3,1
2,2,27,1,30,5,10,0,15,2,30,1,1,0,2,0,30,6,9,0,15,0,30,4,11,0,15,2,30,4,2,0,6,1,-15,3,1
2,4,7,0,30,1,3,0,4,2,30,2,0,0,2,0,30,1,3,0,4,2,30,2,2,0,4,2,30,2,0,0,2,0,-27,3,0
2,2,9,0,30,8,3,0,11,4,30,6,0,0,6,1,30,4,7,0,11,5,30,3,8,0,11,3,30,4,0,0,4,0,-27,3,0
2,4,13,2,30,7,0,0,7,0,30,4,0,0,4,2,30,7,0,0,7,8,30,7,0,0,7,5,30,4,0,0,4,1,-15,3,1
2,2,17,2,30,10,4,0,14,2,30,6,0,0,6,0,30,8,6,0,14,3,30,6,8,0,14,3,30,4,0,0,4,1,-15,3,1
2,4,17,2,30,10,4,0,14,2,30,6,0,0,6,0,30,8,6,0,14,3,30,6,8,0,14,3,30,4,0,0,4,1,-15,3,1
2,2,19,0,30,5,8,0,13,1,30,8,0,0,8,0,30,5,8,0,13,0,30,4,9,0,13,0,30,6,3,0,9,1,-15,3,1
2,3,23,2,30,7,6,0,13,1,30,6,0,0,6,3,30,12,1,0,13,0,30,5,8,0,13,2,30,6,0,0,6,1,-15,3,1
2,4,23,2,30,7,6,0,13,1,30,6,0,0,6,3,30,12,1,0,13,0,30,5,8,0,13,2,30,6,0,0,6,1,-15,3,1
2,3,27,1,30,10,5,0,15,5,30,2,0,0,2,0,30,2,13,0,15,2,30,6,9,0,15,3,30,5,1,0,6,1,-15,3,1
2,4,27,1,30,10,5,0,15,5,30,2,0,0,2,0,30,2,13,0,15,2,30,6,9,0,15,3,30,5,1,0,6,1,-15,3,1
2,3,43,0,30,6,8,0,14,9,30,6,0,0,6,0,30,6,8,0,14,1,30,5,9,0,14,5,30,5,0,0,5,1,-15,3,1
2,4,43,0,30,6,8,0,14,9,30,6,0,0,6,0,30,6,8,0,14,1,30,5,9,0,14,5,30,5,0,0,5,1,-15,3,1
2,4,13,1,30,3,0,0,3,1,30,2,0,0,2,0,30,2,1,0,3,4,30,1,2,0,3,2,30,2,0,0,2,1,-15,3,1
2,4,13,1,30,5,2,0,7,1,30,4,0,0,4,0,30,5,2,0,7,5,30,5,2,0,7,0,30,4,0,0,4,1,-15,3,1
2,4,17,4,30,10,4,0,14,2,30,6,0,0,6,0,30,8,6,0,14,0,30,6,8,0,14,3,30,4,0,0,4,1,-15,3,1
2,1,19,0,30,2,11,0,13,2,30,8,0,0,8,0,30,5,8,0,13,7,30,4,9,0,13,3,30,6,3,0,9,1,-15,3,1
2,4,19,0,30,2,11,0,13,2,30,8,0,0,8,0,30,5,8,0,13,7,30,4,9,0,13,3,30,6,3,0,9,1,-15,3,1
2,4,22,1,30,5,3,0,8,2,30,2,0,0,2,0,30,8,0,0,8,1,30,5,3,0,8,2,30,4,0,0,4,1,-15,3,1
2,1,25,1,30,3,11,0,14,2,30,6,0,0,6,0,30,10,4,0,14,1,30,8,6,0,14,5,30,6,0,0,6,1,-15,3,1
2,2,25,1,30,3,11,0,14,2,30,6,0,0,6,0,30,10,4,0,14,1,30,8,6,0,14,5,30,6,0,0,6,1,-15,3,1
2,3,25,1,30,3,11,0,14,2,30,6,0,0,6,0,30,10,4,0,14,1,30,8,6,0,14,5,30,6,0,0,6,1,-15,3,1
2,3,41,0,30,8,4,0,12,4,30,8,0,0,8,0,30,10,2,0,12,0,30,3,9,0,12,3,30,2,5,0,7,1,-15,3,1
2,4,41,0,30,8,4,0,12,4,30,8,0,0,8,0,30,10,2,0,12,0,30,3,9,0,12,3,30,2,5,0,7,1,-15,3,1
2,1,19,0,30,3,10,0,13,2,30,6,2,0,8,0,30,4,9,0,13,3,30,4,9,0,13,3,30,9,0,0,9,1,-15,3,1
2,2,25,1,30,9,5,0,14,2,30,6,0,0,6,0,30,7,7,0,14,1,30,5,9,0,14,0,30,5,1,0,6,1,-15,3,1
2,3,25,1,30,9,5,0,14,2,30,6,0,0,6,0,30,7,7,0,14,1,30,5,9,0,14,0,30,5,1,0,6,1,-15,3,1
2,4,25,1,30,9,5,0,14,2,30,6,0,0,6,0,30,7,7,0,14,1,30,5,9,0,14,0,30,5,1,0,6,1,-15,3,1
2,2,33,1,30,2,9,0,11,5,30,4,0,0,4,2,30,8,3,0,11,0,30,3,8,0,11,6,30,4,0,0,4,1,-15,3,1
2,3,35,0,30,7,6,0,13,4,30,2,0,0,2,1,30,2,11,0,13,1,30,4,9,0,13,7,30,8,0,0,8,1,-15,3,1
2,4,39,0,30,4,7,0,11,6,30,6,0,0,6,0,30,4,7,0,11,0,30,2,9,0,11,6,30,5,0,0,5,1,-15,3,1
2,4,7,0,30,1,3,0,4,2,30,2,0,0,2,2,30,2,2,0,4,0,30,0,4,0,4,1,30,1,1,0,2,0,-27,3,0
2,4,9,0,30,5,6,0,11,2,30,6,0,0,6,1,30,9,2,0,11,6,30,3,8,0,11,0,30,3,1,0,4,0,-27,3,0
2,4,11,0,30,6,6,0,12,0,30,4,0,0,4,0,30,8,4,0,12,2,30,7,5,0,12,5,30,4,0,0,4,1,-15,3,1
2,1,13,3,30,7,0,0,7,1,30,4,0,0,4,2,30,5,2,0,7,5,30,6,1,0,7,7,30,4,0,0,4,1,-15,3,1
2,2,13,3,30,7,0,0,7,1,30,4,0,0,4,2,30,5,2,0,7,5,30,6,1,0,7,7,30,4,0,0,4,1,-15,3,1
2,3,17,3,30,8,6,0,14,2,30,6,0,0,6,0,30,7,7,0,14,2,30,5,9,0,14,0,30,4,0,0,4,1,-15,3,1
2,1,21,3,30,7,3,0,10,3,30,4,2,0,6,0,30,3,7,0,10,5,30,5,5,0,10,7,30,4,0,0,4,1,-15,3,1
2,2,21,3,30,7,3,0,10,3,30,4,2,0,6,0,30,3,7,0,10,5,30,5,5,0,10,7,30,4,0,0,4,1,-15,3,1
2,3,21,3,30,7,3,0,10,3,30,4,2,0,6,0,30,3,7,0,10,5,30,5,5,0,10,7,30,4,0,0,4,1,-15,3,1
2,3,23,1,30,5,8,0,13,3,30,6,0,0,6,3,30,10,3,0,13,1,30,5,8,0,13,4,30,6,0,0,6,1,-15,3,1
2,1,27,1,30,5,10,0,15,5,30,2,0,0,2,0,30,7,8,0,15,3,30,7,8,0,15,4,30,6,0,0,6,1,-15,3,1
2,3,27,0,30,5,10,0,15,5,30,2,0,0,2,0,30,7,8,0,15,3,30,7,8,0,15,4,30,6,0,0,6,1,-15,3,1
2,4,27,0,30,5,10,0,15,5,30,2,0,0,2,0,30,7,8,0,15,3,30,7,8,0,15,4,30,6,0,0,6,1,-15,3,1
2,4,30,5,30,4,1,0,5,5,30,2,0,0,2,1,30,2,3,0,5,3,30,1,4,0,5,0,30,2,1,0,3,1,-15,3,1
2,3,6,0,30,5,4,0,9,4,30,2,0,0,2,0,30,2,7,0,9,0,30,5,4,0,9,0,30,4,1,0,5,0,-27,3,0
2,4,6,0,30,5,4,0,9,4,30,2,0,0,2,0,30,2,7,0,9,0,30,5,4,0,9,0,30,4,1,0,5,0,-27,3,0
2,4,11,1,30,4,8,0,12,0,30,4,0,0,4,1,30,8,4,0,12,4,30,5,7,0,12,4,30,4,0,0,4,1,-15,3,1
2,1,13,2,30,7,0,0,7,0,30,4,0,0,4,2,30,7,0,0,7,8,30,5,2,0,7,6,30,4,0,0,4,1,-15,3,1
2,2,13,2,30,7,0,0,7,0,30,4,0,0,4,2,30,7,0,0,7,8,30,5,2,0,7,6,30,4,0,0,4,1,-15,3,1
2,4,13,2,30,7,0,0,7,0,30,4,0,0,4,2,30,7,0,0,7,8,30,5,2,0,7,6,30,4,0,0,4,1,-15,3,1
2,2,17,2,30,9,5,0,14,2,30,6,0,0,6,0,30,6,8,0,14,4,30,4,10,0,14,5,30,4,0,0,4,1,-15,3,1
2,4,17,2,30,9,5,0,14,2,30,6,0,0,6,0,30,6,8,0,14,4,30,4,10,0,14,5,30,4,0,0,4,1,-15,3,1
2,1,19,0,30,2,11,0,13,3,30,3,5,0,8,0,30,4,9,0,13,2,30,5,8,0,13,3,30,9,0,0,9,1,-15,3,1
2,2,19,0,30,2,11,0,13,3,30,3,5,0,8,0,30,4,9,0,13,2,30,5,8,0,13,3,30,9,0,0,9,1,-15,3,1
2,2,25,3,30,4,10,0,14,3,30,6,0,0,6,0,30,10,4,0,14,1,30,7,7,0,14,3,30,5,1,0,6,1,-15,3,1
2,1,27,1,30,4,11,0,15,1,30,1,1,0,2,0,30,6,9,0,15,0,30,5,10,0,15,4,30,6,0,0,6,1,-15,3,1
2,4,27,1,30,4,11,0,15,1,30,1,1,0,2,0,30,6,9,0,15,0,30,5,10,0,15,4,30,6,0,0,6,1,-15,3,1
2,4,11,0,30,4,8,0,12,0,30,4,0,0,4,0,30,7,5,0,12,5,30,6,6,0,12,5,30,4,0,0,4,1,-15,3,1
2,2,13,2,30,6,1,0,7,0,30,4,0,0,4,2,30,6,1,0,7,7,30,5,2,0,7,0,30,4,0,0,4,1,-15,3,1
2,3,17,3,30,9,5,0,14,3,30,6,0,0,6,0,30,5,9,0,14,1,30,7,7,0,14,5,30,4,0,0,4,1,-15,3,1
2,4,17,3,30,9,5,0,14,3,30,6,0,0,6,0,30,5,9,0,14,1,30,7,7,0,14,5,30,4,0,0,4,1,-15,3,1
2,4,19,0,30,4,9,0,13,2,30,7,1,0,8,0,30,4,9,0,13,4,30,5,8,0,13,1,30,8,1,0,9,1,-15,3,1
2,2,27,1,30,5,10,0,15,3,30,2,0,0,2,0,30,2,13,0,15,0,30,6,9,0,15,5,30,6,0,0,6,1,-15,3,1
2,3,27,1,30,5,10,0,15,3,30,2,0,0,2,0,30,2,13,0,15,0,30,6,9,0,15,5,30,6,0,0,6,1,-15,3,1
2,4,27,1,30,5,10,0,15,3,30,2,0,0,2,0,30,2,13,0,15,0,30,6,9,0,15,5,30,6,0,0,6,1,-15,3,1
2,4,1,0,30,7,3,0,10,5,30,2,0,0,2,1,30,3,7,0,10,4,30,10,0,0,10,5,30,6,0,0,6,0,-27,3,0
2,2,5,4,30,2,3,0,5,3,30,0,4,0,4,0,30,1,4,0,5,0,30,1,4,0,5,1,30,0,2,0,2,0,-27,3,0
2,3,5,4,30,2,3,0,5,3,30,0,4,0,4,0,30,1,4,0,5,0,30,1,4,0,5,1,30,0,2,0,2,0,-27,3,0
2,3,7,0,30,2,2,0,4,2,30,2,0,0,2,1,30,3,1,0,4,0,30,2,2,0,4,1,30,2,0,0,2,0,-27,3,0
2,4,7,0,30,2,2,0,4,2,30,2,0,0,2,1,30,3,1,0,4,0,30,2,2,0,4,1,30,2,0,0,2,0,-27,3,0
2,1,13,2,30,7,0,0,7,0,30,4,0,0,4,1,30,5,2,0,7,11,30,4,3,0,7,4,30,4,0,0,4,1,-15,3,1
2,4,13,2,30,7,0,0,7,0,30,4,0,0,4,0,30,5,2,0,7,11,30,4,3,0,7,4,30,4,0,0,4,1,-15,3,1
2,1,19,0,30,3,10,0,13,2,30,3,5,0,8,0,30,5,8,0,13,0,30,8,5,0,13,0,30,8,1,0,9,1,-15,3,1
2,2,19,0,30,3,10,0,13,2,30,3,5,0,8,0,30,5,8,0,13,0,30,8,5,0,13,0,30,8,1,0,9,1,-15,3,1
2,4,19,0,30,3,10,0,13,2,30,3,5,0,8,0,30,5,8,0,13,0,30,8,5,0,13,0,30,8,1,0,9,1,-15,3,1
2,2,25,1,30,6,8,0,14,1,30,6,0,0,6,3,30,10,4,0,14,1,30,4,10,0,14,3,30,5,1,0,6,1,-15,3,1
2,3,27,1,30,4,11,0,15,4,30,2,0,0,2,0,30,6,9,0,15,0,30,5,10,0,15,2,30,6,0,0,6,1,-15,3,1
2,1,33,1,30,5,6,0,11,5,30,4,0,0,4,1,30,9,2,0,11,1,30,5,6,0,11,7,30,4,0,0,4,1,-15,3,1
2,2,33,1,30,5,6,0,11,5,30,4,0,0,4,1,30,9,2,0,11,1,30,5,6,0,11,7,30,4,0,0,4,1,-15,3,1
2,3,33,1,30,5,6,0,11,5,30,4,0,0,4,1,30,9,2,0,11,1,30,5,6,0,11,7,30,4,0,0,4,1,-15,3,1
2,2,4,2,30,6,2,0,8,4,30,4,0,0,4,4,30,2,6,0,8,0,30,2,6,0,8,1,30,3,1,0,4,0,-27,3,0
2,1,5,0,30,0,5,0,5,2,30,2,2,0,4,0,30,2,3,0,5,0,30,1,4,0,5,1,30,0,2,0,2,0,-27,3,0
2,4,5,0,30,0,5,0,5,2,30,2,2,0,4,0,30,2,3,0,5,0,30,1,4,0,5,1,30,0,2,0,2,0,-27,3,0
2,4,6,0,30,7,2,0,9,4,30,2,0,0,2,1,30,2,7,0,9,0,30,5,4,0,9,4,30,5,0,0,5,0,-27,3,0
2,1,13,1,30,7,0,0,7,0,30,4,0,0,4,2,30,7,0,0,7,4,30,7,0,0,7,1,30,4,0,0,4,1,-15,3,1
2,2,13,1,30,7,0,0,7,0,30,4,0,0,4,2,30,7,0,0,7,4,30,7,0,0,7,1,30,4,0,0,4,1,-15,3,1
2,3,13,1,30,7,0,0,7,0,30,4,0,0,4,2,30,7,0,0,7,4,30,7,0,0,7,1,30,4,0,0,4,1,-15,3,1
2,4,15,0,30,7,6,0,13,0,30,5,1,0,6,0,30,3,10,0,13,1,30,3,10,0,13,2,30,9,0,0,9,1,-15,3,1
2,2,17,1,30,9,5,0,14,2,30,6,0,0,6,0,30,3,11,0,14,0,30,4,10,0,14,4,30,4,0,0,4,1,-15,3,1
2,3,17,1,30,9,5,0,14,2,30,6,0,0,6,0,30,3,11,0,14,0,30,4,10,0,14,4,30,4,0,0,4,1,-15,3,1
2,4,17,1,30,9,5,0,14,2,30,6,0,0,6,0,30,3,11,0,14,0,30,4,10,0,14,4,30,4,0,0,4,1,-15,3,1
2,3,19,0,30,7,6,0,13,1,30,7,1,0,8,0,30,6,7,0,13,4,30,4,9,0,13,0,30,8,1,0,9,1,-15,3,1
2,4,19,0,30,7,6,0,13,1,30,7,1,0,8,0,30,6,7,0,13,4,30,4,9,0,13,0,30,8,1,0,9,1,-15,3,1
2,4,23,1,30,7,6,0,13,2,30,6,0,0,6,7,30,12,1,0,13,0,30,4,9,0,13,2,30,5,1,0,6,1,-15,3,1
2,3,25,0,30,4,10,0,14,3,30,6,0,0,6,0,30,10,4,0,14,1,30,5,9,0,14,5,30,5,1,0,6,1,-15,3,1
2,1,4,2,30,7,1,0,8,5,30,3,1,0,4,0,30,2,6,0,8,0,30,6,2,0,8,4,30,4,0,0,4,0,-27,3,0
2,2,13,4,30,6,1,0,7,2,30,4,0,0,4,3,30,6,1,0,7,8,30,7,0,0,7,3,30,4,0,0,4,1,-15,3,1
2,4,15,1,30,5,8,0,13,0,30,6,0,0,6,0,30,3,10,0,13,1,30,4,9,0,13,0,30,6,3,0,9,1,-15,3,1
2,1,17,3,30,9,5,0,14,3,30,6,0,0,6,0,30,6,8,0,14,1,30,7,7,0,14,0,30,3,1,0,4,1,-15,3,1
2,1,19,0,30,4,9,0,13,0,30,8,0,0,8,0,30,8,5,0,13,0,30,4,9,0,13,2,30,9,0,0,9,1,-15,3,1
2,2,19,0,30,4,9,0,13,0,30,8,0,0,8,0,30,8,5,0,13,0,30,4,9,0,13,2,30,9,0,0,9,1,-15,3,1
2,4,19,0,30,4,9,0,13,0,30,8,0,0,8,0,30,8,5,0,13,0,30,4,9,0,13,2,30,9,0,0,9,1,-15,3,1
2,3,23,2,30,6,7,0,13,2,30,6,0,0,6,1,30,12,1,0,13,0,30,5,8,0,13,2,30,6,0,0,6,1,-15,3,1
2,4,23,2,30,6,7,0,13,2,30,6,0,0,6,1,30,12,1,0,13,0,30,5,8,0,13,2,30,6,0,0,6,1,-15,3,1
2,4,25,1,30,4,10,0,14,5,30,6,0,0,6,0,30,7,7,0,14,1,30,7,7,0,14,3,30,5,1,0,6,1,-15,3,1
2,2,35,0,30,7,6,0,13,4,30,2,0,0,2,1,30,9,4,0,13,0,30,3,10,0,13,5,30,8,0,0,8,1,-15,3,1
2,3,35,0,30,7,6,0,13,4,30,2,0,0,2,1,30,9,4,0,13,0,30,3,10,0,13,5,30,8,0,0,8,1,-15,3,1
2,4,35,0,30,7,6,0,13,4,30,2,0,0,2,1,30,9,4,0,13,0,30,3,10,0,13,5,30,8,0,0,8,1,-15,3,1
2,3,43,0,30,6,8,0,14,7,30,6,0,0,6,1,30,5,9,0,14,1,30,1,13,0,14,6,30,5,0,0,5,1,-15,3,1
2,1,13,2,30,6,1,0,7,0,30,4,0,0,4,2,30,6,1,0,7,7,30,2,5,0,7,3,30,4,0,0,4,1,-15,3,1
2,4,19,0,30,6,7,0,13,1,30,6,2,0,8,0,30,8,5,0,13,4,30,4,9,0,13,1,30,8,1,0,9,1,-15,3,1
2,2,27,1,30,5,10,0,15,4,30,1,1,0,2,0,30,5,10,0,15,0,30,5,10,0,15,5,30,6,0,0,6,1,-15,3,1
2,4,27,1,30,5,10,0,15,4,30,1,1,0,2,0,30,5,10,0,15,0,30,5,10,0,15,5,30,6,0,0,6,1,-15,3,1
2,3,29,0,30,3,11,0,14,5,30,11,1,0,12,0,30,5,9,0,14,0,30,0,14,0,14,2,30,9,0,0,9,1,-15,3,1
2,1,17,4,30,11,3,0,14,3,30,6,0,0,6,0,30,5,9,0,14,2,30,6,8,0,14,4,30,4,0,0,4,1,-15,3,1
2,3,17,1,30,11,3,0,14,3,30,6,0,0,6,0,30,5,9,0,14,2,30,6,8,0,14,4,30,4,0,0,4,1,-15,3,1
2,4,19,0,30,4,9,0,13,0,30,6,2,0,8,0,30,4,9,0,13,0,30,4,9,0,13,0,30,9,0,0,9,1,-15,3,1
2,3,23,2,30,4,9,0,13,1,30,6,0,0,6,1,30,12,1,0,13,0,30,7,6,0,13,3,30,6,0,0,6,1,-15,3,1
2,3,25,1,30,4,10,0,14,5,30,6,0,0,6,0,30,5,9,0,14,1,30,7,7,0,14,4,30,5,1,0,6,1,-15,3,1
2,3,27,1,30,9,6,0,15,1,30,2,0,0,2,0,30,7,8,0,15,0,30,3,12,0,15,0,30,5,1,0,6,1,-15,3,1
2,4,27,1,30,9,6,0,15,1,30,2,0,0,2,0,30,7,8,0,15,0,30,3,12,0,15,0,30,5,1,0,6,1,-15,3,1
2,4,8,0,30,7,0,0,7,4,30,2,0,0,2,3,30,2,5,0,7,3,30,6,1,0,7,4,30,3,0,0,3,0,-27,3,0
2,2,11,2,30,7,5,0,12,1,30,4,0,0,4,0,30,5,7,0,12,3,30,5,7,0,12,6,30,4,0,0,4,1,-15,3,1
2,4,13,1,30,7,0,0,7,0,30,4,0,0,4,2,30,6,1,0,7,10,30,6,1,0,7,3,30,4,0,0,4,1,-15,3,1
2,2,15,0,30,5,8,0,13,1,30,5,1,0,6,0,30,3,10,0,13,1,30,6,7,0,13,2,30,8,1,0,9,1,-15,3,1
2,3,15,0,30,5,8,0,13,1,30,5,1,0,6,0,30,3,10,0,13,1,30,6,7,0,13,2,30,8,1,0,9,1,-15,3,1
2,3,17,3,30,9,5,0,14,1,30,6,0,0,6,0,30,6,8,0,14,1,30,4,10,0,14,2,30,4,0,0,4,1,-15,3,1
2,4,17,3,30,9,5,0,14,1,30,6,0,0,6,0,30,6,8,0,14,1,30,4,10,0,14,2,30,4,0,0,4,1,-15,3,1
2,2,19,0,30,3,10,0,13,2,30,7,1,0,8,0,30,5,8,0,13,2,30,5,8,0,13,4,30,8,1,0,9,1,-15,3,1
2,0,21,3,30,6,4,0,10,4,30,4,2,0,6,0,30,3,7,0,10,3,30,5,5,0,10,4,30,4,0,0,4,1,-15,3,1
2,2,21,3,30,6,4,0,10,4,30,4,2,0,6,0,30,3,7,0,10,3,30,5,5,0,10,4,30,4,0,0,4,1,-15,3,1
2,4,21,3,30,6,4,0,10,4,30,4,2,0,6,0,30,3,7,0,10,3,30,5,5,0,10,4,30,4,0,0,4,1,-15,3,1
2,0,27,1,30,4,11,0,15,1,30,1,1,0,2,0,30,5,10,0,15,5,30,6,9,0,15,5,30,6,0,0,6,1,-15,3,1
2,3,27,1,30,4,11,0,15,0,30,1,1,0,2,0,30,5,10,0,15,5,30,6,9,0,15,5,30,6,0,0,6,1,-15,3,1
2,3,31,3,30,8,4,0,12,6,30,8,0,0,8,3,30,4,8,0,12,0,30,5,7,0,12,0,30,5,1,0,6,1,-15,3,1
2,0,13,1,30,5,2,0,7,1,30,4,0,0,4,2,30,5,2,0,7,8,30,7,0,0,7,6,30,4,0,0,4,1,-15,3,1
2,2,13,1,30,5,2,0,7,1,30,4,0,0,4,2,30,5,2,0,7,8,30,7,0,0,7,6,30,4,0,0,4,1,-15,3,1
2,4,13,1,30,5,2,0,7,1,30,4,0,0,4,2,30,5,2,0,7,8,30,7,0,0,7,6,30,4,0,0,4,1,-15,3,1
2,2,17,3,30,9,5,0,14,3,30,6,0,0,6,0,30,4,10,0,14,1,30,6,8,0,14,2,30,4,0,0,4,1,-15,3,1
2,4,19,0,30,4,9,0,13,2,30,6,2,0,8,4,30,5,8,0,13,1,30,7,6,0,13,0,30,7,2,0,9,1,-15,3,1
2,3,25,2,30,9,5,0,14,5,30,6,0,0,6,0,30,7,7,0,14,0,30,4,10,0,14,5,30,5,1,0,6,1,-15,3,1
2,1,27,1,30,2,13,0,15,3,30,1,1,0,2,0,30,10,5,0,15,0,30,7,8,0,15,1,30,2,4,0,6,1,-15,3,1
2,3,27,1,30,2,13,0,15,3,30,1,1,0,2,0,30,10,5,0,15,0,30,7,8,0,15,1,30,2,4,0,6,1,-15,3,1
2,3,29,0,30,6,8,0,14,6,30,8,4,0,12,1,30,6,8,0,14,0,30,0,14,0,14,3,30,9,0,0,9,1,-15,3,1
2,1,31,1,30,7,5,0,12,5,30,8,0,0,8,3,30,7,5,0,12,0,30,5,7,0,12,1,30,6,0,0,6,1,-15,3,1
2,2,31,1,30,7,5,0,12,5,30,8,0,0,8,3,30,7,5,0,12,0,30,5,7,0,12,1,30,6,0,0,6,1,-15,3,1
2,2,39,0,30,3,8,0,11,5,30,6,0,0,6,0,30,9,2,0,11,1,30,3,8,0,11,3,30,5,0,0,5,1,-15,3,1
2,4,39,0,30,3,8,0,11,5,30,6,0,0,6,0,30,9,2,0,11,1,30,3,8,0,11,3,30,5,0,0,5,1,-15,3,1
2,4,3,0,30,0,4,0,4,2,30,4,0,0,4,0,30,1,3,0,4,0,30,2,2,0,4,0,30,2,1,0,3,0,-27,3,0
2,2,4,2,30,6,2,0,8,4,30,4,0,0,4,1,30,3,5,0,8,0,30,5,3,0,8,3,30,4,0,0,4,0,-27,3,0
2,2,13,2,30,6,1,0,7,0,30,4,0,0,4,2,30,5,2,0,7,4,30,4,3,0,7,2,30,4,0,0,4,1,-15,3,1
2,4,15,1,30,4,9,0,13,1,30,6,0,0,6,0,30,7,6,0,13,0,30,7,6,0,13,2,30,9,0,0,9,1,-15,3,1
2,3,23,1,30,6,7,0,13,3,30,6,0,0,6,7,30,12,1,0,13,0,30,5,8,0,13,2,30,5,1,0,6,1,-15,3,1
2,2,25,4,30,2,12,0,14,5,30,5,1,0,6,0,30,9,5,0,14,1,30,10,4,0,14,4,30,5,1,0,6,1,-15,3,1
2,3,25,4,30,2,12,0,14,5,30,5,1,0,6,0,30,9,5,0,14,1,30,10,4,0,14,4,30,5,1,0,6,1,-15,3,1
2,4,43,3,30,6,8,0,14,9,30,6,0,0,6,0,30,4,10,0,14,1,30,5,9,0,14,1,30,5,0,0,5,1,-15,3,1
2,0,45,0,30,7,6,0,13,8,30,10,0,0,10,0,30,2,11,0,13,0,30,4,9,0,13,7,30,5,0,0,5,1,-15,3,1
2,2,45,0,30,7,6,0,13,8,30,10,0,0,10,0,30,2,11,0,13,0,30,4,9,0,13,7,30,5,0,0,5,1,-15,3,1
2,3,45,0,30,7,6,0,13,8,30,10,0,0,10,0,30,2,11,0,13,0,30,4,9,0,13,7,30,5,0,0,5,1,-15,3,1
2,3,1,0,30,7,3,0,10,4,30,2,0,0,2,1,30,4,6,0,10,5,30,5,5,0,10,6,30,6,0,0,6,0,-27,3,0
2,3,17,7,30,8,6,0,14,4,30,6,0,0,6,0,30,4,10,0,14,1,30,8,6,0,14,0,30,2,2,0,4,1,-15,3,1
2,1,19,2,30,8,5,0,13,1,30,7,1,0,8,6,30,10,3,0,13,0,30,3,10,0,13,1,30,5,4,0,9,1,-15,3,1
2,3,19,2,30,8,5,0,13,1,30,7,1,0,8,6,30,10,3,0,13,0,30,3,10,0,13,0,30,5,4,0,9,1,-15,3,1
2,4,19,2,30,8,5,0,13,1,30,7,1,0,8,6,30,10,3,0,13,0,30,3,10,0,13,0,30,5,4,0,9,1,-15,3,1
2,2,27,0,30,5,10,0,15,3,30,1,1,0,2,0,30,1,14,0,15,5,30,5,10,0,15,8,30,6,0,0,6,1,-15,3,1
2,3,27,0,30,5,10,0,15,3,30,1,1,0,2,0,30,1,14,0,15,5,30,5,10,0,15,8,30,6,0,0,6,1,-15,3,1
2,1,29,0,30,7,7,0,14,5,30,12,0,0,12,0,30,3,11,0,14,0,30,1,13,0,14,2,30,7,2,0,9,1,-15,3,1
2,2,29,0,30,7,7,0,14,5,30,12,0,0,12,0,30,3,11,0,14,0,30,1,13,0,14,2,30,7,2,0,9,1,-15,3,1
2,1,4,2,30,7,1,0,8,5,30,4,0,0,4,0,30,2,6,0,8,0,30,7,1,0,8,2,30,3,1,0,4,0,-27,3,0
2,4,4,2,30,7,1,0,8,5,30,4,0,0,4,0,30,2,6,0,8,0,30,7,1,0,8,2,30,3,1,0,4,0,-27,3,0
2,4,19,1,30,5,8,0,13,1,30,7,1,0,8,0,30,12,1,0,13,0,30,4,9,0,13,0,30,8,1,0,9,1,-15,3,1
2,3,25,1,30,8,6,0,14,1,30,6,0,0,6,0,30,8,6,0,14,1,30,5,9,0,14,4,30,5,1,0,6,1,-15,3,1
2,2,27,1,30,4,11,0,15,3,30,1,1,0,2,0,30,9,6,0,15,3,30,6,9,0,15,3,30,6,0,0,6,1,-15,3,1
2,3,43,0,30,5,9,0,14,7,30,6,0,0,6,0,30,4,10,0,14,1,30,3,11,0,14,7,30,5,0,0,5,1,-15,3,1
2,4,4,2,30,4,4,0,8,5,30,4,0,0,4,0,30,2,6,0,8,0,30,7,1,0,8,2,30,4,0,0,4,0,-27,3,0
2,4,8,2,30,7,0,0,7,4,30,2,0,0,2,3,30,2,5,0,7,0,30,5,2,0,7,0,30,3,0,0,3,0,-27,3,0
2,1,17,2,30,8,6,0,14,2,30,6,0,0,6,0,30,7,7,0,14,1,30,5,9,0,14,6,30,4,0,0,4,1,-15,3,1
2,3,17,2,30,8,6,0,14,2,30,6,0,0,6,0,30,7,7,0,14,1,30,5,9,0,14,6,30,4,0,0,4,1,-15,3,1
2,4,17,2,30,8,6,0,14,2,30,6,0,0,6,0,30,7,7,0,14,1,30,5,9,0,14,6,30,4,0,0,4,1,-15,3,1
2,2,25,1,30,5,9,0,14,1,30,6,0,0,6,1,30,14,0,0,14,1,30,5,9,0,14,4,30,4,2,0,6,1,-15,3,1
2,2,27,3,30,6,9,0,15,2,30,1,1,0,2,0,30,14,1,0,15,0,30,3,12,0,15,2,30,4,2,0,6,1,-15,3,1
2,4,31,3,30,5,7,0,12,6,30,8,0,0,8,9,30,10,2,0,12,0,30,3,9,0,12,2,30,6,0,0,6,1,-15,3,1
2,4,39,0,30,6,5,0,11,7,30,6,0,0,6,0,30,4,7,0,11,0,30,4,7,0,11,4,30,5,0,0,5,1,-15,3,1
2,3,27,3,30,7,8,0,15,2,30,2,0,0,2,0,30,6,9,0,15,0,30,6,9,0,15,0,30,5,1,0,6,1,-15,3,1
2,1,4,2,30,8,0,0,8,5,30,4,0,0,4,3,30,1,7,0,8,0,30,7,1,0,8,2,30,4,0,0,4,0,-27,3,0
2,3,4,2,30,8,0,0,8,5,30,4,0,0,4,3,30,1,7,0,8,0,30,7,1,0,8,2,30,4,0,0,4,0,-27,3,0
2,4,4,2,30,8,0,0,8,5,30,4,0,0,4,3,30,1,7,0,8,0,30,7,1,0,8,2,30,4,0,0,4,0,-27,3,0
2,4,13,1,30,4,3,0,7,0,30,4,0,0,4,8,30,6,1,0,7,9,30,6,1,0,7,0,30,4,0,0,4,1,-15,3,1
2,1,19,0,30,4,9,0,13,2,30,7,1,0,8,0,30,4,9,0,13,9,30,2,11,0,13,1,30,9,0,0,9,1,-15,3,1
2,2,19,0,30,4,9,0,13,2,30,7,1,0,8,0,30,4,9,0,13,9,30,2,11,0,13,1,30,9,0,0,9,1,-15,3,1
2,4,19,0,30,4,9,0,13,2,30,7,1,0,8,0,30,4,9,0,13,9,30,2,11,0,13,1,30,9,0,0,9,1,-15,3,1
2,3,23,1,30,4,9,0,13,2,30,6,0,0,6,5,30,13,0,0,13,0,30,10,3,0,13,1,30,5,1,0,6,1,-15,3,1
2,0,25,1,30,7,7,0,14,4,30,6,0,0,6,0,30,7,7,0,14,1,30,7,7,0,14,5,30,5,1,0,6,1,-15,3,1
2,3,25,1,30,7,7,0,14,4,30,6,0,0,6,0,30,7,7,0,14,1,30,7,7,0,14,4,30,5,1,0,6,1,-15,3,1
2,4,27,1,30,6,9,0,15,2,30,2,0,0,2,0,30,5,10,0,15,1,30,5,10,0,15,2,30,6,0,0,6,1,-15,3,1
2,2,4,2,30,6,2,0,8,4,30,4,0,0,4,2,30,2,6,0,8,0,30,5,3,0,8,1,30,3,1,0,4,0,-27,3,0
2,1,13,5,30,7,0,0,7,0,30,4,0,0,4,1,30,7,0,0,7,4,30,6,1,0,7,5,30,4,0,0,4,1,-15,3,1
2,3,13,5,30,7,0,0,7,0,30,4,0,0,4,1,30,7,0,0,7,4,30,6,1,0,7,5,30,4,0,0,4,1,-15,3,1
2,4,13,5,30,7,0,0,7,0,30,4,0,0,4,1,30,7,0,0,7,4,30,6,1,0,7,5,30,4,0,0,4,1,-15,3,1
2,3,17,0,30,9,5,0,14,2,30,6,0,0,6,0,30,7,7,0,14,5,30,5,9,0,14,3,30,4,0,0,4,1,-15,3,1
2,4,17,0,30,9,5,0,14,2,30,6,0,0,6,0,30,7,7,0,14,5,30,5,9,0,14,3,30,4,0,0,4,1,-15,3,1
2,0,21,2,30,6,4,0,10,3,30,4,2,0,6,0,30,4,6,0,10,5,30,5,5,0,10,5,30,4,0,0,4,1,-15,3,1
2,3,21,2,30,6,4,0,10,3,30,4,2,0,6,0,30,4,6,0,10,5,30,5,5,0,10,5,30,4,0,0,4,1,-15,3,1
2,0,25,1,30,5,9,0,14,5,30,6,0,0,6,2,30,5,9,0,14,1,30,11,3,0,14,6,30,6,0,0,6,1,-15,3,1
2,1,25,1,30,5,9,0,14,5,30,6,0,0,6,2,30,5,9,0,14,1,30,11,3,0,14,6,30,6,0,0,6,1,-15,3,1
2,2,26,3,30,6,3,0,9,6,30,4,0,0,4,2,30,2,7,0,9,0,30,5,4,0,9,6,30,3,0,0,3,1,-15,3,1
2,1,27,2,30,7,8,0,15,3,30,1,1,0,2,1,30,3,12,0,15,0,30,7,8,0,15,0,30,5,1,0,6,1,-15,3,1
2,3,27,2,30,7,8,0,15,3,30,1,1,0,2,1,30,3,12,0,15,0,30,7,8,0,15,0,30,5,1,0,6,1,-15,3,1
2,4,27,2,30,7,8,0,15,3,30,1,1,0,2,1,30,3,12,0,15,0,30,7,8,0,15,0,30,5,1,0,6,1,-15,3,1
2,3,29,1,30,7,7,0,14,6,30,12,0,0,12,0,30,5,9,0,14,0,30,0,14,0,14,0,30,9,0,0,9,1,-15,3,1
2,4,29,1,30,7,7,0,14,6,30,12,0,0,12,0,30,5,9,0,14,0,30,0,14,0,14,0,30,9,0,0,9,1,-15,3,1
2,1,31,2,30,5,7,0,12,4,30,8,0,0,8,3,30,12,0,0,12,3,30,3,9,0,12,1,30,4,2,0,6,1,-15,3,1
2,4,31,2,30,5,7,0,12,4,30,8,0,0,8,3,30,12,0,0,12,3,30,3,9,0,12,1,30,4,2,0,6,1,-15,3,1
2,0,4,2,30,5,3,0,8,4,30,2,2,0,4,3,30,2,6,0,8,1,30,8,0,0,8,2,30,4,0,0,4,0,-27,3,0
2,1,4,2,30,5,3,0,8,4,30,2,2,0,4,3,30,2,6,0,8,1,30,8,0,0,8,2,30,4,0,0,4,0,-27,3,0
2,3,4,2,30,5,3,0,8,4,30,2,2,0,4,3,30,2,6,0,8,1,30,8,0,0,8,2,30,4,0,0,4,0,-27,3,0
2,4,7,1,30,4,5,0,9,2,30,3,1,0,4,0,30,7,2,0,9,8,30,3,6,0,9,1,30,6,0,0,6,0,-27,3,0
2,3,8,2,30,7,0,0,7,5,30,2,0,0,2,3,30,2,5,0,7,1,30,7,0,0,7,0,30,3,0,0,3,0,-27,3,0
2,4,11,1,30,5,7,0,12,0,30,4,0,0,4,0,30,8,4,0,12,3,30,4,8,0,12,0,30,4,0,0,4,1,-15,3,1
2,3,17,6,30,10,4,0,14,3,30,6,0,0,6,0,30,6,8,0,14,1,30,6,8,0,14,1,30,2,2,0,4,1,-15,3,1
2,4,17,6,30,10,4,0,14,3,30,6,0,0,6,0,30,6,8,0,14,1,30,6,8,0,14,1,30,2,2,0,4,1,-15,3,1
2,4,19,0,30,6,7,0,13,1,30,6,2,0,8,0,30,9,4,0,13,3,30,3,10,0,13,1,30,7,2,0,9,1,-15,3,1
2,2,23,1,30,6,7,0,13,3,30,6,0,0,6,3,30,13,0,0,13,0,30,5,8,0,13,4,30,6,0,0,6,1,-15,3,1
2,4,23,1,30,6,7,0,13,3,30,6,0,0,6,3,30,13,0,0,13,0,30,5,8,0,13,4,30,6,0,0,6,1,-15,3,1
2,0,25,1,30,5,9,0,14,5,30,6,0,0,6,0,30,4,10,0,14,2,30,8,6,0,14,7,30,6,0,0,6,1,-15,3,1
2,2,27,2,30,7,8,0,15,4,30,2,0,0,2,0,30,3,12,0,15,3,30,5,10,0,15,3,30,6,0,0,6,1,-15,3,1
2,3,27,2,30,7,8,0,15,4,30,2,0,0,2,0,30,3,12,0,15,3,30,5,10,0,15,3,30,6,0,0,6,1,-15,3,1
2,4,31,2,30,9,3,0,12,4,30,8,0,0,8,3,30,9,3,0,12,0,30,3,9,0,12,0,30,2,4,0,6,1,-15,3,1
2,1,5,0,30,0,5,0,5,2,30,3,1,0,4,0,30,1,4,0,5,0,30,3,2,0,5,1,30,2,0,0,2,0,-27,3,0
2,3,5,0,30,0,5,0,5,2,30,3,1,0,4,0,30,1,4,0,5,0,30,3,2,0,5,1,30,2,0,0,2,0,-27,3,0
2,4,5,0,30,0,5,0,5,2,30,3,1,0,4,0,30,1,4,0,5,0,30,3,2,0,5,1,30,2,0,0,2,0,-27,3,0
2,3,8,4,30,7,0,0,7,4,30,2,0,0,2,2,30,5,2,0,7,2,30,5,2,0,7,1,30,3,0,0,3,0,-27,3,0
2,0,21,4,30,8,2,0,10,4,30,6,0,0,6,1,30,3,7,0,10,2,30,5,5,0,10,4,30,4,0,0,4,1,-15,3,1
2,2,21,4,30,8,2,0,10,4,30,6,0,0,6,1,30,3,7,0,10,2,30,5,5,0,10,4,30,4,0,0,4,1,-15,3,1
2,4,21,4,30,8,2,0,10,4,30,6,0,0,6,0,30,3,7,0,10,2,30,5,5,0,10,4,30,4,0,0,4,1,-15,3,1
2,2,25,1,30,2,12,0,14,5,30,6,0,0,6,0,30,3,11,0,14,2,30,11,3,0,14,3,30,6,0,0,6,1,-15,3,1
2,3,26,0,30,7,2,0,9,5,30,4,0,0,4,4,30,1,8,0,9,0,30,3,6,0,9,5,30,3,0,0,3,1,-15,3,1
2,2,27,0,30,7,8,0,15,4,30,1,1,0,2,0,30,5,10,0,15,3,30,5,10,0,15,2,30,6,0,0,6,1,-15,3,1
2,3,27,0,30,7,8,0,15,4,30,1,1,0,2,0,30,5,10,0,15,3,30,5,10,0,15,2,30,6,0,0,6,1,-15,3,1
2,2,31,3,30,8,4,0,12,4,30,8,0,0,8,5,30,10,2,0,12,0,30,3,9,0,12,0,30,2,4,0,6,1,-15,3,1
2,3,31,3,30,8,4,0,12,4,30,8,0,0,8,5,30,10,2,0,12,0,30,3,9,0,12,0,30,2,4,0,6,1,-15,3,1
2,3,33,1,30,2,9,0,11,5,30,4,0,0,4,0,30,10,1,0,11,0,30,3,8,0,11,4,30,4,0,0,4,1,-15,3,1
2,3,6,1,30,6,3,0,9,4,30,2,0,0,2,0,30,3,6,0,9,0,30,4,5,0,9,0,30,4,1,0,5,0,-27,3,0
2,4,6,1,30,6,3,0,9,4,30,2,0,0,2,0,30,3,6,0,9,0,30,4,5,0,9,0,30,4,1,0,5,0,-27,3,0
2,4,15,0,30,8,5,0,13,1,30,6,0,0,6,0,30,3,10,0,13,1,30,4,9,0,13,2,30,5,4,0,9,1,-15,3,1
2,0,19,0,30,3,10,0,13,2,30,8,0,0,8,0,30,4,9,0,13,0,30,3,10,0,13,1,30,9,0,0,9,1,-15,3,1
2,0,27,1,30,5,10,0,15,5,30,2,0,0,2,0,30,4,11,0,15,2,30,6,9,0,15,4,30,6,0,0,6,1,-15,3,1
2,3,32,0,30,5,4,0,9,4,30,2,0,0,2,0,30,8,1,0,9,1,30,3,6,0,9,4,30,1,1,0,2,1,-15,3,1
2,1,13,3,30,7,0,0,7,0,30,4,0,0,4,1,30,5,2,0,7,11,30,6,1,0,7,4,30,4,0,0,4,1,-15,3,1
2,4,13,3,30,7,0,0,7,0,30,4,0,0,4,1,30,5,2,0,7,11,30,6,1,0,7,4,30,4,0,0,4,1,-15,3,1
2,3,15,0,30,4,9,0,13,1,30,6,0,0,6,0,30,3,10,0,13,1,30,2,11,0,13,2,30,9,0,0,9,1,-15,3,1
2,2,17,2,30,9,5,0,14,3,30,6,0,0,6,0,30,5,9,0,14,1,30,7,7,0,14,2,30,4,0,0,4,1,-15,3,1
2,2,19,0,30,5,8,0,13,2,30,7,1,0,8,0,30,5,8,0,13,6,30,6,7,0,13,1,30,8,1,0,9,1,-15,3,1
2,3,19,0,30,5,8,0,13,2,30,7,1,0,8,0,30,5,8,0,13,6,30,6,7,0,13,1,30,8,1,0,9,1,-15,3,1
2,0,21,4,30,7,3,0,10,4,30,5,1,0,6,1,30,3,7,0,10,4,30,5,5,0,10,0,30,4,0,0,4,1,-15,3,1
2,2,21,4,30,7,3,0,10,4,30,5,1,0,6,1,30,3,7,0,10,4,30,5,5,0,10,0,30,4,0,0,4,1,-15,3,1
2,4,21,4,30,7,3,0,10,4,30,5,1,0,6,1,30,3,7,0,10,4,30,5,5,0,10,0,30,4,0,0,4,1,-15,3,1
2,2,25,1,30,5,9,0,14,4,30,6,0,0,6,0,30,3,11,0,14,3,30,8,6,0,14,7,30,6,0,0,6,1,-15,3,1
2,3,25,1,30,5,9,0,14,4,30,6,0,0,6,0,30,3,11,0,14,3,30,8,6,0,14,7,30,6,0,0,6,1,-15,3,1
2,0,26,1,30,7,2,0,9,5,30,4,0,0,4,5,30,0,9,0,9,0,30,5,4,0,9,8,30,3,0,0,3,1,-15,3,1
2,1,26,1,30,7,2,0,9,5,30,4,0,0,4,5,30,0,9,0,9,0,30,5,4,0,9,8,30,3,0,0,3,1,-15,3,1
2,2,26,1,30,7,2,0,9,5,30,4,0,0,4,5,30,0,9,0,9,0,30,5,4,0,9,8,30,3,0,0,3,1,-15,3,1
2,1,27,1,30,5,10,0,15,3,30,2,0,0,2,0,30,6,9,0,15,2,30,4,11,0,15,1,30,4,2,0,6,1,-15,3,1
2,2,27,1,30,5,10,0,15,3,30,2,0,0,2,0,30,6,9,0,15,2,30,4,11,0,15,1,30,4,2,0,6,1,-15,3,1
2,3,27,1,30,5,10,0,15,3,30,2,0,0,2,0,30,6,9,0,15,2,30,4,11,0,15,1,30,4,2,0,6,1,-15,3,1
2,4,27,1,30,5,10,0,15,3,30,2,0,0,2,0,30,6,9,0,15,2,30,4,11,0,15,1,30,4,2,0,6,1,-15,3,1
2,1,29,0,30,5,9,0,14,6,30,12,0,0,12,0,30,4,10,0,14,0,30,1,13,0,14,2,30,9,0,0,9,1,-15,3,1
2,2,29,0,30,5,9,0,14,6,30,12,0,0,12,0,30,4,10,0,14,0,30,1,13,0,14,2,30,9,0,0,9,1,-15,3,1
2,1,4,0,30,7,1,0,8,4,30,4,0,0,4,1,30,1,7,0,8,0,30,5,3,0,8,3,30,4,0,0,4,0,-27,3,0
2,1,5,0,30,2,3,0,5,2,30,3,1,0,4,0,30,1,4,0,5,0,30,1,4,0,5,2,30,2,0,0,2,0,-27,3,0
2,3,13,2,30,5,2,0,7,1,30,4,0,0,4,0,30,6,1,0,7,4,30,6,1,0,7,3,30,4,0,0,4,1,-15,3,1
2,4,13,2,30,5,2,0,7,1,30,4,0,0,4,0,30,6,1,0,7,4,30,6,1,0,7,3,30,4,0,0,4,1,-15,3,1
2,2,17,4,30,9,5,0,14,3,30,6,0,0,6,0,30,5,9,0,14,0,30,5,9,0,14,4,30,4,0,0,4,1,-15,3,1
2,3,17,4,30,9,5,0,14,3,30,6,0,0,6,0,30,5,9,0,14,0,30,5,9,0,14,4,30,4,0,0,4,1,-15,3,1
2,3,23,1,30,5,8,0,13,1,30,5,1,0,6,8,30,13,0,0,13,0,30,4,9,0,13,3,30,6,0,0,6,1,-15,3,1
2,4,23,1,30,5,8,0,13,1,30,5,1,0,6,8,30,13,0,0,13,0,30,4,9,0,13,3,30,6,0,0,6,1,-15,3,1
2,3,25,1,30,5,9,0,14,3,30,6,0,0,6,0,30,9,5,0,14,1,30,7,7,0,14,5,30,6,0,0,6,1,-15,3,1
2,1,27,1,30,4,11,0,15,4,30,0,2,0,2,0,30,6,9,0,15,4,30,14,1,0,15,2,30,2,4,0,6,1,-15,3,1
2,2,27,1,30,4,11,0,15,4,30,0,2,0,2,0,30,6,9,0,15,4,30,14,1,0,15,2,30,2,4,0,6,1,-15,3,1
2,3,27,1,30,4,11,0,15,4,30,0,2,0,2,0,30,6,9,0,15,4,30,14,1,0,15,2,30,2,4,0,6,1,-15,3,1
2,4,27,1,30,4,11,0,15,4,30,0,2,0,2,0,30,6,9,0,15,4,30,14,1,0,15,2,30,2,4,0,6,1,-15,3,1
2,4,29,0,30,7,7,0,14,6,30,10,2,0,12,0,30,2,12,0,14,0,30,0,14,0,14,2,30,9,0,0,9,1,-15,3,1
2,2,31,3,30,6,6,0,12,3,30,8,0,0,8,0,30,9,3,0,12,0,30,4,8,0,12,0,30,2,4,0,6,1,-15,3,1
2,4,31,3,30,6,6,0,12,3,30,8,0,0,8,0,30,9,3,0,12,0,30,4,8,0,12,0,30,2,4,0,6,1,-15,3,1
2,2,33,1,30,3,8,0,11,4,30,4,0,0,4,1,30,9,2,0,11,7,30,6,5,0,11,5,30,4,0,0,4,1,-15,3,1
2,2,35,0,30,10,3,0,13,5,30,2,0,0,2,1,30,4,9,0,13,0,30,4,9,0,13,6,30,8,0,0,8,1,-15,3,1
2,2,15,0,30,6,7,0,13,0,30,6,0,0,6,0,30,3,10,0,13,1,30,4,9,0,13,1,30,9,0,0,9,1,-15,3,1
2,2,17,3,30,8,6,0,14,4,30,6,0,0,6,0,30,3,11,0,14,1,30,9,5,0,14,3,30,4,0,0,4,1,-15,3,1
2,3,17,3,30,8,6,0,14,4,30,6,0,0,6,0,30,3,11,0,14,1,30,9,5,0,14,3,30,4,0,0,4,1,-15,3,1
2,0,19,1,30,5,8,0,13,1,30,5,3,0,8,5,30,4,9,0,13,0,30,6,7,0,13,1,30,7,2,0,9,1,-15,3,1
2,1,19,1,30,5,8,0,13,1,30,5,3,0,8,5,30,4,9,0,13,0,30,6,7,0,13,1,30,7,2,0,9,1,-15,3,1
2,4,19,1,30,5,8,0,13,1,30,5,3,0,8,5,30,4,9,0,13,0,30,6,7,0,13,1,30,7,2,0,9,1,-15,3,1
2,3,25,1,30,5,9,0,14,5,30,6,0,0,6,0,30,4,10,0,14,1,30,9,5,0,14,8,30,6,0,0,6,1,-15,3,1
2,1,27,1,30,5,10,0,15,2,30,2,0,0,2,0,30,8,7,0,15,0,30,4,11,0,15,1,30,4,2,0,6,1,-15,3,1
2,0,29,0,30,5,9,0,14,6,30,12,0,0,12,0,30,3,11,0,14,0,30,1,13,0,14,2,30,9,0,0,9,1,-15,3,1
2,1,29,0,30,5,9,0,14,6,30,12,0,0,12,0,30,3,11,0,14,0,30,1,13,0,14,2,30,9,0,0,9,1,-15,3,1
2,2,33,1,30,2,9,0,11,5,30,4,0,0,4,3,30,9,2,0,11,3,30,4,7,0,11,6,30,4,0,0,4,1,-15,3,1
2,3,33,1,30,2,9,0,11,5,30,4,0,0,4,3,30,9,2,0,11,3,30,4,7,0,11,6,30,4,0,0,4,1,-15,3,1
2,3,11,1,30,4,8,0,12,1,30,4,0,0,4,0,30,6,6,0,12,3,30,6,6,0,12,5,30,4,0,0,4,1,-15,3,1
2,0,17,5,30,9,5,0,14,4,30,6,0,0,6,0,30,5,9,0,14,2,30,7,7,0,14,1,30,4,0,0,4,1,-15,3,1
2,3,17,0,30,9,5,0,14,3,30,6,0,0,6,0,30,5,9,0,14,2,30,7,7,0,14,1,30,4,0,0,4,1,-15,3,1
2,0,19,1,30,2,11,0,13,3,30,6,2,0,8,2,30,7,6,0,13,4,30,3,10,0,13,2,30,9,0,0,9,1,-15,3,1
2,1,19,1,30,2,11,0,13,3,30,6,2,0,8,2,30,7,6,0,13,4,30,3,10,0,13,2,30,9,0,0,9,1,-15,3,1
2,3,19,1,30,2,11,0,13,3,30,6,2,0,8,2,30,7,6,0,13,4,30,3,10,0,13,2,30,9,0,0,9,1,-15,3,1
2,4,23,1,30,4,9,0,13,3,30,6,0,0,6,7,30,11,2,0,13,0,30,6,7,0,13,4,30,6,0,0,6,1,-15,3,1
2,4,25,0,30,4,10,0,14,5,30,6,0,0,6,0,30,7,7,0,14,1,30,9,5,0,14,1,30,5,1,0,6,1,-15,3,1
2,0,27,1,30,5,10,0,15,4,30,1,1,0,2,0,30,3,12,0,15,4,30,4,11,0,15,6,30,6,0,0,6,1,-15,3,1
2,1,27,1,30,5,10,0,15,4,30,1,1,0,2,0,30,3,12,0,15,4,30,4,11,0,15,6,30,6,0,0,6,1,-15,3,1
2,2,27,1,30,5,10,0,15,4,30,1,1,0,2,0,30,3,12,0,15,4,30,4,11,0,15,6,30,6,0,0,6,1,-15,3,1
2,4,31,0,30,8,4,0,12,5,30,8,0,0,8,3,30,5,7,0,12,0,30,3,9,0,12,0,30,2,4,0,6,1,-15,3,1
2,3,4,2,30,6,2,0,8,4,30,4,0,0,4,0,30,1,7,0,8,0,30,4,4,0,8,1,30,2,2,0,4,0,-27,3,0
2,4,4,2,30,6,2,0,8,4,30,4,0,0,4,0,30,1,7,0,8,0,30,4,4,0,8,1,30,2,2,0,4,0,-27,3,0
2,4,11,2,30,4,8,0,12,0,30,3,1,0,4,0,30,10,2,0,12,5,30,6,6,0,12,0,30,4,0,0,4,1,-15,3,1
2,2,13,0,30,7,0,0,7,0,30,4,0,0,4,3,30,7,0,0,7,8,30,3,4,0,7,2,30,4,0,0,4,1,-15,3,1
2,0,17,6,30,11,3,0,14,4,30,6,0,0,6,0,30,3,11,0,14,1,30,4,10,0,14,5,30,4,0,0,4,1,-15,3,1
2,4,17,0,30,11,3,0,14,2,30,6,0,0,6,0,30,3,11,0,14,1,30,4,10,0,14,5,30,4,0,0,4,1,-15,3,1
2,2,19,0,30,2,11,0,13,1,30,6,2,0,8,0,30,10,3,0,13,4,30,4,9,0,13,1,30,8,1,0,9,1,-15,3,1
2,4,22,2,30,8,0,0,8,2,30,2,0,0,2,0,30,5,3,0,8,1,30,3,5,0,8,2,30,1,3,0,4,1,-15,3,1
2,4,23,0,30,4,9,0,13,3,30,6,0,0,6,9,30,13,0,0,13,0,30,5,8,0,13,3,30,6,0,0,6,1,-15,3,1
2,4,25,1,30,8,6,0,14,4,30,6,0,0,6,0,30,5,9,0,14,1,30,8,6,0,14,5,30,6,0,0,6,1,-15,3,1
2,0,27,1,30,6,9,0,15,4,30,1,1,0,2,0,30,3,12,0,15,2,30,6,9,0,15,2,30,6,0,0,6,1,-15,3,1
2,3,43,0,30,5,9,0,14,8,30,6,0,0,6,0,30,4,10,0,14,1,30,1,13,0,14,6,30,5,0,0,5,1,-15,3,1
2,1,47,0,30,1,13,0,14,6,30,4,0,0,4,0,30,8,6,0,14,0,30,7,7,0,14,8,30,7,0,0,7,1,-15,3,1
2,3,47,0,30,1,13,0,14,6,30,4,0,0,4,0,30,8,6,0,14,0,30,7,7,0,14,8,30,7,0,0,7,1,-15,3,1
2,1,4,3,30,8,0,0,8,4,30,2,2,0,4,1,30,2,6,0,8,0,30,8,0,0,8,6,30,3,1,0,4,0,-27,3,0
2,2,4,3,30,8,0,0,8,4,30,2,2,0,4,1,30,2,6,0,8,0,30,8,0,0,8,6,30,3,1,0,4,0,-27,3,0
2,3,4,3,30,8,0,0,8,4,30,2,2,0,4,1,30,2,6,0,8,0,30,8,0,0,8,6,30,3,1,0,4,0,-27,3,0
2,1,13,3,30,5,2,0,7,0,30,4,0,0,4,1,30,7,0,0,7,4,30,6,1,0,7,5,30,4,0,0,4,1,-15,3,1
2,2,13,3,30,5,2,0,7,0,30,4,0,0,4,1,30,7,0,0,7,4,30,6,1,0,7,5,30,4,0,0,4,1,-15,3,1
2,3,13,3,30,5,2,0,7,0,30,4,0,0,4,1,30,7,0,0,7,4,30,6,1,0,7,5,30,4,0,0,4,1,-15,3,1
2,1,17,3,30,10,4,0,14,1,30,6,0,0,6,0,30,10,4,0,14,2,30,4,10,0,14,5,30,4,0,0,4,1,-15,3,1
2,3,17,3,30,10,4,0,14,1,30,6,0,0,6,0,30,10,4,0,14,2,30,4,10,0,14,5,30,4,0,0,4,1,-15,3,1
2,4,17,3,30,10,4,0,14,1,30,6,0,0,6,0,30,10,4,0,14,2,30,4,10,0,14,5,30,4,0,0,4,1,-15,3,1
2,2,27,1,30,6,9,0,15,1,30,2,0,0,2,1,30,15,0,0,15,0,30,4,11,0,15,1,30,3,3,0,6,1,-15,3,1
2,2,31,4,30,3,9,0,12,6,30,8,0,0,8,3,30,8,4,0,12,3,30,9,3,0,12,2,30,6,0,0,6,1,-15,3,1
2,4,31,4,30,3,9,0,12,6,30,8,0,0,8,0,30,8,4,0,12,3,30,9,3,0,12,2,30,6,0,0,6,1,-15,3,1
2,2,47,0,30,5,9,0,14,8,30,4,0,0,4,0,30,3,11,0,14,0,30,5,9,0,14,4,30,7,0,0,7,1,-15,3,1
2,3,47,0,30,5,9,0,14,8,30,4,0,0,4,0,30,3,11,0,14,0,30,5,9,0,14,4,30,7,0,0,7,1,-15,3,1
2,3,5,0,30,0,5,0,5,2,30,2,2,0,4,0,30,0,5,0,5,0,30,1,4,0,5,3,30,2,0,0,2,0,-27,3,0
2,1,13,2,30,3,0,0,3,1,30,2,0,0,2,0,30,3,0,0,3,7,30,2,1,0,3,4,30,2,0,0,2,1,-15,3,1
2,2,13,2,30,3,0,0,3,1,30,2,0,0,2,0,30,3,0,0,3,7,30,2,1,0,3,4,30,2,0,0,2,1,-15,3,1
2,1,13,3,30,7,0,0,7,0,30,4,0,0,4,2,30,6,1,0,7,8,30,6,1,0,7,8,30,4,0,0,4,1,-15,3,1
2,2,13,3,30,7,0,0,7,0,30,4,0,0,4,2,30,6,1,0,7,8,30,6,1,0,7,8,30,4,0,0,4,1,-15,3,1
2,2,17,2,30,10,4,0,14,3,30,6,0,0,6,0,30,4,10,0,14,1,30,7,7,0,14,7,30,4,0,0,4,1,-15,3,1
2,1,19,0,30,4,9,0,13,3,30,2,6,0,8,0,30,4,9,0,13,7,30,6,7,0,13,4,30,9,0,0,9,1,-15,3,1
2,2,19,0,30,4,9,0,13,3,30,2,6,0,8,0,30,4,9,0,13,7,30,6,7,0,13,4,30,9,0,0,9,1,-15,3,1
2,4,23,4,30,7,6,0,13,1,30,6,0,0,6,3,30,10,3,0,13,0,30,5,8,0,13,0,30,5,1,0,6,1,-15,3,1
2,4,25,2,30,7,7,0,14,4,30,6,0,0,6,0,30,7,7,0,14,1,30,5,9,0,14,3,30,5,1,0,6,1,-15,3,1
2,0,26,1,30,7,2,0,9,5,30,4,0,0,4,3,30,2,7,0,9,0,30,4,5,0,9,6,30,3,0,0,3,1,-15,3,1
2,0,27,1,30,4,11,0,15,3,30,2,0,0,2,0,30,3,12,0,15,2,30,5,10,0,15,6,30,6,0,0,6,1,-15,3,1
2,2,27,1,30,4,11,0,15,3,30,2,0,0,2,0,30,3,12,0,15,2,30,5,10,0,15,6,30,6,0,0,6,1,-15,3,1
2,0,37,0,30,9,2,0,11,5,30,6,2,0,8,0,30,6,5,0,11,7,30,4,7,0,11,7,30,6,0,0,6,1,-15,3,1
2,2,5,3,30,5,0,0,5,4,30,0,4,0,4,0,30,0,5,0,5,0,30,1,4,0,5,0,30,0,2,0,2,0,-27,3,0
2,3,5,3,30,5,0,0,5,4,30,0,4,0,4,0,30,0,5,0,5,0,30,1,4,0,5,0,30,0,2,0,2,0,-27,3,0
2,4,6,0,30,5,4,0,9,3,30,2,0,0,2,1,30,6,3,0,9,0,30,4,5,0,9,0,30,5,0,0,5,0,-27,3,0
2,3,11,3,30,6,6,0,12,1,30,4,0,0,4,0,30,7,5,0,12,5,30,5,7,0,12,4,30,4,0,0,4,1,-15,3,1
2,4,13,1,30,7,0,0,7,0,30,4,0,0,4,2,30,5,2,0,7,12,30,6,1,0,7,3,30,4,0,0,4,1,-15,3,1
2,3,17,4,30,8,6,0,14,3,30,6,0,0,6,0,30,8,6,0,14,3,30,10,4,0,14,2,30,4,0,0,4,1,-15,3,1
2,4,17,4,30,8,6,0,14,3,30,6,0,0,6,0,30,8,6,0,14,3,30,10,4,0,14,2,30,4,0,0,4,1,-15,3,1
2,2,19,0,30,7,6,0,13,1,30,6,2,0,8,0,30,4,9,0,13,4,30,4,9,0,13,0,30,8,1,0,9,1,-15,3,1
2,2,25,4,30,9,5,0,14,4,30,6,0,0,6,1,30,3,11,0,14,1,30,5,9,0,14,3,30,5,1,0,6,1,-15,3,1
2,3,25,4,30,9,5,0,14,4,30,6,0,0,6,1,30,3,11,0,14,1,30,5,9,0,14,3,30,5,1,0,6,1,-15,3,1
2,0,26,0,30,8,1,0,9,4,30,2,2,0,4,4,30,2,7,0,9,0,30,2,7,0,9,5,30,3,0,0,3,1,-15,3,1
2,1,26,0,30,8,1,0,9,4,30,2,2,0,4,4,30,2,7,0,9,0,30,2,7,0,9,5,30,3,0,0,3,1,-15,3,1
2,3,26,0,30,8,1,0,9,4,30,2,2,0,4,4,30,2,7,0,9,0,30,2,7,0,9,5,30,3,0,0,3,1,-15,3,1
2,4,26,0,30,8,1,0,9,4,30,2,2,0,4,4,30,2,7,0,9,0,30,2,7,0,9,5,30,3,0,0,3,1,-15,3,1
2,1,27,2,30,5,10,0,15,4,30,1,1,0,2,0,30,5,10,0,15,4,30,7,8,0,15,2,30,6,0,0,6,1,-15,3,1
2,2,27,2,30,5,10,0,15,4,30,1,1,0,2,0,30,5,10,0,15,4,30,7,8,0,15,2,30,6,0,0,6,1,-15,3,1
2,3,27,2,30,5,10,0,15,4,30,1,1,0,2,0,30,5,10,0,15,4,30,7,8,0,15,2,30,6,0,0,6,1,-15,3,1
2,4,27,2,30,5,10,0,15,4,30,1,1,0,2,0,30,5,10,0,15,4,30,7,8,0,15,2,30,6,0,0,6,1,-15,3,1
2,2,19,1,30,2,11,0,13,2,30,6,2,0,8,0,30,5,8,0,13,7,30,6,7,0,13,1,30,8,1,0,9,1,-15,3,1
2,2,23,2,30,5,8,0,13,2,30,6,0,0,6,6,30,10,3,0,13,3,30,5,8,0,13,0,30,5,1,0,6,1,-15,3,1
2,4,27,1,30,5,10,0,15,4,30,1,1,0,2,0,30,6,9,0,15,1,30,8,7,0,15,0,30,6,0,0,6,1,-15,3,1
2,3,29,0,30,10,4,0,14,5,30,11,1,0,12,0,30,5,9,0,14,0,30,1,13,0,14,0,30,9,0,0,9,1,-15,3,1
2,3,35,0,30,8,5,0,13,7,30,2,0,0,2,5,30,2,11,0,13,0,30,4,9,0,13,5,30,8,0,0,8,1,-15,3,1
2,0,41,0,30,6,6,0,12,6,30,8,0,0,8,0,30,8,4,0,12,2,30,5,7,0,12,4,30,7,0,0,7,1,-15,3,1
2,1,41,0,30,6,6,0,12,6,30,8,0,0,8,0,30,8,4,0,12,2,30,5,7,0,12,4,30,7,0,0,7,1,-15,3,1
2,3,41,0,30,6,6,0,12,6,30,8,0,0,8,0,30,8,4,0,12,2,30,5,7,0,12,4,30,7,0,0,7,1,-15,3,1
2,2,6,0,30,8,1,0,9,4,30,2,0,0,2,0,30,3,6,0,9,0,30,4,5,0,9,1,30,3,2,0,5,0,-27,3,0
2,3,6,0,30,8,1,0,9,4,30,2,0,0,2,0,30,3,6,0,9,0,30,4,5,0,9,1,30,3,2,0,5,0,-27,3,0
2,1,13,3,30,6,1,0,7,0,30,4,0,0,4,2,30,6,1,0,7,5,30,7,0,0,7,5,30,4,0,0,4,1,-15,3,1
2,2,27,4,30,7,8,0,15,2,30,1,1,0,2,0,30,6,9,0,15,0,30,3,12,0,15,0,30,4,2,0,6,1,-15,3,1
2,3,6,0,30,5,4,0,9,4,30,2,0,0,2,0,30,3,6,0,9,0,30,4,5,0,9,2,30,5,0,0,5,0,-27,3,0
2,4,6,0,30,5,4,0,9,4,30,2,0,0,2,0,30,3,6,0,9,0,30,4,5,0,9,2,30,5,0,0,5,0,-27,3,0
2,2,8,2,30,7,0,0,7,5,30,2,0,0,2,0,30,2,5,0,7,1,30,7,0,0,7,3,30,3,0,0,3,0,-27,3,0
2,2,17,0,30,8,6,0,14,3,30,6,0,0,6,0,30,5,9,0,14,5,30,8,6,0,14,5,30,4,0,0,4,1,-15,3,1
2,3,17,0,30,8,6,0,14,3,30,6,0,0,6,0,30,5,9,0,14,5,30,8,6,0,14,5,30,4,0,0,4,1,-15,3,1
2,4,22,4,30,8,0,0,8,4,30,2,0,0,2,0,30,4,4,0,8,1,30,3,5,0,8,2,30,3,1,0,4,1,-15,3,1
2,3,23,1,30,6,7,0,13,2,30,6,0,0,6,2,30,13,0,0,13,0,30,5,8,0,13,3,30,6,0,0,6,1,-15,3,1
2,0,27,1,30,3,12,0,15,5,30,1,1,0,2,0,30,2,13,0,15,1,30,9,6,0,15,3,30,6,0,0,6,1,-15,3,1
2,2,27,1,30,3,12,0,15,5,30,1,1,0,2,0,30,2,13,0,15,0,30,9,6,0,15,3,30,6,0,0,6,1,-15,3,1
2,3,27,1,30,3,12,0,15,5,30,1,1,0,2,0,30,2,13,0,15,0,30,9,6,0,15,3,30,6,0,0,6,1,-15,3,1
2,3,31,1,30,10,2,0,12,3,30,8,0,0,8,3,30,11,1,0,12,0,30,3,9,0,12,1,30,4,2,0,6,1,-15,3,1
2,4,31,1,30,10,2,0,12,3,30,8,0,0,8,3,30,11,1,0,12,0,30,3,9,0,12,1,30,4,2,0,6,1,-15,3,1
2,1,41,0,30,7,5,0,12,6,30,8,0,0,8,0,30,3,9,0,12,0,30,3,9,0,12,6,30,7,0,0,7,1,-15,3,1
2,3,41,0,30,7,5,0,12,6,30,8,0,0,8,0,30,3,9,0,12,0,30,3,9,0,12,6,30,7,0,0,7,1,-15,3,1
2,4,41,0,30,7,5,0,12,6,30,8,0,0,8,0,30,3,9,0,12,0,30,3,9,0,12,6,30,7,0,0,7,1,-15,3,1
2,3,1,0,30,4,6,0,10,4,30,2,0,0,2,3,30,5,5,0,10,5,30,9,1,0,10,6,30,6,0,0,6,0,-27,3,0
2,4,3,1,30,0,4,0,4,2,30,4,0,0,4,0,30,0,4,0,4,0,30,0,4,0,4,0,30,1,2,0,3,0,-27,3,0
2,1,5,1,30,2,3,0,5,3,30,1,3,0,4,0,30,0,5,0,5,0,30,1,4,0,5,3,30,2,0,0,2,0,-27,3,0
2,2,5,1,30,2,3,0,5,3,30,1,3,0,4,0,30,0,5,0,5,0,30,1,4,0,5,3,30,2,0,0,2,0,-27,3,0
2,4,5,1,30,2,3,0,5,3,30,1,3,0,4,0,30,0,5,0,5,0,30,1,4,0,5,3,30,2,0,0,2,0,-27,3,0
2,3,6,0,30,5,4,0,9,4,30,2,0,0,2,0,30,2,7,0,9,1,30,4,5,0,9,1,30,5,0,0,5,0,-27,3,0
2,4,6,0,30,5,4,0,9,4,30,2,0,0,2,0,30,2,7,0,9,1,30,4,5,0,9,1,30,5,0,0,5,0,-27,3,0
2,2,13,1,30,6,1,0,7,0,30,4,0,0,4,6,30,7,0,0,7,6,30,7,0,0,7,8,30,4,0,0,4,1,-15,3,1
2,3,13,1,30,6,1,0,7,0,30,4,0,0,4,6,30,7,0,0,7,6,30,7,0,0,7,8,30,4,0,0,4,1,-15,3,1
2,1,17,4,30,8,6,0,14,5,30,6,0,0,6,0,30,3,11,0,14,1,30,10,4,0,14,7,30,4,0,0,4,1,-15,3,1
2,3,17,4,30,8,6,0,14,5,30,6,0,0,6,0,30,3,11,0,14,1,30,10,4,0,14,7,30,4,0,0,4,1,-15,3,1
2,2,19,1,30,5,8,0,13,2,30,8,0,0,8,0,30,7,6,0,13,0,30,3,10,0,13,1,30,9,0,0,9,1,-15,3,1
2,3,27,1,30,4,11,0,15,4,30,2,0,0,2,0,30,3,12,0,15,2,30,8,7,0,15,5,30,6,0,0,6,1,-15,3,1
2,4,27,1,30,4,11,0,15,4,30,2,0,0,2,0,30,3,12,0,15,2,30,8,7,0,15,5,30,6,0,0,6,1,-15,3,1
2,0,47,0,30,2,12,0,14,9,30,4,0,0,4,0,30,3,11,0,14,2,30,8,6,0,14,0,30,5,2,0,7,1,-15,3,1
2,3,47,0,30,2,12,0,14,9,30,4,0,0,4,0,30,3,11,0,14,2,30,8,6,0,14,0,30,5,2,0,7,1,-15,3,1
2,4,11,0,30,3,1,0,4,1,30,0,0,0,0,0,30,1,3,0,4,3,30,4,0,0,4,1,30,1,0,0,1,1,-15,3,1
2,3,13,8,30,7,0,0,7,0,30,4,0,0,4,1,30,6,1,0,7,5,30,5,2,0,7,4,30,4,0,0,4,1,-15,3,1
2,4,13,8,30,7,0,0,7,0,30,4,0,0,4,1,30,6,1,0,7,5,30,5,2,0,7,4,30,4,0,0,4,1,-15,3,1
2,2,19,0,30,10,3,0,13,1,30,5,3,0,8,1,30,4,9,0,13,0,30,3,10,0,13,0,30,8,1,0,9,1,-15,3,1
2,4,25,1,30,8,6,0,14,4,30,6,0,0,6,0,30,3,11,0,14,0,30,8,6,0,14,4,30,6,0,0,6,1,-15,3,1
2,1,27,1,30,5,10,0,15,5,30,1,1,0,2,0,30,4,11,0,15,3,30,7,8,0,15,2,30,6,0,0,6,1,-15,3,1
2,3,27,1,30,5,10,0,15,5,30,1,1,0,2,0,30,4,11,0,15,3,30,7,8,0,15,2,30,6,0,0,6,1,-15,3,1
2,4,27,1,30,5,10,0,15,5,30,1,1,0,2,0,30,4,11,0,15,3,30,7,8,0,15,2,30,6,0,0,6,1,-15,3,1
2,0,47,2,30,7,7,0,14,7,30,4,0,0,4,0,30,6,8,0,14,0,30,2,12,0,14,7,30,7,0,0,7,1,-15,3,1
2,3,47,2,30,7,7,0,14,7,30,4,0,0,4,0,30,6,8,0,14,0,30,2,12,0,14,7,30,7,0,0,7,1,-15,3,1
2,2,4,2,30,8,0,0,8,4,30,4,0,0,4,1,30,4,4,0,8,0,30,2,6,0,8,3,30,3,1,0,4,0,-27,3,0
2,3,4,2,30,8,0,0,8,4,30,4,0,0,4,1,30,4,4,0,8,0,30,2,6,0,8,3,30,3,1,0,4,0,-27,3,0
2,4,4,2,30,8,0,0,8,4,30,4,0,0,4,1,30,4,4,0,8,0,30,2,6,0,8,3,30,3,1,0,4,0,-27,3,0
2,4,8,2,30,7,0,0,7,5,30,2,0,0,2,0,30,3,4,0,7,0,30,6,1,0,7,1,30,3,0,0,3,0,-27,3,0
2,1,13,1,30,7,0,0,7,0,30,4,0,0,4,2,30,6,1,0,7,5,30,5,2,0,7,7,30,4,0,0,4,1,-15,3,1
2,2,13,1,30,7,0,0,7,0,30,4,0,0,4,2,30,6,1,0,7,5,30,5,2,0,7,7,30,4,0,0,4,1,-15,3,1
2,3,13,1,30,7,0,0,7,0,30,4,0,0,4,2,30,6,1,0,7,5,30,5,2,0,7,7,30,4,0,0,4,1,-15,3,1
2,1,17,3,30,10,4,0,14,2,30,6,0,0,6,0,30,6,8,0,14,2,30,7,7,0,14,0,30,4,0,0,4,1,-15,3,1
2,4,19,0,30,4,9,0,13,0,30,6,2,0,8,0,30,5,8,0,13,0,30,4,9,0,13,1,30,8,1,0,9,1,-15,3,1
2,4,23,1,30,4,9,0,13,3,30,6,0,0,6,5,30,12,1,0,13,3,30,4,9,0,13,1,30,6,0,0,6,1,-15,3,1
2,4,25,1,30,8,6,0,14,1,30,6,0,0,6,0,30,11,3,0,14,1,30,5,9,0,14,3,30,5,1,0,6,1,-15,3,1
2,0,27,1,30,4,11,0,15,3,30,2,0,0,2,0,30,9,6,0,15,0,30,4,11,0,15,3,30,6,0,0,6,1,-15,3,1
2,2,27,1,30,4,11,0,15,3,30,2,0,0,2,0,30,9,6,0,15,0,30,4,11,0,15,0,30,6,0,0,6,1,-15,3,1
2,3,27,1,30,4,11,0,15,3,30,2,0,0,2,0,30,9,6,0,15,0,30,4,11,0,15,0,30,6,0,0,6,1,-15,3,1
2,4,27,1,30,4,11,0,15,3,30,2,0,0,2,0,30,9,6,0,15,0,30,4,11,0,15,0,30,6,0,0,6,1,-15,3,1
2,0,29,0,30,4,10,0,14,6,30,12,0,0,12,0,30,6,8,0,14,0,30,1,13,0,14,5,30,9,0,0,9,1,-15,3,1
2,2,29,0,30,4,10,0,14,6,30,12,0,0,12,0,30,6,8,0,14,0,30,1,13,0,14,5,30,9,0,0,9,1,-15,3,1
2,3,29,0,30,4,10,0,14,6,30,12,0,0,12,0,30,6,8,0,14,0,30,1,13,0,14,5,30,9,0,0,9,1,-15,3,1
2,4,31,3,30,5,7,0,12,4,30,7,1,0,8,0,30,11,1,0,12,0,30,5,7,0,12,1,30,6,0,0,6,1,-15,3,1
2,3,19,0,30,3,10,0,13,1,30,8,0,0,8,0,30,8,5,0,13,0,30,3,10,0,13,2,30,7,2,0,9,1,-15,3,1
2,4,19,0,30,3,10,0,13,1,30,8,0,0,8,0,30,8,5,0,13,0,30,3,10,0,13,2,30,7,2,0,9,1,-15,3,1
2,1,21,2,30,6,4,0,10,4,30,5,1,0,6,1,30,3,7,0,10,3,30,6,4,0,10,3,30,4,0,0,4,1,-15,3,1
2,3,25,1,30,6,8,0,14,4,30,6,0,0,6,0,30,11,3,0,14,1,30,4,10,0,14,1,30,5,1,0,6,1,-15,3,1
2,4,25,1,30,6,8,0,14,4,30,6,0,0,6,0,30,11,3,0,14,1,30,4,10,0,14,1,30,5,1,0,6,1,-15,3,1
2,1,26,0,30,6,3,0,9,5,30,4,0,0,4,2,30,0,9,0,9,0,30,2,7,0,9,4,30,3,0,0,3,1,-15,3,1
2,2,26,0,30,6,3,0,9,5,30,4,0,0,4,2,30,0,9,0,9,0,30,2,7,0,9,4,30,3,0,0,3,1,-15,3,1
2,4,26,0,30,6,3,0,9,5,30,4,0,0,4,2,30,0,9,0,9,0,30,2,7,0,9,4,30,3,0,0,3,1,-15,3,1
2,3,27,1,30,4,11,0,15,1,30,2,0,0,2,0,30,7,8,0,15,1,30,5,10,0,15,3,30,6,0,0,6,1,-15,3,1
2,4,31,4,30,8,4,0,12,5,30,8,0,0,8,6,30,9,3,0,12,0,30,3,9,0,12,0,30,6,0,0,6,1,-15,3,1
2,2,8,2,30,7,0,0,7,5,30,2,0,0,2,4,30,2,5,0,7,1,30,7,0,0,7,0,30,3,0,0,3,0,-27,3,0
2,3,8,2,30,7,0,0,7,5,30,2,0,0,2,4,30,2,5,0,7,1,30,7,0,0,7,0,30,3,0,0,3,0,-27,3,0
2,1,9,2,30,8,3,0,11,3,30,6,0,0,6,1,30,5,6,0,11,1,30,3,8,0,11,4,30,4,0,0,4,0,-27,3,0
2,2,9,2,30,8,3,0,11,3,30,6,0,0,6,1,30,5,6,0,11,1,30,3,8,0,11,4,30,4,0,0,4,0,-27,3,0
2,2,11,3,30,4,8,0,12,0,30,4,0,0,4,0,30,9,3,0,12,3,30,7,5,0,12,4,30,4,0,0,4,1,-15,3,1
2,1,13,3,30,7,0,0,7,0,30,4,0,0,4,2,30,7,0,0,7,5,30,5,2,0,7,1,30,4,0,0,4,1,-15,3,1
2,2,13,3,30,7,0,0,7,0,30,4,0,0,4,2,30,7,0,0,7,5,30,5,2,0,7,1,30,4,0,0,4,1,-15,3,1
2,3,13,3,30,7,0,0,7,0,30,4,0,0,4,2,30,7,0,0,7,5,30,5,2,0,7,1,30,4,0,0,4,1,-15,3,1
2,2,27,4,30,6,9,0,15,0,30,2,0,0,2,0,30,15,0,0,15,0,30,4,11,0,15,0,30,2,4,0,6,1,-15,3,1
2,3,27,4,30,6,9,0,15,0,30,2,0,0,2,0,30,15,0,0,15,0,30,4,11,0,15,0,30,2,4,0,6,1,-15,3,1
2,3,6,0,30,6,3,0,9,3,30,2,0,0,2,1,30,2,7,0,9,0,30,3,6,0,9,1,30,4,1,0,5,0,-27,3,0
2,4,7,0,30,1,3,0,4,2,30,2,0,0,2,0,30,1,3,0,4,0,30,2,2,0,4,3,30,2,0,0,2,0,-27,3,0
2,2,19,0,30,2,11,0,13,1,30,3,5,0,8,0,30,7,6,0,13,9,30,5,8,0,13,1,30,9,0,0,9,1,-15,3,1
2,4,23,2,30,5,8,0,13,4,30,6,0,0,6,8,30,9,4,0,13,0,30,3,10,0,13,2,30,6,0,0,6,1,-15,3,1
2,0,27,1,30,3,12,0,15,2,30,2,0,0,2,0,30,8,7,0,15,2,30,7,8,0,15,2,30,6,0,0,6,1,-15,3,1
2,3,35,0,30,6,7,0,13,6,30,2,0,0,2,1,30,2,11,0,13,4,30,1,12,0,13,6,30,8,0,0,8,1,-15,3,1
2,4,35,0,30,6,7,0,13,6,30,2,0,0,2,1,30,2,11,0,13,4,30,1,12,0,13,6,30,8,0,0,8,1,-15,3,1
2,3,39,0,30,4,7,0,11,6,30,6,0,0,6,0,30,5,6,0,11,0,30,4,7,0,11,4,30,5,0,0,5,1,-15,3,1
2,3,6,1,30,9,0,0,9,4,30,2,0,0,2,0,30,3,6,0,9,0,30,4,5,0,9,1,30,4,1,0,5,0,-27,3,0
2,4,8,1,30,7,0,0,7,4,30,2,0,0,2,0,30,1,6,0,7,2,30,6,1,0,7,2,30,3,0,0,3,0,-27,3,0
2,4,25,0,30,9,5,0,14,1,30,6,0,0,6,0,30,10,4,0,14,0,30,5,9,0,14,3,30,4,2,0,6,1,-15,3,1
2,4,35,1,30,5,8,0,13,2,30,2,0,0,2,1,30,6,7,0,13,2,30,1,12,0,13,0,30,8,0,0,8,1,-15,3,1
2,4,5,0,30,2,3,0,5,3,30,2,2,0,4,2,30,1,4,0,5,0,30,1,4,0,5,0,30,1,1,0,2,0,-27,3,0
2,4,15,1,30,3,10,0,13,1,30,6,0,0,6,0,30,4,9,0,13,1,30,3,10,0,13,0,30,6,3,0,9,1,-15,3,1
2,3,17,3,30,9,5,0,14,2,30,6,0,0,6,0,30,7,7,0,14,2,30,7,7,0,14,5,30,4,0,0,4,1,-15,3,1
2,4,17,3,30,9,5,0,14,2,30,6,0,0,6,0,30,7,7,0,14,2,30,7,7,0,14,5,30,4,0,0,4,1,-15,3,1
2,2,19,2,30,4,9,0,13,2,30,8,0,0,8,0,30,4,9,0,13,0,30,6,7,0,13,1,30,8,1,0,9,1,-15,3,1
2,3,25,1,30,7,7,0,14,3,30,6,0,0,6,0,30,6,8,0,14,1,30,4,10,0,14,4,30,5,1,0,6,1,-15,3,1
2,1,27,1,30,4,11,0,15,1,30,1,1,0,2,0,30,7,8,0,15,3,30,5,10,0,15,4,30,6,0,0,6,1,-15,3,1
2,0,29,0,30,6,8,0,14,6,30,10,2,0,12,0,30,4,10,0,14,0,30,0,14,0,14,5,30,9,0,0,9,1,-15,3,1
2,4,39,0,30,4,7,0,11,7,30,6,0,0,6,0,30,3,8,0,11,0,30,4,7,0,11,6,30,5,0,0,5,1,-15,3,1
2,0,4,2,30,7,1,0,8,5,30,4,0,0,4,0,30,2,6,0,8,1,30,5,3,0,8,4,30,4,0,0,4,0,-27,3,0
2,3,4,2,30,7,1,0,8,5,30,4,0,0,4,0,30,2,6,0,8,1,30,5,3,0,8,4,30,4,0,0,4,0,-27,3,0
2,2,11,2,30,5,7,0,12,0,30,4,0,0,4,0,30,9,3,0,12,5,30,6,6,0,12,6,30,4,0,0,4,1,-15,3,1
2,1,13,2,30,5,2,0,7,0,30,4,0,0,4,3,30,7,0,0,7,11,30,6,1,0,7,5,30,4,0,0,4,1,-15,3,1
2,2,13,2,30,5,2,0,7,0,30,4,0,0,4,3,30,7,0,0,7,11,30,6,1,0,7,5,30,4,0,0,4,1,-15,3,1
2,3,17,0,30,9,5,0,14,2,30,6,0,0,6,0,30,6,8,0,14,1,30,6,8,0,14,3,30,4,0,0,4,1,-15,3,1
2,2,19,1,30,5,8,0,13,0,30,3,5,0,8,0,30,7,6,0,13,7,30,4,9,0,13,0,30,8,1,0,9,1,-15,3,1
2,1,27,1,30,4,11,0,15,3,30,1,1,0,2,0,30,5,10,0,15,4,30,4,11,0,15,0,30,6,0,0,6,1,-15,3,1
2,4,27,1,30,4,11,0,15,3,30,1,1,0,2,0,30,5,10,0,15,4,30,4,11,0,15,0,30,6,0,0,6,1,-15,3,1
2,3,29,0,30,4,10,0,14,6,30,8,4,0,12,0,30,5,9,0,14,0,30,0,14,0,14,0,30,9,0,0,9,1,-15,3,1
2,4,31,0,30,7,5,0,12,3,30,8,0,0,8,4,30,12,0,0,12,0,30,3,9,0,12,0,30,4,2,0,6,1,-15,3,1
2,2,35,0,30,5,8,0,13,2,30,1,1,0,2,6,30,12,1,0,13,2,30,1,12,0,13,4,30,8,0,0,8,1,-15,3,1
2,0,47,0,30,0,14,0,14,6,30,4,0,0,4,0,30,3,11,0,14,0,30,2,12,0,14,5,30,7,0,0,7,1,-15,3,1
2,1,47,0,30,0,14,0,14,6,30,4,0,0,4,0,30,3,11,0,14,0,30,2,12,0,14,5,30,7,0,0,7,1,-15,3,1
2,3,4,2,30,8,0,0,8,5,30,4,0,0,4,0,30,1,7,0,8,0,30,6,2,0,8,0,30,2,2,0,4,0,-27,3,0
2,4,4,2,30,8,0,0,8,5,30,4,0,0,4,0,30,1,7,0,8,0,30,6,2,0,8,0,30,2,2,0,4,0,-27,3,0
2,1,11,1,30,5,7,0,12,0,30,4,0,0,4,0,30,8,4,0,12,6,30,6,6,0,12,5,30,4,0,0,4,1,-15,3,1
2,3,11,1,30,5,7,0,12,0,30,4,0,0,4,0,30,8,4,0,12,6,30,6,6,0,12,5,30,4,0,0,4,1,-15,3,1
2,4,11,1,30,5,7,0,12,0,30,4,0,0,4,0,30,8,4,0,12,6,30,6,6,0,12,5,30,4,0,0,4,1,-15,3,1
2,4,15,1,30,4,9,0,13,1,30,6,0,0,6,0,30,3,10,0,13,1,30,6,7,0,13,1,30,9,0,0,9,1,-15,3,1
2,2,17,4,30,9,5,0,14,2,30,6,0,0,6,0,30,7,7,0,14,1,30,5,9,0,14,1,30,4,0,0,4,1,-15,3,1
2,1,19,0,30,3,10,0,13,2,30,6,2,0,8,0,30,4,9,0,13,1,30,3,10,0,13,1,30,8,1,0,9,1,-15,3,1
2,2,19,0,30,3,10,0,13,2,30,6,2,0,8,0,30,4,9,0,13,1,30,3,10,0,13,1,30,8,1,0,9,1,-15,3,1
2,3,19,0,30,3,10,0,13,2,30,6,2,0,8,0,30,4,9,0,13,1,30,3,10,0,13,1,30,8,1,0,9,1,-15,3,1
2,4,25,2,30,5,9,0,14,2,30,6,0,0,6,0,30,9,5,0,14,1,30,5,9,0,14,4,30,6,0,0,6,1,-15,3,1
2,0,27,3,30,4,11,0,15,3,30,1,1,0,2,0,30,5,10,0,15,1,30,9,6,0,15,2,30,5,1,0,6,1,-15,3,1
2,4,27,3,30,4,11,0,15,3,30,1,1,0,2,0,30,5,10,0,15,1,30,9,6,0,15,0,30,5,1,0,6,1,-15,3,1
2,3,29,0,30,7,7,0,14,6,30,9,3,0,12,0,30,3,11,0,14,0,30,4,10,0,14,1,30,9,0,0,9,1,-15,3,1
2,4,29,0,30,7,7,0,14,6,30,9,3,0,12,0,30,3,11,0,14,0,30,4,10,0,14,1,30,9,0,0,9,1,-15,3,1
2,3,31,2,30,9,3,0,12,4,30,8,0,0,8,5,30,9,3,0,12,0,30,3,9,0,12,0,30,2,4,0,6,1,-15,3,1
2,3,39,0,30,3,8,0,11,6,30,6,0,0,6,6,30,9,2,0,11,1,30,3,8,0,11,6,30,5,0,0,5,1,-15,3,1
2,0,4,3,30,6,2,0,8,5,30,4,0,0,4,0,30,3,5,0,8,0,30,8,0,0,8,1,30,4,0,0,4,0,-27,3,0
2,0,5,0,30,2,3,0,5,3,30,2,2,0,4,1,30,0,5,0,5,0,30,1,4,0,5,0,30,0,2,0,2,0,-27,3,0
2,1,5,0,30,2,3,0,5,3,30,2,2,0,4,1,30,0,5,0,5,0,30,1,4,0,5,0,30,0,2,0,2,0,-27,3,0
2,2,5,0,30,2,3,0,5,3,30,2,2,0,4,1,30,0,5,0,5,0,30,1,4,0,5,0,30,0,2,0,2,0,-27,3,0
2,3,5,0,30,2,3,0,5,3,30,2,2,0,4,1,30,0,5,0,5,0,30,1,4,0,5,0,30,0,2,0,2,0,-27,3,0
2,4,5,0,30,2,3,0,5,3,30,2,2,0,4,1,30,0,5,0,5,0,30,1,4,0,5,0,30,0,2,0,2,0,-27,3,0
2,2,13,3,30,5,2,0,7,1,30,4,0,0,4,2,30,5,2,0,7,10,30,7,0,0,7,5,30,4,0,0,4,1,-15,3,1
2,3,17,7,30,8,6,0,14,3,30,6,0,0,6,0,30,7,7,0,14,1,30,5,9,0,14,1,30,4,0,0,4,1,-15,3,1
2,2,19,0,30,6,7,0,13,2,30,8,0,0,8,0,30,5,8,0,13,5,30,4,9,0,13,0,30,8,1,0,9,1,-15,3,1
2,3,19,0,30,6,7,0,13,2,30,8,0,0,8,0,30,5,8,0,13,5,30,4,9,0,13,0,30,8,1,0,9,1,-15,3,1
2,4,25,2,30,6,8,0,14,4,30,6,0,0,6,0,30,6,8,0,14,1,30,4,10,0,14,4,30,5,1,0,6,1,-15,3,1
2,1,27,3,30,3,12,0,15,1,30,2,0,0,2,0,30,10,5,0,15,0,30,4,11,0,15,1,30,6,0,0,6,1,-15,3,1
2,3,27,3,30,3,12,0,15,1,30,2,0,0,2,0,30,10,5,0,15,0,30,4,11,0,15,1,30,6,0,0,6,1,-15,3,1
2,4,27,3,30,3,12,0,15,1,30,2,0,0,2,0,30,10,5,0,15,0,30,4,11,0,15,1,30,6,0,0,6,1,-15,3,1
2,2,29,0,30,6,8,0,14,6,30,12,0,0,12,0,30,3,11,0,14,0,30,1,13,0,14,5,30,9,0,0,9,1,-15,3,1
2,3,29,0,30,6,8,0,14,6,30,12,0,0,12,0,30,3,11,0,14,0,30,1,13,0,14,5,30,9,0,0,9,1,-15,3,1
2,4,29,0,30,6,8,0,14,6,30,12,0,0,12,0,30,3,11,0,14,0,30,1,13,0,14,5,30,9,0,0,9,1,-15,3,1
2,0,47,0,30,0,14,0,14,5,30,4,0,0,4,0,30,5,9,0,14,1,30,3,11,0,14,8,30,7,0,0,7,1,-15,3,1
2,1,6,0,30,6,3,0,9,4,30,2,0,0,2,0,30,3,6,0,9,0,30,4,5,0,9,4,30,5,0,0,5,0,-27,3,0
2,3,13,0,30,7,0,0,7,1,30,4,0,0,4,2,30,5,2,0,7,3,30,5,2,0,7,4,30,4,0,0,4,1,-15,3,1
2,2,17,3,30,10,4,0,14,3,30,6,0,0,6,0,30,5,9,0,14,1,30,3,11,0,14,1,30,3,1,0,4,1,-15,3,1
2,3,17,3,30,10,4,0,14,3,30,6,0,0,6,0,30,5,9,0,14,1,30,3,11,0,14,1,30,3,1,0,4,1,-15,3,1
2,2,21,1,30,7,3,0,10,3,30,5,1,0,6,1,30,4,6,0,10,1,30,4,6,0,10,1,30,4,0,0,4,1,-15,3,1
2,4,23,1,30,7,6,0,13,2,30,6,0,0,6,7,30,11,2,0,13,0,30,5,8,0,13,2,30,6,0,0,6,1,-15,3,1
2,0,27,1,30,5,10,0,15,3,30,2,0,0,2,0,30,7,8,0,15,0,30,6,9,0,15,3,30,6,0,0,6,1,-15,3,1
2,1,27,1,30,5,10,0,15,3,30,2,0,0,2,0,30,7,8,0,15,0,30,6,9,0,15,3,30,6,0,0,6,1,-15,3,1
2,2,27,1,30,5,10,0,15,3,30,2,0,0,2,0,30,7,8,0,15,0,30,6,9,0,15,3,30,6,0,0,6,1,-15,3,1
2,2,32,0,30,6,3,0,9,3,30,2,0,0,2,0,30,7,2,0,9,10,30,3,6,0,9,2,30,2,0,0,2,1,-15,3,1
2,0,39,0,30,1,10,0,11,6,30,6,0,0,6,0,30,4,7,0,11,0,30,5,6,0,11,5,30,5,0,0,5,1,-15,3,1
2,1,39,0,30,1,10,0,11,6,30,6,0,0,6,0,30,4,7,0,11,0,30,5,6,0,11,5,30,5,0,0,5,1,-15,3,1
2,3,39,0,30,1,10,0,11,6,30,6,0,0,6,0,30,4,7,0,11,0,30,5,6,0,11,5,30,5,0,0,5,1,-15,3,1
2,4,39,0,30,1,10,0,11,6,30,6,0,0,6,0,30,4,7,0,11,0,30,5,6,0,11,5,30,5,0,0,5,1,-15,3,1
2,2,47,0,30,1,13,0,14,5,30,4,0,0,4,0,30,5,9,0,14,2,30,2,12,0,14,6,30,7,0,0,7,1,-15,3,1
2,3,47,0,30,1,13,0,14,5,30,4,0,0,4,0,30,5,9,0,14,2,30,2,12,0,14,6,30,7,0,0,7,1,-15,3,1
2,2,5,0,30,1,4,0,5,3,30,2,2,0,4,0,30,0,5,0,5,0,30,2,3,0,5,1,30,2,0,0,2,0,-27,3,0
2,3,5,0,30,1,4,0,5,3,30,2,2,0,4,0,30,0,5,0,5,0,30,2,3,0,5,1,30,2,0,0,2,0,-27,3,0
2,2,7,3,30,2,7,0,9,3,30,4,0,0,4,2,30,6,3,0,9,4,30,3,6,0,9,1,30,5,1,0,6,0,-27,3,0
2,3,7,3,30,2,7,0,9,3,30,4,0,0,4,2,30,6,3,0,9,4,30,3,6,0,9,1,30,5,1,0,6,0,-27,3,0
2,4,8,5,30,7,0,0,7,3,30,2,0,0,2,3,30,4,3,0,7,1,30,7,0,0,7,1,30,3,0,0,3,0,-27,3,0
2,2,17,3,30,8,6,0,14,3,30,6,0,0,6,0,30,5,9,0,14,2,30,6,8,0,14,5,30,4,0,0,4,1,-15,3,1
2,3,17,3,30,8,6,0,14,3,30,6,0,0,6,0,30,5,9,0,14,2,30,6,8,0,14,5,30,4,0,0,4,1,-15,3,1
2,3,23,2,30,7,6,0,13,0,30,6,0,0,6,3,30,13,0,0,13,0,30,4,9,0,13,1,30,6,0,0,6,1,-15,3,1
2,4,23,2,30,7,6,0,13,0,30,6,0,0,6,3,30,13,0,0,13,0,30,4,9,0,13,1,30,6,0,0,6,1,-15,3,1
2,0,27,1,30,4,11,0,15,3,30,2,0,0,2,0,30,6,9,0,15,1,30,4,11,0,15,3,30,6,0,0,6,1,-15,3,1
2,2,27,1,30,4,11,0,15,3,30,2,0,0,2,0,30,6,9,0,15,1,30,4,11,0,15,3,30,6,0,0,6,1,-15,3,1
2,4,29,0,30,6,8,0,14,6,30,11,1,0,12,0,30,3,11,0,14,0,30,1,13,0,14,2,30,9,0,0,9,1,-15,3,1
2,0,35,1,30,7,6,0,13,4,30,1,1,0,2,4,30,11,2,0,13,0,30,3,10,0,13,5,30,8,0,0,8,1,-15,3,1
2,4,35,1,30,7,6,0,13,4,30,1,1,0,2,3,30,11,2,0,13,0,30,3,10,0,13,2,30,8,0,0,8,1,-15,3,1
2,0,4,0,30,4,4,0,8,4,30,4,0,0,4,2,30,3,5,0,8,4,30,8,0,0,8,4,30,4,0,0,4,0,-27,3,0
2,4,4,0,30,4,4,0,8,4,30,4,0,0,4,1,30,3,5,0,8,4,30,8,0,0,8,4,30,4,0,0,4,0,-27,3,0
2,1,5,0,30,2,3,0,5,3,30,2,2,0,4,0,30,0,5,0,5,0,30,2,3,0,5,1,30,2,0,0,2,0,-27,3,0
2,2,5,0,30,2,3,0,5,3,30,2,2,0,4,0,30,0,5,0,5,0,30,2,3,0,5,1,30,2,0,0,2,0,-27,3,0
2,4,13,2,30,3,0,0,3,1,30,2,0,0,2,0,30,3,0,0,3,12,30,2,1,0,3,2,30,2,0,0,2,1,-15,3,1
2,1,13,2,30,7,0,0,7,0,30,4,0,0,4,6,30,6,1,0,7,9,30,6,1,0,7,4,30,4,0,0,4,1,-15,3,1
2,1,17,2,30,9,5,0,14,4,30,6,0,0,6,0,30,3,11,0,14,5,30,6,8,0,14,5,30,4,0,0,4,1,-15,3,1
2,2,17,2,30,9,5,0,14,4,30,6,0,0,6,0,30,3,11,0,14,5,30,6,8,0,14,5,30,4,0,0,4,1,-15,3,1
2,3,17,2,30,9,5,0,14,4,30,6,0,0,6,0,30,3,11,0,14,5,30,6,8,0,14,5,30,4,0,0,4,1,-15,3,1
2,3,19,0,30,2,11,0,13,3,30,3,5,0,8,6,30,4,9,0,13,1,30,7,6,0,13,2,30,9,0,0,9,1,-15,3,1
2,3,25,1,30,7,7,0,14,3,30,6,0,0,6,0,30,6,8,0,14,2,30,8,6,0,14,6,30,6,0,0,6,1,-15,3,1
2,4,25,1,30,7,7,0,14,3,30,6,0,0,6,0,30,6,8,0,14,2,30,8,6,0,14,6,30,6,0,0,6,1,-15,3,1
2,0,27,1,30,5,10,0,15,4,30,1,1,0,2,0,30,4,11,0,15,2,30,5,10,0,15,5,30,6,0,0,6,1,-15,3,1
2,3,27,0,30,5,10,0,15,4,30,1,1,0,2,0,30,4,11,0,15,2,30,5,10,0,15,5,30,6,0,0,6,1,-15,3,1
2,4,27,0,30,5,10,0,15,4,30,1,1,0,2,0,30,4,11,0,15,2,30,5,10,0,15,5,30,6,0,0,6,1,-15,3,1
2,2,29,0,30,3,11,0,14,5,30,12,0,0,12,0,30,7,7,0,14,0,30,0,14,0,14,2,30,9,0,0,9,1,-15,3,1
2,1,31,1,30,6,6,0,12,5,30,8,0,0,8,6,30,9,3,0,12,0,30,5,7,0,12,2,30,6,0,0,6,1,-15,3,1
2,3,9,0,30,3,1,0,4,2,30,2,0,0,2,4,30,4,0,0,4,3,30,2,2,0,4,3,30,1,0,0,1,0,-27,3,0
2,4,9,0,30,3,1,0,4,2,30,2,0,0,2,4,30,4,0,0,4,3,30,2,2,0,4,3,30,1,0,0,1,0,-27,3,0
2,3,13,4,30,7,0,0,7,0,30,4,0,0,4,2,30,7,0,0,7,3,30,6,1,0,7,5,30,4,0,0,4,1,-15,3,1
2,4,13,4,30,7,0,0,7,0,30,4,0,0,4,2,30,7,0,0,7,3,30,6,1,0,7,5,30,4,0,0,4,1,-15,3,1
2,1,17,2,30,10,4,0,14,3,30,6,0,0,6,0,30,6,8,0,14,4,30,6,8,0,14,6,30,4,0,0,4,1,-15,3,1
2,2,17,2,30,10,4,0,14,3,30,6,0,0,6,0,30,6,8,0,14,4,30,6,8,0,14,6,30,4,0,0,4,1,-15,3,1
2,3,17,2,30,10,4,0,14,3,30,6,0,0,6,0,30,6,8,0,14,4,30,6,8,0,14,6,30,4,0,0,4,1,-15,3,1
2,3,25,1,30,4,10,0,14,5,30,6,0,0,6,0,30,6,8,0,14,2,30,11,3,0,14,1,30,6,0,0,6,1,-15,3,1
2,3,27,2,30,6,9,0,15,2,30,2,0,0,2,0,30,5,10,0,15,0,30,4,11,0,15,1,30,2,4,0,6,1,-15,3,1
2,4,29,0,30,5,9,0,14,6,30,12,0,0,12,1,30,5,9,0,14,0,30,1,13,0,14,0,30,9,0,0,9,1,-15,3,1
2,3,31,3,30,8,4,0,12,4,30,8,0,0,8,3,30,8,4,0,12,0,30,3,9,0,12,2,30,3,3,0,6,1,-15,3,1
2,0,35,0,30,8,5,0,13,5,30,2,0,0,2,4,30,6,7,0,13,0,30,5,8,0,13,6,30,8,0,0,8,1,-15,3,1
2,2,35,0,30,8,5,0,13,5,30,2,0,0,2,4,30,6,7,0,13,0,30,5,8,0,13,6,30,8,0,0,8,1,-15,3,1
2,3,35,0,30,8,5,0,13,5,30,2,0,0,2,4,30,6,7,0,13,0,30,5,8,0,13,6,30,8,0,0,8,1,-15,3,1
2,0,38,0,30,3,7,0,10,6,30,6,0,0,6,0,30,7,3,0,10,0,30,5,5,0,10,7,30,6,0,0,6,1,-15,3,1
2,3,38,0,30,3,7,0,10,6,30,6,0,0,6,0,30,7,3,0,10,0,30,5,5,0,10,7,30,6,0,0,6,1,-15,3,1
2,0,5,0,30,2,3,0,5,3,30,2,2,0,4,0,30,0,5,0,5,0,30,1,4,0,5,1,30,0,2,0,2,0,-27,3,0
2,1,11,3,30,7,5,0,12,1,30,4,0,0,4,0,30,8,4,0,12,7,30,3,9,0,12,4,30,4,0,0,4,1,-15,3,1
2,4,13,1,30,7,0,0,7,0,30,4,0,0,4,2,30,5,2,0,7,6,30,6,1,0,7,4,30,4,0,0,4,1,-15,3,1
2,2,19,1,30,5,8,0,13,2,30,7,1,0,8,4,30,6,7,0,13,4,30,6,7,0,13,0,30,5,4,0,9,1,-15,3,1
2,3,19,1,30,5,8,0,13,2,30,7,1,0,8,4,30,6,7,0,13,4,30,6,7,0,13,0,30,5,4,0,9,1,-15,3,1
2,4,19,1,30,5,8,0,13,2,30,7,1,0,8,4,30,6,7,0,13,4,30,6,7,0,13,0,30,5,4,0,9,1,-15,3,1
2,2,43,2,30,8,6,0,14,7,30,6,0,0,6,0,30,6,8,0,14,1,30,1,13,0,14,6,30,5,0,0,5,1,-15,3,1
2,4,3,0,30,0,4,0,4,2,30,4,0,0,4,0,30,0,4,0,4,3,30,0,4,0,4,0,30,2,1,0,3,0,-27,3,0
2,0,4,2,30,6,2,0,8,5,30,4,0,0,4,1,30,1,7,0,8,0,30,8,0,0,8,2,30,4,0,0,4,0,-27,3,0
2,2,7,2,30,4,0,0,4,3,30,2,0,0,2,0,30,1,3,0,4,0,30,0,4,0,4,1,30,1,1,0,2,0,-27,3,0
2,3,7,2,30,4,0,0,4,3,30,2,0,0,2,0,30,1,3,0,4,0,30,0,4,0,4,1,30,1,1,0,2,0,-27,3,0
2,3,23,2,30,4,9,0,13,2,30,6,0,0,6,5,30,12,1,0,13,0,30,5,8,0,13,1,30,6,0,0,6,1,-15,3,1
2,4,23,2,30,4,9,0,13,2,30,6,0,0,6,5,30,12,1,0,13,0,30,5,8,0,13,1,30,6,0,0,6,1,-15,3,1
2,2,25,0,30,5,9,0,14,4,30,6,0,0,6,0,30,4,10,0,14,1,30,9,5,0,14,9,30,6,0,0,6,1,-15,3,1
2,3,25,0,30,5,9,0,14,4,30,6,0,0,6,0,30,4,10,0,14,1,30,9,5,0,14,9,30,6,0,0,6,1,-15,3,1
2,2,29,0,30,5,9,0,14,6,30,12,0,0,12,0,30,5,9,0,14,0,30,3,11,0,14,2,30,9,0,0,9,1,-15,3,1
2,3,29,0,30,5,9,0,14,6,30,12,0,0,12,0,30,5,9,0,14,0,30,3,11,0,14,2,30,9,0,0,9,1,-15,3,1
2,0,31,1,30,5,7,0,12,6,30,8,0,0,8,3,30,4,8,0,12,8,30,6,6,0,12,1,30,3,3,0,6,1,-15,3,1
2,1,31,1,30,5,7,0,12,6,30,8,0,0,8,3,30,4,8,0,12,8,30,6,6,0,12,1,30,3,3,0,6,1,-15,3,1
2,0,47,0,30,0,14,0,14,7,30,4,0,0,4,0,30,7,7,0,14,0,30,6,8,0,14,10,30,7,0,0,7,1,-15,3,1
2,2,47,0,30,0,14,0,14,7,30,4,0,0,4,0,30,7,7,0,14,0,30,6,8,0,14,10,30,7,0,0,7,1,-15,3,1
2,0,4,2,30,8,0,0,8,5,30,4,0,0,4,0,30,2,6,0,8,0,30,7,1,0,8,3,30,3,1,0,4,0,-27,3,0
2,3,4,2,30,8,0,0,8,5,30,4,0,0,4,0,30,2,6,0,8,0,30,7,1,0,8,3,30,3,1,0,4,0,-27,3,0
2,4,8,1,30,7,0,0,7,3,30,2,0,0,2,0,30,3,4,0,7,0,30,6,1,0,7,3,30,3,0,0,3,0,-27,3,0
2,4,13,1,30,6,1,0,7,1,30,4,0,0,4,2,30,6,1,0,7,5,30,4,3,0,7,4,30,4,0,0,4,1,-15,3,1
2,2,17,6,30,9,5,0,14,3,30,6,0,0,6,0,30,6,8,0,14,7,30,7,7,0,14,3,30,4,0,0,4,1,-15,3,1
2,0,21,2,30,5,5,0,10,4,30,6,0,0,6,1,30,3,7,0,10,5,30,4,6,0,10,1,30,4,0,0,4,1,-15,3,1
2,1,21,2,30,5,5,0,10,4,30,6,0,0,6,1,30,3,7,0,10,5,30,4,6,0,10,1,30,4,0,0,4,1,-15,3,1
2,2,21,2,30,5,5,0,10,4,30,6,0,0,6,1,30,3,7,0,10,5,30,4,6,0,10,1,30,4,0,0,4,1,-15,3,1
2,3,21,2,30,5,5,0,10,4,30,6,0,0,6,1,30,3,7,0,10,5,30,4,6,0,10,1,30,4,0,0,4,1,-15,3,1
2,3,23,1,30,4,9,0,13,4,30,6,0,0,6,8,30,9,4,0,13,0,30,5,8,0,13,1,30,6,0,0,6,1,-15,3,1
2,2,25,2,30,9,5,0,14,4,30,6,0,0,6,0,30,8,6,0,14,1,30,5,9,0,14,3,30,5,1,0,6,1,-15,3,1
2,4,25,2,30,9,5,0,14,4,30,6,0,0,6,0,30,8,6,0,14,1,30,5,9,0,14,3,30,5,1,0,6,1,-15,3,1
2,0,27,3,30,6,9,0,15,2,30,2,0,0,2,2,30,6,9,0,15,0,30,4,11,0,15,5,30,4,2,0,6,1,-15,3,1
2,1,27,3,30,6,9,0,15,2,30,2,0,0,2,2,30,6,9,0,15,0,30,4,11,0,15,5,30,4,2,0,6,1,-15,3,1
2,2,27,3,30,6,9,0,15,2,30,2,0,0,2,2,30,6,9,0,15,0,30,4,11,0,15,5,30,4,2,0,6,1,-15,3,1
2,4,27,3,30,6,9,0,15,2,30,2,0,0,2,2,30,6,9,0,15,0,30,4,11,0,15,0,30,4,2,0,6,1,-15,3,1
2,3,29,0,30,5,9,0,14,6,30,10,2,0,12,0,30,3,11,0,14,0,30,5,9,0,14,1,30,9,0,0,9,1,-15,3,1
2,4,29,0,30,5,9,0,14,6,30,10,2,0,12,0,30,3,11,0,14,0,30,5,9,0,14,1,30,9,0,0,9,1,-15,3,1
2,2,35,1,30,12,1,0,13,4,30,2,0,0,2,1,30,6,7,0,13,0,30,3,10,0,13,7,30,8,0,0,8,1,-15,3,1
2,3,35,1,30,12,1,0,13,4,30,2,0,0,2,1,30,6,7,0,13,0,30,3,10,0,13,7,30,8,0,0,8,1,-15,3,1
2,4,7,0,30,3,1,0,4,2,30,2,0,0,2,0,30,1,3,0,4,0,30,0,4,0,4,1,30,2,0,0,2,0,-27,3,0
2,2,17,2,30,10,4,0,14,2,30,6,0,0,6,0,30,5,9,0,14,1,30,6,8,0,14,5,30,4,0,0,4,1,-15,3,1
2,4,17,0,30,10,4,0,14,2,30,6,0,0,6,0,30,5,9,0,14,1,30,6,8,0,14,5,30,4,0,0,4,1,-15,3,1
2,3,19,0,30,4,9,0,13,1,30,7,1,0,8,0,30,4,9,0,13,1,30,7,6,0,13,0,30,8,1,0,9,1,-15,3,1
2,2,23,1,30,6,7,0,13,3,30,6,0,0,6,6,30,13,0,0,13,0,30,5,8,0,13,2,30,5,1,0,6,1,-15,3,1
2,3,23,1,30,6,7,0,13,3,30,6,0,0,6,6,30,13,0,0,13,0,30,5,8,0,13,2,30,5,1,0,6,1,-15,3,1
2,4,23,1,30,6,7,0,13,3,30,6,0,0,6,6,30,13,0,0,13,0,30,5,8,0,13,2,30,5,1,0,6,1,-15,3,1
2,2,25,1,30,5,9,0,14,5,30,6,0,0,6,1,30,6,8,0,14,1,30,5,9,0,14,5,30,6,0,0,6,1,-15,3,1
2,4,25,1,30,5,9,0,14,5,30,6,0,0,6,0,30,6,8,0,14,1,30,5,9,0,14,5,30,6,0,0,6,1,-15,3,1
2,4,27,0,30,4,11,0,15,4,30,2,0,0,2,0,30,6,9,0,15,0,30,4,11,0,15,5,30,6,0,0,6,1,-15,3,1
2,1,29,0,30,6,8,0,14,5,30,10,2,0,12,0,30,3,11,0,14,0,30,6,8,0,14,0,30,9,0,0,9,1,-15,3,1
2,2,29,0,30,6,8,0,14,5,30,10,2,0,12,0,30,3,11,0,14,0,30,6,8,0,14,0,30,9,0,0,9,1,-15,3,1
2,3,32,0,30,6,3,0,9,4,30,2,0,0,2,1,30,8,1,0,9,1,30,2,7,0,9,5,30,2,0,0,2,1,-15,3,1
2,4,32,0,30,6,3,0,9,4,30,2,0,0,2,1,30,8,1,0,9,1,30,2,7,0,9,5,30,2,0,0,2,1,-15,3,1
2,0,4,4,30,8,0,0,8,4,30,2,2,0,4,1,30,1,7,0,8,2,30,4,4,0,8,1,30,3,1,0,4,0,-27,3,0
2,2,4,4,30,8,0,0,8,4,30,2,2,0,4,1,30,1,7,0,8,2,30,4,4,0,8,1,30,3,1,0,4,0,-27,3,0
2,3,4,4,30,8,0,0,8,4,30,2,2,0,4,1,30,1,7,0,8,2,30,4,4,0,8,1,30,3,1,0,4,0,-27,3,0
2,3,11,3,30,5,7,0,12,2,30,4,0,0,4,0,30,5,7,0,12,0,30,5,7,0,12,0,30,4,0,0,4,1,-15,3,1
2,2,13,7,30,7,0,0,7,1,30,4,0,0,4,1,30,6,1,0,7,0,30,6,1,0,7,4,30,4,0,0,4,1,-15,3,1
2,3,13,7,30,7,0,0,7,1,30,4,0,0,4,1,30,6,1,0,7,0,30,6,1,0,7,4,30,4,0,0,4,1,-15,3,1
2,0,17,1,30,5,9,0,14,3,30,6,0,0,6,0,30,6,8,0,14,5,30,8,6,0,14,6,30,4,0,0,4,1,-15,3,1
2,1,17,1,30,5,9,0,14,3,30,6,0,0,6,0,30,6,8,0,14,5,30,8,6,0,14,6,30,4,0,0,4,1,-15,3,1
2,3,17,1,30,5,9,0,14,3,30,6,0,0,6,0,30,6,8,0,14,5,30,8,6,0,14,6,30,4,0,0,4,1,-15,3,1
2,1,19,1,30,5,8,0,13,1,30,4,4,0,8,0,30,7,6,0,13,5,30,6,7,0,13,1,30,8,1,0,9,1,-15,3,1
2,2,19,1,30,5,8,0,13,1,30,4,4,0,8,0,30,7,6,0,13,5,30,6,7,0,13,1,30,8,1,0,9,1,-15,3,1
2,4,19,1,30,5,8,0,13,1,30,4,4,0,8,0,30,7,6,0,13,5,30,6,7,0,13,0,30,8,1,0,9,1,-15,3,1
2,4,23,1,30,6,7,0,13,1,30,6,0,0,6,3,30,10,3,0,13,0,30,5,8,0,13,1,30,6,0,0,6,1,-15,3,1
2,2,25,0,30,7,7,0,14,1,30,6,0,0,6,0,30,9,5,0,14,1,30,6,8,0,14,4,30,6,0,0,6,1,-15,3,1
2,2,27,1,30,7,8,0,15,2,30,2,0,0,2,0,30,5,10,0,15,0,30,5,10,0,15,5,30,6,0,0,6,1,-15,3,1
2,4,29,0,30,4,10,0,14,4,30,12,0,0,12,0,30,4,10,0,14,0,30,1,13,0,14,2,30,9,0,0,9,1,-15,3,1
2,4,31,3,30,5,7,0,12,5,30,8,0,0,8,5,30,9,3,0,12,0,30,5,7,0,12,1,30,4,2,0,6,1,-15,3,1
2,3,33,1,30,4,7,0,11,5,30,4,0,0,4,0,30,10,1,0,11,0,30,3,8,0,11,4,30,4,0,0,4,1,-15,3,1
2,4,47,0,30,0,14,0,14,7,30,4,0,0,4,0,30,4,10,0,14,5,30,6,8,0,14,4,30,7,0,0,7,1,-15,3,1
2,2,9,2,30,4,0,0,4,3,30,2,0,0,2,3,30,1,3,0,4,0,30,1,3,0,4,0,30,1,0,0,1,0,-27,3,0
2,2,13,4,30,5,2,0,7,0,30,4,0,0,4,2,30,6,1,0,7,7,30,5,2,0,7,3,30,4,0,0,4,1,-15,3,1
2,4,19,0,30,2,11,0,13,1,30,5,3,0,8,0,30,9,4,0,13,6,30,4,9,0,13,2,30,8,1,0,9,1,-15,3,1
2,4,23,1,30,10,3,0,13,2,30,6,0,0,6,8,30,9,4,0,13,0,30,4,9,0,13,0,30,6,0,0,6,1,-15,3,1
2,1,33,2,30,3,8,0,11,5,30,4,0,0,4,0,30,9,2,0,11,0,30,5,6,0,11,5,30,4,0,0,4,1,-15,3,1
2,3,33,2,30,3,8,0,11,5,30,4,0,0,4,0,30,9,2,0,11,0,30,5,6,0,11,5,30,4,0,0,4,1,-15,3,1
2,1,4,2,30,5,3,0,8,4,30,2,2,0,4,0,30,4,4,0,8,2,30,8,0,0,8,2,30,4,0,0,4,0,-27,3,0
2,3,4,2,30,5,3,0,8,4,30,2,2,0,4,0,30,4,4,0,8,2,30,8,0,0,8,2,30,4,0,0,4,0,-27,3,0
2,4,13,4,30,3,0,0,3,0,30,2,0,0,2,0,30,3,0,0,3,8,30,2,1,0,3,3,30,2,0,0,2,1,-15,3,1
2,1,13,3,30,7,0,0,7,0,30,4,0,0,4,4,30,6,1,0,7,5,30,6,1,0,7,7,30,4,0,0,4,1,-15,3,1
2,3,17,1,30,9,5,0,14,3,30,6,0,0,6,0,30,4,10,0,14,1,30,5,9,0,14,8,30,4,0,0,4,1,-15,3,1
2,1,19,0,30,2,11,0,13,2,30,4,4,0,8,0,30,4,9,0,13,6,30,8,5,0,13,4,30,9,0,0,9,1,-15,3,1
2,2,19,0,30,2,11,0,13,2,30,4,4,0,8,0,30,4,9,0,13,6,30,8,5,0,13,4,30,9,0,0,9,1,-15,3,1
2,3,19,0,30,2,11,0,13,2,30,4,4,0,8,0,30,4,9,0,13,6,30,8,5,0,13,4,30,9,0,0,9,1,-15,3,1
2,3,27,0,30,4,11,0,15,3,30,1,1,0,2,0,30,6,9,0,15,1,30,5,10,0,15,5,30,6,0,0,6,1,-15,3,1
2,4,27,0,30,4,11,0,15,3,30,1,1,0,2,0,30,6,9,0,15,1,30,5,10,0,15,5,30,6,0,0,6,1,-15,3,1
2,1,31,2,30,7,5,0,12,3,30,8,0,0,8,3,30,12,0,0,12,0,30,3,9,0,12,0,30,2,4,0,6,1,-15,3,1
2,2,31,2,30,7,5,0,12,3,30,8,0,0,8,3,30,12,0,0,12,0,30,3,9,0,12,0,30,2,4,0,6,1,-15,3,1
2,3,31,2,30,7,5,0,12,3,30,8,0,0,8,3,30,12,0,0,12,0,30,3,9,0,12,0,30,2,4,0,6,1,-15,3,1
2,0,37,2,30,7,4,0,11,7,30,8,0,0,8,0,30,2,9,0,11,4,30,5,6,0,11,8,30,6,0,0,6,1,-15,3,1
2,3,37,2,30,7,4,0,11,7,30,8,0,0,8,0,30,2,9,0,11,4,30,5,6,0,11,8,30,6,0,0,6,1,-15,3,1
2,2,41,2,30,9,3,0,12,8,30,8,0,0,8,0,30,3,9,0,12,0,30,2,10,0,12,0,30,6,1,0,7,1,-15,3,1
2,2,11,0,30,6,6,0,12,3,30,4,0,0,4,0,30,1,11,0,12,3,30,6,6,0,12,3,30,4,0,0,4,1,-15,3,1
2,3,17,1,30,9,5,0,14,1,30,6,0,0,6,0,30,8,6,0,14,3,30,5,9,0,14,4,30,4,0,0,4,1,-15,3,1
2,4,19,0,30,3,10,0,13,2,30,6,2,0,8,0,30,4,9,0,13,4,30,4,9,0,13,0,30,7,2,0,9,1,-15,3,1
2,3,25,1,30,6,8,0,14,3,30,6,0,0,6,0,30,7,7,0,14,1,30,6,8,0,14,4,30,5,1,0,6,1,-15,3,1
2,4,25,1,30,6,8,0,14,3,30,6,0,0,6,0,30,7,7,0,14,1,30,6,8,0,14,4,30,5,1,0,6,1,-15,3,1
2,0,27,1,30,4,11,0,15,4,30,1,1,0,2,0,30,5,10,0,15,1,30,6,9,0,15,3,30,6,0,0,6,1,-15,3,1
2,2,27,1,30,4,11,0,15,4,30,1,1,0,2,0,30,5,10,0,15,1,30,6,9,0,15,3,30,6,0,0,6,1,-15,3,1
2,3,27,1,30,4,11,0,15,4,30,1,1,0,2,0,30,5,10,0,15,1,30,6,9,0,15,3,30,6,0,0,6,1,-15,3,1
2,2,29,0,30,8,6,0,14,6,30,12,0,0,12,0,30,4,10,0,14,0,30,0,14,0,14,1,30,9,0,0,9,1,-15,3,1
2,2,31,1,30,5,7,0,12,4,30,8,0,0,8,6,30,9,3,0,12,0,30,3,9,0,12,0,30,3,3,0,6,1,-15,3,1
2,3,31,1,30,5,7,0,12,4,30,8,0,0,8,6,30,9,3,0,12,0,30,3,9,0,12,0,30,3,3,0,6,1,-15,3,1
2,0,5,0,30,1,4,0,5,3,30,2,2,0,4,0,30,0,5,0,5,0,30,1,4,0,5,0,30,2,0,0,2,0,-27,3,0
2,1,5,0,30,1,4,0,5,3,30,2,2,0,4,0,30,0,5,0,5,0,30,1,4,0,5,0,30,2,0,0,2,0,-27,3,0
2,4,8,9,30,7,0,0,7,6,30,2,0,0,2,0,30,1,6,0,7,0,30,7,0,0,7,0,30,2,1,0,3,0,-27,3,0
2,2,13,2,30,5,2,0,7,0,30,4,0,0,4,2,30,7,0,0,7,11,30,5,2,0,7,4,30,4,0,0,4,1,-15,3,1
2,4,17,7,30,10,4,0,14,3,30,6,0,0,6,0,30,5,9,0,14,0,30,3,11,0,14,4,30,4,0,0,4,1,-15,3,1
2,2,19,0,30,2,11,0,13,2,30,7,1,0,8,1,30,7,6,0,13,4,30,2,11,0,13,0,30,9,0,0,9,1,-15,3,1
2,3,19,0,30,2,11,0,13,2,30,7,1,0,8,1,30,7,6,0,13,4,30,2,11,0,13,0,30,9,0,0,9,1,-15,3,1
2,3,23,2,30,5,8,0,13,4,30,6,0,0,6,7,30,12,1,0,13,0,30,6,7,0,13,3,30,5,1,0,6,1,-15,3,1
2,3,25,2,30,1,13,0,14,3,30,6,0,0,6,0,30,6,8,0,14,1,30,5,9,0,14,4,30,5,1,0,6,1,-15,3,1
2,4,25,2,30,1,13,0,14,3,30,6,0,0,6,0,30,6,8,0,14,1,30,5,9,0,14,4,30,5,1,0,6,1,-15,3,1
2,2,27,1,30,4,11,0,15,4,30,1,1,0,2,0,30,6,9,0,15,2,30,6,9,0,15,0,30,6,0,0,6,1,-15,3,1
2,3,27,1,30,4,11,0,15,4,30,1,1,0,2,0,30,6,9,0,15,2,30,6,9,0,15,0,30,6,0,0,6,1,-15,3,1
2,2,31,1,30,9,3,0,12,3,30,8,0,0,8,6,30,12,0,0,12,0,30,3,9,0,12,0,30,2,4,0,6,1,-15,3,1
2,4,31,1,30,9,3,0,12,3,30,8,0,0,8,6,30,12,0,0,12,0,30,3,9,0,12,0,30,2,4,0,6,1,-15,3,1
2,2,35,0,30,5,8,0,13,4,30,2,0,0,2,1,30,6,7,0,13,0,30,4,9,0,13,6,30,8,0,0,8,1,-15,3,1
2,0,45,0,30,5,8,0,13,8,30,10,0,0,10,0,30,5,8,0,13,2,30,5,8,0,13,7,30,5,0,0,5,1,-15,3,1
2,2,45,0,30,5,8,0,13,8,30,10,0,0,10,0,30,5,8,0,13,2,30,5,8,0,13,7,30,5,0,0,5,1,-15,3,1
2,4,17,0,30,10,4,0,14,2,30,6,0,0,6,0,30,8,6,0,14,6,30,4,10,0,14,6,30,4,0,0,4,1,-15,3,1
2,4,19,0,30,3,10,0,13,2,30,5,3,0,8,0,30,7,6,0,13,7,30,6,7,0,13,2,30,9,0,0,9,1,-15,3,1
2,4,23,3,30,7,6,0,13,1,30,6,0,0,6,4,30,11,2,0,13,0,30,5,8,0,13,3,30,5,1,0,6,1,-15,3,1
2,0,6,0,30,8,1,0,9,4,30,2,0,0,2,0,30,3,6,0,9,0,30,5,4,0,9,2,30,3,2,0,5,0,-27,3,0
2,3,6,0,30,8,1,0,9,4,30,2,0,0,2,0,30,3,6,0,9,0,30,5,4,0,9,2,30,3,2,0,5,0,-27,3,0
2,1,23,1,30,4,9,0,13,2,30,6,0,0,6,5,30,10,3,0,13,0,30,6,7,0,13,4,30,5,1,0,6,1,-15,3,1
2,3,23,1,30,4,9,0,13,2,30,6,0,0,6,5,30,10,3,0,13,0,30,6,7,0,13,4,30,5,1,0,6,1,-15,3,1
2,0,26,2,30,7,2,0,9,5,30,4,0,0,4,2,30,1,8,0,9,0,30,1,8,0,9,5,30,1,2,0,3,1,-15,3,1
2,1,26,2,30,7,2,0,9,5,30,4,0,0,4,2,30,1,8,0,9,0,30,1,8,0,9,5,30,1,2,0,3,1,-15,3,1
2,2,26,2,30,7,2,0,9,5,30,4,0,0,4,2,30,1,8,0,9,0,30,1,8,0,9,5,30,1,2,0,3,1,-15,3,1
2,2,27,1,30,7,8,0,15,3,30,2,0,0,2,0,30,3,12,0,15,3,30,3,12,0,15,2,30,6,0,0,6,1,-15,3,1
2,3,31,7,30,8,4,0,12,4,30,8,0,0,8,4,30,12,0,0,12,0,30,3,9,0,12,0,30,1,5,0,6,1,-15,3,1
2,0,9,6,30,4,0,0,4,3,30,2,0,0,2,1,30,2,2,0,4,0,30,1,3,0,4,0,30,1,0,0,1,0,-27,3,0
2,3,9,6,30,4,0,0,4,3,30,2,0,0,2,1,30,2,2,0,4,0,30,1,3,0,4,0,30,1,0,0,1,0,-27,3,0
2,3,9,3,30,11,0,0,11,3,30,6,0,0,6,1,30,9,2,0,11,0,30,3,8,0,11,1,30,2,2,0,4,0,-27,3,0
2,2,13,1,30,4,3,0,7,0,30,4,0,0,4,3,30,7,0,0,7,8,30,6,1,0,7,7,30,4,0,0,4,1,-15,3,1
2,1,17,7,30,8,6,0,14,4,30,6,0,0,6,0,30,5,9,0,14,0,30,8,6,0,14,7,30,4,0,0,4,1,-15,3,1
2,2,17,7,30,8,6,0,14,4,30,6,0,0,6,0,30,5,9,0,14,0,30,8,6,0,14,7,30,4,0,0,4,1,-15,3,1
2,2,19,2,30,3,10,0,13,2,30,8,0,0,8,0,30,6,7,0,13,3,30,6,7,0,13,2,30,8,1,0,9,1,-15,3,1
2,3,19,2,30,3,10,0,13,2,30,8,0,0,8,0,30,6,7,0,13,3,30,6,7,0,13,2,30,8,1,0,9,1,-15,3,1
2,4,23,0,30,7,6,0,13,3,30,6,0,0,6,1,30,9,4,0,13,0,30,6,7,0,13,5,30,6,0,0,6,1,-15,3,1
2,0,25,1,30,4,10,0,14,4,30,6,0,0,6,0,30,6,8,0,14,1,30,10,4,0,14,5,30,6,0,0,6,1,-15,3,1
2,1,25,1,30,4,10,0,14,4,30,6,0,0,6,0,30,6,8,0,14,1,30,10,4,0,14,5,30,6,0,0,6,1,-15,3,1
2,0,27,1,30,6,9,0,15,4,30,1,1,0,2,0,30,4,11,0,15,0,30,4,11,0,15,1,30,6,0,0,6,1,-15,3,1
2,2,27,1,30,6,9,0,15,4,30,1,1,0,2,0,30,4,11,0,15,0,30,4,11,0,15,1,30,6,0,0,6,1,-15,3,1
2,1,31,3,30,7,5,0,12,4,30,8,0,0,8,3,30,10,2,0,12,0,30,3,9,0,12,1,30,3,3,0,6,1,-15,3,1
2,4,31,3,30,7,5,0,12,4,30,8,0,0,8,3,30,10,2,0,12,0,30,3,9,0,12,1,30,3,3,0,6,1,-15,3,1
2,2,4,2,30,5,3,0,8,5,30,2,2,0,4,0,30,1,7,0,8,0,30,6,2,0,8,1,30,4,0,0,4,0,-27,3,0
2,3,4,2,30,5,3,0,8,5,30,2,2,0,4,0,30,1,7,0,8,0,30,6,2,0,8,1,30,4,0,0,4,0,-27,3,0
2,4,5,0,30,1,4,0,5,2,30,4,0,0,4,0,30,1,4,0,5,0,30,1,4,0,5,0,30,0,2,0,2,0,-27,3,0
2,4,8,2,30,7,0,0,7,3,30,2,0,0,2,0,30,6,1,0,7,0,30,5,2,0,7,1,30,3,0,0,3,0,-27,3,0
2,3,11,0,30,8,4,0,12,1,30,3,1,0,4,2,30,7,5,0,12,4,30,6,6,0,12,5,30,4,0,0,4,1,-15,3,1
2,4,13,3,30,7,0,0,7,0,30,4,0,0,4,1,30,6,1,0,7,5,30,5,2,0,7,0,30,4,0,0,4,1,-15,3,1
2,0,17,5,30,10,4,0,14,4,30,6,0,0,6,0,30,4,10,0,14,2,30,6,8,0,14,2,30,4,0,0,4,1,-15,3,1
2,1,17,5,30,10,4,0,14,4,30,6,0,0,6,0,30,4,10,0,14,2,30,6,8,0,14,2,30,4,0,0,4,1,-15,3,1
2,3,17,5,30,10,4,0,14,4,30,6,0,0,6,0,30,4,10,0,14,2,30,6,8,0,14,2,30,4,0,0,4,1,-15,3,1
2,4,17,5,30,10,4,0,14,4,30,6,0,0,6,0,30,4,10,0,14,2,30,6,8,0,14,2,30,4,0,0,4,1,-15,3,1
2,3,19,0,30,4,9,0,13,1,30,8,0,0,8,0,30,7,6,0,13,3,30,4,9,0,13,2,30,6,3,0,9,1,-15,3,1
2,4,19,0,30,4,9,0,13,1,30,8,0,0,8,0,30,7,6,0,13,3,30,4,9,0,13,2,30,6,3,0,9,1,-15,3,1
2,3,23,2,30,6,7,0,13,3,30,6,0,0,6,4,30,12,1,0,13,0,30,5,8,0,13,1,30,6,0,0,6,1,-15,3,1
2,0,27,1,30,4,11,0,15,4,30,1,1,0,2,0,30,7,8,0,15,2,30,8,7,0,15,3,30,6,0,0,6,1,-15,3,1
2,2,27,1,30,4,11,0,15,4,30,1,1,0,2,0,30,7,8,0,15,2,30,8,7,0,15,3,30,6,0,0,6,1,-15,3,1
2,2,29,0,30,8,6,0,14,5,30,10,2,0,12,0,30,4,10,0,14,0,30,0,14,0,14,4,30,9,0,0,9,1,-15,3,1
2,0,5,0,30,0,5,0,5,3,30,2,2,0,4,2,30,0,5,0,5,0,30,4,1,0,5,0,30,2,0,0,2,0,-27,3,0
2,4,5,0,30,0,5,0,5,3,30,2,2,0,4,2,30,0,5,0,5,0,30,4,1,0,5,0,30,2,0,0,2,0,-27,3,0
2,2,6,1,30,9,0,0,9,4,30,2,0,0,2,0,30,2,7,0,9,0,30,4,5,0,9,0,30,4,1,0,5,0,-27,3,0
2,4,7,0,30,1,3,0,4,2,30,2,0,0,2,2,30,2,2,0,4,0,30,1,3,0,4,1,30,1,1,0,2,0,-27,3,0
2,3,17,2,30,9,5,0,14,2,30,6,0,0,6,0,30,8,6,0,14,5,30,4,10,0,14,4,30,4,0,0,4,1,-15,3,1
2,2,19,0,30,4,9,0,13,2,30,5,3,0,8,0,30,5,8,0,13,5,30,4,9,0,13,0,30,8,1,0,9,1,-15,3,1
2,4,19,0,30,4,9,0,13,2,30,5,3,0,8,0,30,5,8,0,13,5,30,4,9,0,13,0,30,8,1,0,9,1,-15,3,1
2,4,25,1,30,8,6,0,14,0,30,6,0,0,6,0,30,13,1,0,14,1,30,6,8,0,14,2,30,4,2,0,6,1,-15,3,1
2,0,27,1,30,4,11,0,15,2,30,1,1,0,2,0,30,5,10,0,15,2,30,5,10,0,15,6,30,6,0,0,6,1,-15,3,1
2,3,27,1,30,4,11,0,15,2,30,1,1,0,2,0,30,5,10,0,15,2,30,5,10,0,15,6,30,6,0,0,6,1,-15,3,1
2,4,27,1,30,4,11,0,15,2,30,1,1,0,2,0,30,5,10,0,15,2,30,5,10,0,15,6,30,6,0,0,6,1,-15,3,1
2,0,31,3,30,6,6,0,12,8,30,8,0,0,8,3,30,4,8,0,12,3,30,7,5,0,12,2,30,6,0,0,6,1,-15,3,1
2,2,31,3,30,6,6,0,12,8,30,8,0,0,8,3,30,4,8,0,12,3,30,7,5,0,12,2,30,6,0,0,6,1,-15,3,1
2,3,31,3,30,6,6,0,12,8,30,8,0,0,8,3,30,4,8,0,12,3,30,7,5,0,12,2,30,6,0,0,6,1,-15,3,1
2,0,41,0,30,7,5,0,12,5,30,8,0,0,8,0,30,11,1,0,12,0,30,4,8,0,12,3,30,7,0,0,7,1,-15,3,1
2,3,41,0,30,7,5,0,12,5,30,8,0,0,8,0,30,11,1,0,12,0,30,4,8,0,12,0,30,7,0,0,7,1,-15,3,1
2,4,41,0,30,7,5,0,12,5,30,8,0,0,8,0,30,11,1,0,12,0,30,4,8,0,12,0,30,7,0,0,7,1,-15,3,1
2,3,8,2,30,7,0,0,7,3,30,2,0,0,2,0,30,3,4,0,7,0,30,6,1,0,7,4,30,3,0,0,3,0,-27,3,0
2,3,17,2,30,9,5,0,14,2,30,6,0,0,6,0,30,6,8,0,14,3,30,6,8,0,14,7,30,4,0,0,4,1,-15,3,1
2,1,19,0,30,4,9,0,13,2,30,5,3,0,8,0,30,6,7,0,13,9,30,4,9,0,13,0,30,7,2,0,9,1,-15,3,1
2,2,19,0,30,4,9,0,13,2,30,5,3,0,8,0,30,6,7,0,13,9,30,4,9,0,13,0,30,7,2,0,9,1,-15,3,1
2,3,25,0,30,9,5,0,14,3,30,6,0,0,6,0,30,5,9,0,14,1,30,5,9,0,14,0,30,5,1,0,6,1,-15,3,1
2,4,26,0,30,6,3,0,9,5,30,3,1,0,4,5,30,0,9,0,9,0,30,1,8,0,9,4,30,1,2,0,3,1,-15,3,1
2,2,27,1,30,6,9,0,15,0,30,1,1,0,2,0,30,10,5,0,15,3,30,5,10,0,15,1,30,5,1,0,6,1,-15,3,1
2,3,27,1,30,6,9,0,15,0,30,1,1,0,2,0,30,10,5,0,15,3,30,5,10,0,15,1,30,5,1,0,6,1,-15,3,1
2,4,27,1,30,6,9,0,15,0,30,1,1,0,2,0,30,10,5,0,15,3,30,5,10,0,15,1,30,5,1,0,6,1,-15,3,1
2,2,31,1,30,8,4,0,12,6,30,8,0,0,8,3,30,6,6,0,12,0,30,6,6,0,12,3,30,6,0,0,6,1,-15,3,1
2,4,43,0,30,9,5,0,14,8,30,6,0,0,6,0,30,4,10,0,14,1,30,1,13,0,14,4,30,5,0,0,5,1,-15,3,1
2,3,6,1,30,8,1,0,9,4,30,2,0,0,2,0,30,2,7,0,9,0,30,4,5,0,9,2,30,5,0,0,5,0,-27,3,0
2,1,13,2,30,6,1,0,7,0,30,4,0,0,4,2,30,5,2,0,7,10,30,5,2,0,7,2,30,4,0,0,4,1,-15,3,1
2,4,13,2,30,6,1,0,7,0,30,4,0,0,4,2,30,5,2,0,7,10,30,5,2,0,7,2,30,4,0,0,4,1,-15,3,1
2,2,19,0,30,4,9,0,13,2,30,8,0,0,8,0,30,4,9,0,13,0,30,6,7,0,13,0,30,7,2,0,9,1,-15,3,1
2,3,19,0,30,4,9,0,13,2,30,8,0,0,8,0,30,4,9,0,13,0,30,6,7,0,13,0,30,7,2,0,9,1,-15,3,1
2,4,19,0,30,4,9,0,13,2,30,8,0,0,8,0,30,4,9,0,13,0,30,6,7,0,13,0,30,7,2,0,9,1,-15,3,1
2,4,23,0,30,5,8,0,13,4,30,6,0,0,6,8,30,8,5,0,13,0,30,5,8,0,13,0,30,6,0,0,6,1,-15,3,1
2,1,27,1,30,3,12,0,15,4,30,2,0,0,2,0,30,5,10,0,15,3,30,4,11,0,15,5,30,6,0,0,6,1,-15,3,1
2,2,27,1,30,3,12,0,15,4,30,2,0,0,2,0,30,5,10,0,15,3,30,4,11,0,15,5,30,6,0,0,6,1,-15,3,1
2,3,27,1,30,3,12,0,15,4,30,2,0,0,2,0,30,5,10,0,15,3,30,4,11,0,15,5,30,6,0,0,6,1,-15,3,1
2,3,35,2,30,9,4,0,13,3,30,2,0,0,2,3,30,6,7,0,13,0,30,2,11,0,13,2,30,8,0,0,8,1,-15,3,1
2,2,13,5,30,7,0,0,7,0,30,4,0,0,4,2,30,5,2,0,7,10,30,6,1,0,7,2,30,4,0,0,4,1,-15,3,1
2,4,13,5,30,7,0,0,7,0,30,4,0,0,4,2,30,5,2,0,7,10,30,6,1,0,7,2,30,4,0,0,4,1,-15,3,1
2,0,27,1,30,4,11,0,15,3,30,1,1,0,2,0,30,8,7,0,15,1,30,5,10,0,15,3,30,6,0,0,6,1,-15,3,1
2,1,27,1,30,4,11,0,15,3,30,1,1,0,2,0,30,8,7,0,15,1,30,5,10,0,15,3,30,6,0,0,6,1,-15,3,1
2,2,27,1,30,4,11,0,15,3,30,1,1,0,2,0,30,8,7,0,15,1,30,5,10,0,15,3,30,6,0,0,6,1,-15,3,1
2,1,31,5,30,6,6,0,12,6,30,8,0,0,8,3,30,8,4,0,12,0,30,7,5,0,12,0,30,5,1,0,6,1,-15,3,1
2,2,33,2,30,6,5,0,11,6,30,4,0,0,4,6,30,9,2,0,11,0,30,3,8,0,11,7,30,4,0,0,4,1,-15,3,1
2,0,37,0,30,9,2,0,11,5,30,8,0,0,8,0,30,8,3,0,11,2,30,3,8,0,11,5,30,6,0,0,6,1,-15,3,1
2,1,37,0,30,9,2,0,11,5,30,8,0,0,8,0,30,8,3,0,11,2,30,3,8,0,11,5,30,6,0,0,6,1,-15,3,1
2,2,37,0,30,9,2,0,11,5,30,8,0,0,8,0,30,8,3,0,11,2,30,3,8,0,11,5,30,6,0,0,6,1,-15,3,1
2,3,39,0,30,4,7,0,11,6,30,6,0,0,6,0,30,6,5,0,11,0,30,2,9,0,11,1,30,5,0,0,5,1,-15,3,1
2,4,8,2,30,7,0,0,7,5,30,2,0,0,2,5,30,2,5,0,7,2,30,5,2,0,7,0,30,3,0,0,3,0,-27,3,0
2,1,13,2,30,7,0,0,7,1,30,4,0,0,4,2,30,6,1,0,7,11,30,6,1,0,7,2,30,4,0,0,4,1,-15,3,1
2,4,21,1,30,5,5,0,10,4,30,5,1,0,6,1,30,3,7,0,10,2,30,4,6,0,10,1,30,4,0,0,4,1,-15,3,1
2,0,25,3,30,5,9,0,14,5,30,6,0,0,6,0,30,8,6,0,14,1,30,5,9,0,14,5,30,6,0,0,6,1,-15,3,1
2,1,25,3,30,5,9,0,14,5,30,6,0,0,6,0,30,8,6,0,14,1,30,5,9,0,14,5,30,6,0,0,6,1,-15,3,1
2,1,28,0,30,5,3,0,8,5,30,4,0,0,4,0,30,1,7,0,8,0,30,2,6,0,8,4,30,4,0,0,4,1,-15,3,1
2,4,29,0,30,6,8,0,14,6,30,12,0,0,12,0,30,7,7,0,14,0,30,1,13,0,14,1,30,9,0,0,9,1,-15,3,1
2,3,37,1,30,5,6,0,11,6,30,8,0,0,8,0,30,7,4,0,11,2,30,3,8,0,11,3,30,6,0,0,6,1,-15,3,1
2,4,39,0,30,1,10,0,11,6,30,6,0,0,6,0,30,5,6,0,11,0,30,4,7,0,11,4,30,5,0,0,5,1,-15,3,1
2,2,47,0,30,0,14,0,14,6,30,4,0,0,4,0,30,6,8,0,14,1,30,3,11,0,14,8,30,7,0,0,7,1,-15,3,1
2,1,13,1,30,4,3,0,7,0,30,4,0,0,4,2,30,5,2,0,7,14,30,5,2,0,7,7,30,4,0,0,4,1,-15,3,1
2,3,17,3,30,11,3,0,14,3,30,6,0,0,6,1,30,6,8,0,14,1,30,9,5,0,14,0,30,2,2,0,4,1,-15,3,1
2,2,19,1,30,7,6,0,13,1,30,3,5,0,8,0,30,7,6,0,13,8,30,4,9,0,13,1,30,8,1,0,9,1,-15,3,1
2,3,23,1,30,4,9,0,13,3,30,6,0,0,6,3,30,7,6,0,13,2,30,5,8,0,13,4,30,6,0,0,6,1,-15,3,1
2,4,23,1,30,4,9,0,13,3,30,6,0,0,6,3,30,7,6,0,13,2,30,5,8,0,13,4,30,6,0,0,6,1,-15,3,1
2,3,25,1,30,12,2,0,14,3,30,6,0,0,6,0,30,9,5,0,14,1,30,5,9,0,14,3,30,4,2,0,6,1,-15,3,1
2,4,25,1,30,12,2,0,14,3,30,6,0,0,6,0,30,9,5,0,14,1,30,5,9,0,14,3,30,4,2,0,6,1,-15,3,1
2,4,11,0,30,1,3,0,4,0,30,0,0,0,0,1,30,2,2,0,4,4,30,4,0,0,4,2,30,1,0,0,1,1,-15,3,1
2,3,13,4,30,7,0,0,7,0,30,4,0,0,4,3,30,7,0,0,7,6,30,5,2,0,7,0,30,4,0,0,4,1,-15,3,1
2,4,15,0,30,6,7,0,13,0,30,5,1,0,6,0,30,5,8,0,13,2,30,1,12,0,13,2,30,3,6,0,9,1,-15,3,1
2,0,19,0,30,6,7,0,13,1,30,3,5,0,8,1,30,12,1,0,13,0,30,9,4,0,13,1,30,7,2,0,9,1,-15,3,1
2,2,19,0,30,6,7,0,13,1,30,3,5,0,8,1,30,12,1,0,13,0,30,9,4,0,13,1,30,7,2,0,9,1,-15,3,1
2,3,19,0,30,6,7,0,13,1,30,3,5,0,8,1,30,12,1,0,13,0,30,9,4,0,13,1,30,7,2,0,9,1,-15,3,1
2,4,19,0,30,6,7,0,13,1,30,3,5,0,8,1,30,12,1,0,13,0,30,9,4,0,13,1,30,7,2,0,9,1,-15,3,1
2,3,25,1,30,8,6,0,14,5,30,6,0,0,6,0,30,6,8,0,14,1,30,5,9,0,14,4,30,5,1,0,6,1,-15,3,1
2,4,25,1,30,8,6,0,14,5,30,6,0,0,6,0,30,6,8,0,14,1,30,5,9,0,14,4,30,5,1,0,6,1,-15,3,1
2,1,29,0,30,6,8,0,14,5,30,8,4,0,12,0,30,7,7,0,14,0,30,3,11,0,14,2,30,9,0,0,9,1,-15,3,1
2,3,29,0,30,6,8,0,14,5,30,8,4,0,12,0,30,7,7,0,14,0,30,3,11,0,14,2,30,9,0,0,9,1,-15,3,1
2,0,4,2,30,6,2,0,8,5,30,3,1,0,4,0,30,1,7,0,8,0,30,7,1,0,8,1,30,3,1,0,4,0,-27,3,0
2,4,13,2,30,6,1,0,7,0,30,4,0,0,4,2,30,5,2,0,7,8,30,6,1,0,7,5,30,4,0,0,4,1,-15,3,1
2,2,19,0,30,3,10,0,13,2,30,4,4,0,8,0,30,5,8,0,13,3,30,8,5,0,13,0,30,8,1,0,9,1,-15,3,1
2,4,23,1,30,8,5,0,13,1,30,6,0,0,6,6,30,11,2,0,13,0,30,4,9,0,13,0,30,6,0,0,6,1,-15,3,1
2,1,25,2,30,5,9,0,14,2,30,6,0,0,6,0,30,10,4,0,14,1,30,5,9,0,14,4,30,5,1,0,6,1,-15,3,1
2,0,27,5,30,4,11,0,15,5,30,2,0,0,2,0,30,5,10,0,15,0,30,3,12,0,15,5,30,6,0,0,6,1,-15,3,1
2,1,27,5,30,4,11,0,15,5,30,2,0,0,2,0,30,5,10,0,15,0,30,3,12,0,15,5,30,6,0,0,6,1,-15,3,1
2,3,28,0,30,5,3,0,8,6,30,4,0,0,4,0,30,1,7,0,8,0,30,6,2,0,8,6,30,4,0,0,4,1,-15,3,1
2,4,8,1,30,7,0,0,7,3,30,2,0,0,2,3,30,6,1,0,7,2,30,7,0,0,7,0,30,3,0,0,3,0,-27,3,0
2,2,13,0,30,6,1,0,7,0,30,4,0,0,4,3,30,7,0,0,7,8,30,5,2,0,7,2,30,4,0,0,4,1,-15,3,1
2,4,13,0,30,6,1,0,7,0,30,4,0,0,4,3,30,7,0,0,7,8,30,5,2,0,7,2,30,4,0,0,4,1,-15,3,1
2,4,17,0,30,8,6,0,14,2,30,6,0,0,6,0,30,6,8,0,14,2,30,8,6,0,14,5,30,4,0,0,4,1,-15,3,1
2,0,27,3,30,4,11,0,15,3,30,2,0,0,2,0,30,9,6,0,15,0,30,6,9,0,15,0,30,4,2,0,6,1,-15,3,1
2,2,27,3,30,4,11,0,15,3,30,2,0,0,2,0,30,9,6,0,15,0,30,6,9,0,15,0,30,4,2,0,6,1,-15,3,1
2,3,31,1,30,4,8,0,12,4,30,8,0,0,8,0,30,9,3,0,12,0,30,3,9,0,12,1,30,5,1,0,6,1,-15,3,1
2,4,39,0,30,4,7,0,11,6,30,6,0,0,6,0,30,4,7,0,11,0,30,2,9,0,11,3,30,5,0,0,5,1,-15,3,1
2,1,13,1,30,7,0,0,7,0,30,4,0,0,4,2,30,7,0,0,7,9,30,5,2,0,7,5,30,4,0,0,4,1,-15,3,1
2,2,13,1,30,7,0,0,7,0,30,4,0,0,4,2,30,7,0,0,7,9,30,5,2,0,7,5,30,4,0,0,4,1,-15,3,1
2,4,13,1,30,7,0,0,7,0,30,4,0,0,4,2,30,7,0,0,7,9,30,5,2,0,7,5,30,4,0,0,4,1,-15,3,1
2,4,17,4,30,11,3,0,14,1,30,6,0,0,6,0,30,7,7,0,14,1,30,4,10,0,14,5,30,4,0,0,4,1,-15,3,1
2,2,19,1,30,4,9,0,13,2,30,7,1,0,8,0,30,4,9,0,13,0,30,3,10,0,13,0,30,7,2,0,9,1,-15,3,1
2,3,19,1,30,4,9,0,13,2,30,7,1,0,8,0,30,4,9,0,13,0,30,3,10,0,13,0,30,7,2,0,9,1,-15,3,1
2,4,23,1,30,2,11,0,13,4,30,6,0,0,6,7,30,12,1,0,13,0,30,5,8,0,13,2,30,6,0,0,6,1,-15,3,1
2,4,25,1,30,6,8,0,14,4,30,6,0,0,6,0,30,7,7,0,14,1,30,7,7,0,14,5,30,5,1,0,6,1,-15,3,1
2,3,27,1,30,5,10,0,15,2,30,2,0,0,2,0,30,7,8,0,15,2,30,4,11,0,15,5,30,6,0,0,6,1,-15,3,1
2,4,27,1,30,5,10,0,15,2,30,2,0,0,2,0,30,7,8,0,15,2,30,4,11,0,15,5,30,6,0,0,6,1,-15,3,1
2,3,2,5,30,7,3,0,10,3,30,3,1,0,4,3,30,5,5,0,10,0,30,1,9,0,10,1,30,2,6,0,8,0,-27,3,0
2,4,6,0,30,2,7,0,9,3,30,2,0,0,2,0,30,2,7,0,9,1,30,3,6,0,9,4,30,5,0,0,5,0,-27,3,0
2,2,11,1,30,7,5,0,12,1,30,4,0,0,4,0,30,8,4,0,12,3,30,8,4,0,12,6,30,4,0,0,4,1,-15,3,1
2,3,11,1,30,7,5,0,12,1,30,4,0,0,4,0,30,8,4,0,12,3,30,8,4,0,12,6,30,4,0,0,4,1,-15,3,1
2,3,17,0,30,11,3,0,14,3,30,6,0,0,6,0,30,3,11,0,14,1,30,5,9,0,14,3,30,4,0,0,4,1,-15,3,1
2,4,27,0,30,4,11,0,15,5,30,1,1,0,2,0,30,7,8,0,15,0,30,6,9,0,15,3,30,6,0,0,6,1,-15,3,1
2,2,29,0,30,8,6,0,14,5,30,7,5,0,12,0,30,8,6,0,14,0,30,7,7,0,14,1,30,9,0,0,9,1,-15,3,1
2,3,39,0,30,6,5,0,11,7,30,6,0,0,6,0,30,4,7,0,11,0,30,2,9,0,11,5,30,5,0,0,5,1,-15,3,1
2,1,5,0,30,3,2,0,5,3,30,2,2,0,4,0,30,0,5,0,5,0,30,1,4,0,5,2,30,2,0,0,2,0,-27,3,0
2,4,19,0,30,4,9,0,13,1,30,5,3,0,8,0,30,9,4,0,13,4,30,5,8,0,13,1,30,8,1,0,9,1,-15,3,1
2,4,23,4,30,5,8,0,13,4,30,6,0,0,6,7,30,7,6,0,13,0,30,3,10,0,13,2,30,6,0,0,6,1,-15,3,1
2,4,31,1,30,5,7,0,12,8,30,8,0,0,8,3,30,4,8,0,12,1,30,9,3,0,12,5,30,6,0,0,6,1,-15,3,1
2,2,35,1,30,6,7,0,13,2,30,2,0,0,2,1,30,8,5,0,13,2,30,3,10,0,13,3,30,8,0,0,8,1,-15,3,1
2,4,35,1,30,6,7,0,13,2,30,2,0,0,2,1,30,8,5,0,13,2,30,3,10,0,13,3,30,8,0,0,8,1,-15,3,1
2,4,23,1,30,7,6,0,13,2,30,6,0,0,6,8,30,10,3,0,13,1,30,5,8,0,13,3,30,6,0,0,6,1,-15,3,1
2,2,25,2,30,6,8,0,14,2,30,6,0,0,6,0,30,11,3,0,14,1,30,5,9,0,14,3,30,5,1,0,6,1,-15,3,1
2,3,27,0,30,3,12,0,15,3,30,1,1,0,2,0,30,6,9,0,15,2,30,6,9,0,15,5,30,6,0,0,6,1,-15,3,1
2,4,27,0,30,3,12,0,15,3,30,1,1,0,2,0,30,6,9,0,15,2,30,6,9,0,15,5,30,6,0,0,6,1,-15,3,1
2,2,31,1,30,6,6,0,12,4,30,8,0,0,8,5,30,12,0,0,12,0,30,4,8,0,12,0,30,6,0,0,6,1,-15,3,1
2,2,43,0,30,8,6,0,14,8,30,6,0,0,6,0,30,7,7,0,14,1,30,5,9,0,14,1,30,5,0,0,5,1,-15,3,1
2,2,4,6,30,8,0,0,8,5,30,4,0,0,4,0,30,2,6,0,8,0,30,4,4,0,8,1,30,2,2,0,4,0,-27,3,0
2,1,13,1,30,7,0,0,7,0,30,4,0,0,4,2,30,5,2,0,7,11,30,6,1,0,7,7,30,4,0,0,4,1,-15,3,1
2,3,15,0,30,4,9,0,13,1,30,6,0,0,6,0,30,3,10,0,13,1,30,7,6,0,13,3,30,5,4,0,9,1,-15,3,1
2,0,17,4,30,10,4,0,14,2,30,6,0,0,6,0,30,5,9,0,14,1,30,5,9,0,14,3,30,4,0,0,4,1,-15,3,1
2,3,17,4,30,10,4,0,14,2,30,6,0,0,6,0,30,5,9,0,14,0,30,5,9,0,14,3,30,4,0,0,4,1,-15,3,1
2,1,19,0,30,3,10,0,13,3,30,8,0,0,8,0,30,4,9,0,13,6,30,5,8,0,13,0,30,8,1,0,9,1,-15,3,1
2,4,19,0,30,3,10,0,13,3,30,8,0,0,8,0,30,4,9,0,13,6,30,5,8,0,13,0,30,8,1,0,9,1,-15,3,1
2,1,23,1,30,6,7,0,13,1,30,6,0,0,6,7,30,12,1,0,13,0,30,5,8,0,13,2,30,5,1,0,6,1,-15,3,1
2,3,23,1,30,6,7,0,13,1,30,6,0,0,6,7,30,12,1,0,13,0,30,5,8,0,13,2,30,5,1,0,6,1,-15,3,1
2,4,23,1,30,6,7,0,13,1,30,6,0,0,6,7,30,12,1,0,13,0,30,5,8,0,13,2,30,5,1,0,6,1,-15,3,1
2,1,27,1,30,4,11,0,15,4,30,2,0,0,2,0,30,5,10,0,15,2,30,6,9,0,15,4,30,6,0,0,6,1,-15,3,1
2,2,27,1,30,4,11,0,15,4,30,2,0,0,2,0,30,5,10,0,15,2,30,6,9,0,15,4,30,6,0,0,6,1,-15,3,1
2,2,29,0,30,7,7,0,14,6,30,11,1,0,12,0,30,3,11,0,14,0,30,1,13,0,14,3,30,9,0,0,9,1,-15,3,1
2,3,47,0,30,4,10,0,14,7,30,4,0,0,4,0,30,4,10,0,14,0,30,2,12,0,14,6,30,7,0,0,7,1,-15,3,1
2,3,17,1,30,6,8,0,14,3,30,6,0,0,6,0,30,5,9,0,14,1,30,6,8,0,14,6,30,4,0,0,4,1,-15,3,1
2,1,19,0,30,5,8,0,13,2,30,3,5,0,8,0,30,5,8,0,13,7,30,4,9,0,13,2,30,9,0,0,9,1,-15,3,1
2,4,23,1,30,7,6,0,13,2,30,6,0,0,6,6,30,10,3,0,13,0,30,6,7,0,13,1,30,5,1,0,6,1,-15,3,1
2,3,25,1,30,4,10,0,14,3,30,6,0,0,6,0,30,13,1,0,14,1,30,5,9,0,14,0,30,5,1,0,6,1,-15,3,1
2,4,25,1,30,4,10,0,14,3,30,6,0,0,6,0,30,13,1,0,14,1,30,5,9,0,14,0,30,5,1,0,6,1,-15,3,1
2,1,27,1,30,4,11,0,15,2,30,2,0,0,2,0,30,6,9,0,15,5,30,5,10,0,15,5,30,6,0,0,6,1,-15,3,1
2,2,27,1,30,4,11,0,15,2,30,2,0,0,2,0,30,6,9,0,15,5,30,5,10,0,15,5,30,6,0,0,6,1,-15,3,1
2,4,27,1,30,4,11,0,15,2,30,2,0,0,2,0,30,6,9,0,15,5,30,5,10,0,15,5,30,6,0,0,6,1,-15,3,1
2,4,9,0,30,6,5,0,11,2,30,6,0,0,6,1,30,9,2,0,11,6,30,3,8,0,11,3,30,2,2,0,4,0,-27,3,0
2,4,17,3,30,10,4,0,14,0,30,6,0,0,6,0,30,8,6,0,14,3,30,5,9,0,14,4,30,4,0,0,4,1,-15,3,1
2,0,19,0,30,4,9,0,13,2,30,7,1,0,8,0,30,4,9,0,13,5,30,5,8,0,13,1,30,9,0,0,9,1,-15,3,1
2,4,19,0,30,4,9,0,13,2,30,7,1,0,8,0,30,4,9,0,13,5,30,5,8,0,13,1,30,9,0,0,9,1,-15,3,1
2,4,23,2,30,6,7,0,13,1,30,6,0,0,6,6,30,13,0,0,13,0,30,6,7,0,13,2,30,5,1,0,6,1,-15,3,1
2,4,29,0,30,4,10,0,14,6,30,12,0,0,12,0,30,3,11,0,14,0,30,2,12,0,14,5,30,9,0,0,9,1,-15,3,1
2,4,31,3,30,6,6,0,12,4,30,8,0,0,8,5,30,10,2,0,12,0,30,5,7,0,12,0,30,5,1,0,6,1,-15,3,1
2,2,4,2,30,6,2,0,8,5,30,4,0,0,4,0,30,1,7,0,8,0,30,6,2,0,8,1,30,3,1,0,4,0,-27,3,0
2,3,4,2,30,6,2,0,8,5,30,4,0,0,4,0,30,1,7,0,8,0,30,6,2,0,8,1,30,3,1,0,4,0,-27,3,0
2,3,11,0,30,6,6,0,12,2,30,4,0,0,4,0,30,6,6,0,12,6,30,8,4,0,12,5,30,4,0,0,4,1,-15,3,1
2,4,11,0,30,6,6,0,12,2,30,4,0,0,4,0,30,6,6,0,12,6,30,8,4,0,12,5,30,4,0,0,4,1,-15,3,1
2,4,15,2,30,5,8,0,13,0,30,6,0,0,6,0,30,6,7,0,13,1,30,6,7,0,13,2,30,8,1,0,9,1,-15,3,1
2,2,17,3,30,6,8,0,14,2,30,6,0,0,6,0,30,6,8,0,14,1,30,6,8,0,14,5,30,4,0,0,4,1,-15,3,1
2,3,19,0,30,4,9,0,13,2,30,4,4,0,8,0,30,7,6,0,13,3,30,4,9,0,13,0,30,9,0,0,9,1,-15,3,1
2,2,25,1,30,11,3,0,14,4,30,6,0,0,6,0,30,8,6,0,14,1,30,5,9,0,14,3,30,6,0,0,6,1,-15,3,1
2,3,25,1,30,11,3,0,14,4,30,6,0,0,6,0,30,8,6,0,14,1,30,5,9,0,14,3,30,6,0,0,6,1,-15,3,1
2,2,27,0,30,4,11,0,15,4,30,1,1,0,2,0,30,7,8,0,15,0,30,6,9,0,15,3,30,5,1,0,6,1,-15,3,1
2,3,27,0,30,4,11,0,15,4,30,1,1,0,2,0,30,7,8,0,15,0,30,6,9,0,15,3,30,5,1,0,6,1,-15,3,1
2,0,29,0,30,5,9,0,14,4,30,12,0,0,12,0,30,5,9,0,14,0,30,0,14,0,14,0,30,9,0,0,9,1,-15,3,1
2,1,29,0,30,5,9,0,14,4,30,12,0,0,12,0,30,5,9,0,14,0,30,0,14,0,14,0,30,9,0,0,9,1,-15,3,1
2,3,29,0,30,5,9,0,14,4,30,12,0,0,12,0,30,5,9,0,14,0,30,0,14,0,14,0,30,9,0,0,9,1,-15,3,1
2,4,29,0,30,5,9,0,14,4,30,12,0,0,12,0,30,5,9,0,14,0,30,0,14,0,14,0,30,9,0,0,9,1,-15,3,1
2,2,33,1,30,2,9,0,11,6,30,4,0,0,4,1,30,7,4,0,11,0,30,5,6,0,11,6,30,4,0,0,4,1,-15,3,1
2,2,39,0,30,4,7,0,11,8,30,6,0,0,6,0,30,4,7,0,11,4,30,4,7,0,11,1,30,5,0,0,5,1,-15,3,1
2,0,41,1,30,9,3,0,12,8,30,8,0,0,8,0,30,3,9,0,12,0,30,4,8,0,12,2,30,4,3,0,7,1,-15,3,1
2,2,41,1,30,9,3,0,12,8,30,8,0,0,8,0,30,3,9,0,12,0,30,4,8,0,12,2,30,4,3,0,7,1,-15,3,1
2,3,41,1,30,9,3,0,12,8,30,8,0,0,8,0,30,3,9,0,12,0,30,4,8,0,12,2,30,4,3,0,7,1,-15,3,1
2,2,17,2,30,7,7,0,14,2,30,6,0,0,6,0,30,8,6,0,14,6,30,5,9,0,14,2,30,4,0,0,4,1,-15,3,1
2,1,25,1,30,9,5,0,14,2,30,6,0,0,6,0,30,9,5,0,14,3,30,6,8,0,14,2,30,5,1,0,6,1,-15,3,1
2,2,25,1,30,9,5,0,14,2,30,6,0,0,6,0,30,9,5,0,14,3,30,6,8,0,14,2,30,5,1,0,6,1,-15,3,1
2,4,25,1,30,9,5,0,14,0,30,6,0,0,6,0,30,9,5,0,14,3,30,6,8,0,14,2,30,5,1,0,6,1,-15,3,1
2,1,27,1,30,5,10,0,15,2,30,1,1,0,2,0,30,4,11,0,15,0,30,3,12,0,15,4,30,6,0,0,6,1,-15,3,1
2,3,27,1,30,5,10,0,15,2,30,1,1,0,2,0,30,4,11,0,15,0,30,3,12,0,15,4,30,6,0,0,6,1,-15,3,1
2,3,31,0,30,6,6,0,12,3,30,8,0,0,8,3,30,11,1,0,12,0,30,3,9,0,12,0,30,4,2,0,6,1,-15,3,1
2,3,1,0,30,7,3,0,10,4,30,2,0,0,2,2,30,5,5,0,10,6,30,8,2,0,10,4,30,6,0,0,6,0,-27,3,0
2,4,1,0,30,7,3,0,10,4,30,2,0,0,2,2,30,5,5,0,10,6,30,8,2,0,10,4,30,6,0,0,6,0,-27,3,0
2,0,4,3,30,6,2,0,8,5,30,4,0,0,4,0,30,1,7,0,8,0,30,5,3,0,8,2,30,4,0,0,4,0,-27,3,0
2,1,4,3,30,6,2,0,8,5,30,4,0,0,4,0,30,1,7,0,8,0,30,5,3,0,8,2,30,4,0,0,4,0,-27,3,0
2,3,6,1,30,9,0,0,9,4,30,2,0,0,2,0,30,2,7,0,9,0,30,3,6,0,9,0,30,4,1,0,5,0,-27,3,0
2,4,6,1,30,9,0,0,9,4,30,2,0,0,2,0,30,2,7,0,9,0,30,3,6,0,9,0,30,4,1,0,5,0,-27,3,0
2,4,13,1,30,6,1,0,7,0,30,4,0,0,4,2,30,6,1,0,7,9,30,6,1,0,7,3,30,4,0,0,4,1,-15,3,1
2,3,17,3,30,8,6,0,14,0,30,6,0,0,6,0,30,7,7,0,14,5,30,5,9,0,14,3,30,4,0,0,4,1,-15,3,1
2,4,17,3,30,8,6,0,14,0,30,6,0,0,6,0,30,7,7,0,14,5,30,5,9,0,14,3,30,4,0,0,4,1,-15,3,1
2,2,19,0,30,3,10,0,13,2,30,5,3,0,8,0,30,5,8,0,13,6,30,4,9,0,13,0,30,8,1,0,9,1,-15,3,1
2,4,23,2,30,5,8,0,13,0,30,6,0,0,6,2,30,13,0,0,13,0,30,5,8,0,13,2,30,5,1,0,6,1,-15,3,1
2,4,25,1,30,7,7,0,14,3,30,6,0,0,6,0,30,7,7,0,14,3,30,4,10,0,14,3,30,6,0,0,6,1,-15,3,1
2,4,27,1,30,4,11,0,15,2,30,2,0,0,2,0,30,9,6,0,15,0,30,4,11,0,15,2,30,6,0,0,6,1,-15,3,1
2,4,31,5,30,7,5,0,12,4,30,8,0,0,8,3,30,11,1,0,12,0,30,3,9,0,12,0,30,3,3,0,6,1,-15,3,1
2,3,8,1,30,7,0,0,7,3,30,2,0,0,2,3,30,4,3,0,7,1,30,7,0,0,7,3,30,3,0,0,3,0,-27,3,0
2,4,8,1,30,7,0,0,7,3,30,2,0,0,2,3,30,4,3,0,7,1,30,7,0,0,7,3,30,3,0,0,3,0,-27,3,0
2,3,17,3,30,8,6,0,14,2,30,6,0,0,6,0,30,6,8,0,14,1,30,5,9,0,14,6,30,4,0,0,4,1,-15,3,1
2,4,17,3,30,8,6,0,14,2,30,6,0,0,6,0,30,6,8,0,14,1,30,5,9,0,14,6,30,4,0,0,4,1,-15,3,1
2,2,19,0,30,3,10,0,13,2,30,7,1,0,8,0,30,6,7,0,13,7,30,4,9,0,13,0,30,9,0,0,9,1,-15,3,1
2,4,19,0,30,3,10,0,13,2,30,7,1,0,8,0,30,6,7,0,13,7,30,4,9,0,13,0,30,9,0,0,9,1,-15,3,1
2,4,22,1,30,7,1,0,8,3,30,2,0,0,2,3,30,4,4,0,8,1,30,3,5,0,8,2,30,2,2,0,4,1,-15,3,1
2,3,25,2,30,5,9,0,14,3,30,6,0,0,6,0,30,8,6,0,14,1,30,5,9,0,14,5,30,5,1,0,6,1,-15,3,1
2,4,25,2,30,5,9,0,14,3,30,6,0,0,6,0,30,8,6,0,14,1,30,5,9,0,14,5,30,5,1,0,6,1,-15,3,1
2,2,31,3,30,7,5,0,12,3,30,8,0,0,8,3,30,11,1,0,12,0,30,3,9,0,12,0,30,2,4,0,6,1,-15,3,1
2,2,19,1,30,7,6,0,13,2,30,7,1,0,8,0,30,4,9,0,13,0,30,7,6,0,13,1,30,7,2,0,9,1,-15,3,1
2,3,19,1,30,7,6,0,13,2,30,7,1,0,8,0,30,4,9,0,13,0,30,7,6,0,13,1,30,7,2,0,9,1,-15,3,1
2,1,23,1,30,6,7,0,13,2,30,6,0,0,6,9,30,13,0,0,13,0,30,5,8,0,13,2,30,5,1,0,6,1,-15,3,1
2,3,23,1,30,6,7,0,13,2,30,6,0,0,6,9,30,13,0,0,13,0,30,5,8,0,13,2,30,5,1,0,6,1,-15,3,1
2,3,25,1,30,5,9,0,14,3,30,6,0,0,6,0,30,8,6,0,14,1,30,7,7,0,14,4,30,6,0,0,6,1,-15,3,1
2,4,25,1,30,5,9,0,14,3,30,6,0,0,6,0,30,8,6,0,14,1,30,7,7,0,14,4,30,6,0,0,6,1,-15,3,1
2,0,27,1,30,4,11,0,15,2,30,1,1,0,2,0,30,5,10,0,15,1,30,4,11,0,15,4,30,6,0,0,6,1,-15,3,1
2,1,27,1,30,4,11,0,15,2,30,1,1,0,2,0,30,5,10,0,15,1,30,4,11,0,15,4,30,6,0,0,6,1,-15,3,1
2,4,29,0,30,4,10,0,14,6,30,12,0,0,12,0,30,4,10,0,14,0,30,3,11,0,14,0,30,9,0,0,9,1,-15,3,1
2,4,31,3,30,4,8,0,12,5,30,8,0,0,8,9,30,9,3,0,12,0,30,3,9,0,12,0,30,3,3,0,6,1,-15,3,1
2,2,33,1,30,3,8,0,11,5,30,4,0,0,4,2,30,11,0,0,11,2,30,5,6,0,11,5,30,4,0,0,4,1,-15,3,1
2,4,15,0,30,3,10,0,13,1,30,5,1,0,6,0,30,4,9,0,13,1,30,4,9,0,13,2,30,7,2,0,9,1,-15,3,1
2,1,17,2,30,10,4,0,14,3,30,6,0,0,6,0,30,5,9,0,14,1,30,8,6,0,14,5,30,4,0,0,4,1,-15,3,1
2,3,17,2,30,10,4,0,14,3,30,6,0,0,6,0,30,5,9,0,14,0,30,8,6,0,14,5,30,4,0,0,4,1,-15,3,1
2,3,21,1,30,7,3,0,10,4,30,6,0,0,6,1,30,3,7,0,10,0,30,4,6,0,10,5,30,4,0,0,4,1,-15,3,1
2,4,22,1,30,5,3,0,8,3,30,2,0,0,2,1,30,4,4,0,8,1,30,4,4,0,8,4,30,4,0,0,4,1,-15,3,1
2,4,25,1,30,5,9,0,14,5,30,6,0,0,6,0,30,4,10,0,14,1,30,9,5,0,14,4,30,6,0,0,6,1,-15,3,1
2,2,27,4,30,5,10,0,15,4,30,1,1,0,2,0,30,3,12,0,15,0,30,4,11,0,15,2,30,6,0,0,6,1,-15,3,1
2,4,32,0,30,5,4,0,9,5,30,2,0,0,2,5,30,7,2,0,9,1,30,3,6,0,9,0,30,2,0,0,2,1,-15,3,1
2,2,6,0,30,5,4,0,9,4,30,2,0,0,2,0,30,2,7,0,9,0,30,4,5,0,9,0,30,5,0,0,5,0,-27,3,0
2,2,13,1,30,4,3,0,7,0,30,4,0,0,4,4,30,7,0,0,7,12,30,6,1,0,7,3,30,4,0,0,4,1,-15,3,1
2,1,17,4,30,11,3,0,14,3,30,6,0,0,6,0,30,5,9,0,14,2,30,6,8,0,14,1,30,4,0,0,4,1,-15,3,1
2,3,17,4,30,11,3,0,14,3,30,6,0,0,6,0,30,5,9,0,14,2,30,6,8,0,14,1,30,4,0,0,4,1,-15,3,1
2,2,19,0,30,4,9,0,13,1,30,7,1,0,8,0,30,7,6,0,13,4,30,5,8,0,13,0,30,7,2,0,9,1,-15,3,1
2,3,19,0,30,4,9,0,13,1,30,7,1,0,8,0,30,7,6,0,13,4,30,5,8,0,13,0,30,7,2,0,9,1,-15,3,1
2,4,22,2,30,6,2,0,8,2,30,2,0,0,2,0,30,6,2,0,8,1,30,3,5,0,8,3,30,2,2,0,4,1,-15,3,1
2,3,31,2,30,6,6,0,12,4,30,8,0,0,8,3,30,12,0,0,12,0,30,3,9,0,12,1,30,4,2,0,6,1,-15,3,1
2,4,31,2,30,6,6,0,12,4,30,8,0,0,8,3,30,12,0,0,12,0,30,3,9,0,12,1,30,4,2,0,6,1,-15,3,1
2,4,39,0,30,3,8,0,11,7,30,6,0,0,6,0,30,5,6,0,11,1,30,4,7,0,11,3,30,5,0,0,5,1,-15,3,1
2,4,22,2,30,8,0,0,8,3,30,2,0,0,2,0,30,4,4,0,8,0,30,2,6,0,8,0,30,3,1,0,4,1,-15,3,1
2,4,23,2,30,7,6,0,13,0,30,6,0,0,6,4,30,11,2,0,13,0,30,5,8,0,13,2,30,6,0,0,6,1,-15,3,1
2,0,27,4,30,10,5,0,15,4,30,2,0,0,2,0,30,2,13,0,15,0,30,6,9,0,15,1,30,4,2,0,6,1,-15,3,1
2,1,4,2,30,8,0,0,8,5,30,4,0,0,4,0,30,2,6,0,8,0,30,6,2,0,8,3,30,3,1,0,4,0,-27,3,0
2,3,5,0,30,4,1,0,5,3,30,2,2,0,4,0,30,0,5,0,5,3,30,1,4,0,5,0,30,2,0,0,2,0,-27,3,0
2,1,17,3,30,9,5,0,14,3,30,6,0,0,6,0,30,4,10,0,14,1,30,8,6,0,14,4,30,4,0,0,4,1,-15,3,1
2,3,21,2,30,7,3,0,10,4,30,6,0,0,6,1,30,3,7,0,10,1,30,5,5,0,10,3,30,4,0,0,4,1,-15,3,1
2,2,23,2,30,5,8,0,13,3,30,6,0,0,6,5,30,13,0,0,13,0,30,6,7,0,13,2,30,6,0,0,6,1,-15,3,1
2,2,29,0,30,6,8,0,14,6,30,12,0,0,12,0,30,2,12,0,14,0,30,1,13,0,14,1,30,9,0,0,9,1,-15,3,1
2,4,39,0,30,3,8,0,11,6,30,6,0,0,6,0,30,5,6,0,11,1,30,3,8,0,11,6,30,5,0,0,5,1,-15,3,1
2,1,4,2,30,7,1,0,8,4,30,4,0,0,4,1,30,4,4,0,8,0,30,6,2,0,8,1,30,3,1,0,4,0,-27,3,0
2,3,4,2,30,7,1,0,8,4,30,4,0,0,4,1,30,4,4,0,8,0,30,6,2,0,8,1,30,3,1,0,4,0,-27,3,0
2,4,4,2,30,7,1,0,8,4,30,4,0,0,4,1,30,4,4,0,8,0,30,6,2,0,8,1,30,3,1,0,4,0,-27,3,0
2,1,13,1,30,6,1,0,7,0,30,4,0,0,4,2,30,7,0,0,7,10,30,4,3,0,7,3,30,4,0,0,4,1,-15,3,1
2,3,17,0,30,11,3,0,14,2,30,6,0,0,6,1,30,7,7,0,14,2,30,4,10,0,14,5,30,4,0,0,4,1,-15,3,1
2,1,19,0,30,2,11,0,13,3,30,4,4,0,8,0,30,5,8,0,13,9,30,5,8,0,13,1,30,9,0,0,9,1,-15,3,1
2,2,19,0,30,2,11,0,13,3,30,4,4,0,8,0,30,5,8,0,13,9,30,5,8,0,13,1,30,9,0,0,9,1,-15,3,1
2,4,19,0,30,2,11,0,13,3,30,4,4,0,8,0,30,5,8,0,13,9,30,5,8,0,13,1,30,9,0,0,9,1,-15,3,1
2,2,21,2,30,8,2,0,10,3,30,6,0,0,6,1,30,4,6,0,10,4,30,4,6,0,10,1,30,4,0,0,4,1,-15,3,1
2,3,23,1,30,6,7,0,13,2,30,6,0,0,6,4,30,10,3,0,13,1,30,6,7,0,13,1,30,6,0,0,6,1,-15,3,1
2,4,25,1,30,8,6,0,14,4,30,6,0,0,6,0,30,7,7,0,14,1,30,5,9,0,14,3,30,5,1,0,6,1,-15,3,1
2,1,27,1,30,4,11,0,15,5,30,2,0,0,2,0,30,2,13,0,15,1,30,5,10,0,15,5,30,6,0,0,6,1,-15,3,1
2,2,27,1,30,4,11,0,15,5,30,2,0,0,2,0,30,2,13,0,15,1,30,5,10,0,15,5,30,6,0,0,6,1,-15,3,1
2,3,27,1,30,4,11,0,15,5,30,2,0,0,2,0,30,2,13,0,15,1,30,5,10,0,15,5,30,6,0,0,6,1,-15,3,1
2,2,29,0,30,8,6,0,14,5,30,10,2,0,12,0,30,5,9,0,14,0,30,1,13,0,14,1,30,9,0,0,9,1,-15,3,1
2,4,29,0,30,8,6,0,14,5,30,10,2,0,12,0,30,5,9,0,14,0,30,1,13,0,14,1,30,9,0,0,9,1,-15,3,1
2,2,39,0,30,3,8,0,11,6,30,6,0,0,6,0,30,7,4,0,11,0,30,2,9,0,11,5,30,5,0,0,5,1,-15,3,1
2,3,39,0,30,3,8,0,11,6,30,6,0,0,6,0,30,7,4,0,11,0,30,2,9,0,11,5,30,5,0,0,5,1,-15,3,1
2,0,5,0,30,2,3,0,5,3,30,2,2,0,4,3,30,0,5,0,5,0,30,3,2,0,5,0,30,0,2,0,2,0,-27,3,0
2,2,5,0,30,2,3,0,5,3,30,2,2,0,4,3,30,0,5,0,5,0,30,3,2,0,5,0,30,0,2,0,2,0,-27,3,0
2,4,5,0,30,2,3,0,5,3,30,2,2,0,4,3,30,0,5,0,5,0,30,3,2,0,5,0,30,0,2,0,2,0,-27,3,0
2,1,13,3,30,7,0,0,7,0,30,4,0,0,4,4,30,6,1,0,7,7,30,6,1,0,7,5,30,4,0,0,4,1,-15,3,1
2,2,17,1,30,9,5,0,14,2,30,6,0,0,6,0,30,7,7,0,14,2,30,10,4,0,14,6,30,4,0,0,4,1,-15,3,1
2,3,17,1,30,9,5,0,14,2,30,6,0,0,6,0,30,7,7,0,14,2,30,10,4,0,14,6,30,4,0,0,4,1,-15,3,1
2,1,19,1,30,6,7,0,13,2,30,2,6,0,8,0,30,6,7,0,13,4,30,4,9,0,13,0,30,9,0,0,9,1,-15,3,1
2,2,19,1,30,6,7,0,13,2,30,2,6,0,8,0,30,6,7,0,13,4,30,4,9,0,13,0,30,9,0,0,9,1,-15,3,1
2,1,23,1,30,4,9,0,13,5,30,6,0,0,6,13,30,6,7,0,13,1,30,7,6,0,13,0,30,6,0,0,6,1,-15,3,1
2,1,25,2,30,5,9,0,14,2,30,6,0,0,6,0,30,9,5,0,14,2,30,6,8,0,14,4,30,4,2,0,6,1,-15,3,1
2,2,25,2,30,5,9,0,14,2,30,6,0,0,6,0,30,9,5,0,14,2,30,6,8,0,14,4,30,4,2,0,6,1,-15,3,1
2,3,25,2,30,5,9,0,14,2,30,6,0,0,6,0,30,9,5,0,14,2,30,6,8,0,14,4,30,4,2,0,6,1,-15,3,1
2,0,27,1,30,5,10,0,15,4,30,2,0,0,2,0,30,4,11,0,15,2,30,6,9,0,15,6,30,6,0,0,6,1,-15,3,1
2,3,27,1,30,5,10,0,15,4,30,2,0,0,2,0,30,4,11,0,15,2,30,6,9,0,15,0,30,6,0,0,6,1,-15,3,1
2,4,27,1,30,5,10,0,15,4,30,2,0,0,2,0,30,4,11,0,15,2,30,6,9,0,15,0,30,6,0,0,6,1,-15,3,1
2,2,29,0,30,8,6,0,14,6,30,10,2,0,12,0,30,3,11,0,14,0,30,1,13,0,14,5,30,9,0,0,9,1,-15,3,1
2,3,29,0,30,8,6,0,14,6,30,10,2,0,12,0,30,3,11,0,14,0,30,1,13,0,14,5,30,9,0,0,9,1,-15,3,1
2,1,31,5,30,5,7,0,12,5,30,8,0,0,8,3,30,10,2,0,12,3,30,5,7,0,12,0,30,4,2,0,6,1,-15,3,1
2,4,5,0,30,1,4,0,5,2,30,2,2,0,4,0,30,0,5,0,5,0,30,1,4,0,5,0,30,2,0,0,2,0,-27,3,0
2,3,19,0,30,3,10,0,13,2,30,2,6,0,8,0,30,4,9,0,13,3,30,4,9,0,13,0,30,6,3,0,9,1,-15,3,1
2,4,19,0,30,3,10,0,13,2,30,2,6,0,8,0,30,4,9,0,13,3,30,4,9,0,13,0,30,6,3,0,9,1,-15,3,1
2,3,25,0,30,5,9,0,14,3,30,6,0,0,6,0,30,7,7,0,14,2,30,10,4,0,14,7,30,5,1,0,6,1,-15,3,1
2,1,27,1,30,6,9,0,15,4,30,1,1,0,2,0,30,6,9,0,15,3,30,5,10,0,15,3,30,6,0,0,6,1,-15,3,1
2,0,37,0,30,7,4,0,11,5,30,8,0,0,8,0,30,7,4,0,11,4,30,3,8,0,11,6,30,6,0,0,6,1,-15,3,1
2,2,37,0,30,7,4,0,11,5,30,8,0,0,8,0,30,7,4,0,11,4,30,3,8,0,11,6,30,6,0,0,6,1,-15,3,1
2,4,37,0,30,7,4,0,11,5,30,8,0,0,8,0,30,7,4,0,11,4,30,3,8,0,11,6,30,6,0,0,6,1,-15,3,1
2,3,15,2,30,5,8,0,13,1,30,6,0,0,6,0,30,3,10,0,13,1,30,5,8,0,13,0,30,7,2,0,9,1,-15,3,1
2,4,15,2,30,5,8,0,13,1,30,6,0,0,6,0,30,3,10,0,13,1,30,5,8,0,13,0,30,7,2,0,9,1,-15,3,1
2,4,17,4,30,8,6,0,14,2,30,6,0,0,6,0,30,8,6,0,14,2,30,5,9,0,14,2,30,4,0,0,4,1,-15,3,1
2,1,19,0,30,3,10,0,13,2,30,5,3,0,8,0,30,7,6,0,13,1,30,4,9,0,13,0,30,8,1,0,9,1,-15,3,1
2,3,25,3,30,4,10,0,14,4,30,6,0,0,6,0,30,7,7,0,14,1,30,5,9,0,14,5,30,5,1,0,6,1,-15,3,1
2,0,4,2,30,7,1,0,8,4,30,2,2,0,4,0,30,3,5,0,8,0,30,1,7,0,8,2,30,4,0,0,4,0,-27,3,0
2,1,5,0,30,0,5,0,5,2,30,3,1,0,4,0,30,0,5,0,5,0,30,2,3,0,5,0,30,0,2,0,2,0,-27,3,0
2,2,5,0,30,0,5,0,5,2,30,3,1,0,4,0,30,0,5,0,5,0,30,2,3,0,5,0,30,0,2,0,2,0,-27,3,0
2,4,5,0,30,0,5,0,5,2,30,3,1,0,4,0,30,0,5,0,5,0,30,2,3,0,5,0,30,0,2,0,2,0,-27,3,0
2,3,8,3,30,7,0,0,7,4,30,2,0,0,2,3,30,4,3,0,7,0,30,7,0,0,7,2,30,3,0,0,3,0,-27,3,0
2,1,23,1,30,3,10,0,13,2,30,6,0,0,6,0,30,9,4,0,13,5,30,8,5,0,13,6,30,6,0,0,6,1,-15,3,1
2,4,23,1,30,3,10,0,13,2,30,6,0,0,6,0,30,9,4,0,13,5,30,8,5,0,13,6,30,6,0,0,6,1,-15,3,1
2,3,25,1,30,11,3,0,14,4,30,6,0,0,6,0,30,3,11,0,14,3,30,7,7,0,14,1,30,6,0,0,6,1,-15,3,1
2,1,26,0,30,4,5,0,9,4,30,4,0,0,4,2,30,6,3,0,9,1,30,6,3,0,9,6,30,2,1,0,3,1,-15,3,1
2,3,29,0,30,4,10,0,14,3,30,11,1,0,12,1,30,10,4,0,14,0,30,0,14,0,14,1,30,9,0,0,9,1,-15,3,1
2,0,31,3,30,7,5,0,12,5,30,8,0,0,8,3,30,8,4,0,12,0,30,3,9,0,12,2,30,6,0,0,6,1,-15,3,1
2,3,11,0,30,1,3,0,4,0,30,0,0,0,0,2,30,4,0,0,4,4,30,2,2,0,4,1,30,1,0,0,1,1,-15,3,1
2,4,11,0,30,1,3,0,4,0,30,0,0,0,0,2,30,4,0,0,4,4,30,2,2,0,4,1,30,1,0,0,1,1,-15,3,1
2,4,23,1,30,5,8,0,13,3,30,6,0,0,6,2,30,12,1,0,13,0,30,4,9,0,13,3,30,6,0,0,6,1,-15,3,1
2,2,25,0,30,5,9,0,14,3,30,6,0,0,6,0,30,11,3,0,14,3,30,5,9,0,14,3,30,5,1,0,6,1,-15,3,1
2,3,25,0,30,5,9,0,14,3,30,6,0,0,6,0,30,11,3,0,14,3,30,5,9,0,14,3,30,5,1,0,6,1,-15,3,1
2,2,27,1,30,8,7,0,15,4,30,1,1,0,2,0,30,5,10,0,15,0,30,3,12,0,15,5,30,6,0,0,6,1,-15,3,1
2,4,29,7,30,4,10,0,14,6,30,11,1,0,12,0,30,2,12,0,14,0,30,1,13,0,14,0,30,6,3,0,9,1,-15,3,1
2,4,32,0,30,8,1,0,9,4,30,2,0,0,2,5,30,9,0,0,9,1,30,2,7,0,9,3,30,2,0,0,2,1,-15,3,1
2,4,39,0,30,2,9,0,11,7,30,6,0,0,6,0,30,6,5,0,11,0,30,6,5,0,11,6,30,5,0,0,5,1,-15,3,1
2,4,4,2,30,6,2,0,8,4,30,4,0,0,4,0,30,5,3,0,8,1,30,5,3,0,8,1,30,3,1,0,4,0,-27,3,0
2,1,13,1,30,4,3,0,7,0,30,4,0,0,4,4,30,5,2,0,7,10,30,6,1,0,7,4,30,4,0,0,4,1,-15,3,1
2,2,13,1,30,4,3,0,7,0,30,4,0,0,4,4,30,5,2,0,7,10,30,6,1,0,7,4,30,4,0,0,4,1,-15,3,1
2,4,13,1,30,4,3,0,7,0,30,4,0,0,4,4,30,5,2,0,7,10,30,6,1,0,7,4,30,4,0,0,4,1,-15,3,1
2,1,19,0,30,3,10,0,13,2,30,5,3,0,8,0,30,6,7,0,13,5,30,4,9,0,13,1,30,9,0,0,9,1,-15,3,1
2,2,19,0,30,3,10,0,13,2,30,5,3,0,8,0,30,6,7,0,13,5,30,4,9,0,13,1,30,9,0,0,9,1,-15,3,1
2,4,19,0,30,3,10,0,13,2,30,5,3,0,8,0,30,6,7,0,13,5,30,4,9,0,13,1,30,9,0,0,9,1,-15,3,1
2,4,23,0,30,5,8,0,13,2,30,6,0,0,6,5,30,10,3,0,13,2,30,6,7,0,13,3,30,6,0,0,6,1,-15,3,1
2,3,25,1,30,8,6,0,14,3,30,6,0,0,6,0,30,4,10,0,14,1,30,7,7,0,14,5,30,5,1,0,6,1,-15,3,1
2,3,27,1,30,6,9,0,15,2,30,2,0,0,2,0,30,8,7,0,15,0,30,5,10,0,15,1,30,5,1,0,6,1,-15,3,1
2,3,31,3,30,8,4,0,12,3,30,8,0,0,8,4,30,11,1,0,12,0,30,3,9,0,12,0,30,1,5,0,6,1,-15,3,1
2,1,5,1,30,2,3,0,5,3,30,0,4,0,4,0,30,0,5,0,5,0,30,1,4,0,5,0,30,0,2,0,2,0,-27,3,0
2,4,5,1,30,2,3,0,5,3,30,0,4,0,4,0,30,0,5,0,5,0,30,1,4,0,5,0,30,0,2,0,2,0,-27,3,0
2,1,13,1,30,5,2,0,7,0,30,4,0,0,4,3,30,7,0,0,7,8,30,7,0,0,7,2,30,4,0,0,4,1,-15,3,1
2,2,13,1,30,5,2,0,7,0,30,4,0,0,4,3,30,7,0,0,7,8,30,7,0,0,7,2,30,4,0,0,4,1,-15,3,1
2,4,13,1,30,5,2,0,7,0,30,4,0,0,4,3,30,7,0,0,7,8,30,7,0,0,7,2,30,4,0,0,4,1,-15,3,1
2,1,17,3,30,8,6,0,14,2,30,6,0,0,6,0,30,5,9,0,14,5,30,7,7,0,14,4,30,4,0,0,4,1,-15,3,1
2,2,17,3,30,8,6,0,14,2,30,6,0,0,6,0,30,5,9,0,14,5,30,7,7,0,14,4,30,4,0,0,4,1,-15,3,1
2,3,19,0,30,5,8,0,13,2,30,4,4,0,8,0,30,7,6,0,13,0,30,3,10,0,13,2,30,7,2,0,9,1,-15,3,1
2,3,23,1,30,5,8,0,13,5,30,6,0,0,6,9,30,8,5,0,13,0,30,4,9,0,13,2,30,6,0,0,6,1,-15,3,1
2,2,25,0,30,5,9,0,14,4,30,6,0,0,6,0,30,8,6,0,14,1,30,9,5,0,14,3,30,5,1,0,6,1,-15,3,1
2,2,27,1,30,5,10,0,15,4,30,2,0,0,2,0,30,2,13,0,15,0,30,6,9,0,15,5,30,6,0,0,6,1,-15,3,1
2,3,27,1,30,5,10,0,15,4,30,2,0,0,2,0,30,2,13,0,15,0,30,6,9,0,15,5,30,6,0,0,6,1,-15,3,1
2,4,27,1,30,5,10,0,15,4,30,2,0,0,2,0,30,2,13,0,15,0,30,6,9,0,15,5,30,6,0,0,6,1,-15,3,1
2,4,29,0,30,5,9,0,14,6,30,10,2,0,12,0,30,3,11,0,14,0,30,1,13,0,14,3,30,9,0,0,9,1,-15,3,1
2,3,43,0,30,8,6,0,14,6,30,6,0,0,6,0,30,4,10,0,14,1,30,3,11,0,14,6,30,5,0,0,5,1,-15,3,1
2,1,11,2,30,5,7,0,12,0,30,4,0,0,4,0,30,6,6,0,12,7,30,4,8,0,12,7,30,4,0,0,4,1,-15,3,1
2,2,13,9,30,7,0,0,7,2,30,4,0,0,4,2,30,4,3,0,7,4,30,6,1,0,7,6,30,4,0,0,4,1,-15,3,1
2,1,19,0,30,5,8,0,13,1,30,6,2,0,8,0,30,10,3,0,13,0,30,3,10,0,13,1,30,8,1,0,9,1,-15,3,1
2,2,19,0,30,5,8,0,13,1,30,6,2,0,8,0,30,10,3,0,13,0,30,3,10,0,13,1,30,8,1,0,9,1,-15,3,1
2,4,25,1,30,7,7,0,14,3,30,6,0,0,6,1,30,7,7,0,14,1,30,5,9,0,14,3,30,4,2,0,6,1,-15,3,1
2,0,27,1,30,4,11,0,15,4,30,2,0,0,2,0,30,7,8,0,15,1,30,5,10,0,15,6,30,6,0,0,6,1,-15,3,1
2,2,27,1,30,4,11,0,15,4,30,2,0,0,2,0,30,7,8,0,15,1,30,5,10,0,15,6,30,6,0,0,6,1,-15,3,1
2,0,29,0,30,7,7,0,14,6,30,9,3,0,12,0,30,3,11,0,14,0,30,3,11,0,14,4,30,9,0,0,9,1,-15,3,1
2,1,29,0,30,7,7,0,14,6,30,9,3,0,12,0,30,3,11,0,14,0,30,3,11,0,14,4,30,9,0,0,9,1,-15,3,1
2,3,29,0,30,7,7,0,14,6,30,9,3,0,12,0,30,3,11,0,14,0,30,3,11,0,14,4,30,9,0,0,9,1,-15,3,1
2,0,37,1,30,8,3,0,11,6,30,8,0,0,8,0,30,5,6,0,11,2,30,5,6,0,11,7,30,6,0,0,6,1,-15,3,1
2,1,37,1,30,8,3,0,11,6,30,8,0,0,8,0,30,5,6,0,11,2,30,5,6,0,11,7,30,6,0,0,6,1,-15,3,1
2,2,43,0,30,5,9,0,14,9,30,6,0,0,6,0,30,4,10,0,14,1,30,8,6,0,14,6,30,5,0,0,5,1,-15,3,1
2,2,5,0,30,0,5,0,5,3,30,1,3,0,4,0,30,0,5,0,5,3,30,3,2,0,5,2,30,2,0,0,2,0,-27,3,0
2,2,13,3,30,7,0,0,7,0,30,4,0,0,4,2,30,6,1,0,7,3,30,6,1,0,7,7,30,4,0,0,4,1,-15,3,1
2,4,17,0,30,8,6,0,14,1,30,6,0,0,6,0,30,9,5,0,14,3,30,6,8,0,14,4,30,4,0,0,4,1,-15,3,1
2,0,19,0,30,5,8,0,13,2,30,2,6,0,8,0,30,7,6,0,13,10,30,4,9,0,13,2,30,9,0,0,9,1,-15,3,1
2,4,19,0,30,5,8,0,13,2,30,2,6,0,8,0,30,7,6,0,13,10,30,4,9,0,13,2,30,9,0,0,9,1,-15,3,1
2,2,25,1,30,5,9,0,14,3,30,6,0,0,6,0,30,11,3,0,14,1,30,7,7,0,14,3,30,6,0,0,6,1,-15,3,1
2,3,25,1,30,5,9,0,14,3,30,6,0,0,6,0,30,11,3,0,14,1,30,7,7,0,14,3,30,6,0,0,6,1,-15,3,1
2,4,25,1,30,5,9,0,14,3,30,6,0,0,6,0,30,11,3,0,14,1,30,7,7,0,14,3,30,6,0,0,6,1,-15,3,1
2,0,27,1,30,5,10,0,15,3,30,1,1,0,2,0,30,6,9,0,15,0,30,6,9,0,15,3,30,6,0,0,6,1,-15,3,1
2,2,27,0,30,5,10,0,15,3,30,1,1,0,2,0,30,6,9,0,15,0,30,6,9,0,15,3,30,6,0,0,6,1,-15,3,1
2,4,27,0,30,5,10,0,15,3,30,1,1,0,2,0,30,6,9,0,15,0,30,6,9,0,15,3,30,6,0,0,6,1,-15,3,1
2,2,11,1,30,7,5,0,12,2,30,4,0,0,4,0,30,5,7,0,12,6,30,8,4,0,12,8,30,4,0,0,4,1,-15,3,1
2,3,11,1,30,7,5,0,12,2,30,4,0,0,4,0,30,5,7,0,12,6,30,8,4,0,12,8,30,4,0,0,4,1,-15,3,1
2,4,17,3,30,10,4,0,14,3,30,6,0,0,6,0,30,5,9,0,14,1,30,5,9,0,14,0,30,4,0,0,4,1,-15,3,1
2,3,19,0,30,3,10,0,13,1,30,6,2,0,8,0,30,9,4,0,13,2,30,5,8,0,13,1,30,8,1,0,9,1,-15,3,1
2,4,19,0,30,3,10,0,13,1,30,6,2,0,8,0,30,9,4,0,13,2,30,5,8,0,13,1,30,8,1,0,9,1,-15,3,1
2,3,23,3,30,5,8,0,13,3,30,6,0,0,6,9,30,13,0,0,13,0,30,4,9,0,13,2,30,6,0,0,6,1,-15,3,1
2,3,25,1,30,8,6,0,14,3,30,6,0,0,6,0,30,5,9,0,14,1,30,5,9,0,14,4,30,5,1,0,6,1,-15,3,1
2,4,25,1,30,8,6,0,14,3,30,6,0,0,6,0,30,5,9,0,14,1,30,5,9,0,14,4,30,5,1,0,6,1,-15,3,1
2,2,27,1,30,4,11,0,15,1,30,1,1,0,2,0,30,7,8,0,15,2,30,4,11,0,15,3,30,6,0,0,6,1,-15,3,1
2,4,27,1,30,4,11,0,15,1,30,1,1,0,2,0,30,7,8,0,15,0,30,4,11,0,15,3,30,6,0,0,6,1,-15,3,1
2,4,29,0,30,5,9,0,14,6,30,11,1,0,12,0,30,3,11,0,14,0,30,0,14,0,14,0,30,9,0,0,9,1,-15,3,1
2,4,31,4,30,7,5,0,12,5,30,8,0,0,8,7,30,9,3,0,12,0,30,3,9,0,12,0,30,4,2,0,6,1,-15,3,1
2,0,4,2,30,5,3,0,8,5,30,3,1,0,4,0,30,2,6,0,8,1,30,8,0,0,8,1,30,4,0,0,4,0,-27,3,0
2,2,4,2,30,5,3,0,8,5,30,3,1,0,4,0,30,2,6,0,8,1,30,8,0,0,8,1,30,4,0,0,4,0,-27,3,0
2,1,7,0,30,2,2,0,4,2,30,2,0,0,2,0,30,1,3,0,4,0,30,1,3,0,4,3,30,1,1,0,2,0,-27,3,0
2,4,15,0,30,4,9,0,13,0,30,6,0,0,6,0,30,6,7,0,13,2,30,4,9,0,13,2,30,8,1,0,9,1,-15,3,1
2,2,17,1,30,6,8,0,14,3,30,6,0,0,6,0,30,5,9,0,14,4,30,8,6,0,14,6,30,4,0,0,4,1,-15,3,1
2,4,17,1,30,6,8,0,14,3,30,6,0,0,6,0,30,5,9,0,14,2,30,8,6,0,14,6,30,4,0,0,4,1,-15,3,1
2,1,19,1,30,8,5,0,13,2,30,2,6,0,8,0,30,4,9,0,13,7,30,3,10,0,13,2,30,9,0,0,9,1,-15,3,1
2,2,19,1,30,8,5,0,13,2,30,2,6,0,8,0,30,4,9,0,13,7,30,3,10,0,13,2,30,9,0,0,9,1,-15,3,1
2,4,19,1,30,8,5,0,13,2,30,2,6,0,8,0,30,4,9,0,13,7,30,3,10,0,13,2,30,9,0,0,9,1,-15,3,1
2,1,25,1,30,3,11,0,14,4,30,6,0,0,6,0,30,8,6,0,14,2,30,6,8,0,14,5,30,6,0,0,6,1,-15,3,1
2,2,25,1,30,3,11,0,14,4,30,6,0,0,6,0,30,8,6,0,14,2,30,6,8,0,14,5,30,6,0,0,6,1,-15,3,1
2,3,25,1,30,3,11,0,14,4,30,6,0,0,6,0,30,8,6,0,14,2,30,6,8,0,14,5,30,6,0,0,6,1,-15,3,1
2,3,27,1,30,7,8,0,15,5,30,1,1,0,2,0,30,3,12,0,15,0,30,4,11,0,15,5,30,6,0,0,6,1,-15,3,1
2,1,31,1,30,9,3,0,12,4,30,8,0,0,8,3,30,10,2,0,12,0,30,3,9,0,12,0,30,5,1,0,6,1,-15,3,1
2,3,35,2,30,6,7,0,13,4,30,2,0,0,2,1,30,11,2,0,13,0,30,3,10,0,13,4,30,8,0,0,8,1,-15,3,1
2,4,13,0,30,6,1,0,7,0,30,4,0,0,4,2,30,6,1,0,7,9,30,6,1,0,7,3,30,4,0,0,4,1,-15,3,1
2,2,15,0,30,3,10,0,13,0,30,6,0,0,6,0,30,7,6,0,13,1,30,6,7,0,13,3,30,7,2,0,9,1,-15,3,1
2,2,19,0,30,4,9,0,13,2,30,8,0,0,8,4,30,4,9,0,13,0,30,5,8,0,13,1,30,6,3,0,9,1,-15,3,1
2,4,19,0,30,4,9,0,13,2,30,8,0,0,8,4,30,4,9,0,13,0,30,5,8,0,13,1,30,6,3,0,9,1,-15,3,1
2,4,23,1,30,6,7,0,13,0,30,6,0,0,6,3,30,13,0,0,13,0,30,5,8,0,13,4,30,6,0,0,6,1,-15,3,1
2,0,25,1,30,3,11,0,14,5,30,6,0,0,6,0,30,6,8,0,14,1,30,6,8,0,14,5,30,6,0,0,6,1,-15,3,1
2,1,25,1,30,3,11,0,14,5,30,6,0,0,6,0,30,6,8,0,14,1,30,6,8,0,14,5,30,6,0,0,6,1,-15,3,1
2,2,25,1,30,3,11,0,14,5,30,6,0,0,6,0,30,6,8,0,14,1,30,6,8,0,14,5,30,6,0,0,6,1,-15,3,1
2,4,25,1,30,3,11,0,14,5,30,6,0,0,6,0,30,6,8,0,14,1,30,6,8,0,14,5,30,6,0,0,6,1,-15,3,1
2,4,27,4,30,5,10,0,15,3,30,1,1,0,2,0,30,6,9,0,15,0,30,3,12,0,15,0,30,6,0,0,6,1,-15,3,1
2,4,29,0,30,3,11,0,14,6,30,12,0,0,12,0,30,3,11,0,14,0,30,0,14,0,14,3,30,9,0,0,9,1,-15,3,1
2,0,37,0,30,7,4,0,11,7,30,8,0,0,8,0,30,3,8,0,11,6,30,3,8,0,11,8,30,6,0,0,6,1,-15,3,1
2,3,11,0,30,1,3,0,4,0,30,0,0,0,0,0,30,2,2,0,4,5,30,4,0,0,4,3,30,1,0,0,1,1,-15,3,1
2,4,13,2,30,3,0,0,3,0,30,2,0,0,2,0,30,3,0,0,3,8,30,2,1,0,3,5,30,2,0,0,2,1,-15,3,1
2,2,13,4,30,7,0,0,7,0,30,4,0,0,4,2,30,6,1,0,7,8,30,6,1,0,7,5,30,4,0,0,4,1,-15,3,1
2,4,13,4,30,7,0,0,7,0,30,4,0,0,4,2,30,6,1,0,7,8,30,6,1,0,7,5,30,4,0,0,4,1,-15,3,1
2,4,17,1,30,9,5,0,14,3,30,6,0,0,6,0,30,6,8,0,14,4,30,7,7,0,14,0,30,4,0,0,4,1,-15,3,1
2,4,19,0,30,7,6,0,13,2,30,5,3,0,8,4,30,4,9,0,13,0,30,5,8,0,13,1,30,8,1,0,9,1,-15,3,1
2,4,21,2,30,6,4,0,10,4,30,6,0,0,6,1,30,3,7,0,10,3,30,5,5,0,10,2,30,4,0,0,4,1,-15,3,1
2,2,39,0,30,5,6,0,11,6,30,6,0,0,6,0,30,4,7,0,11,0,30,2,9,0,11,5,30,5,0,0,5,1,-15,3,1
2,4,43,1,30,10,4,0,14,8,30,6,0,0,6,0,30,4,10,0,14,1,30,1,13,0,14,3,30,5,0,0,5,1,-15,3,1
2,3,6,2,30,9,0,0,9,4,30,2,0,0,2,0,30,2,7,0,9,0,30,4,5,0,9,0,30,4,1,0,5,0,-27,3,0
2,4,6,2,30,9,0,0,9,4,30,2,0,0,2,0,30,2,7,0,9,0,30,4,5,0,9,0,30,4,1,0,5,0,-27,3,0
2,2,13,3,30,5,2,0,7,0,30,4,0,0,4,2,30,6,1,0,7,9,30,5,2,0,7,6,30,4,0,0,4,1,-15,3,1
2,1,17,3,30,13,1,0,14,2,30,6,0,0,6,0,30,6,8,0,14,1,30,3,11,0,14,3,30,4,0,0,4,1,-15,3,1
2,3,17,3,30,13,1,0,14,2,30,6,0,0,6,0,30,6,8,0,14,1,30,3,11,0,14,3,30,4,0,0,4,1,-15,3,1
2,1,19,0,30,1,12,0,13,2,30,6,2,0,8,0,30,6,7,0,13,4,30,4,9,0,13,1,30,7,2,0,9,1,-15,3,1
2,2,19,0,30,1,12,0,13,2,30,6,2,0,8,0,30,6,7,0,13,4,30,4,9,0,13,1,30,7,2,0,9,1,-15,3,1
2,4,19,0,30,1,12,0,13,2,30,6,2,0,8,0,30,6,7,0,13,4,30,4,9,0,13,1,30,7,2,0,9,1,-15,3,1
2,3,25,1,30,8,6,0,14,4,30,6,0,0,6,0,30,8,6,0,14,1,30,5,9,0,14,4,30,5,1,0,6,1,-15,3,1
2,4,25,1,30,8,6,0,14,4,30,6,0,0,6,0,30,8,6,0,14,1,30,5,9,0,14,4,30,5,1,0,6,1,-15,3,1
2,0,27,1,30,4,11,0,15,2,30,2,0,0,2,0,30,4,11,0,15,4,30,4,11,0,15,5,30,6,0,0,6,1,-15,3,1
2,2,27,1,30,4,11,0,15,2,30,2,0,0,2,0,30,4,11,0,15,4,30,4,11,0,15,5,30,6,0,0,6,1,-15,3,1
2,3,27,1,30,4,11,0,15,2,30,2,0,0,2,0,30,4,11,0,15,4,30,4,11,0,15,5,30,6,0,0,6,1,-15,3,1
2,1,29,0,30,7,7,0,14,6,30,10,2,0,12,0,30,4,10,0,14,0,30,2,12,0,14,4,30,9,0,0,9,1,-15,3,1
2,3,29,0,30,7,7,0,14,6,30,10,2,0,12,0,30,4,10,0,14,0,30,2,12,0,14,4,30,9,0,0,9,1,-15,3,1
2,2,33,1,30,3,8,0,11,5,30,4,0,0,4,3,30,9,2,0,11,4,30,3,8,0,11,5,30,4,0,0,4,1,-15,3,1
2,3,33,1,30,3,8,0,11,5,30,4,0,0,4,3,30,9,2,0,11,4,30,3,8,0,11,5,30,4,0,0,4,1,-15,3,1
2,1,13,3,30,7,0,0,7,0,30,4,0,0,4,2,30,6,1,0,7,5,30,5,2,0,7,4,30,4,0,0,4,1,-15,3,1
2,3,13,3,30,7,0,0,7,0,30,4,0,0,4,2,30,6,1,0,7,5,30,5,2,0,7,4,30,4,0,0,4,1,-15,3,1
2,4,19,0,30,3,10,0,13,1,30,8,0,0,8,0,30,11,2,0,13,0,30,4,9,0,13,1,30,8,1,0,9,1,-15,3,1
2,3,25,0,30,4,10,0,14,5,30,6,0,0,6,0,30,9,5,0,14,1,30,8,6,0,14,4,30,6,0,0,6,1,-15,3,1
2,4,25,0,30,4,10,0,14,5,30,6,0,0,6,0,30,9,5,0,14,1,30,8,6,0,14,4,30,6,0,0,6,1,-15,3,1
2,0,27,1,30,8,7,0,15,5,30,1,1,0,2,0,30,3,12,0,15,1,30,4,11,0,15,5,30,6,0,0,6,1,-15,3,1
2,0,29,0,30,7,7,0,14,6,30,12,0,0,12,0,30,2,12,0,14,0,30,0,14,0,14,3,30,9,0,0,9,1,-15,3,1
2,1,29,0,30,7,7,0,14,6,30,12,0,0,12,0,30,2,12,0,14,0,30,0,14,0,14,3,30,9,0,0,9,1,-15,3,1
2,4,8,2,30,7,0,0,7,3,30,2,0,0,2,3,30,6,1,0,7,0,30,5,2,0,7,0,30,2,1,0,3,0,-27,3,0
2,2,11,0,30,5,7,0,12,2,30,4,0,0,4,0,30,5,7,0,12,7,30,8,4,0,12,6,30,4,0,0,4,1,-15,3,1
2,4,13,1,30,3,0,0,3,0,30,2,0,0,2,0,30,3,0,0,3,11,30,2,1,0,3,3,30,2,0,0,2,1,-15,3,1
2,1,17,3,30,9,5,0,14,4,30,6,0,0,6,0,30,4,10,0,14,1,30,9,5,0,14,7,30,4,0,0,4,1,-15,3,1
2,2,17,3,30,9,5,0,14,4,30,6,0,0,6,0,30,4,10,0,14,1,30,9,5,0,14,7,30,4,0,0,4,1,-15,3,1
2,4,23,2,30,6,7,0,13,1,30,6,0,0,6,5,30,12,1,0,13,0,30,6,7,0,13,1,30,6,0,0,6,1,-15,3,1
2,2,25,2,30,7,7,0,14,3,30,6,0,0,6,0,30,8,6,0,14,1,30,5,9,0,14,0,30,5,1,0,6,1,-15,3,1
2,0,27,1,30,6,9,0,15,3,30,2,0,0,2,0,30,5,10,0,15,0,30,4,11,0,15,1,30,6,0,0,6,1,-15,3,1
2,1,27,1,30,6,9,0,15,3,30,2,0,0,2,0,30,5,10,0,15,0,30,4,11,0,15,1,30,6,0,0,6,1,-15,3,1
2,2,27,1,30,6,9,0,15,3,30,2,0,0,2,0,30,5,10,0,15,0,30,4,11,0,15,1,30,6,0,0,6,1,-15,3,1
2,3,31,2,30,9,3,0,12,4,30,8,0,0,8,3,30,7,5,0,12,1,30,3,9,0,12,2,30,4,2,0,6,1,-15,3,1
2,4,31,2,30,9,3,0,12,4,30,8,0,0,8,3,30,7,5,0,12,1,30,3,9,0,12,2,30,4,2,0,6,1,-15,3,1
2,1,5,1,30,2,3,0,5,3,30,1,3,0,4,0,30,1,4,0,5,0,30,1,4,0,5,1,30,0,2,0,2,0,-27,3,0
2,4,13,2,30,6,1,0,7,1,30,4,0,0,4,2,30,6,1,0,7,4,30,5,2,0,7,6,30,4,0,0,4,1,-15,3,1
2,3,15,0,30,5,8,0,13,1,30,6,0,0,6,0,30,3,10,0,13,1,30,7,6,0,13,2,30,7,2,0,9,1,-15,3,1
2,4,15,0,30,5,8,0,13,1,30,6,0,0,6,0,30,3,10,0,13,1,30,7,6,0,13,2,30,7,2,0,9,1,-15,3,1
2,3,19,0,30,4,9,0,13,1,30,8,0,0,8,0,30,7,6,0,13,0,30,6,7,0,13,2,30,6,3,0,9,1,-15,3,1
2,4,19,0,30,4,9,0,13,1,30,8,0,0,8,0,30,7,6,0,13,0,30,6,7,0,13,2,30,6,3,0,9,1,-15,3,1
2,4,22,2,30,6,2,0,8,3,30,2,0,0,2,1,30,5,3,0,8,1,30,3,5,0,8,2,30,3,1,0,4,1,-15,3,1
2,1,27,1,30,3,12,0,15,3,30,1,1,0,2,2,30,7,8,0,15,0,30,6,9,0,15,0,30,6,0,0,6,1,-15,3,1
2,4,27,1,30,3,12,0,15,3,30,1,1,0,2,2,30,7,8,0,15,0,30,6,9,0,15,0,30,6,0,0,6,1,-15,3,1
2,3,29,0,30,7,7,0,14,6,30,7,5,0,12,0,30,3,11,0,14,1,30,7,7,0,14,2,30,9,0,0,9,1,-15,3,1
2,0,4,3,30,6,2,0,8,4,30,4,0,0,4,0,30,3,5,0,8,0,30,6,2,0,8,1,30,3,1,0,4,0,-27,3,0
2,3,17,5,30,9,5,0,14,3,30,6,0,0,6,0,30,3,11,0,14,0,30,4,10,0,14,5,30,4,0,0,4,1,-15,3,1
2,4,17,5,30,9,5,0,14,3,30,6,0,0,6,0,30,3,11,0,14,0,30,4,10,0,14,5,30,4,0,0,4,1,-15,3,1
2,2,19,1,30,2,11,0,13,0,30,7,1,0,8,0,30,4,9,0,13,4,30,3,10,0,13,0,30,6,3,0,9,1,-15,3,1
2,4,19,1,30,2,11,0,13,0,30,7,1,0,8,0,30,4,9,0,13,4,30,3,10,0,13,0,30,6,3,0,9,1,-15,3,1
2,1,23,1,30,5,8,0,13,2,30,6,0,0,6,7,30,13,0,0,13,0,30,6,7,0,13,1,30,5,1,0,6,1,-15,3,1
2,1,25,1,30,6,8,0,14,3,30,6,0,0,6,0,30,6,8,0,14,1,30,5,9,0,14,6,30,6,0,0,6,1,-15,3,1
2,1,27,1,30,5,10,0,15,4,30,2,0,0,2,0,30,5,10,0,15,1,30,4,11,0,15,5,30,6,0,0,6,1,-15,3,1
2,2,27,1,30,5,10,0,15,4,30,2,0,0,2,0,30,5,10,0,15,1,30,4,11,0,15,5,30,6,0,0,6,1,-15,3,1
2,4,31,3,30,6,6,0,12,4,30,8,0,0,8,0,30,12,0,0,12,0,30,3,9,0,12,1,30,4,2,0,6,1,-15,3,1
2,1,39,0,30,3,8,0,11,6,30,6,0,0,6,2,30,7,4,0,11,0,30,2,9,0,11,4,30,5,0,0,5,1,-15,3,1
2,3,13,1,30,6,1,0,7,0,30,4,0,0,4,1,30,7,0,0,7,5,30,6,1,0,7,4,30,4,0,0,4,1,-15,3,1
2,0,17,2,30,9,5,0,14,3,30,6,0,0,6,0,30,3,11,0,14,4,30,8,6,0,14,6,30,4,0,0,4,1,-15,3,1
2,1,17,2,30,9,5,0,14,3,30,6,0,0,6,0,30,3,11,0,14,4,30,8,6,0,14,6,30,4,0,0,4,1,-15,3,1
2,3,17,0,30,9,5,0,14,3,30,6,0,0,6,0,30,3,11,0,14,4,30,8,6,0,14,6,30,4,0,0,4,1,-15,3,1
2,1,19,0,30,4,9,0,13,3,30,8,0,0,8,0,30,4,9,0,13,7,30,6,7,0,13,1,30,9,0,0,9,1,-15,3,1
2,3,25,5,30,6,8,0,14,5,30,6,0,0,6,0,30,6,8,0,14,1,30,5,9,0,14,0,30,5,1,0,6,1,-15,3,1
2,0,27,1,30,4,11,0,15,2,30,2,0,0,2,0,30,15,0,0,15,0,30,4,11,0,15,1,30,2,4,0,6,1,-15,3,1
2,1,27,1,30,4,11,0,15,2,30,2,0,0,2,0,30,15,0,0,15,0,30,4,11,0,15,1,30,2,4,0,6,1,-15,3,1
2,3,35,7,30,6,7,0,13,4,30,2,0,0,2,1,30,6,7,0,13,0,30,1,12,0,13,3,30,8,0,0,8,1,-15,3,1
2,0,37,1,30,6,5,0,11,6,30,8,0,0,8,0,30,7,4,0,11,2,30,3,8,0,11,6,30,6,0,0,6,1,-15,3,1
2,2,37,1,30,6,5,0,11,6,30,8,0,0,8,0,30,7,4,0,11,2,30,3,8,0,11,6,30,6,0,0,6,1,-15,3,1
2,3,37,1,30,6,5,0,11,6,30,8,0,0,8,0,30,7,4,0,11,2,30,3,8,0,11,6,30,6,0,0,6,1,-15,3,1
2,4,37,1,30,6,5,0,11,6,30,8,0,0,8,0,30,7,4,0,11,2,30,3,8,0,11,6,30,6,0,0,6,1,-15,3,1
2,1,9,0,30,0,4,0,4,2,30,2,0,0,2,0,30,0,4,0,4,8,30,1,3,0,4,6,30,1,0,0,1,0,-27,3,0
2,4,9,0,30,0,4,0,4,2,30,2,0,0,2,0,30,0,4,0,4,8,30,1,3,0,4,6,30,1,0,0,1,0,-27,3,0
2,2,11,2,30,6,6,0,12,1,30,4,0,0,4,0,30,6,6,0,12,4,30,5,7,0,12,3,30,4,0,0,4,1,-15,3,1
2,2,13,7,30,7,0,0,7,0,30,4,0,0,4,2,30,6,1,0,7,4,30,6,1,0,7,2,30,4,0,0,4,1,-15,3,1
2,3,13,7,30,7,0,0,7,0,30,4,0,0,4,2,30,6,1,0,7,4,30,6,1,0,7,2,30,4,0,0,4,1,-15,3,1
2,1,19,0,30,3,10,0,13,3,30,3,5,0,8,0,30,5,8,0,13,8,30,6,7,0,13,4,30,9,0,0,9,1,-15,3,1
2,2,19,0,30,3,10,0,13,3,30,3,5,0,8,0,30,5,8,0,13,8,30,6,7,0,13,4,30,9,0,0,9,1,-15,3,1
2,4,23,3,30,7,6,0,13,3,30,6,0,0,6,4,30,10,3,0,13,0,30,6,7,0,13,1,30,6,0,0,6,1,-15,3,1
2,4,29,0,30,5,9,0,14,6,30,11,1,0,12,0,30,2,12,0,14,0,30,1,13,0,14,1,30,9,0,0,9,1,-15,3,1
2,1,31,4,30,9,3,0,12,4,30,8,0,0,8,3,30,10,2,0,12,0,30,3,9,0,12,0,30,3,3,0,6,1,-15,3,1
2,2,31,4,30,9,3,0,12,4,30,8,0,0,8,3,30,10,2,0,12,0,30,3,9,0,12,0,30,3,3,0,6,1,-15,3,1
2,4,31,4,30,9,3,0,12,4,30,8,0,0,8,3,30,10,2,0,12,0,30,3,9,0,12,0,30,3,3,0,6,1,-15,3,1
2,3,35,0,30,6,7,0,13,4,30,2,0,0,2,1,30,6,7,0,13,2,30,3,10,0,13,6,30,8,0,0,8,1,-15,3,1
2,4,35,0,30,6,7,0,13,4,30,2,0,0,2,1,30,6,7,0,13,2,30,3,10,0,13,6,30,8,0,0,8,1,-15,3,1
2,3,39,0,30,2,9,0,11,5,30,5,1,0,6,0,30,8,3,0,11,0,30,2,9,0,11,0,30,5,0,0,5,1,-15,3,1
2,1,19,0,30,6,7,0,13,2,30,4,4,0,8,0,30,4,9,0,13,6,30,7,6,0,13,3,30,9,0,0,9,1,-15,3,1
2,2,19,0,30,6,7,0,13,2,30,4,4,0,8,0,30,4,9,0,13,6,30,7,6,0,13,3,30,9,0,0,9,1,-15,3,1
2,3,19,0,30,6,7,0,13,2,30,4,4,0,8,0,30,4,9,0,13,6,30,7,6,0,13,3,30,9,0,0,9,1,-15,3,1
2,3,23,1,30,5,8,0,13,3,30,6,0,0,6,3,30,11,2,0,13,4,30,9,4,0,13,0,30,6,0,0,6,1,-15,3,1
2,4,23,1,30,5,8,0,13,3,30,6,0,0,6,3,30,11,2,0,13,4,30,9,4,0,13,0,30,6,0,0,6,1,-15,3,1
2,0,27,2,30,7,8,0,15,3,30,1,1,0,2,0,30,8,7,0,15,2,30,6,9,0,15,2,30,6,0,0,6,1,-15,3,1
2,4,27,2,30,7,8,0,15,3,30,1,1,0,2,0,30,8,7,0,15,0,30,6,9,0,15,2,30,6,0,0,6,1,-15,3,1
2,4,29,0,30,7,7,0,14,6,30,12,0,0,12,0,30,5,9,0,14,0,30,0,14,0,14,3,30,9,0,0,9,1,-15,3,1
2,0,43,0,30,7,7,0,14,7,30,6,0,0,6,0,30,5,9,0,14,1,30,4,10,0,14,4,30,5,0,0,5,1,-15,3,1
2,4,43,0,30,7,7,0,14,7,30,6,0,0,6,0,30,5,9,0,14,1,30,4,10,0,14,4,30,5,0,0,5,1,-15,3,1
2,2,19,1,30,6,7,0,13,2,30,7,1,0,8,0,30,4,9,0,13,2,30,4,9,0,13,2,30,8,1,0,9,1,-15,3,1
2,2,23,2,30,6,7,0,13,2,30,6,0,0,6,4,30,13,0,0,13,0,30,6,7,0,13,2,30,6,0,0,6,1,-15,3,1
2,3,23,2,30,6,7,0,13,2,30,6,0,0,6,4,30,13,0,0,13,0,30,6,7,0,13,2,30,6,0,0,6,1,-15,3,1
2,0,25,2,30,5,9,0,14,3,30,6,0,0,6,0,30,10,4,0,14,2,30,9,5,0,14,5,30,5,1,0,6,1,-15,3,1
2,4,25,2,30,5,9,0,14,3,30,6,0,0,6,0,30,10,4,0,14,2,30,9,5,0,14,5,30,5,1,0,6,1,-15,3,1
2,2,31,1,30,7,5,0,12,4,30,8,0,0,8,6,30,9,3,0,12,0,30,3,9,0,12,0,30,2,4,0,6,1,-15,3,1
2,4,31,1,30,7,5,0,12,4,30,8,0,0,8,6,30,9,3,0,12,0,30,3,9,0,12,0,30,2,4,0,6,1,-15,3,1
2,4,35,4,30,6,7,0,13,4,30,2,0,0,2,1,30,10,3,0,13,0,30,3,10,0,13,3,30,7,1,0,8,1,-15,3,1
2,2,39,0,30,5,6,0,11,6,30,6,0,0,6,0,30,4,7,0,11,1,30,3,8,0,11,7,30,5,0,0,5,1,-15,3,1
2,3,5,1,30,2,3,0,5,3,30,3,1,0,4,0,30,0,5,0,5,0,30,1,4,0,5,0,30,1,1,0,2,0,-27,3,0
2,2,9,0,30,1,3,0,4,2,30,2,0,0,2,3,30,0,4,0,4,2,30,1,3,0,4,0,30,1,0,0,1,0,-27,3,0
2,2,17,2,30,9,5,0,14,2,30,6,0,0,6,0,30,7,7,0,14,0,30,6,8,0,14,2,30,4,0,0,4,1,-15,3,1
2,1,19,0,30,3,10,0,13,2,30,8,0,0,8,0,30,4,9,0,13,3,30,4,9,0,13,2,30,8,1,0,9,1,-15,3,1
2,2,19,0,30,3,10,0,13,2,30,8,0,0,8,0,30,4,9,0,13,3,30,4,9,0,13,2,30,8,1,0,9,1,-15,3,1
2,3,19,0,30,3,10,0,13,2,30,8,0,0,8,0,30,4,9,0,13,3,30,4,9,0,13,2,30,8,1,0,9,1,-15,3,1
2,4,19,0,30,3,10,0,13,2,30,8,0,0,8,0,30,4,9,0,13,3,30,4,9,0,13,2,30,8,1,0,9,1,-15,3,1
2,3,27,1,30,7,8,0,15,4,30,1,1,0,2,0,30,3,12,0,15,0,30,5,10,0,15,4,30,6,0,0,6,1,-15,3,1
2,4,32,0,30,5,4,0,9,4,30,2,0,0,2,3,30,9,0,0,9,7,30,2,7,0,9,1,30,2,0,0,2,1,-15,3,1
2,2,41,0,30,5,7,0,12,6,30,6,2,0,8,0,30,3,9,0,12,0,30,3,9,0,12,1,30,7,0,0,7,1,-15,3,1
2,3,41,0,30,5,7,0,12,6,30,6,2,0,8,0,30,3,9,0,12,0,30,3,9,0,12,1,30,7,0,0,7,1,-15,3,1
2,4,41,0,30,5,7,0,12,6,30,6,2,0,8,0,30,3,9,0,12,0,30,3,9,0,12,1,30,7,0,0,7,1,-15,3,1
2,3,1,0,30,4,6,0,10,3,30,2,0,0,2,2,30,6,4,0,10,6,30,8,2,0,10,6,30,6,0,0,6,0,-27,3,0
2,1,13,3,30,6,1,0,7,0,30,4,0,0,4,2,30,6,1,0,7,11,30,7,0,0,7,2,30,4,0,0,4,1,-15,3,1
2,4,13,3,30,6,1,0,7,0,30,4,0,0,4,0,30,6,1,0,7,11,30,7,0,0,7,2,30,4,0,0,4,1,-15,3,1
2,3,23,1,30,5,8,0,13,0,30,6,0,0,6,0,30,12,1,0,13,0,30,6,7,0,13,1,30,6,0,0,6,1,-15,3,1
2,4,23,1,30,5,8,0,13,0,30,6,0,0,6,0,30,12,1,0,13,0,30,6,7,0,13,1,30,6,0,0,6,1,-15,3,1
2,2,25,2,30,7,7,0,14,4,30,6,0,0,6,0,30,8,6,0,14,1,30,6,8,0,14,4,30,6,0,0,6,1,-15,3,1
2,2,27,0,30,3,12,0,15,5,30,2,0,0,2,0,30,4,11,0,15,2,30,4,11,0,15,0,30,6,0,0,6,1,-15,3,1
2,3,27,0,30,3,12,0,15,5,30,2,0,0,2,0,30,4,11,0,15,2,30,4,11,0,15,0,30,6,0,0,6,1,-15,3,1
2,1,35,7,30,7,6,0,13,4,30,2,0,0,2,1,30,12,1,0,13,0,30,1,12,0,13,6,30,8,0,0,8,1,-15,3,1
2,3,35,7,30,7,6,0,13,4,30,2,0,0,2,1,30,12,1,0,13,0,30,1,12,0,13,6,30,8,0,0,8,1,-15,3,1
2,4,35,7,30,7,6,0,13,4,30,2,0,0,2,1,30,12,1,0,13,0,30,1,12,0,13,6,30,8,0,0,8,1,-15,3,1
2,4,8,5,30,7,0,0,7,2,30,2,0,0,2,0,30,5,2,0,7,0,30,2,5,0,7,2,30,3,0,0,3,0,-27,3,0
2,2,11,0,30,4,8,0,12,0,30,4,0,0,4,0,30,8,4,0,12,8,30,5,7,0,12,4,30,4,0,0,4,1,-15,3,1
2,2,15,1,30,5,8,0,13,2,30,6,0,0,6,0,30,3,10,0,13,1,30,7,6,0,13,0,30,7,2,0,9,1,-15,3,1
2,2,17,4,30,12,2,0,14,2,30,6,0,0,6,0,30,6,8,0,14,1,30,5,9,0,14,0,30,4,0,0,4,1,-15,3,1
2,1,19,3,30,3,10,0,13,2,30,7,1,0,8,0,30,5,8,0,13,8,30,4,9,0,13,1,30,6,3,0,9,1,-15,3,1
2,2,19,3,30,3,10,0,13,2,30,7,1,0,8,0,30,5,8,0,13,8,30,4,9,0,13,1,30,6,3,0,9,1,-15,3,1
2,4,19,3,30,3,10,0,13,2,30,7,1,0,8,0,30,5,8,0,13,8,30,4,9,0,13,1,30,6,3,0,9,1,-15,3,1
2,2,23,3,30,4,9,0,13,4,30,6,0,0,6,6,30,11,2,0,13,0,30,8,5,0,13,2,30,5,1,0,6,1,-15,3,1
2,3,23,3,30,4,9,0,13,4,30,6,0,0,6,6,30,11,2,0,13,0,30,8,5,0,13,2,30,5,1,0,6,1,-15,3,1
2,4,25,3,30,8,6,0,14,3,30,6,0,0,6,0,30,5,9,0,14,0,30,5,9,0,14,4,30,5,1,0,6,1,-15,3,1
2,0,27,1,30,3,12,0,15,4,30,2,0,0,2,0,30,3,12,0,15,2,30,4,11,0,15,3,30,6,0,0,6,1,-15,3,1
2,4,27,0,30,3,12,0,15,4,30,2,0,0,2,0,30,3,12,0,15,0,30,4,11,0,15,3,30,6,0,0,6,1,-15,3,1
2,3,32,0,30,5,4,0,9,5,30,2,0,0,2,1,30,7,2,0,9,1,30,3,6,0,9,0,30,2,0,0,2,1,-15,3,1
2,2,38,0,30,4,6,0,10,8,30,6,0,0,6,0,30,1,9,0,10,0,30,5,5,0,10,6,30,6,0,0,6,1,-15,3,1
2,4,38,0,30,4,6,0,10,8,30,6,0,0,6,0,30,1,9,0,10,0,30,5,5,0,10,6,30,6,0,0,6,1,-15,3,1
2,0,41,1,30,10,2,0,12,8,30,8,0,0,8,0,30,3,9,0,12,0,30,3,9,0,12,3,30,5,2,0,7,1,-15,3,1
2,4,41,1,30,10,2,0,12,8,30,8,0,0,8,0,30,3,9,0,12,0,30,3,9,0,12,3,30,5,2,0,7,1,-15,3,1
2,4,13,1,30,3,0,0,3,0,30,2,0,0,2,0,30,3,0,0,3,8,30,3,0,0,3,5,30,2,0,0,2,1,-15,3,1
2,2,13,1,30,6,1,0,7,0,30,4,0,0,4,2,30,6,1,0,7,8,30,7,0,0,7,6,30,4,0,0,4,1,-15,3,1
2,2,17,3,30,11,3,0,14,3,30,6,0,0,6,2,30,5,9,0,14,1,30,4,10,0,14,1,30,4,0,0,4,1,-15,3,1
2,3,17,3,30,11,3,0,14,3,30,6,0,0,6,2,30,5,9,0,14,1,30,4,10,0,14,1,30,4,0,0,4,1,-15,3,1
2,4,17,3,30,11,3,0,14,3,30,6,0,0,6,2,30,5,9,0,14,1,30,4,10,0,14,1,30,4,0,0,4,1,-15,3,1
2,2,21,1,30,5,5,0,10,2,30,4,2,0,6,0,30,7,3,0,10,4,30,6,4,0,10,5,30,4,0,0,4,1,-15,3,1
2,4,21,1,30,5,5,0,10,2,30,4,2,0,6,0,30,7,3,0,10,4,30,6,4,0,10,5,30,4,0,0,4,1,-15,3,1
2,3,22,1,30,6,2,0,8,3,30,2,0,0,2,0,30,3,5,0,8,1,30,5,3,0,8,6,30,4,0,0,4,1,-15,3,1
2,1,25,0,30,5,9,0,14,3,30,6,0,0,6,0,30,4,10,0,14,3,30,9,5,0,14,7,30,6,0,0,6,1,-15,3,1
2,2,25,0,30,5,9,0,14,3,30,6,0,0,6,0,30,4,10,0,14,3,30,9,5,0,14,7,30,6,0,0,6,1,-15,3,1
2,1,27,1,30,6,9,0,15,4,30,2,0,0,2,0,30,2,13,0,15,3,30,5,10,0,15,4,30,6,0,0,6,1,-15,3,1
2,3,27,1,30,6,9,0,15,4,30,2,0,0,2,0,30,2,13,0,15,3,30,5,10,0,15,4,30,6,0,0,6,1,-15,3,1
2,4,27,1,30,6,9,0,15,4,30,2,0,0,2,0,30,2,13,0,15,3,30,5,10,0,15,4,30,6,0,0,6,1,-15,3,1
2,1,29,3,30,6,8,0,14,6,30,12,0,0,12,0,30,4,10,0,14,0,30,1,13,0,14,0,30,7,2,0,9,1,-15,3,1
2,2,29,3,30,6,8,0,14,6,30,12,0,0,12,0,30,4,10,0,14,0,30,1,13,0,14,0,30,7,2,0,9,1,-15,3,1
2,3,29,3,30,6,8,0,14,6,30,12,0,0,12,0,30,4,10,0,14,0,30,1,13,0,14,0,30,7,2,0,9,1,-15,3,1
2,4,29,3,30,6,8,0,14,6,30,12,0,0,12,0,30,4,10,0,14,0,30,1,13,0,14,0,30,7,2,0,9,1,-15,3,1
2,0,4,2,30,7,1,0,8,5,30,4,0,0,4,1,30,2,6,0,8,0,30,8,0,0,8,2,30,3,1,0,4,0,-27,3,0
2,2,4,2,30,7,1,0,8,5,30,4,0,0,4,1,30,2,6,0,8,0,30,8,0,0,8,2,30,3,1,0,4,0,-27,3,0
2,3,4,2,30,7,1,0,8,5,30,4,0,0,4,1,30,2,6,0,8,0,30,8,0,0,8,2,30,3,1,0,4,0,-27,3,0
2,1,19,0,30,3,10,0,13,3,30,5,3,0,8,0,30,4,9,0,13,7,30,4,9,0,13,4,30,9,0,0,9,1,-15,3,1
2,3,23,1,30,4,9,0,13,4,30,6,0,0,6,4,30,8,5,0,13,1,30,6,7,0,13,3,30,6,0,0,6,1,-15,3,1
2,3,25,1,30,2,12,0,14,6,30,6,0,0,6,0,30,3,11,0,14,1,30,11,3,0,14,6,30,6,0,0,6,1,-15,3,1
2,0,26,1,30,7,2,0,9,5,30,4,0,0,4,3,30,0,9,0,9,0,30,5,4,0,9,8,30,3,0,0,3,1,-15,3,1
2,1,26,1,30,7,2,0,9,5,30,4,0,0,4,3,30,0,9,0,9,0,30,5,4,0,9,8,30,3,0,0,3,1,-15,3,1
2,1,27,2,30,6,9,0,15,4,30,2,0,0,2,0,30,4,11,0,15,0,30,6,9,0,15,1,30,5,1,0,6,1,-15,3,1
2,2,27,2,30,6,9,0,15,4,30,2,0,0,2,0,30,4,11,0,15,0,30,6,9,0,15,1,30,5,1,0,6,1,-15,3,1
2,3,27,2,30,6,9,0,15,4,30,2,0,0,2,0,30,4,11,0,15,0,30,6,9,0,15,1,30,5,1,0,6,1,-15,3,1
2,4,27,2,30,6,9,0,15,4,30,2,0,0,2,0,30,4,11,0,15,0,30,6,9,0,15,1,30,5,1,0,6,1,-15,3,1
2,3,43,1,30,11,3,0,14,6,30,6,0,0,6,0,30,4,10,0,14,1,30,1,13,0,14,6,30,5,0,0,5,1,-15,3,1
2,2,17,4,30,10,4,0,14,3,30,6,0,0,6,0,30,6,8,0,14,1,30,6,8,0,14,5,30,4,0,0,4,1,-15,3,1
2,3,17,4,30,10,4,0,14,3,30,6,0,0,6,0,30,6,8,0,14,1,30,6,8,0,14,5,30,4,0,0,4,1,-15,3,1
2,4,19,0,30,4,9,0,13,2,30,5,3,0,8,0,30,8,5,0,13,1,30,5,8,0,13,1,30,8,1,0,9,1,-15,3,1
2,3,23,2,30,6,7,0,13,4,30,6,0,0,6,6,30,9,4,0,13,0,30,4,9,0,13,2,30,6,0,0,6,1,-15,3,1
2,4,23,2,30,6,7,0,13,4,30,6,0,0,6,6,30,9,4,0,13,0,30,4,9,0,13,2,30,6,0,0,6,1,-15,3,1
2,4,25,1,30,4,10,0,14,5,30,6,0,0,6,0,30,6,8,0,14,1,30,7,7,0,14,0,30,5,1,0,6,1,-15,3,1
2,2,26,0,30,8,1,0,9,5,30,4,0,0,4,5,30,0,9,0,9,0,30,2,7,0,9,5,30,2,1,0,3,1,-15,3,1
2,3,26,0,30,8,1,0,9,5,30,4,0,0,4,5,30,0,9,0,9,0,30,2,7,0,9,5,30,2,1,0,3,1,-15,3,1
2,4,26,0,30,8,1,0,9,5,30,4,0,0,4,5,30,0,9,0,9,0,30,2,7,0,9,5,30,2,1,0,3,1,-15,3,1
2,2,27,1,30,5,10,0,15,3,30,2,0,0,2,0,30,6,9,0,15,0,30,6,9,0,15,2,30,6,0,0,6,1,-15,3,1
2,3,27,1,30,5,10,0,15,3,30,2,0,0,2,0,30,6,9,0,15,0,30,6,9,0,15,2,30,6,0,0,6,1,-15,3,1
2,3,29,0,30,7,7,0,14,6,30,10,2,0,12,0,30,3,11,0,14,0,30,1,13,0,14,1,30,9,0,0,9,1,-15,3,1
2,3,38,0,30,2,8,0,10,7,30,6,0,0,6,3,30,2,8,0,10,0,30,4,6,0,10,7,30,6,0,0,6,1,-15,3,1
2,3,45,0,30,5,8,0,13,9,30,10,0,0,10,0,30,5,8,0,13,5,30,5,8,0,13,3,30,5,0,0,5,1,-15,3,1
2,4,45,0,30,5,8,0,13,9,30,10,0,0,10,0,30,5,8,0,13,5,30,5,8,0,13,3,30,5,0,0,5,1,-15,3,1
2,2,13,1,30,6,1,0,7,0,30,4,0,0,4,2,30,6,1,0,7,12,30,5,2,0,7,4,30,4,0,0,4,1,-15,3,1
2,4,13,1,30,6,1,0,7,0,30,4,0,0,4,2,30,6,1,0,7,12,30,5,2,0,7,4,30,4,0,0,4,1,-15,3,1
2,4,19,0,30,2,11,0,13,1,30,5,3,0,8,0,30,10,3,0,13,6,30,4,9,0,13,0,30,8,1,0,9,1,-15,3,1
2,2,21,0,30,6,4,0,10,3,30,6,0,0,6,1,30,3,7,0,10,4,30,4,6,0,10,4,30,4,0,0,4,1,-15,3,1
2,3,21,0,30,6,4,0,10,3,30,6,0,0,6,1,30,3,7,0,10,4,30,4,6,0,10,4,30,4,0,0,4,1,-15,3,1
2,4,21,0,30,6,4,0,10,3,30,6,0,0,6,1,30,3,7,0,10,4,30,4,6,0,10,4,30,4,0,0,4,1,-15,3,1
2,4,27,2,30,6,9,0,15,3,30,2,0,0,2,0,30,2,13,0,15,0,30,5,10,0,15,0,30,6,0,0,6,1,-15,3,1
2,1,31,3,30,6,6,0,12,4,30,8,0,0,8,5,30,10,2,0,12,0,30,3,9,0,12,1,30,3,3,0,6,1,-15,3,1
2,3,31,3,30,6,6,0,12,4,30,8,0,0,8,5,30,10,2,0,12,0,30,3,9,0,12,1,30,3,3,0,6,1,-15,3,1
2,4,31,3,30,6,6,0,12,4,30,8,0,0,8,5,30,10,2,0,12,0,30,3,9,0,12,1,30,3,3,0,6,1,-15,3,1
2,1,5,0,30,2,3,0,5,2,30,3,1,0,4,0,30,1,4,0,5,0,30,2,3,0,5,0,30,0,2,0,2,0,-27,3,0
2,0,17,4,30,10,4,0,14,2,30,6,0,0,6,0,30,5,9,0,14,2,30,5,9,0,14,6,30,4,0,0,4,1,-15,3,1
2,1,19,0,30,2,11,0,13,3,30,5,3,0,8,0,30,4,9,0,13,7,30,7,6,0,13,3,30,9,0,0,9,1,-15,3,1
2,4,19,0,30,2,11,0,13,3,30,5,3,0,8,0,30,4,9,0,13,7,30,7,6,0,13,3,30,9,0,0,9,1,-15,3,1
2,3,23,2,30,8,5,0,13,2,30,6,0,0,6,4,30,11,2,0,13,0,30,6,7,0,13,1,30,5,1,0,6,1,-15,3,1
2,4,23,2,30,8,5,0,13,2,30,6,0,0,6,4,30,11,2,0,13,0,30,6,7,0,13,1,30,5,1,0,6,1,-15,3,1
2,4,25,1,30,4,10,0,14,5,30,6,0,0,6,0,30,8,6,0,14,1,30,5,9,0,14,5,30,5,1,0,6,1,-15,3,1
2,3,47,0,30,0,14,0,14,4,30,4,0,0,4,2,30,14,0,0,14,0,30,2,12,0,14,4,30,7,0,0,7,1,-15,3,1
2,3,3,2,30,1,3,0,4,3,30,4,0,0,4,0,30,0,4,0,4,3,30,0,4,0,4,0,30,2,1,0,3,0,-27,3,0
2,0,5,0,30,1,4,0,5,3,30,0,4,0,4,0,30,0,5,0,5,1,30,3,2,0,5,0,30,0,2,0,2,0,-27,3,0
2,4,5,0,30,1,4,0,5,3,30,0,4,0,4,0,30,0,5,0,5,0,30,3,2,0,5,0,30,0,2,0,2,0,-27,3,0
2,2,13,1,30,5,2,0,7,0,30,4,0,0,4,2,30,6,1,0,7,6,30,6,1,0,7,5,30,4,0,0,4,1,-15,3,1
2,2,19,0,30,2,11,0,13,0,30,4,4,0,8,0,30,4,9,0,13,7,30,6,7,0,13,2,30,9,0,0,9,1,-15,3,1
2,4,19,0,30,2,11,0,13,0,30,4,4,0,8,0,30,4,9,0,13,7,30,6,7,0,13,2,30,9,0,0,9,1,-15,3,1
2,0,27,1,30,3,12,0,15,3,30,2,0,0,2,0,30,5,10,0,15,0,30,5,10,0,15,4,30,6,0,0,6,1,-15,3,1
2,2,27,1,30,3,12,0,15,3,30,2,0,0,2,0,30,5,10,0,15,0,30,5,10,0,15,4,30,6,0,0,6,1,-15,3,1
2,4,27,1,30,3,12,0,15,3,30,2,0,0,2,0,30,5,10,0,15,0,30,5,10,0,15,4,30,6,0,0,6,1,-15,3,1
2,4,29,0,30,5,9,0,14,6,30,11,1,0,12,0,30,3,11,0,14,0,30,1,13,0,14,4,30,9,0,0,9,1,-15,3,1
2,3,32,0,30,6,3,0,9,4,30,2,0,0,2,0,30,9,0,0,9,0,30,3,6,0,9,2,30,2,0,0,2,1,-15,3,1
2,2,13,3,30,7,0,0,7,0,30,4,0,0,4,2,30,6,1,0,7,8,30,5,2,0,7,4,30,4,0,0,4,1,-15,3,1
2,3,19,0,30,3,10,0,13,1,30,5,3,0,8,0,30,10,3,0,13,3,30,7,6,0,13,1,30,9,0,0,9,1,-15,3,1
2,4,19,0,30,3,10,0,13,1,30,5,3,0,8,0,30,10,3,0,13,3,30,7,6,0,13,1,30,9,0,0,9,1,-15,3,1
2,2,21,3,30,7,3,0,10,4,30,5,1,0,6,1,30,3,7,0,10,1,30,4,6,0,10,5,30,4,0,0,4,1,-15,3,1
2,3,21,3,30,7,3,0,10,4,30,5,1,0,6,1,30,3,7,0,10,1,30,4,6,0,10,5,30,4,0,0,4,1,-15,3,1
2,4,21,3,30,7,3,0,10,4,30,5,1,0,6,1,30,3,7,0,10,1,30,4,6,0,10,5,30,4,0,0,4,1,-15,3,1
2,4,23,1,30,5,8,0,13,1,30,6,0,0,6,0,30,11,2,0,13,1,30,5,8,0,13,1,30,6,0,0,6,1,-15,3,1
2,1,27,1,30,6,9,0,15,3,30,2,0,0,2,0,30,7,8,0,15,3,30,5,10,0,15,1,30,5,1,0,6,1,-15,3,1
2,4,27,1,30,6,9,0,15,3,30,2,0,0,2,0,30,7,8,0,15,3,30,5,10,0,15,1,30,5,1,0,6,1,-15,3,1
2,0,29,0,30,5,9,0,14,4,30,11,1,0,12,0,30,7,7,0,14,0,30,1,13,0,14,4,30,9,0,0,9,1,-15,3,1
2,3,29,0,30,5,9,0,14,4,30,11,1,0,12,0,30,7,7,0,14,0,30,1,13,0,14,4,30,9,0,0,9,1,-15,3,1
2,4,31,1,30,5,7,0,12,7,30,8,0,0,8,3,30,4,8,0,12,1,30,6,6,0,12,2,30,6,0,0,6,1,-15,3,1
2,2,35,1,30,10,3,0,13,6,30,2,0,0,2,1,30,2,11,0,13,7,30,4,9,0,13,4,30,8,0,0,8,1,-15,3,1
2,4,7,1,30,4,5,0,9,3,30,4,0,0,4,0,30,5,4,0,9,4,30,2,7,0,9,5,30,5,1,0,6,0,-27,3,0
2,4,13,5,30,7,0,0,7,0,30,4,0,0,4,1,30,6,1,0,7,6,30,6,1,0,7,3,30,4,0,0,4,1,-15,3,1
2,4,15,1,30,6,7,0,13,1,30,6,0,0,6,0,30,4,9,0,13,1,30,4,9,0,13,1,30,6,3,0,9,1,-15,3,1
2,4,17,4,30,8,6,0,14,2,30,6,0,0,6,0,30,7,7,0,14,0,30,6,8,0,14,0,30,4,0,0,4,1,-15,3,1
2,4,23,2,30,5,8,0,13,3,30,6,0,0,6,1,30,10,3,0,13,2,30,7,6,0,13,5,30,6,0,0,6,1,-15,3,1
2,4,27,1,30,3,12,0,15,4,30,2,0,0,2,0,30,9,6,0,15,0,30,2,13,0,15,0,30,6,0,0,6,1,-15,3,1
2,0,29,0,30,7,7,0,14,5,30,10,2,0,12,0,30,3,11,0,14,0,30,1,13,0,14,5,30,9,0,0,9,1,-15,3,1
2,1,29,0,30,7,7,0,14,5,30,10,2,0,12,0,30,3,11,0,14,0,30,1,13,0,14,5,30,9,0,0,9,1,-15,3,1
2,3,29,0,30,7,7,0,14,5,30,10,2,0,12,0,30,3,11,0,14,0,30,1,13,0,14,5,30,9,0,0,9,1,-15,3,1
2,3,32,0,30,8,1,0,9,5,30,2,0,0,2,0,30,4,5,0,9,1,30,2,7,0,9,5,30,2,0,0,2,1,-15,3,1
2,4,32,0,30,8,1,0,9,5,30,2,0,0,2,0,30,4,5,0,9,1,30,2,7,0,9,5,30,2,0,0,2,1,-15,3,1
2,3,33,2,30,4,7,0,11,5,30,4,0,0,4,1,30,9,2,0,11,2,30,3,8,0,11,0,30,4,0,0,4,1,-15,3,1
2,4,33,2,30,4,7,0,11,5,30,4,0,0,4,1,30,9,2,0,11,2,30,3,8,0,11,0,30,4,0,0,4,1,-15,3,1
2,4,41,0,30,8,4,0,12,8,30,8,0,0,8,0,30,3,9,0,12,0,30,5,7,0,12,6,30,7,0,0,7,1,-15,3,1
2,2,13,3,30,5,2,0,7,0,30,4,0,0,4,2,30,7,0,0,7,5,30,7,0,0,7,5,30,4,0,0,4,1,-15,3,1
2,4,15,0,30,4,9,0,13,1,30,6,0,0,6,0,30,3,10,0,13,0,30,3,10,0,13,0,30,9,0,0,9,1,-15,3,1
2,4,22,2,30,8,0,0,8,3,30,2,0,0,2,1,30,4,4,0,8,2,30,1,7,0,8,0,30,4,0,0,4,1,-15,3,1
2,3,23,1,30,6,7,0,13,1,30,6,0,0,6,2,30,13,0,0,13,0,30,4,9,0,13,2,30,6,0,0,6,1,-15,3,1
2,0,29,0,30,8,6,0,14,5,30,11,1,0,12,0,30,8,6,0,14,0,30,1,13,0,14,2,30,9,0,0,9,1,-15,3,1
2,4,29,0,30,8,6,0,14,5,30,11,1,0,12,0,30,8,6,0,14,0,30,1,13,0,14,2,30,9,0,0,9,1,-15,3,1
2,2,33,2,30,6,5,0,11,5,30,4,0,0,4,2,30,8,3,0,11,4,30,3,8,0,11,4,30,4,0,0,4,1,-15,3,1
2,3,33,2,30,6,5,0,11,5,30,4,0,0,4,2,30,8,3,0,11,4,30,3,8,0,11,4,30,4,0,0,4,1,-15,3,1
2,1,35,1,30,7,6,0,13,2,30,2,0,0,2,1,30,10,3,0,13,2,30,2,11,0,13,3,30,8,0,0,8,1,-15,3,1
2,3,41,1,30,10,2,0,12,8,30,8,0,0,8,0,30,4,8,0,12,0,30,3,9,0,12,2,30,4,3,0,7,1,-15,3,1
2,4,8,1,30,7,0,0,7,4,30,2,0,0,2,3,30,4,3,0,7,0,30,6,1,0,7,4,30,3,0,0,3,0,-27,3,0
2,3,15,0,30,4,9,0,13,1,30,6,0,0,6,0,30,3,10,0,13,1,30,5,8,0,13,3,30,9,0,0,9,1,-15,3,1
2,4,17,2,30,9,5,0,14,0,30,6,0,0,6,0,30,7,7,0,14,1,30,5,9,0,14,3,30,4,0,0,4,1,-15,3,1
2,2,19,0,30,2,11,0,13,2,30,8,0,0,8,0,30,4,9,0,13,0,30,3,10,0,13,1,30,8,1,0,9,1,-15,3,1
2,4,22,1,30,6,2,0,8,2,30,2,0,0,2,0,30,3,5,0,8,1,30,2,6,0,8,4,30,4,0,0,4,1,-15,3,1
2,3,23,0,30,8,5,0,13,3,30,6,0,0,6,5,30,10,3,0,13,0,30,4,9,0,13,5,30,6,0,0,6,1,-15,3,1
2,3,25,1,30,7,7,0,14,3,30,6,0,0,6,0,30,7,7,0,14,1,30,10,4,0,14,4,30,5,1,0,6,1,-15,3,1
2,2,31,5,30,7,5,0,12,4,30,8,0,0,8,3,30,12,0,0,12,0,30,3,9,0,12,0,30,3,3,0,6,1,-15,3,1
2,2,19,0,30,3,10,0,13,2,30,7,1,0,8,1,30,4,9,0,13,0,30,7,6,0,13,0,30,6,3,0,9,1,-15,3,1
2,4,23,1,30,5,8,0,13,4,30,6,0,0,6,5,30,10,3,0,13,0,30,4,9,0,13,3,30,6,0,0,6,1,-15,3,1
2,2,25,3,30,4,10,0,14,5,30,6,0,0,6,0,30,6,8,0,14,1,30,7,7,0,14,4,30,5,1,0,6,1,-15,3,1
2,3,25,3,30,4,10,0,14,5,30,6,0,0,6,0,30,6,8,0,14,1,30,7,7,0,14,4,30,5,1,0,6,1,-15,3,1
2,0,27,1,30,4,11,0,15,4,30,2,0,0,2,0,30,6,9,0,15,0,30,4,11,0,15,5,30,6,0,0,6,1,-15,3,1
2,2,31,2,30,8,4,0,12,4,30,8,0,0,8,6,30,8,4,0,12,0,30,3,9,0,12,1,30,6,0,0,6,1,-15,3,1
2,1,4,2,30,6,2,0,8,5,30,4,0,0,4,2,30,2,6,0,8,0,30,8,0,0,8,0,30,3,1,0,4,0,-27,3,0
2,3,8,4,30,7,0,0,7,3,30,2,0,0,2,0,30,2,5,0,7,0,30,5,2,0,7,2,30,3,0,0,3,0,-27,3,0
2,2,13,1,30,5,2,0,7,0,30,4,0,0,4,2,30,7,0,0,7,12,30,4,3,0,7,5,30,4,0,0,4,1,-15,3,1
2,2,21,2,30,8,2,0,10,3,30,6,0,0,6,1,30,4,6,0,10,6,30,4,6,0,10,2,30,4,0,0,4,1,-15,3,1
2,4,23,2,30,7,6,0,13,3,30,6,0,0,6,8,30,9,4,0,13,0,30,4,9,0,13,0,30,6,0,0,6,1,-15,3,1
2,4,25,0,30,6,8,0,14,2,30,6,0,0,6,0,30,7,7,0,14,8,30,6,8,0,14,0,30,5,1,0,6,1,-15,3,1
2,0,27,2,30,6,9,0,15,2,30,2,0,0,2,0,30,8,7,0,15,2,30,6,9,0,15,2,30,6,0,0,6,1,-15,3,1
2,3,27,2,30,6,9,0,15,2,30,2,0,0,2,0,30,8,7,0,15,2,30,6,9,0,15,2,30,6,0,0,6,1,-15,3,1
2,4,27,2,30,6,9,0,15,2,30,2,0,0,2,0,30,8,7,0,15,2,30,6,9,0,15,2,30,6,0,0,6,1,-15,3,1
2,4,31,1,30,6,6,0,12,5,30,8,0,0,8,8,30,9,3,0,12,0,30,3,9,0,12,0,30,4,2,0,6,1,-15,3,1
2,4,32,0,30,4,5,0,9,5,30,2,0,0,2,4,30,9,0,0,9,1,30,3,6,0,9,0,30,2,0,0,2,1,-15,3,1
2,2,43,0,30,7,7,0,14,7,30,6,0,0,6,0,30,4,10,0,14,1,30,5,9,0,14,7,30,5,0,0,5,1,-15,3,1
2,4,8,2,30,7,0,0,7,3,30,2,0,0,2,0,30,2,5,0,7,0,30,6,1,0,7,3,30,3,0,0,3,0,-27,3,0
2,1,13,2,30,6,1,0,7,0,30,4,0,0,4,2,30,6,1,0,7,6,30,5,2,0,7,2,30,4,0,0,4,1,-15,3,1
2,3,13,2,30,6,1,0,7,0,30,4,0,0,4,2,30,6,1,0,7,6,30,5,2,0,7,2,30,4,0,0,4,1,-15,3,1
2,4,13,2,30,6,1,0,7,0,30,4,0,0,4,2,30,6,1,0,7,6,30,5,2,0,7,2,30,4,0,0,4,1,-15,3,1
2,2,19,0,30,2,11,0,13,2,30,6,2,0,8,0,30,7,6,0,13,0,30,3,10,0,13,0,30,7,2,0,9,1,-15,3,1
2,4,19,0,30,2,11,0,13,2,30,6,2,0,8,0,30,7,6,0,13,0,30,3,10,0,13,0,30,7,2,0,9,1,-15,3,1
2,1,27,1,30,4,11,0,15,4,30,2,0,0,2,0,30,6,9,0,15,0,30,4,11,0,15,2,30,6,0,0,6,1,-15,3,1
2,2,27,1,30,4,11,0,15,4,30,2,0,0,2,0,30,6,9,0,15,0,30,4,11,0,15,2,30,6,0,0,6,1,-15,3,1
2,3,27,1,30,4,11,0,15,4,30,2,0,0,2,0,30,6,9,0,15,0,30,4,11,0,15,2,30,6,0,0,6,1,-15,3,1
2,0,29,0,30,7,7,0,14,6,30,11,1,0,12,0,30,3,11,0,14,0,30,1,13,0,14,3,30,9,0,0,9,1,-15,3,1
2,3,29,0,30,7,7,0,14,6,30,11,1,0,12,0,30,3,11,0,14,0,30,1,13,0,14,3,30,9,0,0,9,1,-15,3,1
2,3,33,1,30,4,7,0,11,5,30,4,0,0,4,1,30,10,1,0,11,1,30,4,7,0,11,4,30,4,0,0,4,1,-15,3,1
2,0,47,0,30,1,13,0,14,7,30,4,0,0,4,6,30,4,10,0,14,0,30,4,10,0,14,4,30,7,0,0,7,1,-15,3,1
2,3,47,0,30,1,13,0,14,7,30,4,0,0,4,0,30,4,10,0,14,0,30,4,10,0,14,4,30,7,0,0,7,1,-15,3,1
2,4,47,0,30,1,13,0,14,7,30,4,0,0,4,0,30,4,10,0,14,0,30,4,10,0,14,4,30,7,0,0,7,1,-15,3,1
2,4,3,0,30,0,4,0,4,3,30,4,0,0,4,0,30,0,4,0,4,4,30,2,2,0,4,1,30,2,1,0,3,0,-27,3,0
2,2,5,0,30,1,4,0,5,2,30,2,2,0,4,1,30,2,3,0,5,0,30,1,4,0,5,0,30,0,2,0,2,0,-27,3,0
2,1,13,2,30,6,1,0,7,0,30,4,0,0,4,2,30,6,1,0,7,12,30,6,1,0,7,4,30,4,0,0,4,1,-15,3,1
2,2,13,2,30,6,1,0,7,0,30,4,0,0,4,2,30,6,1,0,7,12,30,6,1,0,7,4,30,4,0,0,4,1,-15,3,1
2,2,19,0,30,2,11,0,13,2,30,6,2,0,8,0,30,4,9,0,13,6,30,5,8,0,13,1,30,9,0,0,9,1,-15,3,1
2,3,19,0,30,2,11,0,13,2,30,6,2,0,8,0,30,4,9,0,13,6,30,5,8,0,13,1,30,9,0,0,9,1,-15,3,1
2,4,19,0,30,2,11,0,13,2,30,6,2,0,8,0,30,4,9,0,13,6,30,5,8,0,13,1,30,9,0,0,9,1,-15,3,1
2,2,23,2,30,4,9,0,13,4,30,6,0,0,6,6,30,11,2,0,13,0,30,6,7,0,13,4,30,5,1,0,6,1,-15,3,1
2,3,23,2,30,4,9,0,13,4,30,6,0,0,6,6,30,11,2,0,13,0,30,6,7,0,13,4,30,5,1,0,6,1,-15,3,1
2,4,23,2,30,4,9,0,13,4,30,6,0,0,6,6,30,11,2,0,13,0,30,6,7,0,13,4,30,5,1,0,6,1,-15,3,1
2,1,25,1,30,3,11,0,14,4,30,6,0,0,6,0,30,7,7,0,14,2,30,10,4,0,14,5,30,6,0,0,6,1,-15,3,1
2,2,25,1,30,3,11,0,14,4,30,6,0,0,6,0,30,7,7,0,14,2,30,10,4,0,14,5,30,6,0,0,6,1,-15,3,1
2,1,27,1,30,8,7,0,15,0,30,1,1,0,2,0,30,9,6,0,15,1,30,4,11,0,15,1,30,4,2,0,6,1,-15,3,1
2,2,27,1,30,8,7,0,15,0,30,1,1,0,2,0,30,9,6,0,15,1,30,4,11,0,15,1,30,4,2,0,6,1,-15,3,1
2,3,27,1,30,8,7,0,15,0,30,1,1,0,2,0,30,9,6,0,15,1,30,4,11,0,15,1,30,4,2,0,6,1,-15,3,1
2,3,35,1,30,8,5,0,13,5,30,2,0,0,2,1,30,2,11,0,13,0,30,7,6,0,13,9,30,8,0,0,8,1,-15,3,1
2,0,38,0,30,4,6,0,10,6,30,6,0,0,6,0,30,1,9,0,10,0,30,2,8,0,10,7,30,6,0,0,6,1,-15,3,1
2,1,38,0,30,4,6,0,10,6,30,6,0,0,6,0,30,1,9,0,10,0,30,2,8,0,10,7,30,6,0,0,6,1,-15,3,1
2,2,38,0,30,4,6,0,10,6,30,6,0,0,6,0,30,1,9,0,10,0,30,2,8,0,10,7,30,6,0,0,6,1,-15,3,1
2,4,8,1,30,7,0,0,7,3,30,2,0,0,2,2,30,6,1,0,7,1,30,7,0,0,7,1,30,3,0,0,3,0,-27,3,0
2,2,17,3,30,10,4,0,14,4,30,6,0,0,6,0,30,3,11,0,14,1,30,9,5,0,14,2,30,4,0,0,4,1,-15,3,1
2,3,17,3,30,10,4,0,14,4,30,6,0,0,6,0,30,3,11,0,14,1,30,9,5,0,14,2,30,4,0,0,4,1,-15,3,1
2,4,17,3,30,10,4,0,14,4,30,6,0,0,6,0,30,3,11,0,14,1,30,9,5,0,14,2,30,4,0,0,4,1,-15,3,1
2,3,23,3,30,6,7,0,13,2,30,6,0,0,6,0,30,12,1,0,13,0,30,7,6,0,13,0,30,5,1,0,6,1,-15,3,1
2,4,23,3,30,6,7,0,13,2,30,6,0,0,6,0,30,12,1,0,13,0,30,7,6,0,13,0,30,5,1,0,6,1,-15,3,1
2,4,25,1,30,8,6,0,14,4,30,6,0,0,6,0,30,4,10,0,14,1,30,7,7,0,14,4,30,6,0,0,6,1,-15,3,1
2,3,29,0,30,6,8,0,14,5,30,12,0,0,12,0,30,3,11,0,14,0,30,1,13,0,14,0,30,7,2,0,9,1,-15,3,1
2,4,8,4,30,7,0,0,7,3,30,2,0,0,2,0,30,3,4,0,7,0,30,4,3,0,7,0,30,3,0,0,3,0,-27,3,0
2,4,11,0,30,4,8,0,12,0,30,4,0,0,4,0,30,7,5,0,12,6,30,5,7,0,12,5,30,4,0,0,4,1,-15,3,1
2,2,13,2,30,7,0,0,7,0,30,4,0,0,4,2,30,6,1,0,7,5,30,5,2,0,7,4,30,4,0,0,4,1,-15,3,1
2,3,13,2,30,7,0,0,7,0,30,4,0,0,4,2,30,6,1,0,7,5,30,5,2,0,7,4,30,4,0,0,4,1,-15,3,1
2,4,13,2,30,7,0,0,7,0,30,4,0,0,4,2,30,6,1,0,7,5,30,5,2,0,7,4,30,4,0,0,4,1,-15,3,1
2,2,19,0,30,3,10,0,13,2,30,8,0,0,8,1,30,4,9,0,13,0,30,8,5,0,13,1,30,7,2,0,9,1,-15,3,1
2,3,23,1,30,5,8,0,13,0,30,6,0,0,6,4,30,12,1,0,13,1,30,6,7,0,13,3,30,5,1,0,6,1,-15,3,1
2,0,33,1,30,5,6,0,11,3,30,4,0,0,4,3,30,11,0,0,11,3,30,4,7,0,11,5,30,4,0,0,4,1,-15,3,1
2,2,33,1,30,5,6,0,11,3,30,4,0,0,4,3,30,11,0,0,11,3,30,4,7,0,11,5,30,4,0,0,4,1,-15,3,1
2,4,33,1,30,5,6,0,11,3,30,4,0,0,4,3,30,11,0,0,11,3,30,4,7,0,11,5,30,4,0,0,4,1,-15,3,1
2,2,35,0,30,7,6,0,13,6,30,2,0,0,2,1,30,2,11,0,13,0,30,3,10,0,13,8,30,8,0,0,8,1,-15,3,1
2,3,35,0,30,7,6,0,13,6,30,2,0,0,2,1,30,2,11,0,13,0,30,3,10,0,13,8,30,8,0,0,8,1,-15,3,1
2,0,4,2,30,8,0,0,8,5,30,4,0,0,4,0,30,1,7,0,8,0,30,6,2,0,8,3,30,3,1,0,4,0,-27,3,0
2,3,4,2,30,8,0,0,8,5,30,4,0,0,4,0,30,1,7,0,8,0,30,6,2,0,8,3,30,3,1,0,4,0,-27,3,0
2,4,4,2,30,8,0,0,8,5,30,4,0,0,4,0,30,1,7,0,8,0,30,6,2,0,8,3,30,3,1,0,4,0,-27,3,0
2,4,15,1,30,5,8,0,13,1,30,6,0,0,6,0,30,3,10,0,13,0,30,5,8,0,13,2,30,9,0,0,9,1,-15,3,1
2,1,19,0,30,4,9,0,13,2,30,7,1,0,8,4,30,4,9,0,13,0,30,4,9,0,13,0,30,7,2,0,9,1,-15,3,1
2,0,23,1,30,4,9,0,13,4,30,6,0,0,6,7,30,12,1,0,13,0,30,7,6,0,13,5,30,6,0,0,6,1,-15,3,1
2,1,25,1,30,6,8,0,14,5,30,6,0,0,6,0,30,3,11,0,14,3,30,6,8,0,14,4,30,5,1,0,6,1,-15,3,1
2,2,25,1,30,6,8,0,14,5,30,6,0,0,6,0,30,3,11,0,14,3,30,6,8,0,14,4,30,5,1,0,6,1,-15,3,1
2,3,25,1,30,6,8,0,14,5,30,6,0,0,6,0,30,3,11,0,14,3,30,6,8,0,14,4,30,5,1,0,6,1,-15,3,1
2,4,25,1,30,6,8,0,14,5,30,6,0,0,6,0,30,3,11,0,14,3,30,6,8,0,14,4,30,5,1,0,6,1,-15,3,1
2,0,27,1,30,5,10,0,15,5,30,1,1,0,2,0,30,3,12,0,15,4,30,6,9,0,15,2,30,6,0,0,6,1,-15,3,1
2,1,27,1,30,5,10,0,15,5,30,1,1,0,2,0,30,3,12,0,15,4,30,6,9,0,15,2,30,6,0,0,6,1,-15,3,1
2,4,39,0,30,3,8,0,11,6,30,6,0,0,6,0,30,4,7,0,11,0,30,4,7,0,11,5,30,5,0,0,5,1,-15,3,1
2,2,43,0,30,8,6,0,14,6,30,6,0,0,6,0,30,4,10,0,14,1,30,3,11,0,14,6,30,5,0,0,5,1,-15,3,1
2,4,3,0,30,1,3,0,4,3,30,4,0,0,4,0,30,0,4,0,4,5,30,2,2,0,4,0,30,1,2,0,3,0,-27,3,0
2,1,5,0,30,3,2,0,5,2,30,1,3,0,4,0,30,3,2,0,5,0,30,1,4,0,5,0,30,0,2,0,2,0,-27,3,0
2,3,5,0,30,3,2,0,5,2,30,1,3,0,4,0,30,3,2,0,5,0,30,1,4,0,5,0,30,0,2,0,2,0,-27,3,0
2,4,5,0,30,3,2,0,5,2,30,1,3,0,4,0,30,3,2,0,5,0,30,1,4,0,5,0,30,0,2,0,2,0,-27,3,0
2,1,13,2,30,6,1,0,7,0,30,4,0,0,4,3,30,6,1,0,7,5,30,7,0,0,7,5,30,4,0,0,4,1,-15,3,1
2,4,13,2,30,6,1,0,7,0,30,4,0,0,4,3,30,6,1,0,7,5,30,7,0,0,7,5,30,4,0,0,4,1,-15,3,1
2,1,17,3,30,8,6,0,14,5,30,6,0,0,6,0,30,3,11,0,14,4,30,10,4,0,14,5,30,4,0,0,4,1,-15,3,1
2,3,25,1,30,10,4,0,14,3,30,6,0,0,6,0,30,9,5,0,14,1,30,5,9,0,14,5,30,5,1,0,6,1,-15,3,1
2,0,27,1,30,9,6,0,15,5,30,2,0,0,2,4,30,2,13,0,15,2,30,6,9,0,15,3,30,6,0,0,6,1,-15,3,1
2,1,27,1,30,9,6,0,15,5,30,2,0,0,2,4,30,2,13,0,15,2,30,6,9,0,15,3,30,6,0,0,6,1,-15,3,1
2,2,27,1,30,9,6,0,15,5,30,2,0,0,2,4,30,2,13,0,15,2,30,6,9,0,15,3,30,6,0,0,6,1,-15,3,1
2,3,27,1,30,9,6,0,15,5,30,2,0,0,2,4,30,2,13,0,15,2,30,6,9,0,15,3,30,6,0,0,6,1,-15,3,1
2,3,31,0,30,4,8,0,12,4,30,8,0,0,8,5,30,12,0,0,12,0,30,3,9,0,12,2,30,3,3,0,6,1,-15,3,1
2,4,31,0,30,4,8,0,12,4,30,8,0,0,8,5,30,12,0,0,12,0,30,3,9,0,12,2,30,3,3,0,6,1,-15,3,1
2,3,4,2,30,4,4,0,8,3,30,4,0,0,4,0,30,6,2,0,8,3,30,6,2,0,8,1,30,4,0,0,4,0,-27,3,0
2,2,5,0,30,2,3,0,5,2,30,0,4,0,4,0,30,4,1,0,5,0,30,1,4,0,5,0,30,0,2,0,2,0,-27,3,0
2,3,5,0,30,2,3,0,5,2,30,0,4,0,4,0,30,4,1,0,5,0,30,1,4,0,5,0,30,0,2,0,2,0,-27,3,0
2,4,5,0,30,2,3,0,5,2,30,0,4,0,4,0,30,4,1,0,5,0,30,1,4,0,5,0,30,0,2,0,2,0,-27,3,0
2,2,6,1,30,8,1,0,9,4,30,2,0,0,2,0,30,3,6,0,9,0,30,4,5,0,9,1,30,5,0,0,5,0,-27,3,0
2,4,6,1,30,8,1,0,9,4,30,2,0,0,2,0,30,3,6,0,9,0,30,4,5,0,9,1,30,5,0,0,5,0,-27,3,0
2,3,13,2,30,7,0,0,7,1,30,4,0,0,4,2,30,7,0,0,7,4,30,5,2,0,7,1,30,4,0,0,4,1,-15,3,1
2,4,19,0,30,4,9,0,13,2,30,5,3,0,8,0,30,5,8,0,13,4,30,3,10,0,13,0,30,8,1,0,9,1,-15,3,1
2,3,21,2,30,6,4,0,10,4,30,4,2,0,6,0,30,3,7,0,10,5,30,5,5,0,10,2,30,4,0,0,4,1,-15,3,1
2,4,21,2,30,6,4,0,10,4,30,4,2,0,6,0,30,3,7,0,10,5,30,5,5,0,10,2,30,4,0,0,4,1,-15,3,1
2,4,23,2,30,4,9,0,13,3,30,6,0,0,6,7,30,13,0,0,13,0,30,5,8,0,13,2,30,5,1,0,6,1,-15,3,1
2,3,25,1,30,7,7,0,14,3,30,6,0,0,6,0,30,7,7,0,14,1,30,5,9,0,14,5,30,6,0,0,6,1,-15,3,1
2,3,27,1,30,4,11,0,15,3,30,2,0,0,2,0,30,5,10,0,15,0,30,8,7,0,15,4,30,6,0,0,6,1,-15,3,1
2,4,27,1,30,4,11,0,15,3,30,2,0,0,2,0,30,5,10,0,15,0,30,8,7,0,15,4,30,6,0,0,6,1,-15,3,1
2,3,29,0,30,6,8,0,14,6,30,12,0,0,12,0,30,5,9,0,14,0,30,2,12,0,14,3,30,9,0,0,9,1,-15,3,1
2,4,29,0,30,6,8,0,14,6,30,12,0,0,12,0,30,5,9,0,14,0,30,2,12,0,14,3,30,9,0,0,9,1,-15,3,1
2,0,6,0,30,7,2,0,9,4,30,2,0,0,2,0,30,2,7,0,9,0,30,4,5,0,9,1,30,4,1,0,5,0,-27,3,0
2,2,13,0,30,3,0,0,3,0,30,2,0,0,2,0,30,2,1,0,3,6,30,3,0,0,3,3,30,2,0,0,2,1,-15,3,1
2,3,13,0,30,3,0,0,3,0,30,2,0,0,2,0,30,2,1,0,3,6,30,3,0,0,3,3,30,2,0,0,2,1,-15,3,1
2,1,13,2,30,6,1,0,7,0,30,4,0,0,4,2,30,5,2,0,7,10,30,7,0,0,7,2,30,4,0,0,4,1,-15,3,1
2,2,13,2,30,6,1,0,7,0,30,4,0,0,4,2,30,5,2,0,7,10,30,7,0,0,7,2,30,4,0,0,4,1,-15,3,1
2,3,23,2,30,6,7,0,13,0,30,6,0,0,6,3,30,13,0,0,13,0,30,5,8,0,13,3,30,6,0,0,6,1,-15,3,1
2,2,25,2,30,3,11,0,14,5,30,6,0,0,6,0,30,7,7,0,14,3,30,6,8,0,14,4,30,6,0,0,6,1,-15,3,1
2,0,27,1,30,5,10,0,15,4,30,2,0,0,2,0,30,3,12,0,15,2,30,4,11,0,15,5,30,6,0,0,6,1,-15,3,1
2,4,29,0,30,6,8,0,14,5,30,10,2,0,12,0,30,4,10,0,14,0,30,1,13,0,14,0,30,7,2,0,9,1,-15,3,1
2,1,31,4,30,6,6,0,12,5,30,8,0,0,8,7,30,8,4,0,12,0,30,3,9,0,12,0,30,4,2,0,6,1,-15,3,1
2,3,31,4,30,6,6,0,12,5,30,8,0,0,8,7,30,8,4,0,12,0,30,3,9,0,12,0,30,4,2,0,6,1,-15,3,1
2,4,32,0,30,6,3,0,9,4,30,2,0,0,2,0,30,9,0,0,9,1,30,2,7,0,9,1,30,2,0,0,2,1,-15,3,1
2,3,35,4,30,6,7,0,13,7,30,2,0,0,2,1,30,2,11,0,13,0,30,1,12,0,13,2,30,8,0,0,8,1,-15,3,1
2,3,38,0,30,2,8,0,10,7,30,6,0,0,6,0,30,1,9,0,10,0,30,4,6,0,10,6,30,6,0,0,6,1,-15,3,1
2,3,39,0,30,3,8,0,11,6,30,6,0,0,6,0,30,6,5,0,11,0,30,2,9,0,11,4,30,5,0,0,5,1,-15,3,1
2,4,39,0,30,3,8,0,11,6,30,6,0,0,6,0,30,6,5,0,11,0,30,2,9,0,11,4,30,5,0,0,5,1,-15,3,1
2,1,9,4,30,4,0,0,4,3,30,2,0,0,2,2,30,2,2,0,4,0,30,1,3,0,4,0,30,1,0,0,1,0,-27,3,0
2,2,13,0,30,6,1,0,7,1,30,4,0,0,4,2,30,6,1,0,7,7,30,4,3,0,7,5,30,4,0,0,4,1,-15,3,1
2,4,13,0,30,6,1,0,7,1,30,4,0,0,4,2,30,6,1,0,7,7,30,4,3,0,7,5,30,4,0,0,4,1,-15,3,1
2,2,19,0,30,7,6,0,13,2,30,6,2,0,8,1,30,6,7,0,13,4,30,7,6,0,13,0,30,5,4,0,9,1,-15,3,1
2,3,19,0,30,7,6,0,13,2,30,6,2,0,8,1,30,6,7,0,13,4,30,7,6,0,13,0,30,5,4,0,9,1,-15,3,1
2,4,19,0,30,7,6,0,13,2,30,6,2,0,8,1,30,6,7,0,13,4,30,7,6,0,13,0,30,5,4,0,9,1,-15,3,1
2,3,23,2,30,4,9,0,13,2,30,6,0,0,6,11,30,11,2,0,13,0,30,5,8,0,13,4,30,5,1,0,6,1,-15,3,1
2,4,23,2,30,4,9,0,13,2,30,6,0,0,6,11,30,11,2,0,13,0,30,5,8,0,13,4,30,5,1,0,6,1,-15,3,1
2,2,25,1,30,7,7,0,14,2,30,6,0,0,6,0,30,9,5,0,14,1,30,6,8,0,14,4,30,5,1,0,6,1,-15,3,1
2,3,25,1,30,7,7,0,14,2,30,6,0,0,6,0,30,9,5,0,14,1,30,6,8,0,14,4,30,5,1,0,6,1,-15,3,1
2,0,4,2,30,5,3,0,8,5,30,2,2,0,4,1,30,1,7,0,8,0,30,6,2,0,8,2,30,4,0,0,4,0,-27,3,0
2,1,4,2,30,5,3,0,8,5,30,2,2,0,4,1,30,1,7,0,8,0,30,6,2,0,8,2,30,4,0,0,4,0,-27,3,0
2,3,4,2,30,5,3,0,8,5,30,2,2,0,4,1,30,1,7,0,8,0,30,6,2,0,8,2,30,4,0,0,4,0,-27,3,0
2,2,11,0,30,4,8,0,12,0,30,3,1,0,4,0,30,8,4,0,12,3,30,6,6,0,12,4,30,4,0,0,4,1,-15,3,1
2,1,13,5,30,5,2,0,7,2,30,4,0,0,4,2,30,5,2,0,7,9,30,6,1,0,7,4,30,4,0,0,4,1,-15,3,1
2,4,13,5,30,5,2,0,7,2,30,4,0,0,4,2,30,5,2,0,7,9,30,6,1,0,7,4,30,4,0,0,4,1,-15,3,1
2,1,19,0,30,2,11,0,13,1,30,5,3,0,8,0,30,8,5,0,13,1,30,6,7,0,13,1,30,7,2,0,9,1,-15,3,1
2,3,19,0,30,2,11,0,13,1,30,5,3,0,8,0,30,8,5,0,13,1,30,6,7,0,13,1,30,7,2,0,9,1,-15,3,1
2,3,23,2,30,6,7,0,13,3,30,6,0,0,6,7,30,11,2,0,13,0,30,6,7,0,13,2,30,6,0,0,6,1,-15,3,1
2,2,25,1,30,7,7,0,14,2,30,6,0,0,6,0,30,7,7,0,14,3,30,5,9,0,14,0,30,6,0,0,6,1,-15,3,1
2,3,25,1,30,7,7,0,14,2,30,6,0,0,6,0,30,7,7,0,14,3,30,5,9,0,14,0,30,6,0,0,6,1,-15,3,1
2,2,27,1,30,10,5,0,15,2,30,2,0,0,2,0,30,7,8,0,15,0,30,1,14,0,15,0,30,5,1,0,6,1,-15,3,1
2,3,31,1,30,8,4,0,12,4,30,8,0,0,8,4,30,10,2,0,12,0,30,3,9,0,12,1,30,4,2,0,6,1,-15,3,1
2,4,31,1,30,8,4,0,12,4,30,8,0,0,8,4,30,10,2,0,12,0,30,3,9,0,12,1,30,4,2,0,6,1,-15,3,1
2,2,13,2,30,7,0,0,7,0,30,4,0,0,4,4,30,7,0,0,7,8,30,6,1,0,7,3,30,4,0,0,4,1,-15,3,1
2,4,15,0,30,5,8,0,13,0,30,6,0,0,6,0,30,3,10,0,13,1,30,2,11,0,13,2,30,9,0,0,9,1,-15,3,1
2,3,19,0,30,5,8,0,13,0,30,5,3,0,8,0,30,9,4,0,13,2,30,5,8,0,13,2,30,8,1,0,9,1,-15,3,1
2,4,19,0,30,5,8,0,13,0,30,5,3,0,8,0,30,9,4,0,13,2,30,5,8,0,13,2,30,8,1,0,9,1,-15,3,1
2,4,25,0,30,6,8,0,14,3,30,6,0,0,6,0,30,11,3,0,14,0,30,7,7,0,14,3,30,5,1,0,6,1,-15,3,1
2,0,38,0,30,1,9,0,10,7,30,4,2,0,6,0,30,1,9,0,10,0,30,4,6,0,10,8,30,6,0,0,6,1,-15,3,1
2,2,38,0,30,1,9,0,10,7,30,4,2,0,6,0,30,1,9,0,10,0,30,4,6,0,10,8,30,6,0,0,6,1,-15,3,1
2,3,38,0,30,1,9,0,10,7,30,4,2,0,6,0,30,1,9,0,10,0,30,4,6,0,10,8,30,6,0,0,6,1,-15,3,1
2,4,39,0,30,3,8,0,11,7,30,6,0,0,6,0,30,4,7,0,11,2,30,7,4,0,11,6,30,5,0,0,5,1,-15,3,1
2,4,1,0,30,7,3,0,10,4,30,2,0,0,2,1,30,4,6,0,10,8,30,9,1,0,10,6,30,6,0,0,6,0,-27,3,0
2,1,17,4,30,10,4,0,14,2,30,6,0,0,6,0,30,6,8,0,14,3,30,7,7,0,14,0,30,3,1,0,4,1,-15,3,1
2,2,17,4,30,10,4,0,14,2,30,6,0,0,6,0,30,6,8,0,14,3,30,7,7,0,14,0,30,3,1,0,4,1,-15,3,1
2,3,17,4,30,10,4,0,14,2,30,6,0,0,6,0,30,6,8,0,14,3,30,7,7,0,14,0,30,3,1,0,4,1,-15,3,1
2,3,19,0,30,4,9,0,13,2,30,8,0,0,8,0,30,6,7,0,13,5,30,4,9,0,13,0,30,7,2,0,9,1,-15,3,1
2,4,27,1,30,9,6,0,15,3,30,1,1,0,2,0,30,8,7,0,15,2,30,6,9,0,15,3,30,6,0,0,6,1,-15,3,1
2,4,39,0,30,5,6,0,11,6,30,6,0,0,6,0,30,6,5,0,11,2,30,2,9,0,11,2,30,4,1,0,5,1,-15,3,1
2,0,1,0,30,7,3,0,10,5,30,2,0,0,2,1,30,4,6,0,10,4,30,10,0,0,10,6,30,6,0,0,6,0,-27,3,0
2,2,1,0,30,7,3,0,10,5,30,2,0,0,2,1,30,4,6,0,10,4,30,10,0,0,10,6,30,6,0,0,6,0,-27,3,0
2,4,8,5,30,7,0,0,7,3,30,2,0,0,2,0,30,7,0,0,7,0,30,4,3,0,7,0,30,3,0,0,3,0,-27,3,0
2,2,13,1,30,3,0,0,3,1,30,2,0,0,2,0,30,2,1,0,3,7,30,3,0,0,3,4,30,2,0,0,2,1,-15,3,1
2,4,13,0,30,6,1,0,7,1,30,4,0,0,4,2,30,5,2,0,7,8,30,7,0,0,7,4,30,4,0,0,4,1,-15,3,1
2,2,15,0,30,8,5,0,13,0,30,6,0,0,6,0,30,4,9,0,13,1,30,5,8,0,13,2,30,5,4,0,9,1,-15,3,1
2,2,17,3,30,9,5,0,14,3,30,6,0,0,6,0,30,6,8,0,14,1,30,7,7,0,14,1,30,4,0,0,4,1,-15,3,1
2,3,17,3,30,9,5,0,14,3,30,6,0,0,6,0,30,6,8,0,14,1,30,7,7,0,14,1,30,4,0,0,4,1,-15,3,1
2,3,21,0,30,6,4,0,10,3,30,5,1,0,6,0,30,3,7,0,10,4,30,5,5,0,10,7,30,4,0,0,4,1,-15,3,1
2,4,31,1,30,5,7,0,12,5,30,8,0,0,8,3,30,8,4,0,12,0,30,7,5,0,12,0,30,6,0,0,6,1,-15,3,1
2,3,32,0,30,8,1,0,9,4,30,2,0,0,2,0,30,8,1,0,9,1,30,3,6,0,9,2,30,2,0,0,2,1,-15,3,1
2,4,32,0,30,8,1,0,9,4,30,2,0,0,2,0,30,8,1,0,9,1,30,3,6,0,9,2,30,2,0,0,2,1,-15,3,1
2,1,13,3,30,7,0,0,7,0,30,4,0,0,4,2,30,6,1,0,7,12,30,6,1,0,7,3,30,4,0,0,4,1,-15,3,1
2,2,13,3,30,7,0,0,7,0,30,4,0,0,4,2,30,6,1,0,7,12,30,6,1,0,7,3,30,4,0,0,4,1,-15,3,1
2,4,13,3,30,7,0,0,7,0,30,4,0,0,4,2,30,6,1,0,7,12,30,6,1,0,7,3,30,4,0,0,4,1,-15,3,1
2,3,15,0,30,4,9,0,13,1,30,6,0,0,6,0,30,3,10,0,13,1,30,6,7,0,13,2,30,5,4,0,9,1,-15,3,1
2,2,17,4,30,9,5,0,14,3,30,6,0,0,6,0,30,5,9,0,14,2,30,7,7,0,14,1,30,4,0,0,4,1,-15,3,1
2,2,23,1,30,5,8,0,13,3,30,6,0,0,6,6,30,11,2,0,13,1,30,6,7,0,13,2,30,6,0,0,6,1,-15,3,1
2,3,23,1,30,5,8,0,13,3,30,6,0,0,6,6,30,11,2,0,13,1,30,6,7,0,13,2,30,6,0,0,6,1,-15,3,1
2,4,23,1,30,5,8,0,13,3,30,6,0,0,6,6,30,11,2,0,13,1,30,6,7,0,13,2,30,6,0,0,6,1,-15,3,1
2,2,25,1,30,7,7,0,14,5,30,6,0,0,6,0,30,5,9,0,14,1,30,6,8,0,14,3,30,5,1,0,6,1,-15,3,1
2,2,26,0,30,6,3,0,9,6,30,4,0,0,4,5,30,0,9,0,9,0,30,2,7,0,9,5,30,3,0,0,3,1,-15,3,1
2,3,26,0,30,6,3,0,9,6,30,4,0,0,4,5,30,0,9,0,9,0,30,2,7,0,9,5,30,3,0,0,3,1,-15,3,1
2,1,27,1,30,4,11,0,15,3,30,1,1,0,2,0,30,7,8,0,15,5,30,5,10,0,15,1,30,6,0,0,6,1,-15,3,1
2,1,41,0,30,6,6,0,12,5,30,8,0,0,8,0,30,7,5,0,12,0,30,3,9,0,12,3,30,7,0,0,7,1,-15,3,1
2,2,41,0,30,6,6,0,12,5,30,8,0,0,8,0,30,7,5,0,12,0,30,3,9,0,12,3,30,7,0,0,7,1,-15,3,1
2,4,13,4,30,7,0,0,7,0,30,4,0,0,4,2,30,6,1,0,7,10,30,6,1,0,7,3,30,4,0,0,4,1,-15,3,1
2,2,19,0,30,3,10,0,13,2,30,4,4,0,8,0,30,5,8,0,13,9,30,4,9,0,13,1,30,8,1,0,9,1,-15,3,1
2,4,19,0,30,3,10,0,13,2,30,4,4,0,8,0,30,5,8,0,13,9,30,4,9,0,13,1,30,8,1,0,9,1,-15,3,1
2,1,23,2,30,5,8,0,13,1,30,6,0,0,6,5,30,12,1,0,13,3,30,5,8,0,13,1,30,5,1,0,6,1,-15,3,1
2,3,23,2,30,5,8,0,13,1,30,6,0,0,6,5,30,12,1,0,13,3,30,5,8,0,13,1,30,5,1,0,6,1,-15,3,1
2,1,27,1,30,3,12,0,15,3,30,2,0,0,2,0,30,9,6,0,15,0,30,3,12,0,15,2,30,6,0,0,6,1,-15,3,1
2,2,27,1,30,3,12,0,15,3,30,2,0,0,2,0,30,9,6,0,15,0,30,3,12,0,15,2,30,6,0,0,6,1,-15,3,1
2,4,27,1,30,3,12,0,15,3,30,2,0,0,2,0,30,9,6,0,15,0,30,3,12,0,15,2,30,6,0,0,6,1,-15,3,1
2,3,29,0,30,8,6,0,14,6,30,12,0,0,12,0,30,3,11,0,14,0,30,1,13,0,14,3,30,9,0,0,9,1,-15,3,1
2,2,33,1,30,2,9,0,11,5,30,4,0,0,4,1,30,9,2,0,11,1,30,4,7,0,11,4,30,4,0,0,4,1,-15,3,1
2,2,41,0,30,7,5,0,12,7,30,8,0,0,8,0,30,7,5,0,12,0,30,3,9,0,12,5,30,7,0,0,7,1,-15,3,1
2,4,13,4,30,7,0,0,7,0,30,4,0,0,4,2,30,6,1,0,7,10,30,4,3,0,7,1,30,4,0,0,4,1,-15,3,1
2,2,17,3,30,10,4,0,14,3,30,6,0,0,6,0,30,6,8,0,14,1,30,6,8,0,14,2,30,4,0,0,4,1,-15,3,1
2,3,19,0,30,4,9,0,13,2,30,7,1,0,8,0,30,5,8,0,13,2,30,4,9,0,13,1,30,8,1,0,9,1,-15,3,1
2,0,25,1,30,6,8,0,14,4,30,6,0,0,6,0,30,11,3,0,14,1,30,5,9,0,14,4,30,6,0,0,6,1,-15,3,1
2,1,25,1,30,6,8,0,14,4,30,6,0,0,6,0,30,11,3,0,14,1,30,5,9,0,14,4,30,6,0,0,6,1,-15,3,1
2,3,27,3,30,4,11,0,15,4,30,2,0,0,2,0,30,9,6,0,15,0,30,4,11,0,15,1,30,3,3,0,6,1,-15,3,1
2,4,27,3,30,4,11,0,15,4,30,2,0,0,2,0,30,9,6,0,15,0,30,4,11,0,15,1,30,3,3,0,6,1,-15,3,1
2,2,29,0,30,6,8,0,14,6,30,12,0,0,12,0,30,5,9,0,14,0,30,1,13,0,14,5,30,9,0,0,9,1,-15,3,1
2,3,29,0,30,6,8,0,14,6,30,12,0,0,12,0,30,5,9,0,14,0,30,1,13,0,14,5,30,9,0,0,9,1,-15,3,1
2,2,17,2,30,8,6,0,14,1,30,6,0,0,6,0,30,7,7,0,14,6,30,5,9,0,14,7,30,4,0,0,4,1,-15,3,1
2,4,19,0,30,6,7,0,13,0,30,8,0,0,8,5,30,6,7,0,13,0,30,4,9,0,13,1,30,7,2,0,9,1,-15,3,1
2,2,25,2,30,8,6,0,14,5,30,6,0,0,6,0,30,3,11,0,14,2,30,10,4,0,14,6,30,6,0,0,6,1,-15,3,1
2,3,25,2,30,8,6,0,14,5,30,6,0,0,6,0,30,3,11,0,14,2,30,10,4,0,14,6,30,6,0,0,6,1,-15,3,1
2,4,25,2,30,8,6,0,14,5,30,6,0,0,6,0,30,3,11,0,14,2,30,10,4,0,14,6,30,6,0,0,6,1,-15,3,1
2,0,26,1,30,7,2,0,9,5,30,4,0,0,4,2,30,0,9,0,9,0,30,5,4,0,9,8,30,3,0,0,3,1,-15,3,1
2,0,27,1,30,7,8,0,15,3,30,2,0,0,2,0,30,4,11,0,15,0,30,4,11,0,15,2,30,6,0,0,6,1,-15,3,1
2,2,27,1,30,7,8,0,15,3,30,2,0,0,2,0,30,4,11,0,15,0,30,4,11,0,15,2,30,6,0,0,6,1,-15,3,1
2,4,29,0,30,8,6,0,14,5,30,12,0,0,12,0,30,3,11,0,14,0,30,1,13,0,14,1,30,7,2,0,9,1,-15,3,1
2,2,33,0,30,2,9,0,11,5,30,4,0,0,4,3,30,10,1,0,11,0,30,5,6,0,11,8,30,4,0,0,4,1,-15,3,1
2,3,33,0,30,2,9,0,11,5,30,4,0,0,4,3,30,10,1,0,11,0,30,5,6,0,11,8,30,4,0,0,4,1,-15,3,1
2,0,4,2,30,6,2,0,8,5,30,3,1,0,4,0,30,2,6,0,8,0,30,8,0,0,8,1,30,3,1,0,4,0,-27,3,0
2,1,4,2,30,6,2,0,8,5,30,3,1,0,4,0,30,2,6,0,8,0,30,8,0,0,8,1,30,3,1,0,4,0,-27,3,0
2,3,17,3,30,11,3,0,14,3,30,6,0,0,6,0,30,5,9,0,14,2,30,7,7,0,14,0,30,3,1,0,4,1,-15,3,1
2,4,19,0,30,3,10,0,13,2,30,4,4,0,8,0,30,9,4,0,13,4,30,4,9,0,13,1,30,8,1,0,9,1,-15,3,1
2,2,23,1,30,7,6,0,13,3,30,6,0,0,6,4,30,9,4,0,13,0,30,7,6,0,13,1,30,6,0,0,6,1,-15,3,1
2,3,23,1,30,7,6,0,13,3,30,6,0,0,6,4,30,9,4,0,13,0,30,7,6,0,13,1,30,6,0,0,6,1,-15,3,1
2,4,23,1,30,7,6,0,13,3,30,6,0,0,6,4,30,9,4,0,13,0,30,7,6,0,13,1,30,6,0,0,6,1,-15,3,1
2,1,27,1,30,3,12,0,15,0,30,2,0,0,2,0,30,14,1,0,15,1,30,4,11,0,15,1,30,6,0,0,6,1,-15,3,1
2,2,29,1,30,6,8,0,14,5,30,8,4,0,12,0,30,3,11,0,14,0,30,1,13,0,14,3,30,9,0,0,9,1,-15,3,1
2,3,29,1,30,6,8,0,14,5,30,8,4,0,12,0,30,3,11,0,14,0,30,1,13,0,14,3,30,9,0,0,9,1,-15,3,1
2,4,29,1,30,6,8,0,14,5,30,8,4,0,12,0,30,3,11,0,14,0,30,1,13,0,14,3,30,9,0,0,9,1,-15,3,1
2,0,33,1,30,5,6,0,11,5,30,4,0,0,4,2,30,9,2,0,11,2,30,3,8,0,11,7,30,4,0,0,4,1,-15,3,1
2,2,33,1,30,5,6,0,11,5,30,4,0,0,4,2,30,9,2,0,11,2,30,3,8,0,11,7,30,4,0,0,4,1,-15,3,1
2,3,33,1,30,5,6,0,11,5,30,4,0,0,4,2,30,9,2,0,11,2,30,3,8,0,11,7,30,4,0,0,4,1,-15,3,1
2,3,47,0,30,0,14,0,14,6,30,4,0,0,4,0,30,3,11,0,14,1,30,3,11,0,14,6,30,7,0,0,7,1,-15,3,1
2,3,11,0,30,1,3,0,4,0,30,0,0,0,0,0,30,1,3,0,4,4,30,1,3,0,4,2,30,1,0,0,1,1,-15,3,1
2,0,11,1,30,5,7,0,12,2,30,3,1,0,4,0,30,2,10,0,12,3,30,6,6,0,12,3,30,4,0,0,4,1,-15,3,1
2,1,11,1,30,5,7,0,12,2,30,3,1,0,4,0,30,2,10,0,12,3,30,6,6,0,12,3,30,4,0,0,4,1,-15,3,1
2,2,19,0,30,4,9,0,13,2,30,2,6,0,8,0,30,4,9,0,13,3,30,6,7,0,13,2,30,7,2,0,9,1,-15,3,1
2,0,29,0,30,5,9,0,14,5,30,9,3,0,12,0,30,3,11,0,14,4,30,2,12,0,14,6,30,9,0,0,9,1,-15,3,1
2,4,29,0,30,5,9,0,14,5,30,9,3,0,12,0,30,3,11,0,14,4,30,2,12,0,14,6,30,9,0,0,9,1,-15,3,1
2,4,31,3,30,7,5,0,12,4,30,8,0,0,8,3,30,8,4,0,12,0,30,3,9,0,12,0,30,6,0,0,6,1,-15,3,1
2,4,39,0,30,4,7,0,11,6,30,6,0,0,6,1,30,7,4,0,11,0,30,4,7,0,11,4,30,5,0,0,5,1,-15,3,1
2,1,4,0,30,7,1,0,8,5,30,4,0,0,4,1,30,2,6,0,8,0,30,8,0,0,8,2,30,3,1,0,4,0,-27,3,0
2,4,4,0,30,7,1,0,8,5,30,4,0,0,4,1,30,2,6,0,8,0,30,8,0,0,8,2,30,3,1,0,4,0,-27,3,0
2,2,17,4,30,9,5,0,14,1,30,6,0,0,6,0,30,7,7,0,14,3,30,3,11,0,14,2,30,4,0,0,4,1,-15,3,1
2,3,17,4,30,9,5,0,14,1,30,6,0,0,6,0,30,7,7,0,14,3,30,3,11,0,14,2,30,4,0,0,4,1,-15,3,1
2,0,19,0,30,9,4,0,13,2,30,6,2,0,8,5,30,4,9,0,13,0,30,3,10,0,13,0,30,6,3,0,9,1,-15,3,1
2,3,19,0,30,9,4,0,13,2,30,6,2,0,8,5,30,4,9,0,13,0,30,3,10,0,13,0,30,6,3,0,9,1,-15,3,1
2,3,23,1,30,3,10,0,13,4,30,6,0,0,6,6,30,8,5,0,13,1,30,6,7,0,13,2,30,6,0,0,6,1,-15,3,1
2,3,25,1,30,7,7,0,14,0,30,6,0,0,6,0,30,11,3,0,14,1,30,5,9,0,14,0,30,5,1,0,6,1,-15,3,1
2,2,27,1,30,4,11,0,15,5,30,2,0,0,2,0,30,4,11,0,15,0,30,9,6,0,15,2,30,4,2,0,6,1,-15,3,1
2,2,43,5,30,7,7,0,14,8,30,6,0,0,6,0,30,4,10,0,14,1,30,2,12,0,14,8,30,5,0,0,5,1,-15,3,1
2,2,1,0,30,4,6,0,10,4,30,2,0,0,2,1,30,4,6,0,10,4,30,9,1,0,10,6,30,6,0,0,6,0,-27,3,0
2,0,4,3,30,7,1,0,8,5,30,4,0,0,4,1,30,1,7,0,8,0,30,7,1,0,8,1,30,4,0,0,4,0,-27,3,0
2,1,4,3,30,7,1,0,8,5,30,4,0,0,4,1,30,1,7,0,8,0,30,7,1,0,8,1,30,4,0,0,4,0,-27,3,0
2,2,13,1,30,7,0,0,7,0,30,4,0,0,4,2,30,5,2,0,7,8,30,6,1,0,7,5,30,4,0,0,4,1,-15,3,1
2,4,13,1,30,7,0,0,7,0,30,4,0,0,4,2,30,5,2,0,7,8,30,6,1,0,7,5,30,4,0,0,4,1,-15,3,1
2,2,17,2,30,9,5,0,14,3,30,6,0,0,6,0,30,7,7,0,14,5,30,6,8,0,14,3,30,4,0,0,4,1,-15,3,1
2,0,21,1,30,5,5,0,10,3,30,6,0,0,6,1,30,3,7,0,10,9,30,5,5,0,10,0,30,3,1,0,4,1,-15,3,1
2,3,25,0,30,6,8,0,14,4,30,5,1,0,6,0,30,10,4,0,14,0,30,3,11,0,14,0,30,6,0,0,6,1,-15,3,1
2,4,25,0,30,6,8,0,14,4,30,5,1,0,6,0,30,10,4,0,14,0,30,3,11,0,14,0,30,6,0,0,6,1,-15,3,1
2,0,27,0,30,3,12,0,15,4,30,2,0,0,2,0,30,7,8,0,15,0,30,5,10,0,15,2,30,4,2,0,6,1,-15,3,1
2,1,27,0,30,3,12,0,15,4,30,2,0,0,2,0,30,7,8,0,15,0,30,5,10,0,15,2,30,4,2,0,6,1,-15,3,1
2,2,27,0,30,3,12,0,15,4,30,2,0,0,2,0,30,7,8,0,15,0,30,5,10,0,15,2,30,4,2,0,6,1,-15,3,1
2,2,39,0,30,4,7,0,11,6,30,6,0,0,6,0,30,7,4,0,11,0,30,4,7,0,11,7,30,5,0,0,5,1,-15,3,1
2,0,47,1,30,7,7,0,14,8,30,4,0,0,4,0,30,3,11,0,14,0,30,2,12,0,14,9,30,7,0,0,7,1,-15,3,1
2,4,4,2,30,5,3,0,8,5,30,4,0,0,4,1,30,2,6,0,8,1,30,8,0,0,8,1,30,3,1,0,4,0,-27,3,0
2,4,8,4,30,7,0,0,7,3,30,2,0,0,2,4,30,3,4,0,7,0,30,2,5,0,7,2,30,3,0,0,3,0,-27,3,0
2,2,13,2,30,7,0,0,7,1,30,4,0,0,4,2,30,5,2,0,7,3,30,5,2,0,7,3,30,4,0,0,4,1,-15,3,1
2,3,13,2,30,7,0,0,7,1,30,4,0,0,4,2,30,5,2,0,7,3,30,5,2,0,7,3,30,4,0,0,4,1,-15,3,1
2,4,17,1,30,11,3,0,14,3,30,6,0,0,6,0,30,4,10,0,14,1,30,7,7,0,14,3,30,4,0,0,4,1,-15,3,1
2,4,19,0,30,3,10,0,13,2,30,5,3,0,8,0,30,4,9,0,13,3,30,7,6,0,13,2,30,8,1,0,9,1,-15,3,1
2,1,27,6,30,10,5,0,15,1,30,2,0,0,2,1,30,10,5,0,15,0,30,3,12,0,15,2,30,2,4,0,6,1,-15,3,1
2,2,27,6,30,10,5,0,15,1,30,2,0,0,2,1,30,10,5,0,15,0,30,3,12,0,15,2,30,2,4,0,6,1,-15,3,1
2,3,27,6,30,10,5,0,15,1,30,2,0,0,2,1,30,10,5,0,15,0,30,3,12,0,15,2,30,2,4,0,6,1,-15,3,1
2,2,31,1,30,3,9,0,12,8,30,8,0,0,8,3,30,4,8,0,12,5,30,9,3,0,12,4,30,6,0,0,6,1,-15,3,1
2,2,39,0,30,1,10,0,11,6,30,6,0,0,6,0,30,8,3,0,11,0,30,4,7,0,11,7,30,5,0,0,5,1,-15,3,1
2,2,25,1,30,4,10,0,14,2,30,6,0,0,6,0,30,12,2,0,14,1,30,6,8,0,14,3,30,5,1,0,6,1,-15,3,1
2,3,25,1,30,4,10,0,14,2,30,6,0,0,6,0,30,12,2,0,14,1,30,6,8,0,14,3,30,5,1,0,6,1,-15,3,1
2,0,27,1,30,5,10,0,15,2,30,1,1,0,2,0,30,6,9,0,15,0,30,5,10,0,15,5,30,6,0,0,6,1,-15,3,1
2,1,27,1,30,5,10,0,15,2,30,1,1,0,2,0,30,6,9,0,15,0,30,5,10,0,15,5,30,6,0,0,6,1,-15,3,1
2,2,27,1,30,5,10,0,15,2,30,1,1,0,2,0,30,6,9,0,15,0,30,5,10,0,15,5,30,6,0,0,6,1,-15,3,1
2,4,33,0,30,4,7,0,11,4,30,4,0,0,4,3,30,10,1,0,11,0,30,3,8,0,11,3,30,4,0,0,4,1,-15,3,1
2,2,35,1,30,9,4,0,13,6,30,2,0,0,2,1,30,2,11,0,13,1,30,4,9,0,13,8,30,8,0,0,8,1,-15,3,1
2,3,39,0,30,1,10,0,11,6,30,6,0,0,6,0,30,8,3,0,11,0,30,4,7,0,11,6,30,5,0,0,5,1,-15,3,1
2,2,11,0,30,3,9,0,12,0,30,4,0,0,4,0,30,5,7,0,12,6,30,4,8,0,12,5,30,4,0,0,4,1,-15,3,1
2,4,11,0,30,3,9,0,12,0,30,4,0,0,4,0,30,5,7,0,12,6,30,4,8,0,12,5,30,4,0,0,4,1,-15,3,1
2,1,13,2,30,7,0,0,7,0,30,4,0,0,4,2,30,6,1,0,7,6,30,6,1,0,7,4,30,4,0,0,4,1,-15,3,1
2,2,13,2,30,7,0,0,7,0,30,4,0,0,4,2,30,6,1,0,7,6,30,6,1,0,7,4,30,4,0,0,4,1,-15,3,1
2,2,23,2,30,8,5,0,13,3,30,6,0,0,6,6,30,12,1,0,13,0,30,4,9,0,13,1,30,6,0,0,6,1,-15,3,1
2,4,23,2,30,8,5,0,13,3,30,6,0,0,6,6,30,12,1,0,13,0,30,4,9,0,13,1,30,6,0,0,6,1,-15,3,1
2,3,25,0,30,4,10,0,14,5,30,6,0,0,6,0,30,5,9,0,14,1,30,7,7,0,14,4,30,5,1,0,6,1,-15,3,1
2,4,31,7,30,6,6,0,12,5,30,8,0,0,8,3,30,9,3,0,12,0,30,5,7,0,12,0,30,4,2,0,6,1,-15,3,1
2,3,3,0,30,1,3,0,4,2,30,4,0,0,4,0,30,0,4,0,4,2,30,1,3,0,4,0,30,1,2,0,3,0,-27,3,0
2,0,4,2,30,7,1,0,8,4,30,4,0,0,4,1,30,1,7,0,8,0,30,2,6,0,8,2,30,4,0,0,4,0,-27,3,0
2,1,4,2,30,7,1,0,8,4,30,4,0,0,4,1,30,1,7,0,8,0,30,2,6,0,8,2,30,4,0,0,4,0,-27,3,0
2,2,4,2,30,7,1,0,8,4,30,4,0,0,4,1,30,1,7,0,8,0,30,2,6,0,8,2,30,4,0,0,4,0,-27,3,0
2,2,5,0,30,0,5,0,5,2,30,3,1,0,4,0,30,0,5,0,5,0,30,1,4,0,5,0,30,1,1,0,2,0,-27,3,0
2,4,8,1,30,7,0,0,7,4,30,2,0,0,2,1,30,3,4,0,7,0,30,5,2,0,7,0,30,3,0,0,3,0,-27,3,0
2,4,17,3,30,10,4,0,14,3,30,6,0,0,6,0,30,5,9,0,14,2,30,4,10,0,14,2,30,4,0,0,4,1,-15,3,1
2,4,19,0,30,2,11,0,13,2,30,8,0,0,8,0,30,4,9,0,13,0,30,6,7,0,13,0,30,8,1,0,9,1,-15,3,1
2,2,25,1,30,5,9,0,14,4,30,6,0,0,6,0,30,9,5,0,14,1,30,5,9,0,14,4,30,5,1,0,6,1,-15,3,1
2,4,25,1,30,5,9,0,14,4,30,6,0,0,6,0,30,9,5,0,14,1,30,5,9,0,14,4,30,5,1,0,6,1,-15,3,1
2,1,27,1,30,5,10,0,15,4,30,0,2,0,2,0,30,5,10,0,15,4,30,4,11,0,15,6,30,6,0,0,6,1,-15,3,1
2,0,29,0,30,5,9,0,14,6,30,11,1,0,12,0,30,2,12,0,14,1,30,2,12,0,14,5,30,9,0,0,9,1,-15,3,1
2,2,29,0,30,5,9,0,14,6,30,11,1,0,12,0,30,2,12,0,14,1,30,2,12,0,14,5,30,9,0,0,9,1,-15,3,1
2,3,29,0,30,5,9,0,14,6,30,11,1,0,12,0,30,2,12,0,14,1,30,2,12,0,14,5,30,9,0,0,9,1,-15,3,1
2,3,17,2,30,8,6,0,14,1,30,6,0,0,6,0,30,8,6,0,14,1,30,4,10,0,14,4,30,4,0,0,4,1,-15,3,1
2,3,21,3,30,10,0,0,10,4,30,6,0,0,6,1,30,3,7,0,10,1,30,4,6,0,10,0,30,4,0,0,4,1,-15,3,1
2,4,21,3,30,10,0,0,10,4,30,6,0,0,6,1,30,3,7,0,10,1,30,4,6,0,10,0,30,4,0,0,4,1,-15,3,1
2,4,25,1,30,5,9,0,14,5,30,6,0,0,6,0,30,8,6,0,14,1,30,5,9,0,14,6,30,6,0,0,6,1,-15,3,1
2,0,27,1,30,4,11,0,15,5,30,2,0,0,2,0,30,3,12,0,15,1,30,7,8,0,15,6,30,6,0,0,6,1,-15,3,1
2,4,27,1,30,4,11,0,15,5,30,2,0,0,2,0,30,3,12,0,15,1,30,7,8,0,15,6,30,6,0,0,6,1,-15,3,1
2,2,33,1,30,4,7,0,11,6,30,4,0,0,4,0,30,6,5,0,11,2,30,8,3,0,11,4,30,4,0,0,4,1,-15,3,1
2,3,33,1,30,4,7,0,11,6,30,4,0,0,4,0,30,6,5,0,11,2,30,8,3,0,11,4,30,4,0,0,4,1,-15,3,1
2,3,35,0,30,9,4,0,13,3,30,2,0,0,2,1,30,9,4,0,13,1,30,2,11,0,13,3,30,8,0,0,8,1,-15,3,1
2,4,39,3,30,3,8,0,11,5,30,6,0,0,6,0,30,10,1,0,11,0,30,2,9,0,11,0,30,4,1,0,5,1,-15,3,1
2,3,43,0,30,7,7,0,14,6,30,6,0,0,6,0,30,4,10,0,14,1,30,5,9,0,14,8,30,5,0,0,5,1,-15,3,1
2,3,45,0,30,7,6,0,13,10,30,10,0,0,10,0,30,2,11,0,13,0,30,4,9,0,13,9,30,5,0,0,5,1,-15,3,1
2,3,47,0,30,0,14,0,14,6,30,4,0,0,4,0,30,4,10,0,14,2,30,2,12,0,14,8,30,7,0,0,7,1,-15,3,1
2,0,9,4,30,1,3,0,4,3,30,2,0,0,2,3,30,1,3,0,4,0,30,1,3,0,4,0,30,1,0,0,1,0,-27,3,0
2,3,9,4,30,1,3,0,4,3,30,2,0,0,2,3,30,1,3,0,4,0,30,1,3,0,4,0,30,1,0,0,1,0,-27,3,0
2,4,11,0,30,4,8,0,12,2,30,4,0,0,4,0,30,6,6,0,12,6,30,8,4,0,12,3,30,4,0,0,4,1,-15,3,1
2,4,17,3,30,11,3,0,14,4,30,6,0,0,6,0,30,3,11,0,14,2,30,5,9,0,14,0,30,4,0,0,4,1,-15,3,1
2,4,23,2,30,6,7,0,13,0,30,6,0,0,6,2,30,13,0,0,13,0,30,5,8,0,13,2,30,5,1,0,6,1,-15,3,1
2,2,25,1,30,4,10,0,14,6,30,6,0,0,6,0,30,3,11,0,14,1,30,7,7,0,14,8,30,6,0,0,6,1,-15,3,1
2,3,25,1,30,4,10,0,14,6,30,6,0,0,6,0,30,3,11,0,14,1,30,7,7,0,14,8,30,6,0,0,6,1,-15,3,1
2,3,27,2,30,5,10,0,15,3,30,2,0,0,2,0,30,6,9,0,15,2,30,7,8,0,15,0,30,6,0,0,6,1,-15,3,1
2,3,31,2,30,9,3,0,12,4,30,8,0,0,8,3,30,8,4,0,12,0,30,3,9,0,12,1,30,3,3,0,6,1,-15,3,1
2,4,32,0,30,4,5,0,9,5,30,2,0,0,2,3,30,8,1,0,9,1,30,3,6,0,9,0,30,2,0,0,2,1,-15,3,1
2,2,38,0,30,2,8,0,10,6,30,6,0,0,6,0,30,3,7,0,10,0,30,4,6,0,10,7,30,6,0,0,6,1,-15,3,1
2,3,1,0,30,7,3,0,10,4,30,2,0,0,2,1,30,4,6,0,10,3,30,5,5,0,10,2,30,6,0,0,6,0,-27,3,0
2,4,8,1,30,7,0,0,7,4,30,2,0,0,2,4,30,3,4,0,7,0,30,5,2,0,7,3,30,3,0,0,3,0,-27,3,0
2,1,17,5,30,9,5,0,14,3,30,6,0,0,6,0,30,4,10,0,14,1,30,5,9,0,14,3,30,3,1,0,4,1,-15,3,1
2,3,17,5,30,9,5,0,14,3,30,6,0,0,6,0,30,4,10,0,14,1,30,5,9,0,14,3,30,3,1,0,4,1,-15,3,1
2,4,17,5,30,9,5,0,14,3,30,6,0,0,6,0,30,4,10,0,14,1,30,5,9,0,14,3,30,3,1,0,4,1,-15,3,1
2,0,21,3,30,7,3,0,10,4,30,5,1,0,6,1,30,3,7,0,10,4,30,5,5,0,10,3,30,4,0,0,4,1,-15,3,1
2,3,21,3,30,7,3,0,10,4,30,5,1,0,6,1,30,3,7,0,10,4,30,5,5,0,10,3,30,4,0,0,4,1,-15,3,1
2,4,21,3,30,7,3,0,10,4,30,5,1,0,6,1,30,3,7,0,10,4,30,5,5,0,10,3,30,4,0,0,4,1,-15,3,1
2,1,29,0,30,3,11,0,14,5,30,12,0,0,12,0,30,3,11,0,14,0,30,2,12,0,14,5,30,9,0,0,9,1,-15,3,1
2,2,29,0,30,3,11,0,14,5,30,12,0,0,12,0,30,3,11,0,14,0,30,2,12,0,14,5,30,9,0,0,9,1,-15,3,1
2,3,29,0,30,3,11,0,14,5,30,12,0,0,12,0,30,3,11,0,14,0,30,2,12,0,14,5,30,9,0,0,9,1,-15,3,1
2,3,35,0,30,7,6,0,13,6,30,2,0,0,2,1,30,2,11,0,13,1,30,2,11,0,13,7,30,8,0,0,8,1,-15,3,1
2,3,9,0,30,1,3,0,4,2,30,2,0,0,2,0,30,0,4,0,4,1,30,1,3,0,4,2,30,1,0,0,1,0,-27,3,0
2,4,9,0,30,1,3,0,4,2,30,2,0,0,2,0,30,0,4,0,4,1,30,1,3,0,4,2,30,1,0,0,1,0,-27,3,0
2,4,11,2,30,5,7,0,12,1,30,4,0,0,4,2,30,6,6,0,12,0,30,4,8,0,12,0,30,3,1,0,4,1,-15,3,1
2,4,12,0,30,4,3,0,7,1,30,3,3,0,6,1,30,4,3,0,7,6,30,7,0,0,7,4,30,1,2,0,3,1,-15,3,1
2,2,13,4,30,6,1,0,7,0,30,4,0,0,4,5,30,6,1,0,7,5,30,5,2,0,7,5,30,4,0,0,4,1,-15,3,1
2,3,13,4,30,6,1,0,7,0,30,4,0,0,4,5,30,6,1,0,7,5,30,5,2,0,7,5,30,4,0,0,4,1,-15,3,1
2,0,19,0,30,4,9,0,13,1,30,4,4,0,8,0,30,4,9,0,13,5,30,4,9,0,13,0,30,7,2,0,9,1,-15,3,1
2,2,19,0,30,4,9,0,13,1,30,4,4,0,8,0,30,4,9,0,13,5,30,4,9,0,13,0,30,7,2,0,9,1,-15,3,1
2,3,19,0,30,4,9,0,13,1,30,4,4,0,8,0,30,4,9,0,13,5,30,4,9,0,13,0,30,7,2,0,9,1,-15,3,1
2,4,19,0,30,4,9,0,13,1,30,4,4,0,8,0,30,4,9,0,13,5,30,4,9,0,13,0,30,7,2,0,9,1,-15,3,1
2,2,25,1,30,5,9,0,14,6,30,6,0,0,6,0,30,4,10,0,14,1,30,8,6,0,14,8,30,6,0,0,6,1,-15,3,1
2,1,27,1,30,4,11,0,15,5,30,2,0,0,2,0,30,3,12,0,15,4,30,5,10,0,15,5,30,6,0,0,6,1,-15,3,1
2,3,28,0,30,7,1,0,8,5,30,4,0,0,4,0,30,1,7,0,8,0,30,2,6,0,8,4,30,4,0,0,4,1,-15,3,1
2,2,29,0,30,5,9,0,14,4,30,12,0,0,12,0,30,7,7,0,14,0,30,1,13,0,14,0,30,9,0,0,9,1,-15,3,1
2,0,39,4,30,4,7,0,11,6,30,6,0,0,6,0,30,5,6,0,11,0,30,2,9,0,11,6,30,5,0,0,5,1,-15,3,1
2,1,39,4,30,4,7,0,11,6,30,6,0,0,6,0,30,5,6,0,11,0,30,2,9,0,11,6,30,5,0,0,5,1,-15,3,1
2,2,39,4,30,4,7,0,11,6,30,6,0,0,6,0,30,5,6,0,11,0,30,2,9,0,11,6,30,5,0,0,5,1,-15,3,1
2,1,5,0,30,2,3,0,5,2,30,3,1,0,4,2,30,1,4,0,5,1,30,1,4,0,5,0,30,0,2,0,2,0,-27,3,0
2,4,11,0,30,3,9,0,12,0,30,4,0,0,4,2,30,8,4,0,12,3,30,4,8,0,12,3,30,4,0,0,4,1,-15,3,1
2,4,13,4,30,7,0,0,7,0,30,4,0,0,4,0,30,6,1,0,7,5,30,7,0,0,7,3,30,4,0,0,4,1,-15,3,1
2,4,15,0,30,4,9,0,13,0,30,6,0,0,6,0,30,5,8,0,13,1,30,4,9,0,13,0,30,6,3,0,9,1,-15,3,1
2,3,17,3,30,10,4,0,14,2,30,6,0,0,6,0,30,7,7,0,14,1,30,5,9,0,14,4,30,4,0,0,4,1,-15,3,1
2,0,19,0,30,2,11,0,13,2,30,8,0,0,8,3,30,7,6,0,13,4,30,8,5,0,13,1,30,5,4,0,9,1,-15,3,1
2,2,19,0,30,2,11,0,13,2,30,8,0,0,8,3,30,7,6,0,13,4,30,8,5,0,13,1,30,5,4,0,9,1,-15,3,1
2,3,19,0,30,2,11,0,13,2,30,8,0,0,8,3,30,7,6,0,13,4,30,8,5,0,13,1,30,5,4,0,9,1,-15,3,1
2,4,19,0,30,2,11,0,13,2,30,8,0,0,8,3,30,7,6,0,13,4,30,8,5,0,13,1,30,5,4,0,9,1,-15,3,1
2,2,4,5,30,8,0,0,8,5,30,4,0,0,4,0,30,1,7,0,8,0,30,0,8,0,8,5,30,4,0,0,4,0,-27,3,0
2,4,5,0,30,2,3,0,5,2,30,4,0,0,4,0,30,0,5,0,5,0,30,1,4,0,5,0,30,2,0,0,2,0,-27,3,0
2,3,8,1,30,7,0,0,7,3,30,2,0,0,2,2,30,7,0,0,7,4,30,6,1,0,7,3,30,3,0,0,3,0,-27,3,0
2,0,23,5,30,9,4,0,13,3,30,6,0,0,6,0,30,9,4,0,13,0,30,5,8,0,13,6,30,6,0,0,6,1,-15,3,1
2,3,23,5,30,9,4,0,13,3,30,6,0,0,6,0,30,9,4,0,13,0,30,5,8,0,13,6,30,6,0,0,6,1,-15,3,1
2,3,25,0,30,4,10,0,14,5,30,6,0,0,6,0,30,3,11,0,14,3,30,7,7,0,14,6,30,6,0,0,6,1,-15,3,1
2,1,29,0,30,8,6,0,14,5,30,11,1,0,12,0,30,3,11,0,14,0,30,1,13,0,14,5,30,9,0,0,9,1,-15,3,1
2,2,29,0,30,8,6,0,14,5,30,11,1,0,12,0,30,3,11,0,14,0,30,1,13,0,14,5,30,9,0,0,9,1,-15,3,1
2,3,29,0,30,8,6,0,14,5,30,11,1,0,12,0,30,3,11,0,14,0,30,1,13,0,14,5,30,9,0,0,9,1,-15,3,1
2,1,4,0,30,7,1,0,8,5,30,4,0,0,4,0,30,1,7,0,8,0,30,8,0,0,8,5,30,4,0,0,4,0,-27,3,0
2,2,4,0,30,7,1,0,8,5,30,4,0,0,4,0,30,1,7,0,8,0,30,8,0,0,8,5,30,4,0,0,4,0,-27,3,0
2,3,4,0,30,7,1,0,8,5,30,4,0,0,4,0,30,1,7,0,8,0,30,8,0,0,8,5,30,4,0,0,4,0,-27,3,0
2,4,8,2,30,7,0,0,7,4,30,2,0,0,2,0,30,4,3,0,7,0,30,7,0,0,7,0,30,3,0,0,3,0,-27,3,0
2,1,13,1,30,5,2,0,7,0,30,4,0,0,4,4,30,6,1,0,7,9,30,6,1,0,7,3,30,4,0,0,4,1,-15,3,1
2,4,13,1,30,5,2,0,7,0,30,4,0,0,4,4,30,6,1,0,7,9,30,6,1,0,7,3,30,4,0,0,4,1,-15,3,1
2,3,17,2,30,9,5,0,14,4,30,6,0,0,6,2,30,3,11,0,14,1,30,4,10,0,14,0,30,2,2,0,4,1,-15,3,1
2,0,26,0,30,5,4,0,9,5,30,4,0,0,4,8,30,1,8,0,9,0,30,2,7,0,9,6,30,3,0,0,3,1,-15,3,1
2,1,26,0,30,5,4,0,9,5,30,4,0,0,4,8,30,1,8,0,9,0,30,2,7,0,9,6,30,3,0,0,3,1,-15,3,1
2,3,26,0,30,5,4,0,9,5,30,4,0,0,4,8,30,1,8,0,9,0,30,2,7,0,9,6,30,3,0,0,3,1,-15,3,1
2,3,27,1,30,4,11,0,15,3,30,1,1,0,2,0,30,9,6,0,15,4,30,4,11,0,15,0,30,6,0,0,6,1,-15,3,1
2,3,31,2,30,9,3,0,12,3,30,8,0,0,8,3,30,10,2,0,12,0,30,3,9,0,12,1,30,6,0,0,6,1,-15,3,1
2,4,31,2,30,9,3,0,12,3,30,8,0,0,8,3,30,10,2,0,12,0,30,3,9,0,12,1,30,6,0,0,6,1,-15,3,1
2,3,35,0,30,6,7,0,13,6,30,2,0,0,2,1,30,2,11,0,13,0,30,1,12,0,13,5,30,8,0,0,8,1,-15,3,1
2,4,43,0,30,6,8,0,14,6,30,6,0,0,6,2,30,7,7,0,14,1,30,1,13,0,14,0,30,5,0,0,5,1,-15,3,1
2,3,4,2,30,5,3,0,8,5,30,4,0,0,4,3,30,1,7,0,8,1,30,8,0,0,8,0,30,4,0,0,4,0,-27,3,0
2,1,13,3,30,7,0,0,7,2,30,4,0,0,4,2,30,6,1,0,7,5,30,7,0,0,7,2,30,4,0,0,4,1,-15,3,1
2,3,19,0,30,4,9,0,13,2,30,7,1,0,8,0,30,7,6,0,13,2,30,3,10,0,13,0,30,9,0,0,9,1,-15,3,1
2,4,19,0,30,4,9,0,13,2,30,7,1,0,8,0,30,7,6,0,13,2,30,3,10,0,13,0,30,9,0,0,9,1,-15,3,1
2,2,23,1,30,5,8,0,13,2,30,6,0,0,6,3,30,13,0,0,13,0,30,4,9,0,13,2,30,6,0,0,6,1,-15,3,1
2,3,23,1,30,5,8,0,13,2,30,6,0,0,6,3,30,13,0,0,13,0,30,4,9,0,13,2,30,6,0,0,6,1,-15,3,1
2,4,23,1,30,5,8,0,13,2,30,6,0,0,6,3,30,13,0,0,13,0,30,4,9,0,13,2,30,6,0,0,6,1,-15,3,1
2,1,25,7,30,9,5,0,14,5,30,6,0,0,6,0,30,5,9,0,14,1,30,5,9,0,14,4,30,5,1,0,6,1,-15,3,1
2,2,25,7,30,9,5,0,14,5,30,6,0,0,6,0,30,5,9,0,14,1,30,5,9,0,14,4,30,5,1,0,6,1,-15,3,1
2,3,25,7,30,9,5,0,14,5,30,6,0,0,6,0,30,5,9,0,14,1,30,5,9,0,14,4,30,5,1,0,6,1,-15,3,1
2,4,25,7,30,9,5,0,14,5,30,6,0,0,6,0,30,5,9,0,14,1,30,5,9,0,14,4,30,5,1,0,6,1,-15,3,1
2,2,26,0,30,9,0,0,9,5,30,4,0,0,4,2,30,0,9,0,9,0,30,2,7,0,9,3,30,3,0,0,3,1,-15,3,1
2,3,26,0,30,9,0,0,9,5,30,4,0,0,4,2,30,0,9,0,9,0,30,2,7,0,9,3,30,3,0,0,3,1,-15,3,1
2,4,2,0,30,7,3,0,10,3,30,1,3,0,4,0,30,3,7,0,10,0,30,5,5,0,10,1,30,8,0,0,8,0,-27,3,0
2,1,17,4,30,11,3,0,14,2,30,6,0,0,6,0,30,6,8,0,14,1,30,7,7,0,14,1,30,3,1,0,4,1,-15,3,1
2,2,21,1,30,6,4,0,10,4,30,6,0,0,6,1,30,3,7,0,10,4,30,5,5,0,10,6,30,4,0,0,4,1,-15,3,1
2,3,21,1,30,6,4,0,10,4,30,6,0,0,6,1,30,3,7,0,10,4,30,5,5,0,10,6,30,4,0,0,4,1,-15,3,1
2,2,25,3,30,3,11,0,14,3,30,6,0,0,6,0,30,9,5,0,14,2,30,7,7,0,14,4,30,6,0,0,6,1,-15,3,1
2,4,25,3,30,3,11,0,14,3,30,6,0,0,6,0,30,9,5,0,14,2,30,7,7,0,14,4,30,6,0,0,6,1,-15,3,1
2,0,27,1,30,5,10,0,15,4,30,2,0,0,2,1,30,6,9,0,15,0,30,7,8,0,15,3,30,6,0,0,6,1,-15,3,1
2,4,27,0,30,5,10,0,15,4,30,2,0,0,2,1,30,6,9,0,15,0,30,7,8,0,15,3,30,6,0,0,6,1,-15,3,1
2,4,29,0,30,7,7,0,14,6,30,12,0,0,12,0,30,4,10,0,14,0,30,1,13,0,14,4,30,9,0,0,9,1,-15,3,1
2,2,31,1,30,6,6,0,12,4,30,8,0,0,8,4,30,9,3,0,12,0,30,5,7,0,12,1,30,4,2,0,6,1,-15,3,1
2,4,31,1,30,6,6,0,12,4,30,8,0,0,8,4,30,9,3,0,12,0,30,5,7,0,12,1,30,4,2,0,6,1,-15,3,1
2,3,43,0,30,3,11,0,14,7,30,6,0,0,6,0,30,4,10,0,14,1,30,1,13,0,14,7,30,5,0,0,5,1,-15,3,1
2,3,8,0,30,7,0,0,7,3,30,2,0,0,2,0,30,3,4,0,7,0,30,4,3,0,7,1,30,3,0,0,3,0,-27,3,0
2,1,19,0,30,3,10,0,13,3,30,2,6,0,8,0,30,6,7,0,13,7,30,4,9,0,13,5,30,9,0,0,9,1,-15,3,1
2,2,19,0,30,3,10,0,13,3,30,2,6,0,8,0,30,6,7,0,13,7,30,4,9,0,13,5,30,9,0,0,9,1,-15,3,1
2,4,27,1,30,7,8,0,15,4,30,2,0,0,2,0,30,2,13,0,15,0,30,4,11,0,15,6,30,6,0,0,6,1,-15,3,1
2,3,29,0,30,9,5,0,14,5,30,12,0,0,12,0,30,2,12,0,14,0,30,1,13,0,14,0,30,5,4,0,9,1,-15,3,1
2,0,4,2,30,8,0,0,8,5,30,4,0,0,4,0,30,3,5,0,8,0,30,8,0,0,8,2,30,2,2,0,4,0,-27,3,0
2,2,4,2,30,8,0,0,8,5,30,4,0,0,4,0,30,3,5,0,8,0,30,8,0,0,8,2,30,2,2,0,4,0,-27,3,0
2,3,4,2,30,8,0,0,8,5,30,4,0,0,4,0,30,3,5,0,8,0,30,8,0,0,8,2,30,2,2,0,4,0,-27,3,0
2,3,17,1,30,8,6,0,14,1,30,6,0,0,6,0,30,8,6,0,14,1,30,5,9,0,14,0,30,4,0,0,4,1,-15,3,1
2,1,19,0,30,7,6,0,13,2,30,4,4,0,8,4,30,4,9,0,13,4,30,4,9,0,13,0,30,9,0,0,9,1,-15,3,1
2,2,19,0,30,7,6,0,13,2,30,4,4,0,8,4,30,4,9,0,13,4,30,4,9,0,13,0,30,9,0,0,9,1,-15,3,1
2,3,19,0,30,7,6,0,13,2,30,4,4,0,8,4,30,4,9,0,13,4,30,4,9,0,13,0,30,9,0,0,9,1,-15,3,1
2,4,25,1,30,7,7,0,14,4,30,6,0,0,6,0,30,4,10,0,14,1,30,4,10,0,14,3,30,6,0,0,6,1,-15,3,1
2,4,27,1,30,4,11,0,15,3,30,2,0,0,2,0,30,12,3,0,15,2,30,6,9,0,15,0,30,5,1,0,6,1,-15,3,1
2,0,33,2,30,4,7,0,11,5,30,4,0,0,4,4,30,10,1,0,11,3,30,5,6,0,11,7,30,4,0,0,4,1,-15,3,1
2,1,33,2,30,4,7,0,11,5,30,4,0,0,4,4,30,10,1,0,11,3,30,5,6,0,11,7,30,4,0,0,4,1,-15,3,1
2,1,5,0,30,0,5,0,5,2,30,1,3,0,4,0,30,3,2,0,5,0,30,3,2,0,5,0,30,0,2,0,2,0,-27,3,0
2,4,5,0,30,0,5,0,5,2,30,1,3,0,4,0,30,3,2,0,5,0,30,3,2,0,5,0,30,0,2,0,2,0,-27,3,0
2,0,17,4,30,7,7,0,14,2,30,6,0,0,6,0,30,8,6,0,14,1,30,6,8,0,14,6,30,4,0,0,4,1,-15,3,1
2,1,17,4,30,7,7,0,14,2,30,6,0,0,6,0,30,8,6,0,14,1,30,6,8,0,14,6,30,4,0,0,4,1,-15,3,1
2,2,17,4,30,7,7,0,14,2,30,6,0,0,6,0,30,8,6,0,14,1,30,6,8,0,14,6,30,4,0,0,4,1,-15,3,1
2,3,17,4,30,7,7,0,14,2,30,6,0,0,6,0,30,8,6,0,14,1,30,6,8,0,14,6,30,4,0,0,4,1,-15,3,1
2,4,17,4,30,7,7,0,14,2,30,6,0,0,6,0,30,8,6,0,14,1,30,6,8,0,14,6,30,4,0,0,4,1,-15,3,1
2,2,19,0,30,3,10,0,13,2,30,7,1,0,8,0,30,4,9,0,13,3,30,5,8,0,13,2,30,9,0,0,9,1,-15,3,1
2,3,19,0,30,3,10,0,13,2,30,7,1,0,8,0,30,4,9,0,13,3,30,5,8,0,13,2,30,9,0,0,9,1,-15,3,1
2,3,23,1,30,5,8,0,13,3,30,6,0,0,6,8,30,13,0,0,13,0,30,5,8,0,13,2,30,5,1,0,6,1,-15,3,1
2,4,25,1,30,8,6,0,14,4,30,6,0,0,6,0,30,8,6,0,14,1,30,5,9,0,14,5,30,5,1,0,6,1,-15,3,1
2,3,27,1,30,4,11,0,15,3,30,1,1,0,2,0,30,3,12,0,15,4,30,6,9,0,15,0,30,6,0,0,6,1,-15,3,1
2,4,27,1,30,4,11,0,15,3,30,1,1,0,2,0,30,3,12,0,15,4,30,6,9,0,15,0,30,6,0,0,6,1,-15,3,1
2,0,4,2,30,6,2,0,8,5,30,4,0,0,4,1,30,1,7,0,8,3,30,8,0,0,8,1,30,4,0,0,4,0,-27,3,0
2,2,13,1,30,7,0,0,7,0,30,4,0,0,4,3,30,6,1,0,7,6,30,6,1,0,7,4,30,4,0,0,4,1,-15,3,1
2,2,17,3,30,9,5,0,14,3,30,6,0,0,6,0,30,5,9,0,14,1,30,7,7,0,14,8,30,4,0,0,4,1,-15,3,1
2,3,17,3,30,9,5,0,14,3,30,6,0,0,6,0,30,5,9,0,14,1,30,7,7,0,14,8,30,4,0,0,4,1,-15,3,1
2,3,19,0,30,4,9,0,13,1,30,8,0,0,8,0,30,5,8,0,13,3,30,6,7,0,13,1,30,6,3,0,9,1,-15,3,1
2,4,23,1,30,7,6,0,13,2,30,6,0,0,6,6,30,13,0,0,13,0,30,5,8,0,13,1,30,6,0,0,6,1,-15,3,1
2,1,27,1,30,3,12,0,15,2,30,2,0,0,2,0,30,6,9,0,15,0,30,6,9,0,15,0,30,6,0,0,6,1,-15,3,1
2,0,29,0,30,8,6,0,14,5,30,12,0,0,12,0,30,6,8,0,14,0,30,1,13,0,14,2,30,9,0,0,9,1,-15,3,1
2,1,29,0,30,8,6,0,14,5,30,12,0,0,12,0,30,6,8,0,14,0,30,1,13,0,14,2,30,9,0,0,9,1,-15,3,1
2,3,29,0,30,8,6,0,14,5,30,12,0,0,12,0,30,6,8,0,14,0,30,1,13,0,14,2,30,9,0,0,9,1,-15,3,1
2,4,29,0,30,8,6,0,14,5,30,12,0,0,12,0,30,6,8,0,14,0,30,1,13,0,14,2,30,9,0,0,9,1,-15,3,1
2,3,47,0,30,0,14,0,14,4,30,4,0,0,4,1,30,14,0,0,14,0,30,2,12,0,14,0,30,7,0,0,7,1,-15,3,1
2,2,1,1,30,6,4,0,10,4,30,2,0,0,2,1,30,4,6,0,10,5,30,9,1,0,10,6,30,6,0,0,6,0,-27,3,0
2,3,4,2,30,7,1,0,8,4,30,4,0,0,4,0,30,1,7,0,8,2,30,4,4,0,8,3,30,4,0,0,4,0,-27,3,0
2,4,4,2,30,7,1,0,8,4,30,4,0,0,4,0,30,1,7,0,8,2,30,4,4,0,8,3,30,4,0,0,4,0,-27,3,0
2,4,7,1,30,3,6,0,9,2,30,4,0,0,4,0,30,5,4,0,9,8,30,2,7,0,9,1,30,4,2,0,6,0,-27,3,0
2,3,8,2,30,7,0,0,7,3,30,2,0,0,2,3,30,3,4,0,7,1,30,7,0,0,7,2,30,3,0,0,3,0,-27,3,0
2,2,17,3,30,9,5,0,14,3,30,6,0,0,6,0,30,5,9,0,14,5,30,5,9,0,14,0,30,2,2,0,4,1,-15,3,1
2,4,17,3,30,9,5,0,14,3,30,6,0,0,6,0,30,5,9,0,14,5,30,5,9,0,14,0,30,2,2,0,4,1,-15,3,1
2,4,19,0,30,4,9,0,13,2,30,6,2,0,8,0,30,5,8,0,13,0,30,6,7,0,13,0,30,8,1,0,9,1,-15,3,1
2,0,21,2,30,8,2,0,10,3,30,4,2,0,6,0,30,4,6,0,10,5,30,5,5,0,10,2,30,4,0,0,4,1,-15,3,1
2,1,21,2,30,8,2,0,10,3,30,4,2,0,6,0,30,4,6,0,10,5,30,5,5,0,10,2,30,4,0,0,4,1,-15,3,1
2,3,21,2,30,8,2,0,10,3,30,4,2,0,6,0,30,4,6,0,10,5,30,5,5,0,10,2,30,4,0,0,4,1,-15,3,1
2,4,21,2,30,8,2,0,10,3,30,4,2,0,6,0,30,4,6,0,10,5,30,5,5,0,10,2,30,4,0,0,4,1,-15,3,1
2,4,23,1,30,8,5,0,13,0,30,6,0,0,6,1,30,12,1,0,13,0,30,5,8,0,13,1,30,5,1,0,6,1,-15,3,1
2,3,25,3,30,5,9,0,14,1,30,6,0,0,6,0,30,10,4,0,14,1,30,4,10,0,14,3,30,6,0,0,6,1,-15,3,1
2,3,7,1,30,5,4,0,9,2,30,4,0,0,4,0,30,9,0,0,9,5,30,4,5,0,9,1,30,5,1,0,6,0,-27,3,0
2,4,7,1,30,5,4,0,9,2,30,4,0,0,4,0,30,9,0,0,9,5,30,4,5,0,9,1,30,5,1,0,6,0,-27,3,0
2,3,8,2,30,7,0,0,7,3,30,2,0,0,2,2,30,3,4,0,7,0,30,5,2,0,7,0,30,3,0,0,3,0,-27,3,0
2,3,11,1,30,4,8,0,12,1,30,4,0,0,4,0,30,7,5,0,12,3,30,5,7,0,12,0,30,4,0,0,4,1,-15,3,1
2,2,13,1,30,6,1,0,7,0,30,4,0,0,4,2,30,6,1,0,7,5,30,6,1,0,7,7,30,4,0,0,4,1,-15,3,1
2,3,15,0,30,7,6,0,13,0,30,6,0,0,6,0,30,3,10,0,13,1,30,3,10,0,13,2,30,8,1,0,9,1,-15,3,1
2,3,17,3,30,11,3,0,14,2,30,6,0,0,6,0,30,7,7,0,14,1,30,6,8,0,14,2,30,4,0,0,4,1,-15,3,1
2,4,17,3,30,11,3,0,14,2,30,6,0,0,6,0,30,7,7,0,14,1,30,6,8,0,14,2,30,4,0,0,4,1,-15,3,1
2,2,19,0,30,3,10,0,13,2,30,5,3,0,8,0,30,4,9,0,13,7,30,4,9,0,13,2,30,8,1,0,9,1,-15,3,1
2,4,23,1,30,9,4,0,13,2,30,6,0,0,6,3,30,11,2,0,13,0,30,6,7,0,13,1,30,5,1,0,6,1,-15,3,1
2,2,25,1,30,4,10,0,14,5,30,6,0,0,6,0,30,8,6,0,14,0,30,5,9,0,14,4,30,6,0,0,6,1,-15,3,1
2,3,25,1,30,4,10,0,14,5,30,6,0,0,6,0,30,8,6,0,14,0,30,5,9,0,14,4,30,6,0,0,6,1,-15,3,1
2,3,31,3,30,8,4,0,12,3,30,8,0,0,8,3,30,11,1,0,12,0,30,3,9,0,12,0,30,2,4,0,6,1,-15,3,1
2,1,33,1,30,2,9,0,11,5,30,4,0,0,4,1,30,9,2,0,11,1,30,4,7,0,11,7,30,4,0,0,4,1,-15,3,1
2,2,33,1,30,2,9,0,11,5,30,4,0,0,4,1,30,9,2,0,11,1,30,4,7,0,11,7,30,4,0,0,4,1,-15,3,1
2,3,33,1,30,2,9,0,11,5,30,4,0,0,4,1,30,9,2,0,11,1,30,4,7,0,11,7,30,4,0,0,4,1,-15,3,1
2,3,38,0,30,3,7,0,10,7,30,6,0,0,6,0,30,1,9,0,10,3,30,1,9,0,10,6,30,6,0,0,6,1,-15,3,1
2,4,39,0,30,2,9,0,11,6,30,6,0,0,6,0,30,5,6,0,11,1,30,3,8,0,11,3,30,5,0,0,5,1,-15,3,1
2,2,13,7,30,7,0,0,7,0,30,4,0,0,4,2,30,6,1,0,7,6,30,7,0,0,7,5,30,4,0,0,4,1,-15,3,1
2,3,15,2,30,7,6,0,13,0,30,6,0,0,6,0,30,3,10,0,13,1,30,4,9,0,13,2,30,6,3,0,9,1,-15,3,1
2,4,15,2,30,7,6,0,13,0,30,6,0,0,6,0,30,3,10,0,13,1,30,4,9,0,13,2,30,6,3,0,9,1,-15,3,1
2,1,19,0,30,2,11,0,13,2,30,5,3,0,8,0,30,7,6,0,13,0,30,6,7,0,13,0,30,9,0,0,9,1,-15,3,1
2,3,19,0,30,2,11,0,13,2,30,5,3,0,8,0,30,7,6,0,13,0,30,6,7,0,13,0,30,9,0,0,9,1,-15,3,1
2,4,19,0,30,2,11,0,13,2,30,5,3,0,8,0,30,7,6,0,13,0,30,6,7,0,13,0,30,9,0,0,9,1,-15,3,1
2,1,21,2,30,8,2,0,10,4,30,6,0,0,6,1,30,3,7,0,10,4,30,5,5,0,10,2,30,4,0,0,4,1,-15,3,1
2,4,21,2,30,8,2,0,10,4,30,6,0,0,6,1,30,3,7,0,10,4,30,5,5,0,10,2,30,4,0,0,4,1,-15,3,1
2,3,25,1,30,10,4,0,14,2,30,6,0,0,6,0,30,5,9,0,14,1,30,5,9,0,14,3,30,5,1,0,6,1,-15,3,1
2,4,25,1,30,10,4,0,14,2,30,6,0,0,6,0,30,5,9,0,14,1,30,5,9,0,14,3,30,5,1,0,6,1,-15,3,1
2,2,27,1,30,5,10,0,15,4,30,2,0,0,2,0,30,8,7,0,15,0,30,4,11,0,15,1,30,6,0,0,6,1,-15,3,1
2,2,29,0,30,5,9,0,14,5,30,11,1,0,12,0,30,6,8,0,14,0,30,1,13,0,14,2,30,9,0,0,9,1,-15,3,1
2,2,4,2,30,6,2,0,8,5,30,4,0,0,4,0,30,1,7,0,8,1,30,2,6,0,8,3,30,4,0,0,4,0,-27,3,0
2,2,17,4,30,9,5,0,14,2,30,6,0,0,6,0,30,8,6,0,14,1,30,6,8,0,14,2,30,4,0,0,4,1,-15,3,1
2,4,17,4,30,9,5,0,14,2,30,6,0,0,6,0,30,8,6,0,14,1,30,6,8,0,14,2,30,4,0,0,4,1,-15,3,1
2,3,19,0,30,5,8,0,13,1,30,4,4,0,8,0,30,6,7,0,13,4,30,4,9,0,13,0,30,7,2,0,9,1,-15,3,1
2,2,23,2,30,5,8,0,13,3,30,6,0,0,6,4,30,11,2,0,13,0,30,5,8,0,13,4,30,6,0,0,6,1,-15,3,1
2,4,25,1,30,5,9,0,14,4,30,6,0,0,6,0,30,6,8,0,14,4,30,8,6,0,14,5,30,6,0,0,6,1,-15,3,1
2,3,29,0,30,5,9,0,14,5,30,12,0,0,12,0,30,10,4,0,14,0,30,1,13,0,14,1,30,9,0,0,9,1,-15,3,1
2,2,33,1,30,3,8,0,11,5,30,4,0,0,4,0,30,10,1,0,11,1,30,4,7,0,11,5,30,4,0,0,4,1,-15,3,1
2,3,33,1,30,3,8,0,11,5,30,4,0,0,4,0,30,10,1,0,11,1,30,4,7,0,11,5,30,4,0,0,4,1,-15,3,1
2,1,13,6,30,6,1,0,7,2,30,4,0,0,4,1,30,7,0,0,7,0,30,6,1,0,7,3,30,4,0,0,4,1,-15,3,1
2,4,13,6,30,6,1,0,7,2,30,4,0,0,4,1,30,7,0,0,7,0,30,6,1,0,7,3,30,4,0,0,4,1,-15,3,1
2,2,17,3,30,7,7,0,14,3,30,6,0,0,6,0,30,5,9,0,14,2,30,8,6,0,14,5,30,4,0,0,4,1,-15,3,1
2,3,19,0,30,5,8,0,13,1,30,4,4,0,8,0,30,7,6,0,13,0,30,4,9,0,13,1,30,8,1,0,9,1,-15,3,1
2,3,21,2,30,7,3,0,10,2,30,6,0,0,6,1,30,8,2,0,10,0,30,4,6,0,10,0,30,4,0,0,4,1,-15,3,1
2,4,21,2,30,7,3,0,10,2,30,6,0,0,6,1,30,8,2,0,10,0,30,4,6,0,10,0,30,4,0,0,4,1,-15,3,1
2,3,27,1,30,5,10,0,15,5,30,2,0,0,2,0,30,6,9,0,15,0,30,8,7,0,15,2,30,6,0,0,6,1,-15,3,1
2,4,27,1,30,5,10,0,15,5,30,2,0,0,2,0,30,6,9,0,15,0,30,8,7,0,15,2,30,6,0,0,6,1,-15,3,1
2,2,29,0,30,7,7,0,14,5,30,9,3,0,12,0,30,7,7,0,14,0,30,1,13,0,14,2,30,9,0,0,9,1,-15,3,1
2,2,31,4,30,8,4,0,12,6,30,8,0,0,8,4,30,7,5,0,12,0,30,5,7,0,12,1,30,5,1,0,6,1,-15,3,1
2,3,31,4,30,8,4,0,12,6,30,8,0,0,8,4,30,7,5,0,12,0,30,5,7,0,12,1,30,5,1,0,6,1,-15,3,1
2,4,31,4,30,8,4,0,12,6,30,8,0,0,8,4,30,7,5,0,12,0,30,5,7,0,12,1,30,5,1,0,6,1,-15,3,1
2,2,11,2,30,7,5,0,12,1,30,4,0,0,4,0,30,5,7,0,12,2,30,5,7,0,12,3,30,4,0,0,4,1,-15,3,1
2,3,11,2,30,7,5,0,12,1,30,4,0,0,4,0,30,5,7,0,12,2,30,5,7,0,12,3,30,4,0,0,4,1,-15,3,1
2,3,17,3,30,8,6,0,14,3,30,6,0,0,6,0,30,5,9,0,14,1,30,3,11,0,14,1,30,3,1,0,4,1,-15,3,1
2,1,19,0,30,1,12,0,13,1,30,5,3,0,8,0,30,13,0,0,13,3,30,4,9,0,13,2,30,8,1,0,9,1,-15,3,1
2,4,19,0,30,1,12,0,13,1,30,5,3,0,8,0,30,13,0,0,13,3,30,4,9,0,13,2,30,8,1,0,9,1,-15,3,1
2,1,27,1,30,4,11,0,15,5,30,2,0,0,2,0,30,6,9,0,15,1,30,6,9,0,15,0,30,5,1,0,6,1,-15,3,1
2,2,29,0,30,10,4,0,14,5,30,10,2,0,12,0,30,3,11,0,14,0,30,1,13,0,14,4,30,9,0,0,9,1,-15,3,1
2,2,31,1,30,8,4,0,12,4,30,8,0,0,8,3,30,9,3,0,12,0,30,5,7,0,12,0,30,5,1,0,6,1,-15,3,1
2,3,31,1,30,8,4,0,12,4,30,8,0,0,8,3,30,9,3,0,12,0,30,5,7,0,12,0,30,5,1,0,6,1,-15,3,1
2,1,33,1,30,4,7,0,11,4,30,4,0,0,4,4,30,9,2,0,11,2,30,3,8,0,11,4,30,4,0,0,4,1,-15,3,1
2,2,47,0,30,2,12,0,14,7,30,4,0,0,4,0,30,3,11,0,14,0,30,5,9,0,14,10,30,7,0,0,7,1,-15,3,1
2,3,47,0,30,2,12,0,14,7,30,4,0,0,4,0,30,3,11,0,14,0,30,5,9,0,14,10,30,7,0,0,7,1,-15,3,1
2,0,4,2,30,6,2,0,8,5,30,3,1,0,4,1,30,1,7,0,8,0,30,7,1,0,8,3,30,4,0,0,4,0,-27,3,0
2,1,4,2,30,6,2,0,8,5,30,3,1,0,4,1,30,1,7,0,8,0,30,7,1,0,8,3,30,4,0,0,4,0,-27,3,0
2,2,5,0,30,2,3,0,5,3,30,4,0,0,4,0,30,0,5,0,5,0,30,2,3,0,5,0,30,2,0,0,2,0,-27,3,0
2,4,5,0,30,2,3,0,5,3,30,4,0,0,4,0,30,0,5,0,5,0,30,2,3,0,5,0,30,2,0,0,2,0,-27,3,0
2,1,8,1,30,7,0,0,7,3,30,2,0,0,2,0,30,4,3,0,7,2,30,7,0,0,7,1,30,3,0,0,3,0,-27,3,0
2,3,17,4,30,11,3,0,14,4,30,6,0,0,6,0,30,4,10,0,14,3,30,7,7,0,14,2,30,4,0,0,4,1,-15,3,1
2,3,23,1,30,7,6,0,13,0,30,6,0,0,6,5,30,13,0,0,13,0,30,5,8,0,13,1,30,6,0,0,6,1,-15,3,1
2,1,27,1,30,4,11,0,15,3,30,2,0,0,2,0,30,5,10,0,15,3,30,8,7,0,15,1,30,4,2,0,6,1,-15,3,1
2,2,27,1,30,4,11,0,15,3,30,2,0,0,2,0,30,5,10,0,15,3,30,8,7,0,15,1,30,4,2,0,6,1,-15,3,1
2,4,27,0,30,4,11,0,15,3,30,2,0,0,2,0,30,5,10,0,15,3,30,8,7,0,15,1,30,4,2,0,6,1,-15,3,1
2,3,29,1,30,9,5,0,14,6,30,10,2,0,12,0,30,3,11,0,14,0,30,3,11,0,14,0,30,8,1,0,9,1,-15,3,1
2,4,31,2,30,9,3,0,12,3,30,8,0,0,8,3,30,10,2,0,12,0,30,3,9,0,12,1,30,2,4,0,6,1,-15,3,1
2,3,32,0,30,8,1,0,9,4,30,2,0,0,2,3,30,8,1,0,9,1,30,2,7,0,9,3,30,2,0,0,2,1,-15,3,1
2,1,41,0,30,7,5,0,12,5,30,6,2,0,8,0,30,7,5,0,12,1,30,4,8,0,12,3,30,7,0,0,7,1,-15,3,1
2,2,41,0,30,7,5,0,12,5,30,6,2,0,8,0,30,7,5,0,12,1,30,4,8,0,12,3,30,7,0,0,7,1,-15,3,1
2,3,5,0,30,0,5,0,5,2,30,2,2,0,4,0,30,4,1,0,5,0,30,1,4,0,5,0,30,0,2,0,2,0,-27,3,0
2,2,8,1,30,7,0,0,7,3,30,2,0,0,2,3,30,4,3,0,7,0,30,6,1,0,7,5,30,3,0,0,3,0,-27,3,0
2,1,13,5,30,7,0,0,7,2,30,4,0,0,4,6,30,7,0,0,7,5,30,4,3,0,7,3,30,4,0,0,4,1,-15,3,1
2,3,13,5,30,7,0,0,7,2,30,4,0,0,4,6,30,7,0,0,7,5,30,4,3,0,7,3,30,4,0,0,4,1,-15,3,1
2,4,19,0,30,4,9,0,13,2,30,7,1,0,8,0,30,5,8,0,13,1,30,4,9,0,13,2,30,9,0,0,9,1,-15,3,1
2,0,27,1,30,5,10,0,15,2,30,2,0,0,2,0,30,2,13,0,15,0,30,4,11,0,15,6,30,6,0,0,6,1,-15,3,1
2,1,27,1,30,5,10,0,15,2,30,2,0,0,2,0,30,2,13,0,15,0,30,4,11,0,15,6,30,6,0,0,6,1,-15,3,1
2,2,35,0,30,8,5,0,13,6,30,2,0,0,2,1,30,2,11,0,13,2,30,1,12,0,13,6,30,8,0,0,8,1,-15,3,1
2,3,35,0,30,8,5,0,13,6,30,2,0,0,2,1,30,2,11,0,13,2,30,1,12,0,13,6,30,8,0,0,8,1,-15,3,1
2,2,11,1,30,3,9,0,12,0,30,4,0,0,4,0,30,6,6,0,12,6,30,4,8,0,12,5,30,4,0,0,4,1,-15,3,1
2,4,11,1,30,3,9,0,12,0,30,4,0,0,4,0,30,6,6,0,12,6,30,4,8,0,12,5,30,4,0,0,4,1,-15,3,1
2,4,13,3,30,6,1,0,7,0,30,4,0,0,4,0,30,5,2,0,7,11,30,6,1,0,7,4,30,4,0,0,4,1,-15,3,1
2,4,15,0,30,4,9,0,13,1,30,6,0,0,6,0,30,3,10,0,13,1,30,4,9,0,13,0,30,9,0,0,9,1,-15,3,1
2,3,19,1,30,6,7,0,13,2,30,6,2,0,8,0,30,4,9,0,13,6,30,5,8,0,13,0,30,8,1,0,9,1,-15,3,1
2,2,25,1,30,4,10,0,14,4,30,6,0,0,6,0,30,8,6,0,14,1,30,6,8,0,14,5,30,5,1,0,6,1,-15,3,1
2,0,31,1,30,5,7,0,12,5,30,8,0,0,8,6,30,11,1,0,12,0,30,4,8,0,12,2,30,6,0,0,6,1,-15,3,1
2,4,31,0,30,5,7,0,12,5,30,8,0,0,8,6,30,11,1,0,12,0,30,4,8,0,12,2,30,6,0,0,6,1,-15,3,1
2,2,47,0,30,4,10,0,14,7,30,4,0,0,4,1,30,11,3,0,14,0,30,3,11,0,14,4,30,6,1,0,7,1,-15,3,1
2,3,47,0,30,4,10,0,14,7,30,4,0,0,4,1,30,11,3,0,14,0,30,3,11,0,14,4,30,6,1,0,7,1,-15,3,1
2,2,6,1,30,6,3,0,9,4,30,2,0,0,2,0,30,2,7,0,9,0,30,4,5,0,9,1,30,4,1,0,5,0,-27,3,0
2,4,6,1,30,6,3,0,9,4,30,2,0,0,2,0,30,2,7,0,9,0,30,4,5,0,9,0,30,4,1,0,5,0,-27,3,0
2,2,8,1,30,7,0,0,7,4,30,2,0,0,2,5,30,3,4,0,7,4,30,7,0,0,7,3,30,3,0,0,3,0,-27,3,0
2,4,13,0,30,6,1,0,7,1,30,4,0,0,4,2,30,6,1,0,7,4,30,5,2,0,7,3,30,4,0,0,4,1,-15,3,1
2,1,19,1,30,5,8,0,13,2,30,5,3,0,8,0,30,4,9,0,13,6,30,5,8,0,13,0,30,9,0,0,9,1,-15,3,1
2,2,19,1,30,5,8,0,13,2,30,5,3,0,8,0,30,4,9,0,13,6,30,5,8,0,13,0,30,9,0,0,9,1,-15,3,1
2,3,22,1,30,5,3,0,8,3,30,2,0,0,2,3,30,4,4,0,8,2,30,4,4,0,8,1,30,2,2,0,4,1,-15,3,1
2,4,22,1,30,5,3,0,8,3,30,2,0,0,2,3,30,4,4,0,8,2,30,4,4,0,8,1,30,2,2,0,4,1,-15,3,1
2,4,23,2,30,6,7,0,13,4,30,6,0,0,6,5,30,9,4,0,13,0,30,5,8,0,13,0,30,6,0,0,6,1,-15,3,1
2,2,27,4,30,5,0,0,5,3,30,0,0,0,0,0,30,1,4,0,5,0,30,1,4,0,5,1,30,4,0,0,4,1,-15,3,1
2,1,27,1,30,12,3,0,15,2,30,2,0,0,2,1,30,4,11,0,15,0,30,3,12,0,15,3,30,5,1,0,6,1,-15,3,1
2,2,27,1,30,12,3,0,15,2,30,2,0,0,2,1,30,4,11,0,15,0,30,3,12,0,15,3,30,5,1,0,6,1,-15,3,1
2,4,27,1,30,12,3,0,15,2,30,2,0,0,2,1,30,4,11,0,15,0,30,3,12,0,15,3,30,5,1,0,6,1,-15,3,1
2,0,29,0,30,6,8,0,14,6,30,11,1,0,12,0,30,5,9,0,14,0,30,1,13,0,14,1,30,9,0,0,9,1,-15,3,1
2,1,29,0,30,6,8,0,14,6,30,11,1,0,12,0,30,5,9,0,14,0,30,1,13,0,14,1,30,9,0,0,9,1,-15,3,1
2,2,29,0,30,6,8,0,14,6,30,11,1,0,12,0,30,5,9,0,14,0,30,1,13,0,14,1,30,9,0,0,9,1,-15,3,1
2,3,29,0,30,6,8,0,14,6,30,11,1,0,12,0,30,5,9,0,14,0,30,1,13,0,14,1,30,9,0,0,9,1,-15,3,1
2,1,4,2,30,7,1,0,8,5,30,4,0,0,4,1,30,1,7,0,8,0,30,6,2,0,8,3,30,4,0,0,4,0,-27,3,0
2,2,4,2,30,7,1,0,8,5,30,4,0,0,4,1,30,1,7,0,8,0,30,6,2,0,8,3,30,4,0,0,4,0,-27,3,0
2,3,9,3,30,8,3,0,11,4,30,6,0,0,6,1,30,4,7,0,11,4,30,2,9,0,11,3,30,3,1,0,4,0,-27,3,0
2,4,9,3,30,8,3,0,11,4,30,6,0,0,6,1,30,4,7,0,11,4,30,2,9,0,11,3,30,3,1,0,4,0,-27,3,0
2,2,11,3,30,3,9,0,12,1,30,4,0,0,4,4,30,6,6,0,12,3,30,4,8,0,12,2,30,4,0,0,4,1,-15,3,1
2,4,11,3,30,3,9,0,12,1,30,4,0,0,4,4,30,6,6,0,12,0,30,4,8,0,12,2,30,4,0,0,4,1,-15,3,1
2,3,13,3,30,7,0,0,7,1,30,4,0,0,4,2,30,6,1,0,7,5,30,6,1,0,7,4,30,4,0,0,4,1,-15,3,1
2,4,13,3,30,7,0,0,7,1,30,4,0,0,4,2,30,6,1,0,7,5,30,6,1,0,7,4,30,4,0,0,4,1,-15,3,1
2,4,17,1,30,10,4,0,14,3,30,6,0,0,6,0,30,4,10,0,14,1,30,5,9,0,14,4,30,4,0,0,4,1,-15,3,1
2,4,25,1,30,11,3,0,14,0,30,6,0,0,6,0,30,11,3,0,14,1,30,4,10,0,14,2,30,5,1,0,6,1,-15,3,1
2,1,27,1,30,4,11,0,15,2,30,1,1,0,2,0,30,9,6,0,15,0,30,5,10,0,15,2,30,6,0,0,6,1,-15,3,1
2,2,27,1,30,4,11,0,15,2,30,1,1,0,2,0,30,9,6,0,15,0,30,5,10,0,15,2,30,6,0,0,6,1,-15,3,1
2,3,27,1,30,4,11,0,15,2,30,1,1,0,2,0,30,9,6,0,15,0,30,5,10,0,15,2,30,6,0,0,6,1,-15,3,1
2,2,29,0,30,4,10,0,14,4,30,10,2,0,12,0,30,5,9,0,14,0,30,0,14,0,14,1,30,9,0,0,9,1,-15,3,1
2,2,31,3,30,8,4,0,12,6,30,8,0,0,8,3,30,6,6,0,12,0,30,5,7,0,12,1,30,3,3,0,6,1,-15,3,1
2,3,31,3,30,8,4,0,12,6,30,8,0,0,8,3,30,6,6,0,12,0,30,5,7,0,12,1,30,3,3,0,6,1,-15,3,1
2,4,31,3,30,8,4,0,12,6,30,8,0,0,8,3,30,6,6,0,12,0,30,5,7,0,12,1,30,3,3,0,6,1,-15,3,1
2,1,4,2,30,6,2,0,8,5,30,4,0,0,4,2,30,2,6,0,8,0,30,8,0,0,8,1,30,4,0,0,4,0,-27,3,0
2,2,4,2,30,6,2,0,8,5,30,4,0,0,4,2,30,2,6,0,8,0,30,8,0,0,8,1,30,4,0,0,4,0,-27,3,0
2,3,5,0,30,2,3,0,5,3,30,4,0,0,4,0,30,1,4,0,5,0,30,2,3,0,5,0,30,0,2,0,2,0,-27,3,0
2,2,13,4,30,6,1,0,7,1,30,4,0,0,4,1,30,6,1,0,7,3,30,7,0,0,7,4,30,4,0,0,4,1,-15,3,1
2,4,13,4,30,6,1,0,7,1,30,4,0,0,4,1,30,6,1,0,7,3,30,7,0,0,7,4,30,4,0,0,4,1,-15,3,1
2,2,17,4,30,7,7,0,14,3,30,6,0,0,6,0,30,6,8,0,14,1,30,6,8,0,14,1,30,4,0,0,4,1,-15,3,1
2,4,22,2,30,8,0,0,8,3,30,2,0,0,2,0,30,4,4,0,8,0,30,1,7,0,8,2,30,2,2,0,4,1,-15,3,1
2,1,25,1,30,7,7,0,14,2,30,6,0,0,6,0,30,12,2,0,14,1,30,5,9,0,14,3,30,5,1,0,6,1,-15,3,1
2,3,39,0,30,5,6,0,11,8,30,6,0,0,6,0,30,5,6,0,11,3,30,5,6,0,11,0,30,5,0,0,5,1,-15,3,1
2,4,39,0,30,5,6,0,11,8,30,6,0,0,6,0,30,5,6,0,11,3,30,5,6,0,11,0,30,5,0,0,5,1,-15,3,1
2,4,8,2,30,7,0,0,7,4,30,2,0,0,2,2,30,4,3,0,7,2,30,6,1,0,7,0,30,3,0,0,3,0,-27,3,0
2,4,12,0,30,6,1,0,7,2,30,2,4,0,6,2,30,2,5,0,7,5,30,5,2,0,7,5,30,3,0,0,3,1,-15,3,1
2,0,19,0,30,3,10,0,13,2,30,6,2,0,8,0,30,4,9,0,13,0,30,3,10,0,13,0,30,9,0,0,9,1,-15,3,1
2,1,19,0,30,3,10,0,13,2,30,6,2,0,8,0,30,4,9,0,13,0,30,3,10,0,13,0,30,9,0,0,9,1,-15,3,1
2,2,19,0,30,3,10,0,13,2,30,6,2,0,8,0,30,4,9,0,13,0,30,3,10,0,13,0,30,9,0,0,9,1,-15,3,1
2,3,19,0,30,3,10,0,13,2,30,6,2,0,8,0,30,4,9,0,13,0,30,3,10,0,13,0,30,9,0,0,9,1,-15,3,1
2,4,25,1,30,7,7,0,14,0,30,6,0,0,6,0,30,11,3,0,14,1,30,5,9,0,14,1,30,5,1,0,6,1,-15,3,1
2,1,27,1,30,5,10,0,15,3,30,2,0,0,2,0,30,8,7,0,15,0,30,3,12,0,15,1,30,5,1,0,6,1,-15,3,1
2,2,27,1,30,5,10,0,15,3,30,2,0,0,2,0,30,8,7,0,15,0,30,3,12,0,15,1,30,5,1,0,6,1,-15,3,1
2,4,29,0,30,3,11,0,14,6,30,12,0,0,12,0,30,4,10,0,14,0,30,1,13,0,14,4,30,9,0,0,9,1,-15,3,1
2,2,13,2,30,7,0,0,7,0,30,4,0,0,4,2,30,6,1,0,7,7,30,7,0,0,7,6,30,4,0,0,4,1,-15,3,1
2,1,17,5,30,10,4,0,14,3,30,6,0,0,6,0,30,6,8,0,14,1,30,5,9,0,14,1,30,2,2,0,4,1,-15,3,1
2,2,17,5,30,10,4,0,14,3,30,6,0,0,6,0,30,6,8,0,14,1,30,5,9,0,14,1,30,2,2,0,4,1,-15,3,1
2,3,17,5,30,10,4,0,14,3,30,6,0,0,6,0,30,6,8,0,14,1,30,5,9,0,14,1,30,2,2,0,4,1,-15,3,1
2,2,19,3,30,4,9,0,13,3,30,8,0,0,8,0,30,4,9,0,13,0,30,5,8,0,13,1,30,8,1,0,9,1,-15,3,1
2,2,27,1,30,5,10,0,15,2,30,1,1,0,2,0,30,9,6,0,15,0,30,7,8,0,15,3,30,6,0,0,6,1,-15,3,1
2,3,4,2,30,4,4,0,8,5,30,4,0,0,4,2,30,1,7,0,8,1,30,8,0,0,8,1,30,3,1,0,4,0,-27,3,0
2,2,13,3,30,7,0,0,7,0,30,4,0,0,4,2,30,5,2,0,7,5,30,6,1,0,7,6,30,4,0,0,4,1,-15,3,1
2,1,17,1,30,8,6,0,14,2,30,6,0,0,6,0,30,6,8,0,14,1,30,5,9,0,14,6,30,4,0,0,4,1,-15,3,1
2,2,17,1,30,8,6,0,14,2,30,6,0,0,6,0,30,6,8,0,14,1,30,5,9,0,14,6,30,4,0,0,4,1,-15,3,1
2,3,17,1,30,8,6,0,14,2,30,6,0,0,6,0,30,6,8,0,14,1,30,5,9,0,14,6,30,4,0,0,4,1,-15,3,1
2,0,19,0,30,3,10,0,13,2,30,3,5,0,8,0,30,4,9,0,13,9,30,6,7,0,13,3,30,9,0,0,9,1,-15,3,1
2,1,19,0,30,3,10,0,13,2,30,3,5,0,8,0,30,4,9,0,13,9,30,6,7,0,13,3,30,9,0,0,9,1,-15,3,1
2,2,19,0,30,3,10,0,13,2,30,3,5,0,8,0,30,4,9,0,13,9,30,6,7,0,13,3,30,9,0,0,9,1,-15,3,1
2,3,23,1,30,6,7,0,13,4,30,6,0,0,6,8,30,10,3,0,13,0,30,5,8,0,13,1,30,5,1,0,6,1,-15,3,1
2,4,29,0,30,5,9,0,14,6,30,10,2,0,12,0,30,3,11,0,14,0,30,1,13,0,14,1,30,9,0,0,9,1,-15,3,1
2,4,30,2,30,2,3,0,5,5,30,2,0,0,2,1,30,1,4,0,5,8,30,1,4,0,5,1,30,3,0,0,3,1,-15,3,1
2,3,45,0,30,12,1,0,13,10,30,10,0,0,10,0,30,1,12,0,13,0,30,4,9,0,13,8,30,5,0,0,5,1,-15,3,1
2,3,4,0,30,7,1,0,8,4,30,4,0,0,4,2,30,4,4,0,8,2,30,6,2,0,8,1,30,3,1,0,4,0,-27,3,0
2,4,8,0,30,7,0,0,7,3,30,2,0,0,2,1,30,5,2,0,7,1,30,6,1,0,7,5,30,3,0,0,3,0,-27,3,0
2,1,13,9,30,7,0,0,7,2,30,4,0,0,4,2,30,5,2,0,7,2,30,7,0,0,7,4,30,4,0,0,4,1,-15,3,1
2,4,13,9,30,7,0,0,7,2,30,4,0,0,4,2,30,5,2,0,7,2,30,7,0,0,7,4,30,4,0,0,4,1,-15,3,1
2,3,19,0,30,2,11,0,13,1,30,8,0,0,8,0,30,9,4,0,13,4,30,7,6,0,13,1,30,8,1,0,9,1,-15,3,1
2,4,19,0,30,2,11,0,13,1,30,8,0,0,8,0,30,9,4,0,13,4,30,7,6,0,13,1,30,8,1,0,9,1,-15,3,1
2,3,23,3,30,6,7,0,13,2,30,6,0,0,6,4,30,12,1,0,13,0,30,3,10,0,13,2,30,5,1,0,6,1,-15,3,1
2,0,37,1,30,7,4,0,11,6,30,8,0,0,8,0,30,2,9,0,11,2,30,3,8,0,11,6,30,6,0,0,6,1,-15,3,1
2,4,37,1,30,7,4,0,11,6,30,8,0,0,8,0,30,2,9,0,11,2,30,3,8,0,11,6,30,6,0,0,6,1,-15,3,1
2,4,39,3,30,5,6,0,11,6,30,6,0,0,6,0,30,8,3,0,11,0,30,3,8,0,11,1,30,5,0,0,5,1,-15,3,1
2,2,4,2,30,7,1,0,8,5,30,4,0,0,4,0,30,2,6,0,8,1,30,7,1,0,8,0,30,3,1,0,4,0,-27,3,0
2,3,4,2,30,7,1,0,8,5,30,4,0,0,4,0,30,2,6,0,8,1,30,7,1,0,8,0,30,3,1,0,4,0,-27,3,0
2,2,11,0,30,3,9,0,12,0,30,4,0,0,4,0,30,6,6,0,12,7,30,4,8,0,12,4,30,4,0,0,4,1,-15,3,1
2,1,17,3,30,10,4,0,14,3,30,6,0,0,6,0,30,7,7,0,14,2,30,8,6,0,14,1,30,4,0,0,4,1,-15,3,1
2,2,17,3,30,10,4,0,14,3,30,6,0,0,6,0,30,7,7,0,14,2,30,8,6,0,14,1,30,4,0,0,4,1,-15,3,1
2,3,17,3,30,10,4,0,14,3,30,6,0,0,6,0,30,7,7,0,14,2,30,8,6,0,14,1,30,4,0,0,4,1,-15,3,1
2,4,17,3,30,10,4,0,14,3,30,6,0,0,6,0,30,7,7,0,14,2,30,8,6,0,14,1,30,4,0,0,4,1,-15,3,1
2,2,19,0,30,5,8,0,13,2,30,7,1,0,8,0,30,5,8,0,13,5,30,4,9,0,13,0,30,7,2,0,9,1,-15,3,1
2,3,23,1,30,5,8,0,13,0,30,6,0,0,6,4,30,12,1,0,13,0,30,5,8,0,13,3,30,6,0,0,6,1,-15,3,1
2,4,23,1,30,5,8,0,13,0,30,6,0,0,6,4,30,12,1,0,13,0,30,5,8,0,13,3,30,6,0,0,6,1,-15,3,1
2,4,27,1,30,6,9,0,15,3,30,2,0,0,2,0,30,2,13,0,15,1,30,5,10,0,15,3,30,6,0,0,6,1,-15,3,1
2,3,31,5,30,7,5,0,12,4,30,8,0,0,8,3,30,10,2,0,12,0,30,3,9,0,12,1,30,3,3,0,6,1,-15,3,1
2,0,37,1,30,7,4,0,11,7,30,8,0,0,8,0,30,5,6,0,11,2,30,3,8,0,11,6,30,6,0,0,6,1,-15,3,1
2,4,37,1,30,7,4,0,11,7,30,8,0,0,8,0,30,5,6,0,11,2,30,3,8,0,11,6,30,6,0,0,6,1,-15,3,1
2,0,39,0,30,4,7,0,11,5,30,3,3,0,6,0,30,7,4,0,11,0,30,2,9,0,11,1,30,5,0,0,5,1,-15,3,1
2,2,39,0,30,4,7,0,11,5,30,3,3,0,6,0,30,7,4,0,11,0,30,2,9,0,11,1,30,5,0,0,5,1,-15,3,1
2,4,39,0,30,4,7,0,11,5,30,3,3,0,6,0,30,7,4,0,11,0,30,2,9,0,11,1,30,5,0,0,5,1,-15,3,1
2,3,43,0,30,7,7,0,14,6,30,6,0,0,6,0,30,4,10,0,14,1,30,3,11,0,14,7,30,5,0,0,5,1,-15,3,1
2,3,8,1,30,7,0,0,7,4,30,2,0,0,2,6,30,3,4,0,7,0,30,7,0,0,7,0,30,3,0,0,3,0,-27,3,0
2,4,13,2,30,7,0,0,7,0,30,4,0,0,4,2,30,6,1,0,7,10,30,6,1,0,7,5,30,4,0,0,4,1,-15,3,1
2,0,37,0,30,7,4,0,11,4,30,6,2,0,8,4,30,10,1,0,11,4,30,3,8,0,11,5,30,5,1,0,6,1,-15,3,1
2,1,37,0,30,7,4,0,11,4,30,6,2,0,8,4,30,10,1,0,11,4,30,3,8,0,11,5,30,5,1,0,6,1,-15,3,1
2,4,37,0,30,7,4,0,11,4,30,6,2,0,8,4,30,10,1,0,11,4,30,3,8,0,11,5,30,5,1,0,6,1,-15,3,1
2,2,39,3,30,4,7,0,11,7,30,6,0,0,6,0,30,4,7,0,11,0,30,3,8,0,11,4,30,5,0,0,5,1,-15,3,1
2,2,6,0,30,6,3,0,9,4,30,2,0,0,2,0,30,3,6,0,9,0,30,4,5,0,9,1,30,5,0,0,5,0,-27,3,0
2,4,8,2,30,7,0,0,7,4,30,2,0,0,2,0,30,1,6,0,7,1,30,7,0,0,7,4,30,3,0,0,3,0,-27,3,0
2,4,11,1,30,4,8,0,12,0,30,4,0,0,4,0,30,6,6,0,12,7,30,4,8,0,12,0,30,3,1,0,4,1,-15,3,1
2,2,13,3,30,5,2,0,7,0,30,4,0,0,4,2,30,7,0,0,7,8,30,6,1,0,7,4,30,4,0,0,4,1,-15,3,1
2,4,13,3,30,5,2,0,7,0,30,4,0,0,4,2,30,7,0,0,7,8,30,6,1,0,7,4,30,4,0,0,4,1,-15,3,1
2,4,15,1,30,6,7,0,13,1,30,5,1,0,6,0,30,4,9,0,13,1,30,4,9,0,13,0,30,7,2,0,9,1,-15,3,1
2,3,17,8,30,8,6,0,14,3,30,6,0,0,6,0,30,8,6,0,14,0,30,5,9,0,14,3,30,4,0,0,4,1,-15,3,1
2,2,19,0,30,5,8,0,13,1,30,6,2,0,8,0,30,7,6,0,13,4,30,5,8,0,13,0,30,6,3,0,9,1,-15,3,1
2,3,25,1,30,7,7,0,14,3,30,6,0,0,6,0,30,10,4,0,14,1,30,5,9,0,14,2,30,4,2,0,6,1,-15,3,1
2,1,27,1,30,5,10,0,15,3,30,2,0,0,2,0,30,2,13,0,15,2,30,7,8,0,15,1,30,6,0,0,6,1,-15,3,1
2,4,27,1,30,5,10,0,15,3,30,2,0,0,2,0,30,2,13,0,15,2,30,7,8,0,15,1,30,6,0,0,6,1,-15,3,1
2,0,29,0,30,8,6,0,14,5,30,10,2,0,12,0,30,3,11,0,14,0,30,1,13,0,14,1,30,9,0,0,9,1,-15,3,1
2,1,29,0,30,8,6,0,14,5,30,10,2,0,12,0,30,3,11,0,14,0,30,1,13,0,14,1,30,9,0,0,9,1,-15,3,1
2,2,36,0,30,2,7,0,9,5,30,1,1,0,2,2,30,5,4,0,9,0,30,4,5,0,9,7,30,3,0,0,3,1,-15,3,1
2,0,47,0,30,5,9,0,14,5,30,4,0,0,4,0,30,7,7,0,14,0,30,2,12,0,14,3,30,7,0,0,7,1,-15,3,1
2,3,47,0,30,5,9,0,14,5,30,4,0,0,4,0,30,7,7,0,14,0,30,2,12,0,14,3,30,7,0,0,7,1,-15,3,1
2,4,47,0,30,5,9,0,14,5,30,4,0,0,4,0,30,7,7,0,14,0,30,2,12,0,14,3,30,7,0,0,7,1,-15,3,1
2,3,8,3,30,7,0,0,7,3,30,2,0,0,2,2,30,3,4,0,7,0,30,4,3,0,7,4,30,3,0,0,3,0,-27,3,0
2,1,13,3,30,5,2,0,7,0,30,4,0,0,4,1,30,6,1,0,7,10,30,7,0,0,7,5,30,4,0,0,4,1,-15,3,1
2,3,17,3,30,9,5,0,14,2,30,6,0,0,6,0,30,6,8,0,14,1,30,6,8,0,14,4,30,4,0,0,4,1,-15,3,1
2,4,17,3,30,9,5,0,14,2,30,6,0,0,6,0,30,6,8,0,14,1,30,6,8,0,14,4,30,4,0,0,4,1,-15,3,1
2,2,25,1,30,6,8,0,14,5,30,6,0,0,6,0,30,8,6,0,14,3,30,5,9,0,14,3,30,6,0,0,6,1,-15,3,1
2,1,27,2,30,5,10,0,15,4,30,1,1,0,2,0,30,6,9,0,15,2,30,6,9,0,15,3,30,6,0,0,6,1,-15,3,1
2,1,31,3,30,7,5,0,12,4,30,8,0,0,8,4,30,10,2,0,12,0,30,3,9,0,12,0,30,3,3,0,6,1,-15,3,1
2,2,35,0,30,6,7,0,13,3,30,2,0,0,2,1,30,10,3,0,13,2,30,3,10,0,13,5,30,8,0,0,8,1,-15,3,1
2,4,35,0,30,6,7,0,13,3,30,2,0,0,2,1,30,10,3,0,13,2,30,3,10,0,13,5,30,8,0,0,8,1,-15,3,1
2,1,5,2,30,2,3,0,5,3,30,1,3,0,4,2,30,1,4,0,5,3,30,3,2,0,5,0,30,0,2,0,2,0,-27,3,0
2,3,5,2,30,2,3,0,5,3,30,1,3,0,4,2,30,1,4,0,5,3,30,3,2,0,5,0,30,0,2,0,2,0,-27,3,0
2,4,5,2,30,2,3,0,5,3,30,1,3,0,4,2,30,1,4,0,5,3,30,3,2,0,5,0,30,0,2,0,2,0,-27,3,0
2,1,13,1,30,6,1,0,7,0,30,4,0,0,4,2,30,6,1,0,7,9,30,5,2,0,7,3,30,4,0,0,4,1,-15,3,1
2,4,13,1,30,6,1,0,7,0,30,4,0,0,4,2,30,6,1,0,7,9,30,5,2,0,7,3,30,4,0,0,4,1,-15,3,1
2,1,17,3,30,12,2,0,14,2,30,6,0,0,6,0,30,6,8,0,14,1,30,6,8,0,14,6,30,4,0,0,4,1,-15,3,1
2,2,17,3,30,12,2,0,14,2,30,6,0,0,6,0,30,6,8,0,14,1,30,6,8,0,14,6,30,4,0,0,4,1,-15,3,1
2,3,17,3,30,12,2,0,14,2,30,6,0,0,6,0,30,6,8,0,14,1,30,6,8,0,14,6,30,4,0,0,4,1,-15,3,1
2,4,17,3,30,12,2,0,14,2,30,6,0,0,6,0,30,6,8,0,14,1,30,6,8,0,14,6,30,4,0,0,4,1,-15,3,1
2,2,25,0,30,4,10,0,14,3,30,5,1,0,6,0,30,6,8,0,14,1,30,8,6,0,14,5,30,6,0,0,6,1,-15,3,1
2,0,29,1,30,6,8,0,14,6,30,10,2,0,12,0,30,3,11,0,14,0,30,1,13,0,14,4,30,9,0,0,9,1,-15,3,1
2,4,31,3,30,6,6,0,12,5,30,8,0,0,8,9,30,9,3,0,12,0,30,3,9,0,12,0,30,2,4,0,6,1,-15,3,1
2,3,5,0,30,0,5,0,5,3,30,0,4,0,4,1,30,0,5,0,5,0,30,1,4,0,5,2,30,2,0,0,2,0,-27,3,0
2,4,8,6,30,7,0,0,7,4,30,2,0,0,2,0,30,3,4,0,7,0,30,2,5,0,7,3,30,3,0,0,3,0,-27,3,0
2,3,17,4,30,6,8,0,14,4,30,6,0,0,6,0,30,5,9,0,14,2,30,11,3,0,14,5,30,4,0,0,4,1,-15,3,1
2,4,23,1,30,3,10,0,13,1,30,6,0,0,6,3,30,10,3,0,13,1,30,4,9,0,13,2,30,6,0,0,6,1,-15,3,1
2,2,27,3,30,5,10,0,15,5,30,1,1,0,2,0,30,8,7,0,15,0,30,6,9,0,15,4,30,6,0,0,6,1,-15,3,1
2,1,4,2,30,7,1,0,8,5,30,3,1,0,4,1,30,2,6,0,8,0,30,8,0,0,8,1,30,4,0,0,4,0,-27,3,0
2,2,13,2,30,3,0,0,3,1,30,2,0,0,2,0,30,3,0,0,3,4,30,3,0,0,3,2,30,2,0,0,2,1,-15,3,1
2,3,13,2,30,3,0,0,3,1,30,2,0,0,2,0,30,3,0,0,3,4,30,3,0,0,3,2,30,2,0,0,2,1,-15,3,1
2,1,13,4,30,7,0,0,7,1,30,4,0,0,4,2,30,6,1,0,7,1,30,7,0,0,7,2,30,4,0,0,4,1,-15,3,1
2,2,19,1,30,6,7,0,13,2,30,6,2,0,8,0,30,6,7,0,13,1,30,4,9,0,13,1,30,8,1,0,9,1,-15,3,1
2,2,25,1,30,3,11,0,14,4,30,6,0,0,6,0,30,7,7,0,14,1,30,6,8,0,14,5,30,6,0,0,6,1,-15,3,1
2,0,27,1,30,4,11,0,15,5,30,1,1,0,2,4,30,6,9,0,15,0,30,6,9,0,15,1,30,4,2,0,6,1,-15,3,1
2,4,27,1,30,4,11,0,15,4,30,1,1,0,2,4,30,6,9,0,15,0,30,6,9,0,15,1,30,4,2,0,6,1,-15,3,1
2,4,29,0,30,10,4,0,14,4,30,8,4,0,12,0,30,6,8,0,14,0,30,0,14,0,14,0,30,8,1,0,9,1,-15,3,1
2,4,39,2,30,3,8,0,11,6,30,6,0,0,6,0,30,8,3,0,11,2,30,3,8,0,11,1,30,5,0,0,5,1,-15,3,1
2,4,3,0,30,1,3,0,4,2,30,4,0,0,4,0,30,0,4,0,4,0,30,2,2,0,4,1,30,1,2,0,3,0,-27,3,0
2,2,6,2,30,9,0,0,9,4,30,2,0,0,2,0,30,2,7,0,9,0,30,4,5,0,9,0,30,2,3,0,5,0,-27,3,0
2,4,6,2,30,9,0,0,9,4,30,2,0,0,2,0,30,2,7,0,9,0,30,4,5,0,9,0,30,2,3,0,5,0,-27,3,0
2,2,11,1,30,5,7,0,12,1,30,4,0,0,4,0,30,5,7,0,12,3,30,7,5,0,12,6,30,4,0,0,4,1,-15,3,1
2,4,11,1,30,5,7,0,12,1,30,4,0,0,4,0,30,5,7,0,12,3,30,7,5,0,12,6,30,4,0,0,4,1,-15,3,1
2,4,13,2,30,7,0,0,7,0,30,4,0,0,4,2,30,6,1,0,7,9,30,6,1,0,7,6,30,4,0,0,4,1,-15,3,1
2,3,15,0,30,4,9,0,13,0,30,6,0,0,6,0,30,3,10,0,13,1,30,5,8,0,13,3,30,9,0,0,9,1,-15,3,1
2,2,17,4,30,11,3,0,14,4,30,6,0,0,6,1,30,4,10,0,14,0,30,9,5,0,14,0,30,3,1,0,4,1,-15,3,1
2,3,17,4,30,11,3,0,14,4,30,6,0,0,6,1,30,4,10,0,14,0,30,9,5,0,14,0,30,3,1,0,4,1,-15,3,1
2,1,25,1,30,10,4,0,14,2,30,6,0,0,6,0,30,9,5,0,14,1,30,4,10,0,14,4,30,6,0,0,6,1,-15,3,1
2,1,29,0,30,3,11,0,14,5,30,12,0,0,12,0,30,7,7,0,14,0,30,0,14,0,14,4,30,9,0,0,9,1,-15,3,1
2,1,35,0,30,7,6,0,13,4,30,2,0,0,2,1,30,6,7,0,13,5,30,4,9,0,13,2,30,8,0,0,8,1,-15,3,1
2,2,37,2,30,8,3,0,11,6,30,8,0,0,8,0,30,5,6,0,11,10,30,3,8,0,11,2,30,6,0,0,6,1,-15,3,1
2,4,37,2,30,8,3,0,11,6,30,8,0,0,8,0,30,5,6,0,11,10,30,3,8,0,11,2,30,6,0,0,6,1,-15,3,1
2,0,41,0,30,10,2,0,12,5,30,8,0,0,8,0,30,7,5,0,12,0,30,2,10,0,12,1,30,5,2,0,7,1,-15,3,1
2,1,41,0,30,10,2,0,12,5,30,8,0,0,8,0,30,7,5,0,12,0,30,2,10,0,12,1,30,5,2,0,7,1,-15,3,1
2,4,41,0,30,10,2,0,12,5,30,8,0,0,8,0,30,7,5,0,12,0,30,2,10,0,12,1,30,5,2,0,7,1,-15,3,1
2,1,5,0,30,2,3,0,5,3,30,3,1,0,4,2,30,1,4,0,5,0,30,1,4,0,5,0,30,1,1,0,2,0,-27,3,0
2,3,5,0,30,2,3,0,5,3,30,3,1,0,4,2,30,1,4,0,5,0,30,1,4,0,5,0,30,1,1,0,2,0,-27,3,0
2,4,7,0,30,4,0,0,4,2,30,2,0,0,2,0,30,1,3,0,4,0,30,0,4,0,4,2,30,1,1,0,2,0,-27,3,0
2,4,13,2,30,5,2,0,7,0,30,4,0,0,4,1,30,6,1,0,7,13,30,5,2,0,7,1,30,4,0,0,4,1,-15,3,1
2,4,17,4,30,11,3,0,14,2,30,6,0,0,6,0,30,5,9,0,14,1,30,3,11,0,14,6,30,4,0,0,4,1,-15,3,1
2,4,19,0,30,2,11,0,13,2,30,7,1,0,8,0,30,6,7,0,13,9,30,2,11,0,13,2,30,9,0,0,9,1,-15,3,1
2,0,26,0,30,8,1,0,9,4,30,4,0,0,4,2,30,0,9,0,9,5,30,2,7,0,9,4,30,2,1,0,3,1,-15,3,1
2,1,26,0,30,8,1,0,9,4,30,4,0,0,4,2,30,0,9,0,9,5,30,2,7,0,9,4,30,2,1,0,3,1,-15,3,1
2,2,26,0,30,8,1,0,9,4,30,4,0,0,4,2,30,0,9,0,9,5,30,2,7,0,9,4,30,2,1,0,3,1,-15,3,1
2,2,27,5,30,5,10,0,15,2,30,2,0,0,2,2,30,7,8,0,15,2,30,7,8,0,15,1,30,2,4,0,6,1,-15,3,1
2,4,27,5,30,5,10,0,15,2,30,2,0,0,2,2,30,7,8,0,15,2,30,7,8,0,15,1,30,2,4,0,6,1,-15,3,1
2,3,31,4,30,8,4,0,12,3,30,8,0,0,8,4,30,12,0,0,12,0,30,3,9,0,12,0,30,3,3,0,6,1,-15,3,1
2,0,41,0,30,6,6,0,12,6,30,7,1,0,8,0,30,5,7,0,12,3,30,4,8,0,12,5,30,7,0,0,7,1,-15,3,1
2,3,41,0,30,6,6,0,12,6,30,7,1,0,8,0,30,5,7,0,12,3,30,4,8,0,12,5,30,7,0,0,7,1,-15,3,1
2,4,8,2,30,7,0,0,7,3,30,2,0,0,2,1,30,7,0,0,7,0,30,4,3,0,7,2,30,3,0,0,3,0,-27,3,0
2,1,21,2,30,5,5,0,10,4,30,6,0,0,6,1,30,3,7,0,10,6,30,6,4,0,10,3,30,4,0,0,4,1,-15,3,1
2,4,25,1,30,13,1,0,14,2,30,6,0,0,6,0,30,8,6,0,14,1,30,5,9,0,14,3,30,5,1,0,6,1,-15,3,1
2,2,31,3,30,3,9,0,12,5,30,8,0,0,8,3,30,8,4,0,12,0,30,7,5,0,12,3,30,6,0,0,6,1,-15,3,1
2,2,5,0,30,1,4,0,5,2,30,2,2,0,4,2,30,1,4,0,5,0,30,2,3,0,5,0,30,0,2,0,2,0,-27,3,0
2,4,8,3,30,7,0,0,7,3,30,2,0,0,2,0,30,4,3,0,7,0,30,2,5,0,7,2,30,3,0,0,3,0,-27,3,0
2,1,11,0,30,3,9,0,12,0,30,4,0,0,4,0,30,5,7,0,12,3,30,5,7,0,12,3,30,4,0,0,4,1,-15,3,1
2,0,13,4,30,7,0,0,7,2,30,4,0,0,4,2,30,6,1,0,7,1,30,7,0,0,7,4,30,4,0,0,4,1,-15,3,1
2,1,13,4,30,7,0,0,7,2,30,4,0,0,4,2,30,6,1,0,7,1,30,7,0,0,7,4,30,4,0,0,4,1,-15,3,1
2,2,13,4,30,7,0,0,7,2,30,4,0,0,4,2,30,6,1,0,7,1,30,7,0,0,7,4,30,4,0,0,4,1,-15,3,1
2,4,15,0,30,4,9,0,13,1,30,6,0,0,6,0,30,4,9,0,13,1,30,4,9,0,13,0,30,9,0,0,9,1,-15,3,1
2,2,19,0,30,4,9,0,13,1,30,5,3,0,8,0,30,9,4,0,13,6,30,6,7,0,13,2,30,8,1,0,9,1,-15,3,1
2,1,23,2,30,5,8,0,13,2,30,6,0,0,6,2,30,13,0,0,13,0,30,4,9,0,13,3,30,6,0,0,6,1,-15,3,1
2,4,23,2,30,5,8,0,13,2,30,6,0,0,6,2,30,13,0,0,13,0,30,4,9,0,13,3,30,6,0,0,6,1,-15,3,1
2,3,25,2,30,7,7,0,14,3,30,6,0,0,6,0,30,7,7,0,14,1,30,5,9,0,14,4,30,6,0,0,6,1,-15,3,1
2,4,25,2,30,7,7,0,14,3,30,6,0,0,6,0,30,7,7,0,14,1,30,5,9,0,14,4,30,6,0,0,6,1,-15,3,1
2,1,27,1,30,4,11,0,15,3,30,1,1,0,2,0,30,8,7,0,15,2,30,7,8,0,15,0,30,6,0,0,6,1,-15,3,1
2,2,27,1,30,4,11,0,15,3,30,1,1,0,2,0,30,8,7,0,15,2,30,7,8,0,15,0,30,6,0,0,6,1,-15,3,1
2,4,29,0,30,5,9,0,14,6,30,12,0,0,12,0,30,4,10,0,14,0,30,0,14,0,14,3,30,9,0,0,9,1,-15,3,1
2,1,6,1,30,8,1,0,9,4,30,2,0,0,2,0,30,2,7,0,9,0,30,4,5,0,9,1,30,3,2,0,5,0,-27,3,0
2,3,11,3,30,4,8,0,12,1,30,4,0,0,4,0,30,6,6,0,12,0,30,4,8,0,12,2,30,3,1,0,4,1,-15,3,1
2,4,11,3,30,4,8,0,12,1,30,4,0,0,4,0,30,6,6,0,12,0,30,4,8,0,12,2,30,3,1,0,4,1,-15,3,1
2,2,13,1,30,7,0,0,7,0,30,4,0,0,4,2,30,5,2,0,7,3,30,6,1,0,7,5,30,4,0,0,4,1,-15,3,1
2,3,13,1,30,7,0,0,7,0,30,4,0,0,4,2,30,5,2,0,7,3,30,6,1,0,7,5,30,4,0,0,4,1,-15,3,1
2,3,17,3,30,10,4,0,14,2,30,6,0,0,6,0,30,7,7,0,14,1,30,5,9,0,14,6,30,4,0,0,4,1,-15,3,1
2,2,19,1,30,4,9,0,13,2,30,3,5,0,8,0,30,6,7,0,13,1,30,6,7,0,13,3,30,9,0,0,9,1,-15,3,1
2,3,23,1,30,5,8,0,13,0,30,6,0,0,6,4,30,12,1,0,13,0,30,4,9,0,13,1,30,6,0,0,6,1,-15,3,1
2,2,29,0,30,10,4,0,14,5,30,7,5,0,12,0,30,4,10,0,14,0,30,3,11,0,14,2,30,9,0,0,9,1,-15,3,1
2,4,31,0,30,5,7,0,12,5,30,8,0,0,8,3,30,7,5,0,12,0,30,8,4,0,12,1,30,6,0,0,6,1,-15,3,1
2,2,33,2,30,5,6,0,11,4,30,4,0,0,4,1,30,11,0,0,11,3,30,5,6,0,11,6,30,4,0,0,4,1,-15,3,1
2,3,33,2,30,5,6,0,11,4,30,4,0,0,4,1,30,11,0,0,11,3,30,5,6,0,11,6,30,4,0,0,4,1,-15,3,1
2,3,35,0,30,7,6,0,13,3,30,2,0,0,2,0,30,2,11,0,13,3,30,2,11,0,13,6,30,8,0,0,8,1,-15,3,1
2,4,35,0,30,7,6,0,13,3,30,2,0,0,2,0,30,2,11,0,13,3,30,2,11,0,13,6,30,8,0,0,8,1,-15,3,1
2,2,5,0,30,0,5,0,5,2,30,2,2,0,4,0,30,0,5,0,5,0,30,1,4,0,5,0,30,0,2,0,2,0,-27,3,0
2,3,5,0,30,0,5,0,5,2,30,2,2,0,4,0,30,0,5,0,5,0,30,1,4,0,5,0,30,0,2,0,2,0,-27,3,0
2,4,5,0,30,0,5,0,5,2,30,2,2,0,4,0,30,0,5,0,5,0,30,1,4,0,5,0,30,0,2,0,2,0,-27,3,0
2,4,8,2,30,7,0,0,7,3,30,2,0,0,2,1,30,4,3,0,7,0,30,6,1,0,7,4,30,3,0,0,3,0,-27,3,0
2,2,13,1,30,5,2,0,7,0,30,4,0,0,4,2,30,6,1,0,7,7,30,6,1,0,7,4,30,4,0,0,4,1,-15,3,1
2,1,19,1,30,4,9,0,13,3,30,6,2,0,8,0,30,4,9,0,13,5,30,4,9,0,13,1,30,9,0,0,9,1,-15,3,1
2,2,19,1,30,4,9,0,13,3,30,6,2,0,8,0,30,4,9,0,13,5,30,4,9,0,13,1,30,9,0,0,9,1,-15,3,1
2,4,19,1,30,4,9,0,13,3,30,6,2,0,8,0,30,4,9,0,13,5,30,4,9,0,13,1,30,9,0,0,9,1,-15,3,1
2,3,39,0,30,8,3,0,11,7,30,6,0,0,6,2,30,4,7,0,11,0,30,2,9,0,11,0,30,5,0,0,5,1,-15,3,1
2,3,45,0,30,13,0,0,13,10,30,10,0,0,10,0,30,0,13,0,13,0,30,4,9,0,13,6,30,5,0,0,5,1,-15,3,1
2,1,5,0,30,0,5,0,5,2,30,3,1,0,4,0,30,0,5,0,5,0,30,1,4,0,5,0,30,2,0,0,2,0,-27,3,0
2,1,6,0,30,7,2,0,9,4,30,2,0,0,2,0,30,3,6,0,9,0,30,4,5,0,9,3,30,5,0,0,5,0,-27,3,0
2,2,6,0,30,7,2,0,9,4,30,2,0,0,2,0,30,3,6,0,9,0,30,4,5,0,9,3,30,5,0,0,5,0,-27,3,0
2,4,6,0,30,7,2,0,9,4,30,2,0,0,2,0,30,3,6,0,9,0,30,4,5,0,9,3,30,5,0,0,5,0,-27,3,0
2,3,9,0,30,7,4,0,11,2,30,6,0,0,6,1,30,10,1,0,11,5,30,5,6,0,11,1,30,4,0,0,4,0,-27,3,0
2,4,9,0,30,7,4,0,11,2,30,6,0,0,6,1,30,10,1,0,11,5,30,5,6,0,11,1,30,4,0,0,4,0,-27,3,0
2,1,17,5,30,10,4,0,14,3,30,6,0,0,6,0,30,5,9,0,14,1,30,6,8,0,14,1,30,4,0,0,4,1,-15,3,1
2,1,25,1,30,8,6,0,14,3,30,6,0,0,6,0,30,7,7,0,14,1,30,8,6,0,14,6,30,6,0,0,6,1,-15,3,1
2,2,27,1,30,5,10,0,15,4,30,1,1,0,2,2,30,7,8,0,15,0,30,3,12,0,15,3,30,6,0,0,6,1,-15,3,1
2,0,29,0,30,5,9,0,14,6,30,11,1,0,12,0,30,3,11,0,14,0,30,0,14,0,14,2,30,9,0,0,9,1,-15,3,1
2,2,38,0,30,2,8,0,10,6,30,6,0,0,6,0,30,1,9,0,10,0,30,3,7,0,10,8,30,6,0,0,6,1,-15,3,1
2,3,38,0,30,2,8,0,10,6,30,6,0,0,6,0,30,1,9,0,10,0,30,3,7,0,10,8,30,6,0,0,6,1,-15,3,1
2,1,13,2,30,6,1,0,7,0,30,4,0,0,4,3,30,7,0,0,7,5,30,6,1,0,7,5,30,4,0,0,4,1,-15,3,1
2,2,13,2,30,6,1,0,7,0,30,4,0,0,4,3,30,7,0,0,7,5,30,6,1,0,7,5,30,4,0,0,4,1,-15,3,1
2,4,15,1,30,4,9,0,13,1,30,6,0,0,6,0,30,4,9,0,13,1,30,4,9,0,13,5,30,5,4,0,9,1,-15,3,1
2,2,17,3,30,11,3,0,14,3,30,6,0,0,6,0,30,3,11,0,14,1,30,6,8,0,14,4,30,4,0,0,4,1,-15,3,1
2,4,17,3,30,11,3,0,14,3,30,6,0,0,6,0,30,3,11,0,14,1,30,6,8,0,14,4,30,4,0,0,4,1,-15,3,1
2,2,25,4,30,3,11,0,14,3,30,6,0,0,6,0,30,11,3,0,14,1,30,8,6,0,14,4,30,5,1,0,6,1,-15,3,1
2,3,25,4,30,3,11,0,14,3,30,6,0,0,6,0,30,11,3,0,14,1,30,8,6,0,14,4,30,5,1,0,6,1,-15,3,1
2,3,27,1,30,4,11,0,15,1,30,2,0,0,2,0,30,5,10,0,15,0,30,3,12,0,15,0,30,6,0,0,6,1,-15,3,1
2,4,29,0,30,3,11,0,14,6,30,10,2,0,12,0,30,3,11,0,14,0,30,1,13,0,14,3,30,9,0,0,9,1,-15,3,1
2,3,35,4,30,8,5,0,13,3,30,2,0,0,2,1,30,8,5,0,13,0,30,4,9,0,13,3,30,8,0,0,8,1,-15,3,1
2,4,35,4,30,8,5,0,13,3,30,2,0,0,2,1,30,8,5,0,13,0,30,4,9,0,13,3,30,8,0,0,8,1,-15,3,1
2,2,13,6,30,5,2,0,7,1,30,4,0,0,4,2,30,7,0,0,7,13,30,6,1,0,7,2,30,4,0,0,4,1,-15,3,1
2,4,13,6,30,5,2,0,7,1,30,4,0,0,4,2,30,7,0,0,7,13,30,6,1,0,7,2,30,4,0,0,4,1,-15,3,1
2,4,15,1,30,4,9,0,13,1,30,6,0,0,6,0,30,3,10,0,13,1,30,6,7,0,13,0,30,6,3,0,9,1,-15,3,1
2,4,19,0,30,7,6,0,13,2,30,6,2,0,8,4,30,4,9,0,13,0,30,4,9,0,13,4,30,7,2,0,9,1,-15,3,1
2,2,25,1,30,7,7,0,14,2,30,6,0,0,6,1,30,6,8,0,14,1,30,6,8,0,14,3,30,5,1,0,6,1,-15,3,1
2,4,26,0,30,5,4,0,9,3,30,2,2,0,4,1,30,1,8,0,9,7,30,2,7,0,9,6,30,3,0,0,3,1,-15,3,1
2,1,27,4,30,6,9,0,15,5,30,2,0,0,2,0,30,2,13,0,15,4,30,9,6,0,15,1,30,5,1,0,6,1,-15,3,1
2,3,27,4,30,6,9,0,15,5,30,2,0,0,2,0,30,2,13,0,15,4,30,9,6,0,15,1,30,5,1,0,6,1,-15,3,1
2,3,32,0,30,7,2,0,9,4,30,2,0,0,2,1,30,8,1,0,9,1,30,4,5,0,9,3,30,1,1,0,2,1,-15,3,1
2,1,5,0,30,3,2,0,5,2,30,2,2,0,4,0,30,3,2,0,5,0,30,1,4,0,5,0,30,0,2,0,2,0,-27,3,0
2,4,8,2,30,7,0,0,7,3,30,2,0,0,2,0,30,3,4,0,7,0,30,5,2,0,7,1,30,3,0,0,3,0,-27,3,0
2,3,17,3,30,9,5,0,14,2,30,6,0,0,6,0,30,9,5,0,14,2,30,6,8,0,14,4,30,4,0,0,4,1,-15,3,1
2,4,17,3,30,9,5,0,14,2,30,6,0,0,6,0,30,9,5,0,14,2,30,6,8,0,14,4,30,4,0,0,4,1,-15,3,1
2,3,23,0,30,5,8,0,13,3,30,6,0,0,6,6,30,13,0,0,13,0,30,4,9,0,13,3,30,6,0,0,6,1,-15,3,1
2,1,25,0,30,6,8,0,14,3,30,6,0,0,6,0,30,6,8,0,14,1,30,5,9,0,14,4,30,5,1,0,6,1,-15,3,1
2,2,25,0,30,6,8,0,14,3,30,6,0,0,6,0,30,6,8,0,14,1,30,5,9,0,14,4,30,5,1,0,6,1,-15,3,1
2,4,25,0,30,6,8,0,14,3,30,6,0,0,6,0,30,6,8,0,14,1,30,5,9,0,14,3,30,5,1,0,6,1,-15,3,1
2,4,27,0,30,5,10,0,15,5,30,2,0,0,2,0,30,3,12,0,15,2,30,4,11,0,15,0,30,4,2,0,6,1,-15,3,1
2,2,41,0,30,5,7,0,12,5,30,8,0,0,8,0,30,7,5,0,12,0,30,4,8,0,12,4,30,7,0,0,7,1,-15,3,1
2,3,45,0,30,6,7,0,13,10,30,10,0,0,10,0,30,3,10,0,13,0,30,8,5,0,13,8,30,5,0,0,5,1,-15,3,1
2,2,4,2,30,6,2,0,8,4,30,4,0,0,4,0,30,3,5,0,8,0,30,4,4,0,8,1,30,3,1,0,4,0,-27,3,0
2,3,4,2,30,6,2,0,8,4,30,4,0,0,4,0,30,3,5,0,8,0,30,4,4,0,8,1,30,3,1,0,4,0,-27,3,0
2,4,4,2,30,6,2,0,8,4,30,4,0,0,4,0,30,3,5,0,8,0,30,4,4,0,8,1,30,3,1,0,4,0,-27,3,0
2,1,13,2,30,7,0,0,7,1,30,4,0,0,4,2,30,5,2,0,7,9,30,5,2,0,7,3,30,4,0,0,4,1,-15,3,1
2,2,13,2,30,7,0,0,7,1,30,4,0,0,4,2,30,5,2,0,7,9,30,5,2,0,7,3,30,4,0,0,4,1,-15,3,1
2,3,19,0,30,4,9,0,13,1,30,4,4,0,8,0,30,9,4,0,13,1,30,4,9,0,13,1,30,7,2,0,9,1,-15,3,1
2,4,25,4,30,4,10,0,14,3,30,6,0,0,6,0,30,13,1,0,14,1,30,7,7,0,14,1,30,5,1,0,6,1,-15,3,1
2,0,27,1,30,4,11,0,15,4,30,2,0,0,2,0,30,2,13,0,15,2,30,6,9,0,15,4,30,6,0,0,6,1,-15,3,1
2,2,27,1,30,4,11,0,15,4,30,2,0,0,2,0,30,2,13,0,15,2,30,6,9,0,15,4,30,6,0,0,6,1,-15,3,1
2,4,27,1,30,4,11,0,15,4,30,2,0,0,2,0,30,2,13,0,15,2,30,6,9,0,15,4,30,6,0,0,6,1,-15,3,1
2,1,37,1,30,6,5,0,11,6,30,8,0,0,8,0,30,5,6,0,11,2,30,3,8,0,11,1,30,6,0,0,6,1,-15,3,1
2,3,39,2,30,6,5,0,11,6,30,6,0,0,6,0,30,6,5,0,11,0,30,2,9,0,11,1,30,5,0,0,5,1,-15,3,1
2,4,39,2,30,6,5,0,11,6,30,6,0,0,6,0,30,6,5,0,11,0,30,2,9,0,11,1,30,5,0,0,5,1,-15,3,1
2,1,5,3,30,1,4,0,5,3,30,2,2,0,4,0,30,2,3,0,5,0,30,1,4,0,5,0,30,0,2,0,2,0,-27,3,0
2,2,5,3,30,1,4,0,5,3,30,2,2,0,4,0,30,2,3,0,5,0,30,1,4,0,5,0,30,0,2,0,2,0,-27,3,0
2,4,13,4,30,7,0,0,7,2,30,4,0,0,4,1,30,6,1,0,7,0,30,7,0,0,7,2,30,4,0,0,4,1,-15,3,1
2,2,17,2,30,8,6,0,14,2,30,6,0,0,6,0,30,5,9,0,14,1,30,5,9,0,14,5,30,4,0,0,4,1,-15,3,1
2,2,19,0,30,3,10,0,13,2,30,5,3,0,8,0,30,8,5,0,13,0,30,5,8,0,13,1,30,9,0,0,9,1,-15,3,1
2,2,21,1,30,8,2,0,10,3,30,6,0,0,6,1,30,4,6,0,10,5,30,5,5,0,10,3,30,4,0,0,4,1,-15,3,1
2,4,23,2,30,7,6,0,13,2,30,6,0,0,6,2,30,12,1,0,13,0,30,5,8,0,13,3,30,6,0,0,6,1,-15,3,1
2,3,25,1,30,8,6,0,14,4,30,6,0,0,6,0,30,7,7,0,14,0,30,5,9,0,14,2,30,5,1,0,6,1,-15,3,1
2,3,31,1,30,4,8,0,12,6,30,8,0,0,8,4,30,4,8,0,12,0,30,6,6,0,12,3,30,6,0,0,6,1,-15,3,1
2,3,33,1,30,5,6,0,11,5,30,4,0,0,4,0,30,6,5,0,11,4,30,3,8,0,11,7,30,4,0,0,4,1,-15,3,1
2,0,41,0,30,10,2,0,12,7,30,8,0,0,8,0,30,4,8,0,12,0,30,3,9,0,12,3,30,1,6,0,7,1,-15,3,1
2,2,13,5,30,7,0,0,7,0,30,4,0,0,4,0,30,6,1,0,7,9,30,7,0,0,7,2,30,4,0,0,4,1,-15,3,1
2,4,15,2,30,4,9,0,13,1,30,6,0,0,6,0,30,3,10,0,13,1,30,2,11,0,13,0,30,6,3,0,9,1,-15,3,1
2,4,19,0,30,4,9,0,13,2,30,8,0,0,8,0,30,6,7,0,13,7,30,6,7,0,13,0,30,6,3,0,9,1,-15,3,1
2,1,25,1,30,3,11,0,14,4,30,6,0,0,6,0,30,7,7,0,14,4,30,7,7,0,14,6,30,6,0,0,6,1,-15,3,1
2,3,25,0,30,3,11,0,14,4,30,6,0,0,6,0,30,7,7,0,14,4,30,7,7,0,14,6,30,6,0,0,6,1,-15,3,1
2,4,29,0,30,5,9,0,14,6,30,11,1,0,12,0,30,8,6,0,14,0,30,3,11,0,14,2,30,9,0,0,9,1,-15,3,1
2,3,35,0,30,8,5,0,13,3,30,2,0,0,2,1,30,6,7,0,13,2,30,1,12,0,13,5,30,8,0,0,8,1,-15,3,1
2,4,13,3,30,7,0,0,7,0,30,4,0,0,4,2,30,6,1,0,7,5,30,4,3,0,7,2,30,4,0,0,4,1,-15,3,1
2,2,17,3,30,10,4,0,14,2,30,6,0,0,6,0,30,7,7,0,14,2,30,5,9,0,14,5,30,4,0,0,4,1,-15,3,1
2,3,17,3,30,10,4,0,14,2,30,6,0,0,6,0,30,7,7,0,14,2,30,5,9,0,14,5,30,4,0,0,4,1,-15,3,1
2,4,17,3,30,10,4,0,14,2,30,6,0,0,6,0,30,7,7,0,14,2,30,5,9,0,14,5,30,4,0,0,4,1,-15,3,1
2,0,25,3,30,4,10,0,14,4,30,5,1,0,6,0,30,9,5,0,14,1,30,6,8,0,14,4,30,6,0,0,6,1,-15,3,1
2,2,25,3,30,4,10,0,14,4,30,5,1,0,6,0,30,9,5,0,14,1,30,6,8,0,14,4,30,6,0,0,6,1,-15,3,1
2,3,25,3,30,4,10,0,14,4,30,5,1,0,6,0,30,9,5,0,14,1,30,6,8,0,14,4,30,6,0,0,6,1,-15,3,1
2,0,27,1,30,3,12,0,15,3,30,2,0,0,2,0,30,1,14,0,15,2,30,5,10,0,15,5,30,6,0,0,6,1,-15,3,1
2,2,27,1,30,3,12,0,15,3,30,2,0,0,2,0,30,1,14,0,15,2,30,5,10,0,15,5,30,6,0,0,6,1,-15,3,1
2,3,27,1,30,3,12,0,15,3,30,2,0,0,2,0,30,1,14,0,15,2,30,5,10,0,15,5,30,6,0,0,6,1,-15,3,1
2,1,5,0,30,2,3,0,5,3,30,0,4,0,4,0,30,0,5,0,5,0,30,2,3,0,5,0,30,0,2,0,2,0,-27,3,0
2,1,17,2,30,9,5,0,14,3,30,6,0,0,6,0,30,6,8,0,14,3,30,9,5,0,14,5,30,4,0,0,4,1,-15,3,1
2,1,19,0,30,5,8,0,13,1,30,3,5,0,8,0,30,5,8,0,13,7,30,4,9,0,13,0,30,9,0,0,9,1,-15,3,1
2,3,23,2,30,5,8,0,13,5,30,6,0,0,6,8,30,9,4,0,13,0,30,3,10,0,13,5,30,6,0,0,6,1,-15,3,1
2,3,25,0,30,4,10,0,14,3,30,6,0,0,6,2,30,14,0,0,14,1,30,5,9,0,14,3,30,5,1,0,6,1,-15,3,1
2,2,4,2,30,8,0,0,8,3,30,4,0,0,4,0,30,5,3,0,8,1,30,4,4,0,8,1,30,4,0,0,4,0,-27,3,0
2,3,4,2,30,8,0,0,8,3,30,4,0,0,4,0,30,5,3,0,8,1,30,4,4,0,8,1,30,4,0,0,4,0,-27,3,0
2,4,8,0,30,7,0,0,7,2,30,2,0,0,2,1,30,2,5,0,7,2,30,7,0,0,7,5,30,3,0,0,3,0,-27,3,0
2,4,13,4,30,7,0,0,7,0,30,4,0,0,4,2,30,7,0,0,7,8,30,6,1,0,7,1,30,4,0,0,4,1,-15,3,1
2,3,17,2,30,10,4,0,14,2,30,6,0,0,6,0,30,8,6,0,14,1,30,5,9,0,14,3,30,4,0,0,4,1,-15,3,1
2,4,23,2,30,6,7,0,13,2,30,6,0,0,6,1,30,11,2,0,13,0,30,6,7,0,13,3,30,6,0,0,6,1,-15,3,1
2,1,27,3,30,6,9,0,15,2,30,1,1,0,2,0,30,3,12,0,15,0,30,5,10,0,15,1,30,6,0,0,6,1,-15,3,1
2,3,27,3,30,6,9,0,15,2,30,1,1,0,2,0,30,3,12,0,15,0,30,5,10,0,15,1,30,6,0,0,6,1,-15,3,1
2,1,4,2,30,7,1,0,8,4,30,4,0,0,4,0,30,3,5,0,8,0,30,5,3,0,8,3,30,4,0,0,4,0,-27,3,0
2,3,4,2,30,7,1,0,8,4,30,4,0,0,4,0,30,3,5,0,8,0,30,5,3,0,8,3,30,4,0,0,4,0,-27,3,0
2,4,4,2,30,7,1,0,8,4,30,4,0,0,4,0,30,3,5,0,8,0,30,5,3,0,8,3,30,4,0,0,4,0,-27,3,0
2,4,7,0,30,3,6,0,9,1,30,4,0,0,4,0,30,9,0,0,9,8,30,3,6,0,9,2,30,5,1,0,6,0,-27,3,0
2,4,10,2,30,5,4,0,9,1,30,4,0,0,4,0,30,2,7,0,9,0,30,0,9,0,9,0,30,4,1,0,5,1,-15,3,1
2,0,13,1,30,6,1,0,7,2,30,4,0,0,4,6,30,5,2,0,7,7,30,6,1,0,7,4,30,4,0,0,4,1,-15,3,1
2,1,13,1,30,6,1,0,7,2,30,4,0,0,4,6,30,5,2,0,7,7,30,6,1,0,7,4,30,4,0,0,4,1,-15,3,1
2,2,13,1,30,6,1,0,7,2,30,4,0,0,4,6,30,5,2,0,7,7,30,6,1,0,7,4,30,4,0,0,4,1,-15,3,1
2,4,13,1,30,6,1,0,7,2,30,4,0,0,4,6,30,5,2,0,7,7,30,6,1,0,7,4,30,4,0,0,4,1,-15,3,1
2,3,15,0,30,3,10,0,13,1,30,6,0,0,6,0,30,4,9,0,13,2,30,5,8,0,13,2,30,8,1,0,9,1,-15,3,1
2,4,15,0,30,3,10,0,13,1,30,6,0,0,6,0,30,4,9,0,13,2,30,5,8,0,13,2,30,8,1,0,9,1,-15,3,1
2,0,17,5,30,11,3,0,14,3,30,6,0,0,6,0,30,3,11,0,14,2,30,5,9,0,14,5,30,4,0,0,4,1,-15,3,1
2,2,17,5,30,11,3,0,14,3,30,6,0,0,6,0,30,3,11,0,14,2,30,5,9,0,14,5,30,4,0,0,4,1,-15,3,1
2,4,17,5,30,11,3,0,14,3,30,6,0,0,6,0,30,3,11,0,14,2,30,5,9,0,14,5,30,4,0,0,4,1,-15,3,1
2,0,19,0,30,3,10,0,13,1,30,7,1,0,8,0,30,9,4,0,13,7,30,4,9,0,13,1,30,8,1,0,9,1,-15,3,1
2,1,19,0,30,3,10,0,13,1,30,7,1,0,8,0,30,9,4,0,13,7,30,4,9,0,13,1,30,8,1,0,9,1,-15,3,1
2,1,25,1,30,7,7,0,14,3,30,6,0,0,6,0,30,7,7,0,14,1,30,7,7,0,14,5,30,5,1,0,6,1,-15,3,1
2,2,25,1,30,7,7,0,14,3,30,6,0,0,6,0,30,7,7,0,14,1,30,7,7,0,14,5,30,5,1,0,6,1,-15,3,1
2,2,27,1,30,4,11,0,15,2,30,1,1,0,2,0,30,5,10,0,15,0,30,7,8,0,15,6,30,6,0,0,6,1,-15,3,1
2,3,27,1,30,4,11,0,15,2,30,1,1,0,2,0,30,5,10,0,15,0,30,7,8,0,15,6,30,6,0,0,6,1,-15,3,1
2,1,13,1,30,4,3,0,7,0,30,4,0,0,4,2,30,6,1,0,7,11,30,7,0,0,7,3,30,4,0,0,4,1,-15,3,1
2,4,13,1,30,4,3,0,7,0,30,4,0,0,4,2,30,6,1,0,7,11,30,7,0,0,7,3,30,4,0,0,4,1,-15,3,1
2,3,17,4,30,10,4,0,14,3,30,6,0,0,6,0,30,4,10,0,14,1,30,5,9,0,14,4,30,4,0,0,4,1,-15,3,1
2,4,17,4,30,10,4,0,14,3,30,6,0,0,6,0,30,4,10,0,14,1,30,5,9,0,14,4,30,4,0,0,4,1,-15,3,1
2,3,19,0,30,4,9,0,13,0,30,6,2,0,8,0,30,4,9,0,13,0,30,6,7,0,13,0,30,8,1,0,9,1,-15,3,1
2,4,31,0,30,7,5,0,12,7,30,8,0,0,8,3,30,4,8,0,12,0,30,9,3,0,12,3,30,6,0,0,6,1,-15,3,1
2,2,8,2,30,7,0,0,7,3,30,2,0,0,2,0,30,5,2,0,7,0,30,5,2,0,7,2,30,3,0,0,3,0,-27,3,0
2,3,8,2,30,7,0,0,7,3,30,2,0,0,2,0,30,5,2,0,7,0,30,5,2,0,7,2,30,3,0,0,3,0,-27,3,0
2,1,17,4,30,9,5,0,14,3,30,6,0,0,6,0,30,6,8,0,14,4,30,8,6,0,14,4,30,4,0,0,4,1,-15,3,1
2,3,17,4,30,9,5,0,14,3,30,6,0,0,6,0,30,6,8,0,14,4,30,8,6,0,14,4,30,4,0,0,4,1,-15,3,1
2,4,17,4,30,9,5,0,14,3,30,6,0,0,6,0,30,6,8,0,14,4,30,8,6,0,14,4,30,4,0,0,4,1,-15,3,1
2,3,19,0,30,5,8,0,13,2,30,8,0,0,8,0,30,4,9,0,13,1,30,6,7,0,13,0,30,6,3,0,9,1,-15,3,1
2,0,25,1,30,6,8,0,14,3,30,6,0,0,6,0,30,9,5,0,14,1,30,5,9,0,14,4,30,5,1,0,6,1,-15,3,1
2,4,25,1,30,6,8,0,14,3,30,6,0,0,6,0,30,9,5,0,14,1,30,5,9,0,14,4,30,5,1,0,6,1,-15,3,1
2,0,27,1,30,4,11,0,15,4,30,2,0,0,2,4,30,3,12,0,15,0,30,11,4,0,15,2,30,2,4,0,6,1,-15,3,1
2,1,27,1,30,4,11,0,15,4,30,2,0,0,2,4,30,3,12,0,15,0,30,11,4,0,15,2,30,2,4,0,6,1,-15,3,1
2,4,27,1,30,4,11,0,15,4,30,2,0,0,2,0,30,3,12,0,15,0,30,11,4,0,15,2,30,2,4,0,6,1,-15,3,1
2,4,39,0,30,1,10,0,11,6,30,6,0,0,6,2,30,7,4,0,11,0,30,2,9,0,11,4,30,5,0,0,5,1,-15,3,1
2,4,5,0,30,2,3,0,5,3,30,3,1,0,4,0,30,0,5,0,5,0,30,1,4,0,5,3,30,2,0,0,2,0,-27,3,0
2,2,17,7,30,12,2,0,14,4,30,6,0,0,6,0,30,3,11,0,14,1,30,5,9,0,14,1,30,4,0,0,4,1,-15,3,1
2,4,17,7,30,12,2,0,14,4,30,6,0,0,6,0,30,3,11,0,14,1,30,5,9,0,14,1,30,4,0,0,4,1,-15,3,1
2,0,25,1,30,5,9,0,14,4,30,6,0,0,6,0,30,10,4,0,14,1,30,7,7,0,14,4,30,6,0,0,6,1,-15,3,1
2,4,25,1,30,5,9,0,14,4,30,6,0,0,6,0,30,10,4,0,14,1,30,7,7,0,14,4,30,6,0,0,6,1,-15,3,1
2,4,27,1,30,4,11,0,15,3,30,2,0,0,2,0,30,3,12,0,15,0,30,6,9,0,15,0,30,5,1,0,6,1,-15,3,1
2,3,29,0,30,9,5,0,14,6,30,12,0,0,12,0,30,4,10,0,14,0,30,1,13,0,14,1,30,9,0,0,9,1,-15,3,1
2,4,29,0,30,9,5,0,14,6,30,12,0,0,12,0,30,4,10,0,14,0,30,1,13,0,14,1,30,9,0,0,9,1,-15,3,1
2,3,31,1,30,5,7,0,12,4,30,8,0,0,8,6,30,12,0,0,12,0,30,3,9,0,12,1,30,3,3,0,6,1,-15,3,1
2,4,31,1,30,5,7,0,12,4,30,8,0,0,8,6,30,12,0,0,12,0,30,3,9,0,12,1,30,3,3,0,6,1,-15,3,1
2,3,8,3,30,7,0,0,7,4,30,2,0,0,2,3,30,3,4,0,7,0,30,5,2,0,7,5,30,3,0,0,3,0,-27,3,0
2,4,8,3,30,7,0,0,7,4,30,2,0,0,2,3,30,3,4,0,7,0,30,5,2,0,7,5,30,3,0,0,3,0,-27,3,0
2,2,9,0,30,5,6,0,11,2,30,6,0,0,6,1,30,7,4,0,11,6,30,3,8,0,11,3,30,4,0,0,4,0,-27,3,0
2,4,9,0,30,5,6,0,11,2,30,6,0,0,6,1,30,7,4,0,11,6,30,3,8,0,11,3,30,4,0,0,4,0,-27,3,0
2,4,13,2,30,6,1,0,7,0,30,4,0,0,4,2,30,5,2,0,7,8,30,5,2,0,7,4,30,4,0,0,4,1,-15,3,1
2,2,21,2,30,6,4,0,10,3,30,4,2,0,6,0,30,4,6,0,10,7,30,6,4,0,10,4,30,4,0,0,4,1,-15,3,1
2,4,21,2,30,6,4,0,10,3,30,4,2,0,6,0,30,4,6,0,10,7,30,6,4,0,10,4,30,4,0,0,4,1,-15,3,1
2,2,23,1,30,4,9,0,13,3,30,6,0,0,6,3,30,13,0,0,13,0,30,5,8,0,13,4,30,6,0,0,6,1,-15,3,1
2,2,25,1,30,5,9,0,14,4,30,6,0,0,6,0,30,5,9,0,14,1,30,10,4,0,14,5,30,6,0,0,6,1,-15,3,1
2,4,25,1,30,5,9,0,14,4,30,6,0,0,6,0,30,5,9,0,14,1,30,10,4,0,14,5,30,6,0,0,6,1,-15,3,1
2,0,27,1,30,7,8,0,15,4,30,1,1,0,2,0,30,5,10,0,15,0,30,4,11,0,15,2,30,6,0,0,6,1,-15,3,1
2,1,27,1,30,7,8,0,15,4,30,1,1,0,2,0,30,5,10,0,15,0,30,4,11,0,15,2,30,6,0,0,6,1,-15,3,1
2,2,27,1,30,7,8,0,15,4,30,1,1,0,2,0,30,5,10,0,15,0,30,4,11,0,15,2,30,6,0,0,6,1,-15,3,1
2,3,27,1,30,7,8,0,15,4,30,1,1,0,2,0,30,5,10,0,15,0,30,4,11,0,15,2,30,6,0,0,6,1,-15,3,1
2,4,27,1,30,7,8,0,15,4,30,1,1,0,2,0,30,5,10,0,15,0,30,4,11,0,15,2,30,6,0,0,6,1,-15,3,1
2,0,31,4,30,7,5,0,12,5,30,8,0,0,8,3,30,10,2,0,12,0,30,3,9,0,12,3,30,3,3,0,6,1,-15,3,1
2,3,31,4,30,7,5,0,12,5,30,8,0,0,8,3,30,10,2,0,12,0,30,3,9,0,12,3,30,3,3,0,6,1,-15,3,1
2,4,31,4,30,7,5,0,12,5,30,8,0,0,8,3,30,10,2,0,12,0,30,3,9,0,12,3,30,3,3,0,6,1,-15,3,1
2,2,35,2,30,12,1,0,13,7,30,2,0,0,2,1,30,2,11,0,13,0,30,5,8,0,13,6,30,8,0,0,8,1,-15,3,1
2,0,4,4,30,7,1,0,8,4,30,2,2,0,4,0,30,3,5,0,8,0,30,2,6,0,8,4,30,4,0,0,4,0,-27,3,0
2,2,4,4,30,7,1,0,8,4,30,2,2,0,4,0,30,3,5,0,8,0,30,2,6,0,8,4,30,4,0,0,4,0,-27,3,0
2,4,8,1,30,7,0,0,7,4,30,2,0,0,2,4,30,4,3,0,7,0,30,7,0,0,7,5,30,3,0,0,3,0,-27,3,0
2,2,9,0,30,6,5,0,11,3,30,6,0,0,6,1,30,5,6,0,11,3,30,4,7,0,11,5,30,4,0,0,4,0,-27,3,0
2,1,13,5,30,7,0,0,7,0,30,4,0,0,4,2,30,6,1,0,7,5,30,4,3,0,7,1,30,4,0,0,4,1,-15,3,1
2,2,13,5,30,7,0,0,7,0,30,4,0,0,4,2,30,6,1,0,7,5,30,4,3,0,7,1,30,4,0,0,4,1,-15,3,1
2,0,17,6,30,10,4,0,14,3,30,6,0,0,6,0,30,7,7,0,14,5,30,5,9,0,14,2,30,3,1,0,4,1,-15,3,1
2,0,27,2,30,6,9,0,15,4,30,1,1,0,2,0,30,2,13,0,15,0,30,7,8,0,15,5,30,6,0,0,6,1,-15,3,1
2,2,9,6,30,3,1,0,4,3,30,2,0,0,2,0,30,3,1,0,4,0,30,0,4,0,4,1,30,1,0,0,1,0,-27,3,0
2,4,9,6,30,3,1,0,4,3,30,2,0,0,2,0,30,3,1,0,4,0,30,0,4,0,4,1,30,1,0,0,1,0,-27,3,0
2,2,13,1,30,3,4,0,7,0,30,4,0,0,4,2,30,7,0,0,7,7,30,6,1,0,7,4,30,4,0,0,4,1,-15,3,1
2,4,13,1,30,3,4,0,7,0,30,4,0,0,4,2,30,7,0,0,7,7,30,6,1,0,7,4,30,4,0,0,4,1,-15,3,1
2,4,17,4,30,12,2,0,14,2,30,6,0,0,6,0,30,5,9,0,14,0,30,4,10,0,14,1,30,2,2,0,4,1,-15,3,1
2,3,23,2,30,6,7,0,13,3,30,6,0,0,6,3,30,13,0,0,13,0,30,6,7,0,13,2,30,5,1,0,6,1,-15,3,1
2,4,23,2,30,6,7,0,13,3,30,6,0,0,6,3,30,13,0,0,13,0,30,6,7,0,13,2,30,5,1,0,6,1,-15,3,1
2,3,25,1,30,9,5,0,14,3,30,6,0,0,6,0,30,9,5,0,14,1,30,5,9,0,14,4,30,6,0,0,6,1,-15,3,1
2,2,27,1,30,4,11,0,15,3,30,2,0,0,2,0,30,6,9,0,15,0,30,6,9,0,15,2,30,6,0,0,6,1,-15,3,1
2,2,29,0,30,9,5,0,14,5,30,12,0,0,12,0,30,5,9,0,14,0,30,1,13,0,14,0,30,7,2,0,9,1,-15,3,1
2,4,29,0,30,9,5,0,14,5,30,12,0,0,12,0,30,5,9,0,14,0,30,1,13,0,14,0,30,7,2,0,9,1,-15,3,1
2,3,31,2,30,6,6,0,12,5,30,8,0,0,8,7,30,8,4,0,12,0,30,3,9,0,12,1,30,2,4,0,6,1,-15,3,1
2,3,8,0,30,7,0,0,7,3,30,2,0,0,2,4,30,2,5,0,7,5,30,7,0,0,7,4,30,3,0,0,3,0,-27,3,0
2,4,8,0,30,7,0,0,7,3,30,2,0,0,2,4,30,2,5,0,7,5,30,7,0,0,7,4,30,3,0,0,3,0,-27,3,0
2,4,13,1,30,4,3,0,7,1,30,4,0,0,4,0,30,5,2,0,7,4,30,7,0,0,7,4,30,4,0,0,4,1,-15,3,1
2,4,23,0,30,4,9,0,13,4,30,6,0,0,6,7,30,10,3,0,13,0,30,5,8,0,13,3,30,6,0,0,6,1,-15,3,1
2,0,25,6,30,4,10,0,14,5,30,6,0,0,6,2,30,9,5,0,14,1,30,5,9,0,14,4,30,5,1,0,6,1,-15,3,1
2,1,25,6,30,4,10,0,14,5,30,6,0,0,6,2,30,9,5,0,14,1,30,5,9,0,14,4,30,5,1,0,6,1,-15,3,1
2,4,25,6,30,4,10,0,14,5,30,6,0,0,6,2,30,9,5,0,14,1,30,5,9,0,14,4,30,5,1,0,6,1,-15,3,1
2,0,26,0,30,9,0,0,9,5,30,4,0,0,4,2,30,2,7,0,9,0,30,2,7,0,9,7,30,3,0,0,3,1,-15,3,1
2,1,26,0,30,9,0,0,9,5,30,4,0,0,4,2,30,2,7,0,9,0,30,2,7,0,9,7,30,3,0,0,3,1,-15,3,1
2,1,27,1,30,5,10,0,15,3,30,2,0,0,2,0,30,3,12,0,15,3,30,5,10,0,15,6,30,6,0,0,6,1,-15,3,1
2,4,27,0,30,5,10,0,15,3,30,2,0,0,2,0,30,3,12,0,15,3,30,5,10,0,15,6,30,6,0,0,6,1,-15,3,1
2,4,33,0,30,6,5,0,11,5,30,4,0,0,4,0,30,9,2,0,11,0,30,6,5,0,11,4,30,4,0,0,4,1,-15,3,1
2,2,47,0,30,0,14,0,14,6,30,4,0,0,4,0,30,4,10,0,14,0,30,4,10,0,14,9,30,7,0,0,7,1,-15,3,1
2,3,47,0,30,0,14,0,14,6,30,4,0,0,4,0,30,4,10,0,14,0,30,4,10,0,14,9,30,7,0,0,7,1,-15,3,1
2,0,4,3,30,8,0,0,8,5,30,4,0,0,4,0,30,1,7,0,8,0,30,7,1,0,8,1,30,3,1,0,4,0,-27,3,0
2,3,11,1,30,5,7,0,12,2,30,4,0,0,4,0,30,5,7,0,12,3,30,7,5,0,12,3,30,4,0,0,4,1,-15,3,1
2,3,15,1,30,5,8,0,13,2,30,6,0,0,6,0,30,3,10,0,13,1,30,7,6,0,13,0,30,7,2,0,9,1,-15,3,1
2,4,15,1,30,5,8,0,13,2,30,6,0,0,6,0,30,3,10,0,13,1,30,7,6,0,13,0,30,7,2,0,9,1,-15,3,1
2,4,17,6,30,12,2,0,14,3,30,6,0,0,6,0,30,5,9,0,14,0,30,5,9,0,14,0,30,2,2,0,4,1,-15,3,1
2,4,23,0,30,4,9,0,13,1,30,6,0,0,6,0,30,13,0,0,13,0,30,5,8,0,13,3,30,6,0,0,6,1,-15,3,1
2,2,24,6,30,5,1,0,6,4,30,4,0,0,4,4,30,1,5,0,6,2,30,1,5,0,6,3,30,4,0,0,4,1,-15,3,1
2,4,24,6,30,5,1,0,6,4,30,4,0,0,4,4,30,1,5,0,6,2,30,1,5,0,6,3,30,4,0,0,4,1,-15,3,1
2,4,29,0,30,5,9,0,14,5,30,11,1,0,12,0,30,9,5,0,14,0,30,1,13,0,14,1,30,9,0,0,9,1,-15,3,1
2,0,31,0,30,7,5,0,12,5,30,8,0,0,8,3,30,8,4,0,12,0,30,3,9,0,12,2,30,4,2,0,6,1,-15,3,1
2,4,31,0,30,7,5,0,12,4,30,8,0,0,8,3,30,8,4,0,12,0,30,3,9,0,12,0,30,4,2,0,6,1,-15,3,1
2,4,32,1,30,6,3,0,9,4,30,2,0,0,2,0,30,8,1,0,9,1,30,3,6,0,9,4,30,2,0,0,2,1,-15,3,1
2,2,33,1,30,2,9,0,11,5,30,4,0,0,4,1,30,9,2,0,11,3,30,4,7,0,11,6,30,4,0,0,4,1,-15,3,1
2,1,4,6,30,7,1,0,8,6,30,2,2,0,4,0,30,1,7,0,8,0,30,8,0,0,8,2,30,4,0,0,4,0,-27,3,0
2,2,4,6,30,7,1,0,8,6,30,2,2,0,4,0,30,1,7,0,8,0,30,8,0,0,8,2,30,4,0,0,4,0,-27,3,0
2,3,4,6,30,7,1,0,8,6,30,2,2,0,4,0,30,1,7,0,8,0,30,8,0,0,8,2,30,4,0,0,4,0,-27,3,0
2,4,15,0,30,4,9,0,13,1,30,6,0,0,6,0,30,4,9,0,13,1,30,7,6,0,13,1,30,9,0,0,9,1,-15,3,1
2,1,19,0,30,3,10,0,13,3,30,7,1,0,8,4,30,4,9,0,13,3,30,8,5,0,13,0,30,6,3,0,9,1,-15,3,1
2,2,19,0,30,3,10,0,13,3,30,7,1,0,8,4,30,4,9,0,13,3,30,8,5,0,13,0,30,6,3,0,9,1,-15,3,1
2,1,23,1,30,4,9,0,13,2,30,6,0,0,6,7,30,13,0,0,13,0,30,5,8,0,13,3,30,6,0,0,6,1,-15,3,1
2,3,23,1,30,4,9,0,13,2,30,6,0,0,6,7,30,13,0,0,13,0,30,5,8,0,13,3,30,6,0,0,6,1,-15,3,1
2,4,25,1,30,6,8,0,14,5,30,6,0,0,6,0,30,6,8,0,14,0,30,6,8,0,14,5,30,5,1,0,6,1,-15,3,1
2,0,27,1,30,3,12,0,15,3,30,1,1,0,2,0,30,7,8,0,15,0,30,5,10,0,15,2,30,6,0,0,6,1,-15,3,1
2,1,27,1,30,3,12,0,15,3,30,1,1,0,2,0,30,7,8,0,15,0,30,5,10,0,15,2,30,6,0,0,6,1,-15,3,1
2,2,27,1,30,3,12,0,15,3,30,1,1,0,2,0,30,7,8,0,15,0,30,5,10,0,15,2,30,6,0,0,6,1,-15,3,1
2,3,27,1,30,3,12,0,15,3,30,1,1,0,2,0,30,7,8,0,15,0,30,5,10,0,15,2,30,6,0,0,6,1,-15,3,1
2,4,27,1,30,3,12,0,15,3,30,1,1,0,2,0,30,7,8,0,15,0,30,5,10,0,15,2,30,6,0,0,6,1,-15,3,1
2,2,31,0,30,5,7,0,12,4,30,8,0,0,8,6,30,11,1,0,12,0,30,3,9,0,12,0,30,6,0,0,6,1,-15,3,1
2,2,17,3,30,11,3,0,14,3,30,6,0,0,6,0,30,4,10,0,14,1,30,4,10,0,14,5,30,4,0,0,4,1,-15,3,1
2,4,23,2,30,5,8,0,13,3,30,6,0,0,6,7,30,12,1,0,13,0,30,6,7,0,13,2,30,5,1,0,6,1,-15,3,1
2,3,25,2,30,6,8,0,14,5,30,6,0,0,6,0,30,7,7,0,14,1,30,5,9,0,14,3,30,5,1,0,6,1,-15,3,1
2,0,27,2,30,5,10,0,15,3,30,1,1,0,2,0,30,6,9,0,15,3,30,5,10,0,15,3,30,6,0,0,6,1,-15,3,1
2,2,27,2,30,5,10,0,15,3,30,1,1,0,2,0,30,6,9,0,15,3,30,5,10,0,15,3,30,6,0,0,6,1,-15,3,1
2,3,32,0,30,7,2,0,9,4,30,2,0,0,2,2,30,9,0,0,9,1,30,3,6,0,9,2,30,2,0,0,2,1,-15,3,1
2,0,4,2,30,6,2,0,8,4,30,4,0,0,4,3,30,3,5,0,8,0,30,7,1,0,8,1,30,3,1,0,4,0,-27,3,0
2,3,4,0,30,6,2,0,8,4,30,4,0,0,4,3,30,3,5,0,8,0,30,7,1,0,8,0,30,3,1,0,4,0,-27,3,0
2,2,13,3,30,6,1,0,7,0,30,4,0,0,4,2,30,6,1,0,7,6,30,5,2,0,7,3,30,4,0,0,4,1,-15,3,1
2,1,17,2,30,8,6,0,14,0,30,6,0,0,6,0,30,8,6,0,14,5,30,6,8,0,14,8,30,4,0,0,4,1,-15,3,1
2,3,17,2,30,8,6,0,14,0,30,6,0,0,6,0,30,8,6,0,14,5,30,6,8,0,14,8,30,4,0,0,4,1,-15,3,1
2,3,19,0,30,2,11,0,13,2,30,5,3,0,8,0,30,4,9,0,13,2,30,4,9,0,13,1,30,9,0,0,9,1,-15,3,1
2,4,19,0,30,2,11,0,13,2,30,5,3,0,8,0,30,4,9,0,13,2,30,4,9,0,13,1,30,9,0,0,9,1,-15,3,1
2,3,23,1,30,6,7,0,13,0,30,6,0,0,6,4,30,13,0,0,13,0,30,6,7,0,13,3,30,6,0,0,6,1,-15,3,1
2,4,23,1,30,6,7,0,13,0,30,6,0,0,6,4,30,13,0,0,13,0,30,6,7,0,13,3,30,6,0,0,6,1,-15,3,1
2,1,27,2,30,5,10,0,15,3,30,2,0,0,2,0,30,4,11,0,15,0,30,4,11,0,15,1,30,5,1,0,6,1,-15,3,1
2,3,29,0,30,6,8,0,14,4,30,9,3,0,12,0,30,7,7,0,14,0,30,1,13,0,14,3,30,9,0,0,9,1,-15,3,1
2,4,8,1,30,7,0,0,7,4,30,2,0,0,2,2,30,4,3,0,7,2,30,7,0,0,7,0,30,3,0,0,3,0,-27,3,0
2,1,13,3,30,7,0,0,7,0,30,4,0,0,4,2,30,6,1,0,7,4,30,7,0,0,7,7,30,4,0,0,4,1,-15,3,1
2,3,17,1,30,8,6,0,14,2,30,6,0,0,6,0,30,7,7,0,14,1,30,6,8,0,14,3,30,4,0,0,4,1,-15,3,1
2,1,19,0,30,5,8,0,13,2,30,5,3,0,8,0,30,5,8,0,13,5,30,3,10,0,13,2,30,9,0,0,9,1,-15,3,1
2,3,19,0,30,5,8,0,13,2,30,5,3,0,8,0,30,5,8,0,13,5,30,3,10,0,13,2,30,9,0,0,9,1,-15,3,1
2,4,19,0,30,5,8,0,13,2,30,5,3,0,8,0,30,5,8,0,13,5,30,3,10,0,13,2,30,9,0,0,9,1,-15,3,1
2,4,23,1,30,5,8,0,13,0,30,6,0,0,6,2,30,13,0,0,13,0,30,6,7,0,13,2,30,6,0,0,6,1,-15,3,1
2,2,25,1,30,5,9,0,14,5,30,6,0,0,6,0,30,6,8,0,14,1,30,6,8,0,14,6,30,6,0,0,6,1,-15,3,1
2,3,25,1,30,5,9,0,14,5,30,6,0,0,6,0,30,6,8,0,14,1,30,6,8,0,14,6,30,6,0,0,6,1,-15,3,1
2,3,26,1,30,8,1,0,9,5,30,4,0,0,4,2,30,0,9,0,9,0,30,2,7,0,9,7,30,3,0,0,3,1,-15,3,1
2,3,43,0,30,8,6,0,14,8,30,6,0,0,6,0,30,4,10,0,14,6,30,5,9,0,14,1,30,5,0,0,5,1,-15,3,1
2,0,45,0,30,4,9,0,13,8,30,10,0,0,10,0,30,0,13,0,13,0,30,4,9,0,13,8,30,5,0,0,5,1,-15,3,1
2,3,13,4,30,7,0,0,7,0,30,4,0,0,4,5,30,6,1,0,7,3,30,6,1,0,7,3,30,4,0,0,4,1,-15,3,1
2,4,13,4,30,7,0,0,7,0,30,4,0,0,4,5,30,6,1,0,7,3,30,6,1,0,7,3,30,4,0,0,4,1,-15,3,1
2,0,21,2,30,7,3,0,10,4,30,6,0,0,6,1,30,3,7,0,10,4,30,5,5,0,10,7,30,4,0,0,4,1,-15,3,1
2,1,21,2,30,7,3,0,10,4,30,6,0,0,6,1,30,3,7,0,10,4,30,5,5,0,10,7,30,4,0,0,4,1,-15,3,1
2,2,21,2,30,7,3,0,10,4,30,6,0,0,6,1,30,3,7,0,10,4,30,5,5,0,10,7,30,4,0,0,4,1,-15,3,1
2,1,25,1,30,4,10,0,14,4,30,6,0,0,6,0,30,10,4,0,14,3,30,5,9,0,14,5,30,6,0,0,6,1,-15,3,1
2,2,25,1,30,4,10,0,14,4,30,6,0,0,6,0,30,10,4,0,14,3,30,5,9,0,14,5,30,6,0,0,6,1,-15,3,1
2,3,27,0,30,4,11,0,15,4,30,1,1,0,2,0,30,2,13,0,15,0,30,7,8,0,15,5,30,6,0,0,6,1,-15,3,1
2,2,29,0,30,8,6,0,14,6,30,12,0,0,12,0,30,3,11,0,14,0,30,0,14,0,14,1,30,9,0,0,9,1,-15,3,1
2,3,29,0,30,8,6,0,14,6,30,12,0,0,12,0,30,3,11,0,14,0,30,0,14,0,14,1,30,9,0,0,9,1,-15,3,1
2,4,29,0,30,8,6,0,14,6,30,12,0,0,12,0,30,3,11,0,14,0,30,0,14,0,14,1,30,9,0,0,9,1,-15,3,1
2,4,3,0,30,0,4,0,4,2,30,4,0,0,4,2,30,1,3,0,4,1,30,2,2,0,4,0,30,1,2,0,3,0,-27,3,0
2,1,5,0,30,2,3,0,5,3,30,1,3,0,4,0,30,0,5,0,5,0,30,4,1,0,5,0,30,1,1,0,2,0,-27,3,0
2,2,13,1,30,4,3,0,7,1,30,4,0,0,4,3,30,6,1,0,7,6,30,6,1,0,7,3,30,4,0,0,4,1,-15,3,1
2,3,13,1,30,4,3,0,7,1,30,4,0,0,4,3,30,6,1,0,7,6,30,6,1,0,7,3,30,4,0,0,4,1,-15,3,1
2,4,15,1,30,8,5,0,13,1,30,6,0,0,6,0,30,3,10,0,13,0,30,4,9,0,13,1,30,7,2,0,9,1,-15,3,1
2,2,21,6,30,9,1,0,10,4,30,4,2,0,6,1,30,4,6,0,10,1,30,4,6,0,10,0,30,3,1,0,4,1,-15,3,1
2,4,21,6,30,9,1,0,10,4,30,4,2,0,6,1,30,4,6,0,10,1,30,4,6,0,10,0,30,3,1,0,4,1,-15,3,1
2,2,23,1,30,5,8,0,13,3,30,6,0,0,6,3,30,13,0,0,13,2,30,4,9,0,13,6,30,5,1,0,6,1,-15,3,1
2,3,23,1,30,5,8,0,13,3,30,6,0,0,6,3,30,13,0,0,13,2,30,4,9,0,13,6,30,5,1,0,6,1,-15,3,1
2,2,27,1,30,5,10,0,15,4,30,1,1,0,2,0,30,5,10,0,15,0,30,6,9,0,15,0,30,5,1,0,6,1,-15,3,1
2,3,27,1,30,5,10,0,15,4,30,1,1,0,2,0,30,5,10,0,15,0,30,6,9,0,15,0,30,5,1,0,6,1,-15,3,1
2,1,31,0,30,4,8,0,12,4,30,8,0,0,8,5,30,11,1,0,12,1,30,3,9,0,12,3,30,4,2,0,6,1,-15,3,1
2,2,31,0,30,4,8,0,12,4,30,8,0,0,8,5,30,11,1,0,12,1,30,3,9,0,12,3,30,4,2,0,6,1,-15,3,1
2,3,31,0,30,4,8,0,12,4,30,8,0,0,8,5,30,11,1,0,12,1,30,3,9,0,12,3,30,4,2,0,6,1,-15,3,1
2,4,31,0,30,4,8,0,12,4,30,8,0,0,8,5,30,11,1,0,12,1,30,3,9,0,12,3,30,4,2,0,6,1,-15,3,1
2,3,4,0,30,7,1,0,8,5,30,4,0,0,4,0,30,2,6,0,8,1,30,8,0,0,8,3,30,3,1,0,4,0,-27,3,0
2,1,6,1,30,7,2,0,9,4,30,2,0,0,2,0,30,3,6,0,9,0,30,5,4,0,9,0,30,3,2,0,5,0,-27,3,0
2,3,6,1,30,7,2,0,9,4,30,2,0,0,2,0,30,3,6,0,9,0,30,5,4,0,9,0,30,3,2,0,5,0,-27,3,0
2,4,15,0,30,5,8,0,13,0,30,6,0,0,6,0,30,5,8,0,13,1,30,2,11,0,13,2,30,5,4,0,9,1,-15,3,1
2,2,17,8,30,9,5,0,14,4,30,6,0,0,6,0,30,5,9,0,14,1,30,6,8,0,14,3,30,4,0,0,4,1,-15,3,1
2,3,17,8,30,9,5,0,14,4,30,6,0,0,6,0,30,5,9,0,14,1,30,6,8,0,14,3,30,4,0,0,4,1,-15,3,1
2,3,25,0,30,6,8,0,14,3,30,6,0,0,6,0,30,8,6,0,14,1,30,8,6,0,14,3,30,5,1,0,6,1,-15,3,1
2,2,27,0,30,4,11,0,15,4,30,2,0,0,2,0,30,4,11,0,15,3,30,5,10,0,15,4,30,6,0,0,6,1,-15,3,1
2,4,27,0,30,4,11,0,15,4,30,2,0,0,2,0,30,4,11,0,15,3,30,5,10,0,15,4,30,6,0,0,6,1,-15,3,1
2,3,31,2,30,8,4,0,12,4,30,8,0,0,8,3,30,8,4,0,12,0,30,3,9,0,12,0,30,3,3,0,6,1,-15,3,1
2,4,31,2,30,8,4,0,12,4,30,8,0,0,8,3,30,8,4,0,12,0,30,3,9,0,12,0,30,3,3,0,6,1,-15,3,1
2,1,33,1,30,3,8,0,11,5,30,4,0,0,4,0,30,10,1,0,11,0,30,3,8,0,11,4,30,4,0,0,4,1,-15,3,1
2,3,11,1,30,5,7,0,12,1,30,4,0,0,4,0,30,5,7,0,12,3,30,4,8,0,12,4,30,4,0,0,4,1,-15,3,1
2,4,11,1,30,5,7,0,12,1,30,4,0,0,4,0,30,5,7,0,12,3,30,4,8,0,12,4,30,4,0,0,4,1,-15,3,1
2,1,13,4,30,6,1,0,7,1,30,4,0,0,4,2,30,6,1,0,7,8,30,4,3,0,7,5,30,4,0,0,4,1,-15,3,1
2,3,15,0,30,5,8,0,13,0,30,5,1,0,6,0,30,7,6,0,13,1,30,8,5,0,13,0,30,9,0,0,9,1,-15,3,1
2,3,17,1,30,9,5,0,14,2,30,6,0,0,6,0,30,5,9,0,14,3,30,6,8,0,14,7,30,4,0,0,4,1,-15,3,1
2,4,22,1,30,7,1,0,8,2,30,2,0,0,2,1,30,4,4,0,8,0,30,3,5,0,8,2,30,4,0,0,4,1,-15,3,1
2,2,27,1,30,3,12,0,15,3,30,2,0,0,2,0,30,5,10,0,15,0,30,3,12,0,15,4,30,6,0,0,6,1,-15,3,1
2,3,27,1,30,3,12,0,15,3,30,2,0,0,2,0,30,5,10,0,15,0,30,3,12,0,15,4,30,6,0,0,6,1,-15,3,1
2,2,31,4,30,10,2,0,12,4,30,8,0,0,8,3,30,11,1,0,12,0,30,3,9,0,12,1,30,2,4,0,6,1,-15,3,1
2,3,31,4,30,10,2,0,12,4,30,8,0,0,8,3,30,11,1,0,12,0,30,3,9,0,12,1,30,2,4,0,6,1,-15,3,1
2,4,31,4,30,10,2,0,12,4,30,8,0,0,8,3,30,11,1,0,12,0,30,3,9,0,12,1,30,2,4,0,6,1,-15,3,1
2,1,6,2,30,8,1,0,9,3,30,2,0,0,2,0,30,5,4,0,9,0,30,4,5,0,9,0,30,3,2,0,5,0,-27,3,0
2,4,13,1,30,6,1,0,7,0,30,4,0,0,4,3,30,7,0,0,7,10,30,5,2,0,7,3,30,4,0,0,4,1,-15,3,1
2,3,15,0,30,4,9,0,13,0,30,6,0,0,6,0,30,4,9,0,13,1,30,3,10,0,13,2,30,6,3,0,9,1,-15,3,1
2,4,15,0,30,4,9,0,13,0,30,6,0,0,6,0,30,4,9,0,13,1,30,3,10,0,13,2,30,6,3,0,9,1,-15,3,1
2,1,17,4,30,9,5,0,14,3,30,6,0,0,6,0,30,3,11,0,14,2,30,4,10,0,14,2,30,4,0,0,4,1,-15,3,1
2,3,17,4,30,9,5,0,14,3,30,6,0,0,6,0,30,3,11,0,14,2,30,4,10,0,14,2,30,4,0,0,4,1,-15,3,1
2,4,19,0,30,2,11,0,13,3,30,8,0,0,8,0,30,4,9,0,13,1,30,5,8,0,13,2,30,8,1,0,9,1,-15,3,1
2,1,23,3,30,8,5,0,13,1,30,6,0,0,6,6,30,12,1,0,13,0,30,6,7,0,13,3,30,6,0,0,6,1,-15,3,1
2,2,23,3,30,8,5,0,13,1,30,6,0,0,6,6,30,12,1,0,13,0,30,6,7,0,13,3,30,6,0,0,6,1,-15,3,1
2,2,25,0,30,3,11,0,14,3,30,6,0,0,6,0,30,5,9,0,14,1,30,5,9,0,14,5,30,5,1,0,6,1,-15,3,1
2,4,25,0,30,3,11,0,14,3,30,6,0,0,6,0,30,5,9,0,14,1,30,5,9,0,14,0,30,5,1,0,6,1,-15,3,1
2,1,27,1,30,4,11,0,15,4,30,2,0,0,2,0,30,8,7,0,15,2,30,6,9,0,15,4,30,6,0,0,6,1,-15,3,1
2,2,27,1,30,4,11,0,15,4,30,2,0,0,2,0,30,8,7,0,15,2,30,6,9,0,15,4,30,6,0,0,6,1,-15,3,1
2,4,27,1,30,4,11,0,15,4,30,2,0,0,2,0,30,8,7,0,15,2,30,6,9,0,15,4,30,6,0,0,6,1,-15,3,1
2,1,38,0,30,3,7,0,10,5,30,6,0,0,6,0,30,5,5,0,10,0,30,2,8,0,10,5,30,6,0,0,6,1,-15,3,1
2,3,38,0,30,3,7,0,10,5,30,6,0,0,6,0,30,5,5,0,10,0,30,2,8,0,10,5,30,6,0,0,6,1,-15,3,1
2,4,38,0,30,3,7,0,10,5,30,6,0,0,6,0,30,5,5,0,10,0,30,2,8,0,10,5,30,6,0,0,6,1,-15,3,1
2,0,5,0,30,2,3,0,5,3,30,3,1,0,4,0,30,0,5,0,5,1,30,5,0,0,5,0,30,0,2,0,2,0,-27,3,0
2,2,5,0,30,2,3,0,5,3,30,3,1,0,4,0,30,0,5,0,5,1,30,5,0,0,5,0,30,0,2,0,2,0,-27,3,0
2,0,19,0,30,2,11,0,13,2,30,6,2,0,8,0,30,9,4,0,13,1,30,9,4,0,13,2,30,9,0,0,9,1,-15,3,1
2,1,19,0,30,2,11,0,13,2,30,6,2,0,8,0,30,9,4,0,13,1,30,9,4,0,13,2,30,9,0,0,9,1,-15,3,1
2,2,19,0,30,2,11,0,13,2,30,6,2,0,8,0,30,9,4,0,13,1,30,9,4,0,13,2,30,9,0,0,9,1,-15,3,1
2,3,22,1,30,5,3,0,8,1,30,2,0,0,2,2,30,5,3,0,8,4,30,3,5,0,8,3,30,2,2,0,4,1,-15,3,1
2,4,22,1,30,5,3,0,8,1,30,2,0,0,2,2,30,5,3,0,8,4,30,3,5,0,8,3,30,2,2,0,4,1,-15,3,1
2,4,31,1,30,7,5,0,12,4,30,8,0,0,8,5,30,10,2,0,12,0,30,5,7,0,12,1,30,6,0,0,6,1,-15,3,1
2,2,11,0,30,4,8,0,12,3,30,4,0,0,4,0,30,1,11,0,12,3,30,7,5,0,12,2,30,4,0,0,4,1,-15,3,1
2,1,13,7,30,3,0,0,3,3,30,2,0,0,2,1,30,3,0,0,3,2,30,3,0,0,3,2,30,2,0,0,2,1,-15,3,1
2,3,13,7,30,3,0,0,3,3,30,2,0,0,2,1,30,3,0,0,3,2,30,3,0,0,3,2,30,2,0,0,2,1,-15,3,1
2,4,13,8,30,7,0,0,7,2,30,4,0,0,4,2,30,7,0,0,7,1,30,6,1,0,7,2,30,4,0,0,4,1,-15,3,1
2,2,17,1,30,3,11,0,14,2,30,6,0,0,6,0,30,6,8,0,14,4,30,8,6,0,14,0,30,4,0,0,4,1,-15,3,1
2,4,17,1,30,3,11,0,14,2,30,6,0,0,6,0,30,6,8,0,14,4,30,8,6,0,14,0,30,4,0,0,4,1,-15,3,1
2,4,19,0,30,5,8,0,13,2,30,3,5,0,8,0,30,6,7,0,13,6,30,4,9,0,13,3,30,9,0,0,9,1,-15,3,1
2,0,21,2,30,7,3,0,10,3,30,5,1,0,6,1,30,3,7,0,10,4,30,2,8,0,10,6,30,4,0,0,4,1,-15,3,1
2,1,21,2,30,7,3,0,10,3,30,5,1,0,6,1,30,3,7,0,10,4,30,2,8,0,10,6,30,4,0,0,4,1,-15,3,1
2,3,25,1,30,6,8,0,14,3,30,6,0,0,6,0,30,4,10,0,14,1,30,7,7,0,14,3,30,5,1,0,6,1,-15,3,1
2,4,25,1,30,6,8,0,14,3,30,6,0,0,6,0,30,4,10,0,14,1,30,7,7,0,14,3,30,5,1,0,6,1,-15,3,1
2,0,47,0,30,2,12,0,14,9,30,4,0,0,4,0,30,3,11,0,14,0,30,7,7,0,14,8,30,7,0,0,7,1,-15,3,1
2,2,47,0,30,2,12,0,14,9,30,4,0,0,4,0,30,3,11,0,14,0,30,7,7,0,14,8,30,7,0,0,7,1,-15,3,1
2,0,17,4,30,9,5,0,14,3,30,6,0,0,6,0,30,5,9,0,14,2,30,5,9,0,14,1,30,4,0,0,4,1,-15,3,1
2,1,17,4,30,9,5,0,14,3,30,6,0,0,6,0,30,5,9,0,14,2,30,5,9,0,14,1,30,4,0,0,4,1,-15,3,1
2,1,21,3,30,6,4,0,10,3,30,4,2,0,6,0,30,5,5,0,10,2,30,5,5,0,10,2,30,4,0,0,4,1,-15,3,1
2,2,23,2,30,7,6,0,13,3,30,6,0,0,6,3,30,13,0,0,13,0,30,5,8,0,13,4,30,6,0,0,6,1,-15,3,1
2,3,23,2,30,7,6,0,13,3,30,6,0,0,6,3,30,13,0,0,13,0,30,5,8,0,13,4,30,6,0,0,6,1,-15,3,1
2,2,25,1,30,3,11,0,14,5,30,6,0,0,6,0,30,4,10,0,14,1,30,9,5,0,14,7,30,6,0,0,6,1,-15,3,1
2,0,27,2,30,9,6,0,15,4,30,2,0,0,2,0,30,6,9,0,15,2,30,4,11,0,15,0,30,4,2,0,6,1,-15,3,1
2,3,27,2,30,9,6,0,15,0,30,2,0,0,2,0,30,6,9,0,15,2,30,4,11,0,15,0,30,4,2,0,6,1,-15,3,1
2,2,39,3,30,4,7,0,11,6,30,6,0,0,6,2,30,9,2,0,11,0,30,4,7,0,11,2,30,5,0,0,5,1,-15,3,1
2,3,8,1,30,7,0,0,7,4,30,2,0,0,2,3,30,4,3,0,7,1,30,7,0,0,7,1,30,3,0,0,3,0,-27,3,0
2,3,11,3,30,4,8,0,12,2,30,4,0,0,4,0,30,3,9,0,12,0,30,4,8,0,12,3,30,4,0,0,4,1,-15,3,1
2,4,11,3,30,4,8,0,12,2,30,4,0,0,4,0,30,3,9,0,12,0,30,4,8,0,12,3,30,4,0,0,4,1,-15,3,1
2,4,13,0,30,3,0,0,3,0,30,2,0,0,2,1,30,3,0,0,3,8,30,3,0,0,3,2,30,2,0,0,2,1,-15,3,1
2,3,17,2,30,8,6,0,14,3,30,6,0,0,6,0,30,6,8,0,14,6,30,5,9,0,14,4,30,4,0,0,4,1,-15,3,1
2,2,19,0,30,7,6,0,13,1,30,5,3,0,8,0,30,4,9,0,13,0,30,2,11,0,13,1,30,8,1,0,9,1,-15,3,1
2,3,25,0,30,6,8,0,14,3,30,6,0,0,6,0,30,7,7,0,14,3,30,7,7,0,14,5,30,6,0,0,6,1,-15,3,1
2,2,27,0,30,4,11,0,15,4,30,2,0,0,2,0,30,1,14,0,15,2,30,5,10,0,15,4,30,6,0,0,6,1,-15,3,1
2,4,27,0,30,4,11,0,15,4,30,2,0,0,2,0,30,1,14,0,15,2,30,5,10,0,15,4,30,6,0,0,6,1,-15,3,1
2,3,29,0,30,5,9,0,14,5,30,12,0,0,12,0,30,4,10,0,14,0,30,1,13,0,14,0,30,8,1,0,9,1,-15,3,1
2,4,29,0,30,5,9,0,14,5,30,12,0,0,12,0,30,4,10,0,14,0,30,1,13,0,14,0,30,8,1,0,9,1,-15,3,1
2,0,5,0,30,2,3,0,5,3,30,2,2,0,4,1,30,1,4,0,5,0,30,1,4,0,5,0,30,0,2,0,2,0,-27,3,0
2,1,5,0,30,2,3,0,5,3,30,2,2,0,4,1,30,1,4,0,5,0,30,1,4,0,5,0,30,0,2,0,2,0,-27,3,0
2,3,5,0,30,2,3,0,5,3,30,2,2,0,4,1,30,1,4,0,5,0,30,1,4,0,5,0,30,0,2,0,2,0,-27,3,0
2,4,5,0,30,2,3,0,5,3,30,2,2,0,4,1,30,1,4,0,5,0,30,1,4,0,5,0,30,0,2,0,2,0,-27,3,0
2,2,13,2,30,6,1,0,7,0,30,4,0,0,4,2,30,6,1,0,7,6,30,6,1,0,7,3,30,4,0,0,4,1,-15,3,1
2,3,15,1,30,4,9,0,13,0,30,6,0,0,6,0,30,3,10,0,13,1,30,3,10,0,13,0,30,9,0,0,9,1,-15,3,1
2,4,15,1,30,4,9,0,13,0,30,6,0,0,6,0,30,3,10,0,13,1,30,3,10,0,13,0,30,9,0,0,9,1,-15,3,1
2,1,17,3,30,9,5,0,14,3,30,6,0,0,6,0,30,5,9,0,14,1,30,9,5,0,14,6,30,4,0,0,4,1,-15,3,1
2,0,19,1,30,4,9,0,13,2,30,8,0,0,8,4,30,8,5,0,13,3,30,4,9,0,13,0,30,6,3,0,9,1,-15,3,1
2,1,19,1,30,4,9,0,13,2,30,8,0,0,8,4,30,8,5,0,13,3,30,4,9,0,13,0,30,6,3,0,9,1,-15,3,1
2,3,19,1,30,4,9,0,13,2,30,8,0,0,8,4,30,8,5,0,13,3,30,4,9,0,13,0,30,6,3,0,9,1,-15,3,1
2,0,23,1,30,5,8,0,13,4,30,6,0,0,6,9,30,12,1,0,13,0,30,5,8,0,13,5,30,6,0,0,6,1,-15,3,1
2,3,23,1,30,5,8,0,13,4,30,6,0,0,6,9,30,12,1,0,13,0,30,5,8,0,13,5,30,6,0,0,6,1,-15,3,1
2,0,25,1,30,4,10,0,14,4,30,6,0,0,6,0,30,4,10,0,14,3,30,9,5,0,14,8,30,6,0,0,6,1,-15,3,1
2,3,27,1,30,5,10,0,15,4,30,2,0,0,2,0,30,6,9,0,15,0,30,5,10,0,15,1,30,4,2,0,6,1,-15,3,1
2,4,27,1,30,5,10,0,15,4,30,2,0,0,2,0,30,6,9,0,15,0,30,5,10,0,15,1,30,4,2,0,6,1,-15,3,1
2,2,29,0,30,7,7,0,14,6,30,12,0,0,12,0,30,3,11,0,14,0,30,1,13,0,14,0,30,9,0,0,9,1,-15,3,1
2,3,31,5,30,5,7,0,12,5,30,8,0,0,8,0,30,10,2,0,12,0,30,3,9,0,12,1,30,4,2,0,6,1,-15,3,1
2,1,4,2,30,7,1,0,8,4,30,4,0,0,4,1,30,3,5,0,8,0,30,6,2,0,8,3,30,3,1,0,4,0,-27,3,0
2,3,4,0,30,7,1,0,8,4,30,4,0,0,4,1,30,3,5,0,8,0,30,6,2,0,8,3,30,3,1,0,4,0,-27,3,0
2,1,13,1,30,5,2,0,7,1,30,4,0,0,4,2,30,6,1,0,7,10,30,6,1,0,7,4,30,4,0,0,4,1,-15,3,1
2,3,15,0,30,4,9,0,13,1,30,5,1,0,6,4,30,3,10,0,13,1,30,6,7,0,13,2,30,6,3,0,9,1,-15,3,1
2,1,17,3,30,11,3,0,14,2,30,6,0,0,6,0,30,7,7,0,14,0,30,5,9,0,14,1,30,3,1,0,4,1,-15,3,1
2,3,17,3,30,11,3,0,14,2,30,6,0,0,6,0,30,7,7,0,14,0,30,5,9,0,14,1,30,3,1,0,4,1,-15,3,1
2,1,21,1,30,6,4,0,10,4,30,6,0,0,6,1,30,3,7,0,10,3,30,6,4,0,10,3,30,4,0,0,4,1,-15,3,1
2,3,23,1,30,5,8,0,13,3,30,5,1,0,6,7,30,12,1,0,13,0,30,5,8,0,13,3,30,6,0,0,6,1,-15,3,1
2,1,25,1,30,8,6,0,14,1,30,6,0,0,6,0,30,9,5,0,14,1,30,5,9,0,14,5,30,5,1,0,6,1,-15,3,1
2,0,27,1,30,4,11,0,15,3,30,0,2,0,2,0,30,6,9,0,15,3,30,6,9,0,15,5,30,6,0,0,6,1,-15,3,1
2,2,27,1,30,4,11,0,15,3,30,0,2,0,2,0,30,6,9,0,15,3,30,6,9,0,15,5,30,6,0,0,6,1,-15,3,1
2,3,27,1,30,4,11,0,15,3,30,0,2,0,2,0,30,6,9,0,15,3,30,6,9,0,15,5,30,6,0,0,6,1,-15,3,1
2,4,27,1,30,4,11,0,15,3,30,0,2,0,2,0,30,6,9,0,15,3,30,6,9,0,15,5,30,6,0,0,6,1,-15,3,1
2,0,29,0,30,3,11,0,14,6,30,12,0,0,12,0,30,2,12,0,14,0,30,2,12,0,14,4,30,9,0,0,9,1,-15,3,1
2,1,29,0,30,3,11,0,14,6,30,12,0,0,12,0,30,2,12,0,14,0,30,2,12,0,14,4,30,9,0,0,9,1,-15,3,1
2,3,29,0,30,3,11,0,14,6,30,12,0,0,12,0,30,2,12,0,14,0,30,2,12,0,14,4,30,9,0,0,9,1,-15,3,1
2,1,4,0,30,7,1,0,8,5,30,4,0,0,4,1,30,2,6,0,8,0,30,8,0,0,8,4,30,4,0,0,4,0,-27,3,0
2,2,4,0,30,7,1,0,8,5,30,4,0,0,4,1,30,2,6,0,8,0,30,8,0,0,8,4,30,4,0,0,4,0,-27,3,0
2,3,11,1,30,4,8,0,12,1,30,4,0,0,4,0,30,6,6,0,12,3,30,6,6,0,12,4,30,4,0,0,4,1,-15,3,1
2,3,19,0,30,7,6,0,13,2,30,5,3,0,8,3,30,4,9,0,13,3,30,4,9,0,13,2,30,8,1,0,9,1,-15,3,1
2,3,23,2,30,5,8,0,13,3,30,6,0,0,6,8,30,10,3,0,13,0,30,6,7,0,13,2,30,6,0,0,6,1,-15,3,1
2,4,23,2,30,5,8,0,13,3,30,6,0,0,6,8,30,10,3,0,13,0,30,6,7,0,13,2,30,6,0,0,6,1,-15,3,1
2,2,25,1,30,7,7,0,14,4,30,6,0,0,6,0,30,7,7,0,14,1,30,5,9,0,14,3,30,5,1,0,6,1,-15,3,1
2,3,27,1,30,9,6,0,15,4,30,2,0,0,2,0,30,3,12,0,15,0,30,4,11,0,15,1,30,5,1,0,6,1,-15,3,1
2,3,29,0,30,5,9,0,14,3,30,12,0,0,12,0,30,7,7,0,14,0,30,1,13,0,14,0,30,9,0,0,9,1,-15,3,1
2,4,35,0,30,10,3,0,13,4,30,2,0,0,2,1,30,5,8,0,13,2,30,3,10,0,13,4,30,8,0,0,8,1,-15,3,1
2,4,13,1,30,6,1,0,7,0,30,4,0,0,4,2,30,6,1,0,7,6,30,7,0,0,7,5,30,4,0,0,4,1,-15,3,1
2,3,17,3,30,9,5,0,14,3,30,6,0,0,6,1,30,5,9,0,14,2,30,5,9,0,14,3,30,4,0,0,4,1,-15,3,1
2,3,19,0,30,3,10,0,13,2,30,8,0,0,8,1,30,9,4,0,13,0,30,4,9,0,13,1,30,8,1,0,9,1,-15,3,1
2,4,19,0,30,3,10,0,13,2,30,8,0,0,8,1,30,9,4,0,13,0,30,4,9,0,13,1,30,8,1,0,9,1,-15,3,1
2,3,23,1,30,5,8,0,13,4,30,6,0,0,6,8,30,11,2,0,13,0,30,5,8,0,13,3,30,6,0,0,6,1,-15,3,1
2,3,25,0,30,4,10,0,14,4,30,6,0,0,6,0,30,7,7,0,14,2,30,8,6,0,14,4,30,5,1,0,6,1,-15,3,1
2,1,33,1,30,3,8,0,11,5,30,4,0,0,4,2,30,9,2,0,11,3,30,4,7,0,11,7,30,4,0,0,4,1,-15,3,1
2,4,8,1,30,7,0,0,7,4,30,2,0,0,2,7,30,3,4,0,7,2,30,7,0,0,7,0,30,3,0,0,3,0,-27,3,0
2,3,11,1,30,5,7,0,12,0,30,4,0,0,4,0,30,7,5,0,12,5,30,4,8,0,12,4,30,4,0,0,4,1,-15,3,1
2,4,13,3,30,5,2,0,7,0,30,4,0,0,4,0,30,7,0,0,7,4,30,5,2,0,7,3,30,4,0,0,4,1,-15,3,1
2,2,17,3,30,9,5,0,14,3,30,6,0,0,6,0,30,6,8,0,14,2,30,9,5,0,14,8,30,4,0,0,4,1,-15,3,1
2,1,19,0,30,5,8,0,13,2,30,6,2,0,8,0,30,4,9,0,13,4,30,7,6,0,13,1,30,9,0,0,9,1,-15,3,1
2,2,19,0,30,5,8,0,13,2,30,6,2,0,8,0,30,4,9,0,13,4,30,7,6,0,13,1,30,9,0,0,9,1,-15,3,1
2,4,19,0,30,5,8,0,13,2,30,6,2,0,8,0,30,4,9,0,13,4,30,7,6,0,13,1,30,9,0,0,9,1,-15,3,1
2,4,23,1,30,7,6,0,13,3,30,6,0,0,6,1,30,8,5,0,13,0,30,5,8,0,13,0,30,4,2,0,6,1,-15,3,1
2,0,27,2,30,6,9,0,15,4,30,1,1,0,2,0,30,6,9,0,15,0,30,5,10,0,15,2,30,6,0,0,6,1,-15,3,1
2,2,27,2,30,6,9,0,15,0,30,1,1,0,2,0,30,6,9,0,15,0,30,5,10,0,15,2,30,6,0,0,6,1,-15,3,1
2,0,5,0,30,2,3,0,5,3,30,1,3,0,4,0,30,0,5,0,5,1,30,2,3,0,5,0,30,2,0,0,2,0,-27,3,0
2,3,6,0,30,6,3,0,9,4,30,2,0,0,2,0,30,2,7,0,9,0,30,3,6,0,9,4,30,5,0,0,5,0,-27,3,0
2,4,15,0,30,5,8,0,13,0,30,6,0,0,6,0,30,4,9,0,13,1,30,4,9,0,13,1,30,6,3,0,9,1,-15,3,1
2,3,17,3,30,9,5,0,14,3,30,6,0,0,6,0,30,6,8,0,14,3,30,8,6,0,14,3,30,4,0,0,4,1,-15,3,1
2,4,17,3,30,9,5,0,14,3,30,6,0,0,6,0,30,6,8,0,14,3,30,8,6,0,14,3,30,4,0,0,4,1,-15,3,1
2,2,25,1,30,9,5,0,14,3,30,6,0,0,6,0,30,9,5,0,14,1,30,4,10,0,14,4,30,5,1,0,6,1,-15,3,1
2,3,25,1,30,9,5,0,14,3,30,6,0,0,6,0,30,9,5,0,14,1,30,4,10,0,14,4,30,5,1,0,6,1,-15,3,1
2,1,27,1,30,7,8,0,15,2,30,2,0,0,2,0,30,6,9,0,15,0,30,5,10,0,15,5,30,6,0,0,6,1,-15,3,1
2,3,27,1,30,7,8,0,15,2,30,2,0,0,2,0,30,6,9,0,15,0,30,5,10,0,15,5,30,6,0,0,6,1,-15,3,1
2,1,31,2,30,6,6,0,12,5,30,8,0,0,8,3,30,5,7,0,12,0,30,3,9,0,12,0,30,2,4,0,6,1,-15,3,1
2,3,31,2,30,6,6,0,12,5,30,8,0,0,8,3,30,5,7,0,12,0,30,3,9,0,12,0,30,2,4,0,6,1,-15,3,1
2,4,31,2,30,6,6,0,12,5,30,8,0,0,8,3,30,5,7,0,12,0,30,3,9,0,12,0,30,2,4,0,6,1,-15,3,1
2,2,33,3,30,4,7,0,11,4,30,4,0,0,4,1,30,11,0,0,11,3,30,4,7,0,11,8,30,4,0,0,4,1,-15,3,1
2,3,33,3,30,4,7,0,11,4,30,4,0,0,4,1,30,11,0,0,11,3,30,4,7,0,11,8,30,4,0,0,4,1,-15,3,1
2,2,37,1,30,8,3,0,11,5,30,6,2,0,8,0,30,8,3,0,11,4,30,5,6,0,11,4,30,6,0,0,6,1,-15,3,1
2,4,39,0,30,5,6,0,11,6,30,6,0,0,6,0,30,7,4,0,11,0,30,2,9,0,11,4,30,5,0,0,5,1,-15,3,1
2,2,1,0,30,7,3,0,10,5,30,2,0,0,2,1,30,3,7,0,10,3,30,8,2,0,10,5,30,6,0,0,6,0,-27,3,0
2,4,5,0,30,3,2,0,5,2,30,4,0,0,4,0,30,1,4,0,5,0,30,1,4,0,5,0,30,0,2,0,2,0,-27,3,0
2,1,13,4,30,7,0,0,7,0,30,4,0,0,4,2,30,7,0,0,7,4,30,5,2,0,7,6,30,4,0,0,4,1,-15,3,1
2,3,13,4,30,7,0,0,7,0,30,4,0,0,4,2,30,7,0,0,7,4,30,5,2,0,7,6,30,4,0,0,4,1,-15,3,1
2,3,17,3,30,8,6,0,14,2,30,6,0,0,6,0,30,6,8,0,14,1,30,6,8,0,14,5,30,4,0,0,4,1,-15,3,1
2,1,25,1,30,9,5,0,14,3,30,6,0,0,6,0,30,7,7,0,14,1,30,8,6,0,14,4,30,6,0,0,6,1,-15,3,1
2,0,27,2,30,6,9,0,15,3,30,1,1,0,2,0,30,6,9,0,15,4,30,8,7,0,15,0,30,5,1,0,6,1,-15,3,1
2,2,27,2,30,6,9,0,15,3,30,1,1,0,2,0,30,6,9,0,15,4,30,8,7,0,15,0,30,5,1,0,6,1,-15,3,1
2,3,27,2,30,6,9,0,15,3,30,1,1,0,2,0,30,6,9,0,15,4,30,8,7,0,15,0,30,5,1,0,6,1,-15,3,1
2,4,29,0,30,5,9,0,14,5,30,12,0,0,12,0,30,7,7,0,14,0,30,0,14,0,14,1,30,9,0,0,9,1,-15,3,1
2,2,39,0,30,4,7,0,11,7,30,6,0,0,6,0,30,4,7,0,11,0,30,4,7,0,11,5,30,5,0,0,5,1,-15,3,1
2,3,39,0,30,4,7,0,11,7,30,6,0,0,6,0,30,4,7,0,11,0,30,4,7,0,11,5,30,5,0,0,5,1,-15,3,1
2,3,47,0,30,0,14,0,14,7,30,4,0,0,4,0,30,3,11,0,14,0,30,2,12,0,14,3,30,7,0,0,7,1,-15,3,1
2,3,8,1,30,7,0,0,7,4,30,2,0,0,2,3,30,2,5,0,7,0,30,7,0,0,7,4,30,3,0,0,3,0,-27,3,0
2,2,13,3,30,6,1,0,7,0,30,4,0,0,4,2,30,6,1,0,7,11,30,7,0,0,7,5,30,4,0,0,4,1,-15,3,1
2,4,17,3,30,10,4,0,14,2,30,6,0,0,6,0,30,7,7,0,14,0,30,5,9,0,14,4,30,4,0,0,4,1,-15,3,1
2,4,19,0,30,3,10,0,13,1,30,7,1,0,8,0,30,7,6,0,13,0,30,4,9,0,13,1,30,6,3,0,9,1,-15,3,1
2,0,26,0,30,8,1,0,9,4,30,4,0,0,4,3,30,2,7,0,9,0,30,2,7,0,9,4,30,3,0,0,3,1,-15,3,1
2,1,26,0,30,8,1,0,9,4,30,4,0,0,4,3,30,2,7,0,9,0,30,2,7,0,9,4,30,3,0,0,3,1,-15,3,1
2,2,26,0,30,8,1,0,9,4,30,4,0,0,4,3,30,2,7,0,9,0,30,2,7,0,9,4,30,3,0,0,3,1,-15,3,1
2,4,26,0,30,8,1,0,9,4,30,4,0,0,4,3,30,2,7,0,9,0,30,2,7,0,9,4,30,3,0,0,3,1,-15,3,1
2,0,27,3,30,4,11,0,15,4,30,1,1,0,2,0,30,6,9,0,15,3,30,5,10,0,15,1,30,6,0,0,6,1,-15,3,1
2,3,27,3,30,4,11,0,15,4,30,1,1,0,2,0,30,6,9,0,15,3,30,5,10,0,15,1,30,6,0,0,6,1,-15,3,1
2,2,29,0,30,5,9,0,14,6,30,12,0,0,12,0,30,6,8,0,14,0,30,0,14,0,14,3,30,9,0,0,9,1,-15,3,1
2,3,29,0,30,5,9,0,14,6,30,12,0,0,12,0,30,6,8,0,14,0,30,0,14,0,14,3,30,9,0,0,9,1,-15,3,1
2,4,29,0,30,5,9,0,14,6,30,12,0,0,12,0,30,6,8,0,14,0,30,0,14,0,14,3,30,9,0,0,9,1,-15,3,1
2,3,31,3,30,9,3,0,12,3,30,8,0,0,8,3,30,10,2,0,12,0,30,3,9,0,12,1,30,5,1,0,6,1,-15,3,1
2,0,33,1,30,5,6,0,11,4,30,4,0,0,4,0,30,8,3,0,11,1,30,4,7,0,11,5,30,4,0,0,4,1,-15,3,1
2,1,33,1,30,5,6,0,11,4,30,4,0,0,4,0,30,8,3,0,11,1,30,4,7,0,11,5,30,4,0,0,4,1,-15,3,1
2,2,33,1,30,5,6,0,11,4,30,4,0,0,4,0,30,8,3,0,11,1,30,4,7,0,11,5,30,4,0,0,4,1,-15,3,1
2,3,33,1,30,5,6,0,11,4,30,4,0,0,4,0,30,8,3,0,11,1,30,4,7,0,11,5,30,4,0,0,4,1,-15,3,1
2,4,33,1,30,5,6,0,11,4,30,4,0,0,4,0,30,8,3,0,11,1,30,4,7,0,11,5,30,4,0,0,4,1,-15,3,1
2,4,35,0,30,5,8,0,13,5,30,2,0,0,2,5,30,2,11,0,13,0,30,1,12,0,13,3,30,8,0,0,8,1,-15,3,1
2,4,17,3,30,9,5,0,14,3,30,6,0,0,6,0,30,5,9,0,14,1,30,7,7,0,14,2,30,4,0,0,4,1,-15,3,1
2,2,23,1,30,5,8,0,13,2,30,6,0,0,6,6,30,11,2,0,13,0,30,4,9,0,13,3,30,6,0,0,6,1,-15,3,1
2,4,23,1,30,5,8,0,13,2,30,6,0,0,6,6,30,11,2,0,13,0,30,4,9,0,13,3,30,6,0,0,6,1,-15,3,1
2,2,25,5,30,5,9,0,14,3,30,6,0,0,6,0,30,9,5,0,14,1,30,5,9,0,14,4,30,5,1,0,6,1,-15,3,1
2,0,27,1,30,4,11,0,15,5,30,1,1,0,2,0,30,2,13,0,15,4,30,7,8,0,15,5,30,6,0,0,6,1,-15,3,1
2,3,27,0,30,4,11,0,15,5,30,1,1,0,2,0,30,2,13,0,15,4,30,7,8,0,15,5,30,6,0,0,6,1,-15,3,1
2,3,29,0,30,8,6,0,14,6,30,12,0,0,12,0,30,2,12,0,14,0,30,0,14,0,14,0,30,8,1,0,9,1,-15,3,1
2,0,31,1,30,7,5,0,12,3,30,7,1,0,8,4,30,12,0,0,12,0,30,3,9,0,12,0,30,2,4,0,6,1,-15,3,1
2,1,31,1,30,7,5,0,12,3,30,7,1,0,8,4,30,12,0,0,12,0,30,3,9,0,12,0,30,2,4,0,6,1,-15,3,1
2,3,31,1,30,7,5,0,12,3,30,7,1,0,8,4,30,12,0,0,12,0,30,3,9,0,12,0,30,2,4,0,6,1,-15,3,1
2,0,5,0,30,2,3,0,5,3,30,2,2,0,4,0,30,0,5,0,5,0,30,3,2,0,5,0,30,1,1,0,2,0,-27,3,0
2,1,5,0,30,2,3,0,5,3,30,2,2,0,4,0,30,0,5,0,5,0,30,3,2,0,5,0,30,1,1,0,2,0,-27,3,0
2,4,8,2,30,7,0,0,7,4,30,2,0,0,2,4,30,5,2,0,7,0,30,6,1,0,7,1,30,3,0,0,3,0,-27,3,0
2,3,17,2,30,10,4,0,14,2,30,6,0,0,6,0,30,7,7,0,14,1,30,6,8,0,14,2,30,3,1,0,4,1,-15,3,1
2,3,19,0,30,2,11,0,13,2,30,6,2,0,8,0,30,7,6,0,13,5,30,4,9,0,13,1,30,8,1,0,9,1,-15,3,1
2,2,25,2,30,9,5,0,14,5,30,6,0,0,6,0,30,6,8,0,14,1,30,5,9,0,14,3,30,5,1,0,6,1,-15,3,1
2,3,25,2,30,9,5,0,14,5,30,6,0,0,6,0,30,6,8,0,14,1,30,5,9,0,14,3,30,5,1,0,6,1,-15,3,1
2,1,26,0,30,6,3,0,9,5,30,4,0,0,4,2,30,2,7,0,9,0,30,2,7,0,9,6,30,2,1,0,3,1,-15,3,1
2,4,27,2,30,7,8,0,15,0,30,2,0,0,2,0,30,13,2,0,15,0,30,4,11,0,15,0,30,2,4,0,6,1,-15,3,1
2,4,32,0,30,2,7,0,9,4,30,2,0,0,2,0,30,5,4,0,9,1,30,2,7,0,9,4,30,2,0,0,2,1,-15,3,1
2,4,39,0,30,3,8,0,11,7,30,6,0,0,6,0,30,6,5,0,11,5,30,4,7,0,11,0,30,5,0,0,5,1,-15,3,1
2,2,11,0,30,2,2,0,4,0,30,0,0,0,0,1,30,1,3,0,4,4,30,2,2,0,4,0,30,1,0,0,1,1,-15,3,1
2,3,11,0,30,2,2,0,4,0,30,0,0,0,0,1,30,1,3,0,4,4,30,2,2,0,4,0,30,1,0,0,1,1,-15,3,1
2,1,13,1,30,5,2,0,7,0,30,4,0,0,4,2,30,6,1,0,7,4,30,5,2,0,7,4,30,4,0,0,4,1,-15,3,1
2,4,13,1,30,5,2,0,7,0,30,4,0,0,4,2,30,6,1,0,7,4,30,5,2,0,7,4,30,4,0,0,4,1,-15,3,1
2,4,17,2,30,10,4,0,14,2,30,6,0,0,6,0,30,5,9,0,14,2,30,5,9,0,14,0,30,4,0,0,4,1,-15,3,1
2,4,21,0,30,8,2,0,10,3,30,5,1,0,6,1,30,3,7,0,10,5,30,4,6,0,10,4,30,4,0,0,4,1,-15,3,1
2,4,25,1,30,8,6,0,14,3,30,6,0,0,6,0,30,8,6,0,14,1,30,7,7,0,14,3,30,6,0,0,6,1,-15,3,1
2,3,32,0,30,5,4,0,9,4,30,2,0,0,2,1,30,9,0,0,9,1,30,3,6,0,9,4,30,2,0,0,2,1,-15,3,1
2,4,32,0,30,5,4,0,9,4,30,2,0,0,2,1,30,9,0,0,9,1,30,3,6,0,9,4,30,2,0,0,2,1,-15,3,1
2,3,39,0,30,4,7,0,11,6,30,6,0,0,6,0,30,7,4,0,11,0,30,3,8,0,11,4,30,5,0,0,5,1,-15,3,1
2,3,43,8,30,7,7,0,14,10,30,6,0,0,6,0,30,4,10,0,14,1,30,1,13,0,14,4,30,5,0,0,5,1,-15,3,1
2,3,5,0,30,5,0,0,5,1,30,3,1,0,4,0,30,0,5,0,5,0,30,1,4,0,5,0,30,0,2,0,2,0,-27,3,0
2,4,6,0,30,5,4,0,9,3,30,2,0,0,2,0,30,3,6,0,9,0,30,3,6,0,9,1,30,4,1,0,5,0,-27,3,0
2,1,13,5,30,7,0,0,7,0,30,4,0,0,4,1,30,5,2,0,7,8,30,7,0,0,7,4,30,4,0,0,4,1,-15,3,1
2,2,13,5,30,7,0,0,7,0,30,4,0,0,4,1,30,5,2,0,7,8,30,7,0,0,7,4,30,4,0,0,4,1,-15,3,1
2,4,17,3,30,8,6,0,14,2,30,6,0,0,6,0,30,7,7,0,14,3,30,6,8,0,14,3,30,4,0,0,4,1,-15,3,1
2,4,19,0,30,4,9,0,13,1,30,5,3,0,8,0,30,6,7,0,13,8,30,7,6,0,13,0,30,8,1,0,9,1,-15,3,1
2,4,23,1,30,8,5,0,13,1,30,6,0,0,6,5,30,13,0,0,13,0,30,4,9,0,13,1,30,6,0,0,6,1,-15,3,1
2,2,28,0,30,4,4,0,8,5,30,4,0,0,4,0,30,1,7,0,8,0,30,2,6,0,8,5,30,3,1,0,4,1,-15,3,1
2,0,29,0,30,5,9,0,14,5,30,12,0,0,12,0,30,8,6,0,14,0,30,1,13,0,14,2,30,9,0,0,9,1,-15,3,1
2,1,29,0,30,5,9,0,14,5,30,12,0,0,12,0,30,8,6,0,14,0,30,1,13,0,14,2,30,9,0,0,9,1,-15,3,1
2,2,29,0,30,5,9,0,14,5,30,12,0,0,12,0,30,8,6,0,14,0,30,1,13,0,14,2,30,9,0,0,9,1,-15,3,1
2,4,29,0,30,5,9,0,14,5,30,12,0,0,12,0,30,8,6,0,14,0,30,1,13,0,14,2,30,9,0,0,9,1,-15,3,1
2,0,4,2,30,7,1,0,8,5,30,4,0,0,4,1,30,2,6,0,8,3,30,8,0,0,8,1,30,3,1,0,4,0,-27,3,0
2,4,8,4,30,7,0,0,7,3,30,2,0,0,2,3,30,7,0,0,7,0,30,6,1,0,7,0,30,2,1,0,3,0,-27,3,0
2,4,17,3,30,8,6,0,14,4,30,6,0,0,6,0,30,4,10,0,14,5,30,6,8,0,14,3,30,4,0,0,4,1,-15,3,1
2,4,19,0,30,3,10,0,13,0,30,5,3,0,8,0,30,7,6,0,13,4,30,4,9,0,13,1,30,8,1,0,9,1,-15,3,1
2,1,26,0,30,7,2,0,9,4,30,2,2,0,4,1,30,0,9,0,9,0,30,2,7,0,9,3,30,2,1,0,3,1,-15,3,1
2,1,27,1,30,5,10,0,15,0,30,1,1,0,2,0,30,12,3,0,15,0,30,4,11,0,15,1,30,3,3,0,6,1,-15,3,1
2,2,27,1,30,5,10,0,15,0,30,1,1,0,2,0,30,12,3,0,15,0,30,4,11,0,15,1,30,3,3,0,6,1,-15,3,1
2,4,27,1,30,5,10,0,15,0,30,1,1,0,2,0,30,12,3,0,15,0,30,4,11,0,15,1,30,3,3,0,6,1,-15,3,1
2,3,31,1,30,2,10,0,12,7,30,8,0,0,8,3,30,4,8,0,12,0,30,7,5,0,12,6,30,6,0,0,6,1,-15,3,1
2,4,31,1,30,2,10,0,12,7,30,8,0,0,8,3,30,4,8,0,12,0,30,7,5,0,12,6,30,6,0,0,6,1,-15,3,1
2,4,35,1,30,11,2,0,13,5,30,2,0,0,2,1,30,2,11,0,13,0,30,1,12,0,13,2,30,8,0,0,8,1,-15,3,1
2,0,5,0,30,2,3,0,5,3,30,0,4,0,4,0,30,1,4,0,5,2,30,5,0,0,5,0,30,0,2,0,2,0,-27,3,0
2,2,11,2,30,6,6,0,12,0,30,4,0,0,4,0,30,6,6,0,12,8,30,4,8,0,12,7,30,4,0,0,4,1,-15,3,1
2,4,13,4,30,7,0,0,7,0,30,4,0,0,4,2,30,6,1,0,7,12,30,4,3,0,7,1,30,4,0,0,4,1,-15,3,1
2,4,17,2,30,9,5,0,14,2,30,6,0,0,6,1,30,9,5,0,14,2,30,5,9,0,14,0,30,4,0,0,4,1,-15,3,1
2,4,19,0,30,3,10,0,13,0,30,5,3,0,8,0,30,7,6,0,13,5,30,4,9,0,13,1,30,7,2,0,9,1,-15,3,1
2,1,25,0,30,6,8,0,14,5,30,6,0,0,6,0,30,4,10,0,14,2,30,12,2,0,14,5,30,6,0,0,6,1,-15,3,1
2,2,25,0,30,6,8,0,14,5,30,6,0,0,6,0,30,4,10,0,14,2,30,12,2,0,14,5,30,6,0,0,6,1,-15,3,1
2,3,25,0,30,6,8,0,14,5,30,6,0,0,6,0,30,4,10,0,14,2,30,12,2,0,14,5,30,6,0,0,6,1,-15,3,1
2,3,27,2,30,11,4,0,15,4,30,2,0,0,2,0,30,2,13,0,15,0,30,5,10,0,15,1,30,6,0,0,6,1,-15,3,1
2,4,27,2,30,11,4,0,15,4,30,2,0,0,2,0,30,2,13,0,15,0,30,5,10,0,15,1,30,6,0,0,6,1,-15,3,1
2,1,31,4,30,6,6,0,12,5,30,8,0,0,8,3,30,8,4,0,12,6,30,3,9,0,12,0,30,2,4,0,6,1,-15,3,1
2,3,8,2,30,7,0,0,7,2,30,2,0,0,2,2,30,6,1,0,7,3,30,6,1,0,7,0,30,2,1,0,3,0,-27,3,0
2,4,8,2,30,7,0,0,7,2,30,2,0,0,2,2,30,6,1,0,7,3,30,6,1,0,7,0,30,2,1,0,3,0,-27,3,0
2,2,11,2,30,5,7,0,12,0,30,4,0,0,4,0,30,7,5,0,12,6,30,4,8,0,12,4,30,4,0,0,4,1,-15,3,1
2,3,11,2,30,5,7,0,12,0,30,4,0,0,4,0,30,7,5,0,12,6,30,4,8,0,12,4,30,4,0,0,4,1,-15,3,1
2,4,11,2,30,5,7,0,12,0,30,4,0,0,4,0,30,7,5,0,12,6,30,4,8,0,12,4,30,4,0,0,4,1,-15,3,1
2,2,13,3,30,5,2,0,7,0,30,4,0,0,4,2,30,7,0,0,7,4,30,7,0,0,7,5,30,4,0,0,4,1,-15,3,1
2,4,13,3,30,5,2,0,7,0,30,4,0,0,4,2,30,7,0,0,7,4,30,7,0,0,7,5,30,4,0,0,4,1,-15,3,1
2,4,15,0,30,4,9,0,13,0,30,6,0,0,6,0,30,4,9,0,13,1,30,2,11,0,13,2,30,8,1,0,9,1,-15,3,1
2,2,19,0,30,3,10,0,13,2,30,5,3,0,8,0,30,8,5,0,13,6,30,5,8,0,13,3,30,9,0,0,9,1,-15,3,1
2,3,19,0,30,3,10,0,13,2,30,5,3,0,8,0,30,8,5,0,13,6,30,5,8,0,13,3,30,9,0,0,9,1,-15,3,1
2,4,19,0,30,3,10,0,13,2,30,5,3,0,8,0,30,8,5,0,13,6,30,5,8,0,13,3,30,9,0,0,9,1,-15,3,1
2,3,25,2,30,6,8,0,14,5,30,6,0,0,6,0,30,5,9,0,14,2,30,7,7,0,14,3,30,5,1,0,6,1,-15,3,1
2,4,25,2,30,6,8,0,14,5,30,6,0,0,6,0,30,5,9,0,14,2,30,7,7,0,14,3,30,5,1,0,6,1,-15,3,1
2,1,27,1,30,7,8,0,15,3,30,1,1,0,2,0,30,3,12,0,15,3,30,5,10,0,15,0,30,6,0,0,6,1,-15,3,1
2,2,35,2,30,5,8,0,13,5,30,1,1,0,2,1,30,6,7,0,13,0,30,0,13,0,13,2,30,8,0,0,8,1,-15,3,1
2,3,35,2,30,5,8,0,13,5,30,1,1,0,2,1,30,6,7,0,13,0,30,0,13,0,13,2,30,8,0,0,8,1,-15,3,1
2,1,17,4,30,9,5,0,14,4,30,6,0,0,6,0,30,3,11,0,14,1,30,7,7,0,14,3,30,4,0,0,4,1,-15,3,1
2,2,17,4,30,9,5,0,14,4,30,6,0,0,6,0,30,3,11,0,14,1,30,7,7,0,14,3,30,4,0,0,4,1,-15,3,1
2,3,17,4,30,9,5,0,14,4,30,6,0,0,6,0,30,3,11,0,14,1,30,7,7,0,14,3,30,4,0,0,4,1,-15,3,1
2,4,23,1,30,9,4,0,13,0,30,5,1,0,6,4,30,13,0,0,13,0,30,4,9,0,13,3,30,6,0,0,6,1,-15,3,1
2,0,27,1,30,3,12,0,15,3,30,2,0,0,2,0,30,5,10,0,15,0,30,5,10,0,15,5,30,6,0,0,6,1,-15,3,1
2,2,27,1,30,3,12,0,15,3,30,2,0,0,2,0,30,5,10,0,15,0,30,5,10,0,15,5,30,6,0,0,6,1,-15,3,1
2,3,27,1,30,3,12,0,15,3,30,2,0,0,2,0,30,5,10,0,15,0,30,5,10,0,15,5,30,6,0,0,6,1,-15,3,1
2,2,29,0,30,6,8,0,14,6,30,7,5,0,12,0,30,3,11,0,14,0,30,6,8,0,14,6,30,6,3,0,9,1,-15,3,1
2,3,29,0,30,6,8,0,14,6,30,7,5,0,12,0,30,3,11,0,14,0,30,6,8,0,14,6,30,6,3,0,9,1,-15,3,1
2,2,35,0,30,7,6,0,13,4,30,2,0,0,2,4,30,7,6,0,13,0,30,5,8,0,13,3,30,7,1,0,8,1,-15,3,1
2,4,35,0,30,7,6,0,13,4,30,2,0,0,2,4,30,7,6,0,13,0,30,5,8,0,13,3,30,7,1,0,8,1,-15,3,1
2,3,9,0,30,2,2,0,4,2,30,2,0,0,2,1,30,4,0,0,4,2,30,3,1,0,4,0,30,1,0,0,1,0,-27,3,0
2,4,9,0,30,2,2,0,4,2,30,2,0,0,2,1,30,4,0,0,4,2,30,3,1,0,4,0,30,1,0,0,1,0,-27,3,0
2,4,15,0,30,4,9,0,13,1,30,6,0,0,6,0,30,4,9,0,13,1,30,6,7,0,13,0,30,6,3,0,9,1,-15,3,1
2,4,17,3,30,10,4,0,14,2,30,6,0,0,6,0,30,6,8,0,14,2,30,5,9,0,14,0,30,2,2,0,4,1,-15,3,1
2,2,19,0,30,3,10,0,13,0,30,6,2,0,8,0,30,9,4,0,13,5,30,6,7,0,13,2,30,8,1,0,9,1,-15,3,1
2,1,21,3,30,6,4,0,10,4,30,6,0,0,6,1,30,3,7,0,10,3,30,4,6,0,10,4,30,4,0,0,4,1,-15,3,1
2,2,25,0,30,6,8,0,14,4,30,6,0,0,6,0,30,6,8,0,14,1,30,7,7,0,14,4,30,6,0,0,6,1,-15,3,1
2,3,25,0,30,6,8,0,14,4,30,6,0,0,6,0,30,6,8,0,14,1,30,7,7,0,14,4,30,6,0,0,6,1,-15,3,1
2,3,27,1,30,5,10,0,15,5,30,2,0,0,2,0,30,2,13,0,15,1,30,5,10,0,15,1,30,4,2,0,6,1,-15,3,1
2,4,27,1,30,5,10,0,15,5,30,2,0,0,2,0,30,2,13,0,15,1,30,5,10,0,15,1,30,4,2,0,6,1,-15,3,1
2,3,29,0,30,7,7,0,14,5,30,11,1,0,12,0,30,7,7,0,14,0,30,1,13,0,14,0,30,8,1,0,9,1,-15,3,1
2,3,8,0,30,7,0,0,7,3,30,2,0,0,2,3,30,3,4,0,7,0,30,5,2,0,7,3,30,3,0,0,3,0,-27,3,0
2,2,11,0,30,4,8,0,12,0,30,4,0,0,4,0,30,7,5,0,12,4,30,6,6,0,12,5,30,4,0,0,4,1,-15,3,1
2,4,11,0,30,4,8,0,12,0,30,4,0,0,4,0,30,7,5,0,12,4,30,6,6,0,12,5,30,4,0,0,4,1,-15,3,1
2,2,13,2,30,5,2,0,7,0,30,4,0,0,4,3,30,5,2,0,7,6,30,6,1,0,7,4,30,4,0,0,4,1,-15,3,1
2,4,13,2,30,5,2,0,7,0,30,4,0,0,4,2,30,5,2,0,7,6,30,6,1,0,7,4,30,4,0,0,4,1,-15,3,1
2,3,17,1,30,11,3,0,14,2,30,6,0,0,6,0,30,7,7,0,14,2,30,5,9,0,14,4,30,4,0,0,4,1,-15,3,1
2,4,25,0,30,3,11,0,14,5,30,6,0,0,6,0,30,8,6,0,14,1,30,5,9,0,14,4,30,5,1,0,6,1,-15,3,1
2,0,27,1,30,4,11,0,15,2,30,1,1,0,2,0,30,5,10,0,15,0,30,4,11,0,15,4,30,6,0,0,6,1,-15,3,1
2,2,27,1,30,4,11,0,15,2,30,1,1,0,2,0,30,5,10,0,15,0,30,4,11,0,15,4,30,6,0,0,6,1,-15,3,1
2,3,35,0,30,8,5,0,13,4,30,2,0,0,2,1,30,2,11,0,13,0,30,5,8,0,13,9,30,8,0,0,8,1,-15,3,1
2,2,5,0,30,0,5,0,5,3,30,0,4,0,4,0,30,0,5,0,5,0,30,1,4,0,5,0,30,1,1,0,2,0,-27,3,0
2,3,5,0,30,0,5,0,5,3,30,0,4,0,4,0,30,0,5,0,5,0,30,1,4,0,5,0,30,1,1,0,2,0,-27,3,0
2,4,5,0,30,0,5,0,5,3,30,0,4,0,4,0,30,0,5,0,5,0,30,1,4,0,5,0,30,1,1,0,2,0,-27,3,0
2,3,11,2,30,5,7,0,12,0,30,4,0,0,4,0,30,7,5,0,12,5,30,4,8,0,12,4,30,4,0,0,4,1,-15,3,1
2,2,15,0,30,4,9,0,13,1,30,6,0,0,6,0,30,3,10,0,13,3,30,7,6,0,13,2,30,9,0,0,9,1,-15,3,1
2,4,15,0,30,4,9,0,13,1,30,6,0,0,6,0,30,3,10,0,13,3,30,7,6,0,13,2,30,9,0,0,9,1,-15,3,1
2,1,17,5,30,11,3,0,14,5,30,6,0,0,6,0,30,2,12,0,14,2,30,7,7,0,14,3,30,4,0,0,4,1,-15,3,1
2,3,19,0,30,6,7,0,13,2,30,8,0,0,8,1,30,5,8,0,13,0,30,4,9,0,13,3,30,8,1,0,9,1,-15,3,1
2,4,19,0,30,6,7,0,13,2,30,8,0,0,8,1,30,5,8,0,13,0,30,4,9,0,13,3,30,8,1,0,9,1,-15,3,1
2,1,27,1,30,4,11,0,15,3,30,1,1,0,2,0,30,5,10,0,15,4,30,6,9,0,15,4,30,6,0,0,6,1,-15,3,1
2,3,29,0,30,6,8,0,14,6,30,11,1,0,12,0,30,3,11,0,14,0,30,1,13,0,14,2,30,9,0,0,9,1,-15,3,1
2,3,31,2,30,7,5,0,12,3,30,8,0,0,8,4,30,12,0,0,12,0,30,3,9,0,12,0,30,3,3,0,6,1,-15,3,1
2,3,39,0,30,5,6,0,11,7,30,6,0,0,6,0,30,4,7,0,11,1,30,3,8,0,11,2,30,5,0,0,5,1,-15,3,1
2,0,6,1,30,9,0,0,9,3,30,2,0,0,2,0,30,4,5,0,9,0,30,4,5,0,9,0,30,1,4,0,5,0,-27,3,0
2,1,6,1,30,9,0,0,9,3,30,2,0,0,2,0,30,4,5,0,9,0,30,4,5,0,9,0,30,1,4,0,5,0,-27,3,0
2,3,6,1,30,9,0,0,9,3,30,2,0,0,2,0,30,4,5,0,9,0,30,4,5,0,9,0,30,1,4,0,5,0,-27,3,0
2,4,6,1,30,9,0,0,9,3,30,2,0,0,2,0,30,4,5,0,9,0,30,4,5,0,9,0,30,1,4,0,5,0,-27,3,0
2,4,8,2,30,7,0,0,7,5,30,2,0,0,2,4,30,1,6,0,7,2,30,7,0,0,7,1,30,3,0,0,3,0,-27,3,0
2,3,19,0,30,4,9,0,13,1,30,4,4,0,8,0,30,9,4,0,13,4,30,8,5,0,13,1,30,7,2,0,9,1,-15,3,1
2,2,21,5,30,10,0,0,10,4,30,4,2,0,6,1,30,3,7,0,10,0,30,4,6,0,10,2,30,4,0,0,4,1,-15,3,1
2,3,21,5,30,10,0,0,10,4,30,4,2,0,6,1,30,3,7,0,10,0,30,4,6,0,10,2,30,4,0,0,4,1,-15,3,1
2,4,21,5,30,10,0,0,10,4,30,4,2,0,6,1,30,3,7,0,10,0,30,4,6,0,10,2,30,4,0,0,4,1,-15,3,1
2,4,39,0,30,4,7,0,11,7,30,6,0,0,6,0,30,4,7,0,11,1,30,5,6,0,11,5,30,5,0,0,5,1,-15,3,1
2,2,45,0,30,7,6,0,13,9,30,10,0,0,10,0,30,0,13,0,13,0,30,4,9,0,13,7,30,5,0,0,5,1,-15,3,1
2,4,11,1,30,6,6,0,12,0,30,4,0,0,4,0,30,5,7,0,12,4,30,3,9,0,12,3,30,4,0,0,4,1,-15,3,1
2,3,15,1,30,3,10,0,13,1,30,6,0,0,6,0,30,5,8,0,13,2,30,9,4,0,13,5,30,7,2,0,9,1,-15,3,1
2,4,19,0,30,5,8,0,13,2,30,3,5,0,8,0,30,5,8,0,13,7,30,9,4,0,13,1,30,8,1,0,9,1,-15,3,1
2,0,27,1,30,9,6,0,15,2,30,2,0,0,2,0,30,5,10,0,15,1,30,4,11,0,15,5,30,5,1,0,6,1,-15,3,1
2,3,27,1,30,9,6,0,15,2,30,2,0,0,2,0,30,5,10,0,15,1,30,4,11,0,15,3,30,5,1,0,6,1,-15,3,1
2,1,29,0,30,7,7,0,14,5,30,11,1,0,12,0,30,6,8,0,14,0,30,1,13,0,14,0,30,7,2,0,9,1,-15,3,1
2,2,29,0,30,7,7,0,14,5,30,11,1,0,12,0,30,6,8,0,14,0,30,1,13,0,14,0,30,7,2,0,9,1,-15,3,1
2,3,29,0,30,7,7,0,14,5,30,11,1,0,12,0,30,6,8,0,14,0,30,1,13,0,14,0,30,7,2,0,9,1,-15,3,1
2,4,3,0,30,0,4,0,4,2,30,4,0,0,4,0,30,1,3,0,4,3,30,1,3,0,4,0,30,1,2,0,3,0,-27,3,0
2,0,4,2,30,6,2,0,8,5,30,4,0,0,4,0,30,2,6,0,8,0,30,7,1,0,8,4,30,3,1,0,4,0,-27,3,0
2,3,4,0,30,6,2,0,8,5,30,4,0,0,4,0,30,2,6,0,8,0,30,7,1,0,8,4,30,3,1,0,4,0,-27,3,0
2,4,4,0,30,6,2,0,8,5,30,4,0,0,4,0,30,2,6,0,8,0,30,7,1,0,8,4,30,3,1,0,4,0,-27,3,0
2,3,8,1,30,7,0,0,7,5,30,2,0,0,2,4,30,2,5,0,7,1,30,7,0,0,7,1,30,3,0,0,3,0,-27,3,0
2,4,8,1,30,7,0,0,7,5,30,2,0,0,2,4,30,2,5,0,7,1,30,7,0,0,7,1,30,3,0,0,3,0,-27,3,0
2,2,17,2,30,8,6,0,14,2,30,6,0,0,6,0,30,7,7,0,14,4,30,6,8,0,14,6,30,4,0,0,4,1,-15,3,1
2,4,17,2,30,8,6,0,14,2,30,6,0,0,6,0,30,7,7,0,14,4,30,6,8,0,14,6,30,4,0,0,4,1,-15,3,1
2,4,25,3,30,4,10,0,14,5,30,6,0,0,6,0,30,6,8,0,14,1,30,4,10,0,14,4,30,5,1,0,6,1,-15,3,1
2,2,27,1,30,4,11,0,15,4,30,2,0,0,2,0,30,2,13,0,15,0,30,4,11,0,15,6,30,6,0,0,6,1,-15,3,1
2,2,31,1,30,6,6,0,12,4,30,8,0,0,8,5,30,10,2,0,12,0,30,3,9,0,12,0,30,3,3,0,6,1,-15,3,1
2,4,31,1,30,6,6,0,12,4,30,8,0,0,8,5,30,10,2,0,12,0,30,3,9,0,12,0,30,3,3,0,6,1,-15,3,1
2,2,47,0,30,0,14,0,14,6,30,4,0,0,4,0,30,3,11,0,14,1,30,3,11,0,14,8,30,7,0,0,7,1,-15,3,1
2,3,8,3,30,7,0,0,7,3,30,2,0,0,2,4,30,4,3,0,7,1,30,7,0,0,7,0,30,3,0,0,3,0,-27,3,0
2,4,8,3,30,7,0,0,7,3,30,2,0,0,2,4,30,4,3,0,7,1,30,7,0,0,7,0,30,3,0,0,3,0,-27,3,0
2,1,13,2,30,6,1,0,7,0,30,4,0,0,4,2,30,5,2,0,7,6,30,7,0,0,7,5,30,4,0,0,4,1,-15,3,1
2,2,13,2,30,6,1,0,7,0,30,4,0,0,4,2,30,5,2,0,7,6,30,7,0,0,7,5,30,4,0,0,4,1,-15,3,1
2,3,13,2,30,6,1,0,7,0,30,4,0,0,4,2,30,5,2,0,7,6,30,7,0,0,7,5,30,4,0,0,4,1,-15,3,1
2,3,17,2,30,11,3,0,14,2,30,6,0,0,6,0,30,6,8,0,14,3,30,5,9,0,14,3,30,4,0,0,4,1,-15,3,1
2,2,19,0,30,3,10,0,13,3,30,5,3,0,8,0,30,4,9,0,13,8,30,5,8,0,13,0,30,8,1,0,9,1,-15,3,1
2,1,27,1,30,5,10,0,15,3,30,1,1,0,2,0,30,6,9,0,15,3,30,7,8,0,15,3,30,6,0,0,6,1,-15,3,1
2,2,27,1,30,5,10,0,15,3,30,1,1,0,2,0,30,6,9,0,15,3,30,7,8,0,15,3,30,6,0,0,6,1,-15,3,1
2,3,27,1,30,5,10,0,15,3,30,1,1,0,2,0,30,6,9,0,15,3,30,7,8,0,15,3,30,6,0,0,6,1,-15,3,1
2,4,27,1,30,5,10,0,15,3,30,1,1,0,2,0,30,6,9,0,15,3,30,7,8,0,15,3,30,6,0,0,6,1,-15,3,1
2,2,31,1,30,8,4,0,12,7,30,8,0,0,8,3,30,4,8,0,12,0,30,7,5,0,12,2,30,6,0,0,6,1,-15,3,1
2,3,35,0,30,8,5,0,13,3,30,2,0,0,2,1,30,2,11,0,13,3,30,2,11,0,13,6,30,8,0,0,8,1,-15,3,1
2,3,38,0,30,3,7,0,10,6,30,6,0,0,6,2,30,3,7,0,10,0,30,0,10,0,10,6,30,6,0,0,6,1,-15,3,1
2,1,4,5,30,6,2,0,8,4,30,3,1,0,4,1,30,2,6,0,8,0,30,3,5,0,8,3,30,4,0,0,4,0,-27,3,0
2,4,19,0,30,3,10,0,13,3,30,7,1,0,8,0,30,4,9,0,13,3,30,7,6,0,13,4,30,9,0,0,9,1,-15,3,1
2,3,25,1,30,3,11,0,14,3,30,6,0,0,6,0,30,10,4,0,14,1,30,5,9,0,14,4,30,5,1,0,6,1,-15,3,1
2,4,27,1,30,4,11,0,15,3,30,1,1,0,2,0,30,6,9,0,15,0,30,7,8,0,15,5,30,6,0,0,6,1,-15,3,1
2,3,35,1,30,6,7,0,13,4,30,2,0,0,2,5,30,2,11,0,13,0,30,1,12,0,13,5,30,8,0,0,8,1,-15,3,1
2,2,13,3,30,7,0,0,7,0,30,4,0,0,4,2,30,5,2,0,7,10,30,7,0,0,7,2,30,4,0,0,4,1,-15,3,1
2,4,13,3,30,7,0,0,7,0,30,4,0,0,4,2,30,5,2,0,7,10,30,7,0,0,7,2,30,4,0,0,4,1,-15,3,1
2,3,19,0,30,4,9,0,13,1,30,8,0,0,8,0,30,9,4,0,13,1,30,7,6,0,13,1,30,8,1,0,9,1,-15,3,1
2,4,19,0,30,4,9,0,13,1,30,8,0,0,8,0,30,9,4,0,13,1,30,7,6,0,13,1,30,8,1,0,9,1,-15,3,1
2,4,22,1,30,8,0,0,8,3,30,2,0,0,2,0,30,3,5,0,8,4,30,6,2,0,8,1,30,1,3,0,4,1,-15,3,1
2,4,23,1,30,6,7,0,13,1,30,6,0,0,6,2,30,13,0,0,13,0,30,4,9,0,13,2,30,6,0,0,6,1,-15,3,1
2,4,25,5,30,7,7,0,14,5,30,6,0,0,6,0,30,8,6,0,14,1,30,5,9,0,14,3,30,5,1,0,6,1,-15,3,1
2,0,26,0,30,9,0,0,9,5,30,4,0,0,4,4,30,1,8,0,9,0,30,2,7,0,9,6,30,3,0,0,3,1,-15,3,1
2,1,26,0,30,9,0,0,9,5,30,4,0,0,4,4,30,1,8,0,9,0,30,2,7,0,9,6,30,3,0,0,3,1,-15,3,1
2,2,26,0,30,9,0,0,9,5,30,4,0,0,4,4,30,1,8,0,9,0,30,2,7,0,9,6,30,3,0,0,3,1,-15,3,1
2,4,26,0,30,9,0,0,9,5,30,4,0,0,4,4,30,1,8,0,9,0,30,2,7,0,9,0,30,3,0,0,3,1,-15,3,1
2,2,27,0,30,4,11,0,15,1,30,2,0,0,2,0,30,5,10,0,15,2,30,4,11,0,15,0,30,3,3,0,6,1,-15,3,1
2,4,27,0,30,4,11,0,15,1,30,2,0,0,2,0,30,5,10,0,15,2,30,4,11,0,15,0,30,3,3,0,6,1,-15,3,1
2,2,29,0,30,6,8,0,14,6,30,12,0,0,12,0,30,3,11,0,14,0,30,3,11,0,14,5,30,9,0,0,9,1,-15,3,1
2,3,29,0,30,6,8,0,14,6,30,12,0,0,12,0,30,3,11,0,14,0,30,3,11,0,14,5,30,9,0,0,9,1,-15,3,1
2,4,39,4,30,6,5,0,11,6,30,6,0,0,6,0,30,7,4,0,11,0,30,2,9,0,11,2,30,2,3,0,5,1,-15,3,1
2,0,41,0,30,7,5,0,12,5,30,7,1,0,8,0,30,7,5,0,12,0,30,3,9,0,12,2,30,7,0,0,7,1,-15,3,1
2,1,41,0,30,7,5,0,12,5,30,7,1,0,8,0,30,7,5,0,12,0,30,3,9,0,12,2,30,7,0,0,7,1,-15,3,1
2,2,41,0,30,7,5,0,12,5,30,7,1,0,8,0,30,7,5,0,12,0,30,3,9,0,12,2,30,7,0,0,7,1,-15,3,1
2,1,13,1,30,7,0,0,7,0,30,4,0,0,4,2,30,6,1,0,7,11,30,7,0,0,7,7,30,4,0,0,4,1,-15,3,1
2,1,19,0,30,4,9,0,13,1,30,7,1,0,8,0,30,7,6,0,13,2,30,4,9,0,13,2,30,6,3,0,9,1,-15,3,1
2,4,19,0,30,4,9,0,13,1,30,7,1,0,8,0,30,7,6,0,13,2,30,4,9,0,13,2,30,6,3,0,9,1,-15,3,1
2,3,25,1,30,7,7,0,14,5,30,6,0,0,6,0,30,6,8,0,14,1,30,4,10,0,14,5,30,6,0,0,6,1,-15,3,1
2,4,25,1,30,7,7,0,14,5,30,6,0,0,6,0,30,6,8,0,14,1,30,4,10,0,14,5,30,6,0,0,6,1,-15,3,1
2,3,27,2,30,11,4,0,15,4,30,2,0,0,2,0,30,1,14,0,15,1,30,3,12,0,15,2,30,5,1,0,6,1,-15,3,1
2,3,29,0,30,6,8,0,14,5,30,12,0,0,12,0,30,7,7,0,14,0,30,1,13,0,14,0,30,9,0,0,9,1,-15,3,1
2,4,29,0,30,6,8,0,14,5,30,12,0,0,12,0,30,7,7,0,14,0,30,1,13,0,14,0,30,9,0,0,9,1,-15,3,1
2,4,31,2,30,10,2,0,12,4,30,8,0,0,8,3,30,9,3,0,12,0,30,3,9,0,12,1,30,3,3,0,6,1,-15,3,1
2,2,39,5,30,5,6,0,11,6,30,6,0,0,6,0,30,8,3,0,11,0,30,2,9,0,11,0,30,4,1,0,5,1,-15,3,1
2,3,39,5,30,5,6,0,11,6,30,6,0,0,6,0,30,8,3,0,11,0,30,2,9,0,11,0,30,4,1,0,5,1,-15,3,1
2,4,15,1,30,3,10,0,13,1,30,6,0,0,6,0,30,3,10,0,13,1,30,8,5,0,13,3,30,9,0,0,9,1,-15,3,1
2,3,17,1,30,9,5,0,14,2,30,6,0,0,6,0,30,8,6,0,14,2,30,8,6,0,14,6,30,4,0,0,4,1,-15,3,1
2,4,17,1,30,9,5,0,14,2,30,6,0,0,6,0,30,8,6,0,14,2,30,8,6,0,14,6,30,4,0,0,4,1,-15,3,1
2,3,23,1,30,5,8,0,13,3,30,6,0,0,6,5,30,13,0,0,13,0,30,4,9,0,13,2,30,5,1,0,6,1,-15,3,1
2,4,23,1,30,5,8,0,13,3,30,6,0,0,6,5,30,13,0,0,13,0,30,4,9,0,13,2,30,5,1,0,6,1,-15,3,1
2,3,25,0,30,6,8,0,14,5,30,6,0,0,6,0,30,4,10,0,14,1,30,6,8,0,14,2,30,6,0,0,6,1,-15,3,1
2,4,25,0,30,6,8,0,14,5,30,6,0,0,6,0,30,4,10,0,14,1,30,6,8,0,14,2,30,6,0,0,6,1,-15,3,1
2,2,26,0,30,4,5,0,9,5,30,4,0,0,4,5,30,0,9,0,9,0,30,2,7,0,9,4,30,3,0,0,3,1,-15,3,1
2,4,26,0,30,4,5,0,9,5,30,4,0,0,4,5,30,0,9,0,9,0,30,2,7,0,9,4,30,3,0,0,3,1,-15,3,1
2,0,27,1,30,6,9,0,15,4,30,2,0,0,2,0,30,6,9,0,15,2,30,4,11,0,15,1,30,5,1,0,6,1,-15,3,1
2,1,27,1,30,6,9,0,15,4,30,2,0,0,2,0,30,6,9,0,15,2,30,4,11,0,15,1,30,5,1,0,6,1,-15,3,1
2,2,27,1,30,6,9,0,15,4,30,2,0,0,2,0,30,6,9,0,15,2,30,4,11,0,15,1,30,5,1,0,6,1,-15,3,1
2,3,27,1,30,6,9,0,15,4,30,2,0,0,2,0,30,6,9,0,15,2,30,4,11,0,15,1,30,5,1,0,6,1,-15,3,1
2,3,31,3,30,9,3,0,12,4,30,8,0,0,8,4,30,9,3,0,12,0,30,3,9,0,12,0,30,1,5,0,6,1,-15,3,1
2,4,31,3,30,9,3,0,12,4,30,8,0,0,8,4,30,9,3,0,12,0,30,3,9,0,12,0,30,1,5,0,6,1,-15,3,1
2,3,33,1,30,2,9,0,11,4,30,4,0,0,4,0,30,9,2,0,11,0,30,3,8,0,11,5,30,4,0,0,4,1,-15,3,1
2,1,3,1,30,6,5,0,11,2,30,8,0,0,8,0,30,5,6,0,11,8,30,1,10,0,11,4,30,7,0,0,7,0,-27,3,0
2,3,11,1,30,3,9,0,12,0,30,4,0,0,4,0,30,7,5,0,12,4,30,4,8,0,12,4,30,4,0,0,4,1,-15,3,1
2,1,13,3,30,6,1,0,7,0,30,4,0,0,4,2,30,6,1,0,7,4,30,7,0,0,7,5,30,4,0,0,4,1,-15,3,1
2,3,13,0,30,6,1,0,7,0,30,4,0,0,4,2,30,6,1,0,7,4,30,7,0,0,7,5,30,4,0,0,4,1,-15,3,1
2,4,13,0,30,6,1,0,7,0,30,4,0,0,4,2,30,6,1,0,7,4,30,7,0,0,7,5,30,4,0,0,4,1,-15,3,1
2,3,17,1,30,10,4,0,14,2,30,6,0,0,6,0,30,7,7,0,14,2,30,5,9,0,14,1,30,3,1,0,4,1,-15,3,1
2,4,17,1,30,10,4,0,14,2,30,6,0,0,6,0,30,7,7,0,14,2,30,5,9,0,14,1,30,3,1,0,4,1,-15,3,1
2,4,19,0,30,7,6,0,13,1,30,5,3,0,8,0,30,7,6,0,13,0,30,3,10,0,13,0,30,8,1,0,9,1,-15,3,1
2,0,21,2,30,7,3,0,10,3,30,5,1,0,6,1,30,5,5,0,10,3,30,5,5,0,10,2,30,4,0,0,4,1,-15,3,1
2,1,21,2,30,7,3,0,10,3,30,5,1,0,6,1,30,5,5,0,10,3,30,5,5,0,10,2,30,4,0,0,4,1,-15,3,1
2,2,21,2,30,7,3,0,10,3,30,5,1,0,6,1,30,5,5,0,10,3,30,5,5,0,10,2,30,4,0,0,4,1,-15,3,1
2,4,21,0,30,7,3,0,10,3,30,5,1,0,6,1,30,5,5,0,10,3,30,5,5,0,10,2,30,4,0,0,4,1,-15,3,1
2,3,23,2,30,4,9,0,13,4,30,6,0,0,6,5,30,11,2,0,13,0,30,4,9,0,13,1,30,5,1,0,6,1,-15,3,1
2,4,23,2,30,4,9,0,13,4,30,6,0,0,6,5,30,11,2,0,13,0,30,4,9,0,13,1,30,5,1,0,6,1,-15,3,1
2,2,25,1,30,7,7,0,14,0,30,6,0,0,6,0,30,10,4,0,14,4,30,7,7,0,14,5,30,5,1,0,6,1,-15,3,1
2,3,25,1,30,7,7,0,14,0,30,6,0,0,6,0,30,10,4,0,14,4,30,7,7,0,14,5,30,5,1,0,6,1,-15,3,1
2,3,27,1,30,7,8,0,15,2,30,2,0,0,2,0,30,8,7,0,15,0,30,3,12,0,15,0,30,6,0,0,6,1,-15,3,1
2,3,5,0,30,0,5,0,5,2,30,3,1,0,4,0,30,1,4,0,5,0,30,4,1,0,5,1,30,0,2,0,2,0,-27,3,0
2,4,5,0,30,0,5,0,5,2,30,3,1,0,4,0,30,1,4,0,5,0,30,4,1,0,5,1,30,0,2,0,2,0,-27,3,0
2,4,8,3,30,7,0,0,7,3,30,2,0,0,2,0,30,6,1,0,7,1,30,5,2,0,7,0,30,3,0,0,3,0,-27,3,0
2,4,11,0,30,6,6,0,12,0,30,4,0,0,4,0,30,7,5,0,12,7,30,5,7,0,12,4,30,4,0,0,4,1,-15,3,1
2,1,13,3,30,7,0,0,7,0,30,4,0,0,4,2,30,6,1,0,7,7,30,7,0,0,7,4,30,4,0,0,4,1,-15,3,1
2,2,13,3,30,7,0,0,7,0,30,4,0,0,4,2,30,6,1,0,7,7,30,7,0,0,7,4,30,4,0,0,4,1,-15,3,1
2,4,13,3,30,7,0,0,7,0,30,4,0,0,4,2,30,6,1,0,7,7,30,7,0,0,7,4,30,4,0,0,4,1,-15,3,1
2,4,15,2,30,4,9,0,13,1,30,6,0,0,6,0,30,3,10,0,13,1,30,1,12,0,13,2,30,8,1,0,9,1,-15,3,1
2,4,17,2,30,9,5,0,14,0,30,6,0,0,6,0,30,8,6,0,14,1,30,4,10,0,14,4,30,4,0,0,4,1,-15,3,1
2,2,25,1,30,7,7,0,14,4,30,6,0,0,6,0,30,7,7,0,14,1,30,8,6,0,14,1,30,5,1,0,6,1,-15,3,1
2,0,26,1,30,7,2,0,9,5,30,4,0,0,4,5,30,0,9,0,9,0,30,4,5,0,9,5,30,3,0,0,3,1,-15,3,1
2,0,27,1,30,4,11,0,15,4,30,1,1,0,2,3,30,7,8,0,15,0,30,6,9,0,15,1,30,6,0,0,6,1,-15,3,1
2,2,27,1,30,4,11,0,15,4,30,1,1,0,2,3,30,7,8,0,15,0,30,6,9,0,15,1,30,6,0,0,6,1,-15,3,1
2,4,27,1,30,4,11,0,15,4,30,1,1,0,2,3,30,7,8,0,15,0,30,6,9,0,15,1,30,6,0,0,6,1,-15,3,1
2,4,29,0,30,4,10,0,14,6,30,12,0,0,12,0,30,6,8,0,14,0,30,0,14,0,14,2,30,9,0,0,9,1,-15,3,1
2,3,33,1,30,2,9,0,11,4,30,4,0,0,4,0,30,8,3,0,11,0,30,4,7,0,11,6,30,4,0,0,4,1,-15,3,1
2,3,8,1,30,7,0,0,7,4,30,2,0,0,2,3,30,2,5,0,7,3,30,7,0,0,7,0,30,2,1,0,3,0,-27,3,0
2,4,8,1,30,7,0,0,7,4,30,2,0,0,2,3,30,2,5,0,7,3,30,7,0,0,7,0,30,2,1,0,3,0,-27,3,0
2,1,11,4,30,4,8,0,12,0,30,4,0,0,4,0,30,7,5,0,12,6,30,4,8,0,12,4,30,4,0,0,4,1,-15,3,1
2,2,11,4,30,4,8,0,12,0,30,4,0,0,4,0,30,7,5,0,12,6,30,4,8,0,12,4,30,4,0,0,4,1,-15,3,1
2,3,13,2,30,5,2,0,7,0,30,4,0,0,4,2,30,5,2,0,7,6,30,7,0,0,7,6,30,4,0,0,4,1,-15,3,1
2,1,17,2,30,10,4,0,14,3,30,6,0,0,6,0,30,7,7,0,14,5,30,8,6,0,14,1,30,4,0,0,4,1,-15,3,1
2,2,17,2,30,10,4,0,14,3,30,6,0,0,6,0,30,7,7,0,14,5,30,8,6,0,14,1,30,4,0,0,4,1,-15,3,1
2,3,17,2,30,10,4,0,14,3,30,6,0,0,6,0,30,7,7,0,14,5,30,8,6,0,14,1,30,4,0,0,4,1,-15,3,1
2,4,17,2,30,10,4,0,14,3,30,6,0,0,6,0,30,7,7,0,14,5,30,8,6,0,14,1,30,4,0,0,4,1,-15,3,1
2,1,19,1,30,4,9,0,13,1,30,8,0,0,8,0,30,7,6,0,13,0,30,4,9,0,13,2,30,6,3,0,9,1,-15,3,1
2,2,19,1,30,4,9,0,13,1,30,8,0,0,8,0,30,7,6,0,13,0,30,4,9,0,13,2,30,6,3,0,9,1,-15,3,1
2,1,23,1,30,4,9,0,13,2,30,6,0,0,6,10,30,13,0,0,13,0,30,5,8,0,13,3,30,6,0,0,6,1,-15,3,1
2,3,23,1,30,4,9,0,13,2,30,6,0,0,6,10,30,13,0,0,13,0,30,5,8,0,13,3,30,6,0,0,6,1,-15,3,1
2,3,27,2,30,11,4,0,15,3,30,2,0,0,2,2,30,6,9,0,15,0,30,4,11,0,15,2,30,3,3,0,6,1,-15,3,1
2,2,31,3,30,5,7,0,12,6,30,8,0,0,8,2,30,8,4,0,12,0,30,8,4,0,12,5,30,6,0,0,6,1,-15,3,1
2,2,43,1,30,7,7,0,14,7,30,6,0,0,6,0,30,4,10,0,14,1,30,6,8,0,14,8,30,5,0,0,5,1,-15,3,1
2,3,8,2,30,7,0,0,7,5,30,2,0,0,2,0,30,3,4,0,7,1,30,7,0,0,7,2,30,3,0,0,3,0,-27,3,0
2,4,11,3,30,6,6,0,12,1,30,4,0,0,4,0,30,4,8,0,12,1,30,3,9,0,12,2,30,4,0,0,4,1,-15,3,1
2,4,15,1,30,6,7,0,13,0,30,6,0,0,6,0,30,8,5,0,13,1,30,3,10,0,13,3,30,5,4,0,9,1,-15,3,1
2,0,17,3,30,8,6,0,14,3,30,6,0,0,6,0,30,6,8,0,14,2,30,9,5,0,14,5,30,4,0,0,4,1,-15,3,1
2,1,17,3,30,8,6,0,14,3,30,6,0,0,6,0,30,6,8,0,14,2,30,9,5,0,14,5,30,4,0,0,4,1,-15,3,1
2,2,19,0,30,5,8,0,13,2,30,6,2,0,8,0,30,4,9,0,13,5,30,2,11,0,13,4,30,9,0,0,9,1,-15,3,1
2,3,19,0,30,5,8,0,13,2,30,6,2,0,8,0,30,4,9,0,13,5,30,2,11,0,13,4,30,9,0,0,9,1,-15,3,1
2,4,19,0,30,5,8,0,13,2,30,6,2,0,8,0,30,4,9,0,13,5,30,2,11,0,13,4,30,9,0,0,9,1,-15,3,1
2,1,25,6,30,10,4,0,14,2,30,6,0,0,6,0,30,7,7,0,14,1,30,4,10,0,14,3,30,5,1,0,6,1,-15,3,1
2,2,25,6,30,10,4,0,14,2,30,6,0,0,6,0,30,7,7,0,14,1,30,4,10,0,14,3,30,5,1,0,6,1,-15,3,1
2,3,25,6,30,10,4,0,14,2,30,6,0,0,6,0,30,7,7,0,14,1,30,4,10,0,14,3,30,5,1,0,6,1,-15,3,1
2,2,27,1,30,8,7,0,15,2,30,2,0,0,2,1,30,4,11,0,15,0,30,3,12,0,15,1,30,3,3,0,6,1,-15,3,1
2,0,5,0,30,1,4,0,5,3,30,1,3,0,4,1,30,0,5,0,5,0,30,1,4,0,5,0,30,0,2,0,2,0,-27,3,0
2,1,5,0,30,1,4,0,5,3,30,1,3,0,4,1,30,0,5,0,5,0,30,1,4,0,5,0,30,0,2,0,2,0,-27,3,0
2,2,17,3,30,7,7,0,14,2,30,6,0,0,6,0,30,9,5,0,14,3,30,8,6,0,14,7,30,4,0,0,4,1,-15,3,1
2,3,23,1,30,4,9,0,13,2,30,6,0,0,6,7,30,13,0,0,13,0,30,5,8,0,13,0,30,6,0,0,6,1,-15,3,1
2,4,23,1,30,4,9,0,13,2,30,6,0,0,6,7,30,13,0,0,13,0,30,5,8,0,13,0,30,6,0,0,6,1,-15,3,1
2,0,27,1,30,4,11,0,15,2,30,2,0,0,2,0,30,5,10,0,15,3,30,7,8,0,15,4,30,6,0,0,6,1,-15,3,1
2,1,27,1,30,4,11,0,15,2,30,2,0,0,2,0,30,5,10,0,15,3,30,7,8,0,15,4,30,6,0,0,6,1,-15,3,1
2,2,27,1,30,4,11,0,15,2,30,2,0,0,2,0,30,5,10,0,15,3,30,7,8,0,15,4,30,6,0,0,6,1,-15,3,1
2,3,27,1,30,4,11,0,15,2,30,2,0,0,2,0,30,5,10,0,15,3,30,7,8,0,15,4,30,6,0,0,6,1,-15,3,1
2,2,29,1,30,8,6,0,14,5,30,11,1,0,12,0,30,3,11,0,14,0,30,1,13,0,14,0,30,9,0,0,9,1,-15,3,1
2,1,5,1,30,4,1,0,5,3,30,0,4,0,4,0,30,0,5,0,5,0,30,1,4,0,5,0,30,0,2,0,2,0,-27,3,0
2,2,5,1,30,4,1,0,5,3,30,0,4,0,4,0,30,0,5,0,5,0,30,1,4,0,5,0,30,0,2,0,2,0,-27,3,0
2,1,9,0,30,2,2,0,4,2,30,2,0,0,2,0,30,1,3,0,4,0,30,1,3,0,4,0,30,0,1,0,1,0,-27,3,0
2,2,9,0,30,2,2,0,4,2,30,2,0,0,2,0,30,1,3,0,4,0,30,1,3,0,4,0,30,0,1,0,1,0,-27,3,0
2,2,13,1,30,5,2,0,7,0,30,4,0,0,4,2,30,5,2,0,7,7,30,6,1,0,7,4,30,4,0,0,4,1,-15,3,1
2,4,13,1,30,5,2,0,7,0,30,4,0,0,4,2,30,5,2,0,7,7,30,6,1,0,7,4,30,4,0,0,4,1,-15,3,1
2,3,17,5,30,10,4,0,14,3,30,6,0,0,6,0,30,5,9,0,14,0,30,5,9,0,14,2,30,4,0,0,4,1,-15,3,1
2,2,19,0,30,2,11,0,13,2,30,8,0,0,8,0,30,6,7,0,13,0,30,4,9,0,13,0,30,8,1,0,9,1,-15,3,1
2,3,19,0,30,2,11,0,13,2,30,8,0,0,8,0,30,6,7,0,13,0,30,4,9,0,13,0,30,8,1,0,9,1,-15,3,1
2,2,25,1,30,6,8,0,14,5,30,6,0,0,6,0,30,6,8,0,14,1,30,5,9,0,14,3,30,5,1,0,6,1,-15,3,1
2,4,25,0,30,6,8,0,14,5,30,6,0,0,6,0,30,6,8,0,14,1,30,5,9,0,14,3,30,5,1,0,6,1,-15,3,1
2,2,26,0,30,8,1,0,9,4,30,4,0,0,4,3,30,2,7,0,9,0,30,2,7,0,9,6,30,3,0,0,3,1,-15,3,1
2,3,26,0,30,8,1,0,9,4,30,4,0,0,4,3,30,2,7,0,9,0,30,2,7,0,9,6,30,3,0,0,3,1,-15,3,1
2,3,27,1,30,6,9,0,15,3,30,2,0,0,2,0,30,4,11,0,15,0,30,6,9,0,15,4,30,6,0,0,6,1,-15,3,1
2,4,27,1,30,6,9,0,15,3,30,2,0,0,2,0,30,4,11,0,15,0,30,6,9,0,15,4,30,6,0,0,6,1,-15,3,1
2,2,31,2,30,7,5,0,12,4,30,8,0,0,8,3,30,12,0,0,12,0,30,3,9,0,12,1,30,4,2,0,6,1,-15,3,1
2,3,31,2,30,7,5,0,12,4,30,8,0,0,8,3,30,12,0,0,12,0,30,3,9,0,12,1,30,4,2,0,6,1,-15,3,1
2,4,31,2,30,7,5,0,12,4,30,8,0,0,8,3,30,12,0,0,12,0,30,3,9,0,12,1,30,4,2,0,6,1,-15,3,1
2,2,35,0,30,7,6,0,13,3,30,2,0,0,2,1,30,10,3,0,13,0,30,3,10,0,13,1,30,8,0,0,8,1,-15,3,1
2,3,35,0,30,7,6,0,13,3,30,2,0,0,2,1,30,10,3,0,13,0,30,3,10,0,13,1,30,8,0,0,8,1,-15,3,1
2,4,35,0,30,7,6,0,13,3,30,2,0,0,2,1,30,10,3,0,13,0,30,3,10,0,13,1,30,8,0,0,8,1,-15,3,1
2,1,5,0,30,0,5,0,5,2,30,3,1,0,4,0,30,2,3,0,5,0,30,2,3,0,5,0,30,0,2,0,2,0,-27,3,0
2,3,5,0,30,0,5,0,5,2,30,3,1,0,4,0,30,2,3,0,5,0,30,2,3,0,5,0,30,0,2,0,2,0,-27,3,0
2,4,7,0,30,2,7,0,9,2,30,2,2,0,4,1,30,7,2,0,9,8,30,4,5,0,9,4,30,5,1,0,6,0,-27,3,0
2,4,15,1,30,10,3,0,13,2,30,6,0,0,6,0,30,5,8,0,13,3,30,6,7,0,13,0,30,3,6,0,9,1,-15,3,1
2,3,19,5,30,4,9,0,13,2,30,2,6,0,8,0,30,8,5,0,13,1,30,6,7,0,13,0,30,9,0,0,9,1,-15,3,1
2,4,19,5,30,4,9,0,13,2,30,2,6,0,8,0,30,8,5,0,13,1,30,6,7,0,13,0,30,9,0,0,9,1,-15,3,1
2,2,21,3,30,5,5,0,10,4,30,6,0,0,6,1,30,3,7,0,10,2,30,4,6,0,10,0,30,3,1,0,4,1,-15,3,1
2,2,23,2,30,5,8,0,13,4,30,6,0,0,6,5,30,10,3,0,13,0,30,6,7,0,13,2,30,6,0,0,6,1,-15,3,1
2,3,23,2,30,5,8,0,13,4,30,6,0,0,6,5,30,10,3,0,13,0,30,6,7,0,13,2,30,6,0,0,6,1,-15,3,1
2,4,25,2,30,5,9,0,14,4,30,6,0,0,6,0,30,5,9,0,14,2,30,9,5,0,14,3,30,6,0,0,6,1,-15,3,1
2,1,27,1,30,5,10,0,15,1,30,2,0,0,2,3,30,11,4,0,15,0,30,4,11,0,15,1,30,2,4,0,6,1,-15,3,1
2,2,27,1,30,5,10,0,15,1,30,2,0,0,2,3,30,11,4,0,15,0,30,4,11,0,15,1,30,2,4,0,6,1,-15,3,1
2,0,5,0,30,2,3,0,5,3,30,0,4,0,4,0,30,0,5,0,5,0,30,2,3,0,5,1,30,2,0,0,2,0,-27,3,0
2,1,5,0,30,2,3,0,5,3,30,0,4,0,4,0,30,0,5,0,5,0,30,2,3,0,5,1,30,2,0,0,2,0,-27,3,0
2,3,5,0,30,2,3,0,5,3,30,0,4,0,4,0,30,0,5,0,5,0,30,2,3,0,5,1,30,2,0,0,2,0,-27,3,0
2,3,8,2,30,7,0,0,7,4,30,2,0,0,2,0,30,3,4,0,7,0,30,6,1,0,7,1,30,3,0,0,3,0,-27,3,0
2,4,8,2,30,7,0,0,7,4,30,2,0,0,2,0,30,3,4,0,7,0,30,6,1,0,7,1,30,3,0,0,3,0,-27,3,0
2,4,15,0,30,5,8,0,13,0,30,6,0,0,6,0,30,5,8,0,13,1,30,2,11,0,13,2,30,7,2,0,9,1,-15,3,1
2,2,19,0,30,6,7,0,13,1,30,4,4,0,8,0,30,8,5,0,13,4,30,4,9,0,13,2,30,9,0,0,9,1,-15,3,1
2,4,19,0,30,6,7,0,13,1,30,4,4,0,8,0,30,8,5,0,13,4,30,4,9,0,13,2,30,9,0,0,9,1,-15,3,1
2,3,23,1,30,7,6,0,13,0,30,6,0,0,6,3,30,13,0,0,13,0,30,5,8,0,13,1,30,6,0,0,6,1,-15,3,1
2,4,23,1,30,7,6,0,13,0,30,6,0,0,6,3,30,13,0,0,13,0,30,5,8,0,13,1,30,6,0,0,6,1,-15,3,1
2,3,27,1,30,4,11,0,15,3,30,2,0,0,2,0,30,6,9,0,15,0,30,4,11,0,15,1,30,5,1,0,6,1,-15,3,1
2,1,11,1,30,5,7,0,12,0,30,4,0,0,4,0,30,7,5,0,12,0,30,6,6,0,12,3,30,4,0,0,4,1,-15,3,1
2,3,11,1,30,5,7,0,12,0,30,4,0,0,4,0,30,7,5,0,12,0,30,6,6,0,12,3,30,4,0,0,4,1,-15,3,1
2,4,11,1,30,5,7,0,12,0,30,4,0,0,4,0,30,7,5,0,12,0,30,6,6,0,12,3,30,4,0,0,4,1,-15,3,1
2,2,13,1,30,5,2,0,7,0,30,4,0,0,4,2,30,5,2,0,7,14,30,7,0,0,7,6,30,4,0,0,4,1,-15,3,1
2,4,13,1,30,5,2,0,7,0,30,4,0,0,4,2,30,5,2,0,7,14,30,7,0,0,7,6,30,4,0,0,4,1,-15,3,1
2,2,17,4,30,12,2,0,14,3,30,6,0,0,6,0,30,4,10,0,14,2,30,5,9,0,14,4,30,4,0,0,4,1,-15,3,1
2,3,17,4,30,12,2,0,14,3,30,6,0,0,6,0,30,4,10,0,14,2,30,5,9,0,14,4,30,4,0,0,4,1,-15,3,1
2,2,25,1,30,7,7,0,14,4,30,6,0,0,6,0,30,5,9,0,14,1,30,4,10,0,14,4,30,5,1,0,6,1,-15,3,1
2,0,27,1,30,4,11,0,15,4,30,1,1,0,2,0,30,4,11,0,15,3,30,5,10,0,15,3,30,6,0,0,6,1,-15,3,1
2,1,27,1,30,4,11,0,15,4,30,1,1,0,2,0,30,4,11,0,15,3,30,5,10,0,15,3,30,6,0,0,6,1,-15,3,1
2,2,27,1,30,4,11,0,15,4,30,1,1,0,2,0,30,4,11,0,15,3,30,5,10,0,15,3,30,6,0,0,6,1,-15,3,1
2,3,27,1,30,4,11,0,15,4,30,1,1,0,2,0,30,4,11,0,15,3,30,5,10,0,15,3,30,6,0,0,6,1,-15,3,1
2,4,27,1,30,4,11,0,15,4,30,1,1,0,2,0,30,4,11,0,15,3,30,5,10,0,15,3,30,6,0,0,6,1,-15,3,1
2,2,31,3,30,8,4,0,12,4,30,8,0,0,8,3,30,9,3,0,12,2,30,4,8,0,12,0,30,3,3,0,6,1,-15,3,1
2,4,31,3,30,8,4,0,12,4,30,8,0,0,8,3,30,9,3,0,12,2,30,4,8,0,12,0,30,3,3,0,6,1,-15,3,1
2,2,39,6,30,5,6,0,11,7,30,6,0,0,6,0,30,8,3,0,11,0,30,2,9,0,11,1,30,5,0,0,5,1,-15,3,1
2,3,39,6,30,5,6,0,11,7,30,6,0,0,6,0,30,8,3,0,11,0,30,2,9,0,11,1,30,5,0,0,5,1,-15,3,1
2,4,39,6,30,5,6,0,11,7,30,6,0,0,6,0,30,8,3,0,11,0,30,2,9,0,11,1,30,5,0,0,5,1,-15,3,1
2,1,4,2,30,8,0,0,8,4,30,4,0,0,4,0,30,2,6,0,8,0,30,5,3,0,8,2,30,3,1,0,4,0,-27,3,0
2,4,15,0,30,3,10,0,13,1,30,6,0,0,6,0,30,3,10,0,13,5,30,4,9,0,13,4,30,9,0,0,9,1,-15,3,1
2,1,19,0,30,6,7,0,13,2,30,6,2,0,8,0,30,5,8,0,13,3,30,5,8,0,13,1,30,8,1,0,9,1,-15,3,1
2,2,19,0,30,6,7,0,13,2,30,6,2,0,8,0,30,5,8,0,13,3,30,5,8,0,13,1,30,8,1,0,9,1,-15,3,1
2,4,19,0,30,6,7,0,13,2,30,6,2,0,8,0,30,5,8,0,13,3,30,5,8,0,13,1,30,8,1,0,9,1,-15,3,1
2,3,27,1,30,3,12,0,15,5,30,2,0,0,2,0,30,8,7,0,15,2,30,6,9,0,15,1,30,6,0,0,6,1,-15,3,1
2,0,41,0,30,8,4,0,12,7,30,8,0,0,8,0,30,3,9,0,12,0,30,4,8,0,12,6,30,7,0,0,7,1,-15,3,1
2,0,19,0,30,3,10,0,13,2,30,6,2,0,8,0,30,4,9,0,13,3,30,7,6,0,13,1,30,9,0,0,9,1,-15,3,1
2,2,19,0,30,3,10,0,13,2,30,6,2,0,8,0,30,4,9,0,13,3,30,7,6,0,13,0,30,9,0,0,9,1,-15,3,1
2,3,19,0,30,3,10,0,13,2,30,6,2,0,8,0,30,4,9,0,13,3,30,7,6,0,13,0,30,9,0,0,9,1,-15,3,1
2,4,19,0,30,3,10,0,13,2,30,6,2,0,8,0,30,4,9,0,13,3,30,7,6,0,13,0,30,9,0,0,9,1,-15,3,1
2,3,23,1,30,8,5,0,13,1,30,6,0,0,6,5,30,13,0,0,13,0,30,5,8,0,13,3,30,5,1,0,6,1,-15,3,1
2,4,23,1,30,8,5,0,13,1,30,6,0,0,6,5,30,13,0,0,13,0,30,5,8,0,13,3,30,5,1,0,6,1,-15,3,1
2,0,25,1,30,3,11,0,14,5,30,6,0,0,6,0,30,8,6,0,14,1,30,5,9,0,14,4,30,5,1,0,6,1,-15,3,1
2,1,25,1,30,3,11,0,14,5,30,6,0,0,6,0,30,8,6,0,14,1,30,5,9,0,14,4,30,5,1,0,6,1,-15,3,1
2,3,25,1,30,3,11,0,14,5,30,6,0,0,6,0,30,8,6,0,14,1,30,5,9,0,14,4,30,5,1,0,6,1,-15,3,1
2,1,27,1,30,4,11,0,15,4,30,2,0,0,2,0,30,3,12,0,15,2,30,6,9,0,15,4,30,6,0,0,6,1,-15,3,1
2,2,27,1,30,4,11,0,15,4,30,2,0,0,2,0,30,3,12,0,15,2,30,6,9,0,15,4,30,6,0,0,6,1,-15,3,1
2,3,27,1,30,4,11,0,15,4,30,2,0,0,2,0,30,3,12,0,15,2,30,6,9,0,15,4,30,6,0,0,6,1,-15,3,1
2,4,27,1,30,4,11,0,15,4,30,2,0,0,2,0,30,3,12,0,15,2,30,6,9,0,15,4,30,6,0,0,6,1,-15,3,1
2,2,35,0,30,6,7,0,13,2,30,2,0,0,2,1,30,7,6,0,13,6,30,1,12,0,13,6,30,8,0,0,8,1,-15,3,1
2,0,47,0,30,1,13,0,14,7,30,4,0,0,4,0,30,6,8,0,14,0,30,6,8,0,14,5,30,7,0,0,7,1,-15,3,1
2,2,13,2,30,6,1,0,7,0,30,4,0,0,4,2,30,5,2,0,7,6,30,7,0,0,7,4,30,4,0,0,4,1,-15,3,1
2,4,17,3,30,9,5,0,14,3,30,6,0,0,6,0,30,4,10,0,14,0,30,5,9,0,14,4,30,4,0,0,4,1,-15,3,1
2,2,19,0,30,3,10,0,13,1,30,8,0,0,8,1,30,9,4,0,13,1,30,4,9,0,13,1,30,7,2,0,9,1,-15,3,1
2,3,23,1,30,7,6,0,13,0,30,6,0,0,6,5,30,12,1,0,13,0,30,4,9,0,13,3,30,6,0,0,6,1,-15,3,1
2,4,23,1,30,7,6,0,13,0,30,6,0,0,6,5,30,12,1,0,13,0,30,4,9,0,13,3,30,6,0,0,6,1,-15,3,1
2,2,27,1,30,3,12,0,15,4,30,2,0,0,2,0,30,6,9,0,15,1,30,7,8,0,15,4,30,6,0,0,6,1,-15,3,1
2,4,27,1,30,3,12,0,15,4,30,2,0,0,2,0,30,6,9,0,15,1,30,7,8,0,15,4,30,6,0,0,6,1,-15,3,1
2,3,45,0,30,4,9,0,13,8,30,10,0,0,10,0,30,2,11,0,13,0,30,4,9,0,13,8,30,5,0,0,5,1,-15,3,1
2,1,4,2,30,5,3,0,8,5,30,4,0,0,4,2,30,2,6,0,8,0,30,6,2,0,8,4,30,4,0,0,4,0,-27,3,0
2,4,4,2,30,5,3,0,8,5,30,4,0,0,4,2,30,2,6,0,8,0,30,6,2,0,8,4,30,4,0,0,4,0,-27,3,0
2,4,19,0,30,4,9,0,13,2,30,4,4,0,8,0,30,6,7,0,13,3,30,4,9,0,13,0,30,9,0,0,9,1,-15,3,1
2,4,25,1,30,10,4,0,14,0,30,6,0,0,6,0,30,12,2,0,14,1,30,5,9,0,14,3,30,5,1,0,6,1,-15,3,1
2,0,31,1,30,5,7,0,12,4,30,8,0,0,8,7,30,12,0,0,12,1,30,8,4,0,12,0,30,5,1,0,6,1,-15,3,1
2,3,31,1,30,5,7,0,12,4,30,8,0,0,8,7,30,12,0,0,12,1,30,8,4,0,12,0,30,5,1,0,6,1,-15,3,1
2,4,15,0,30,8,5,0,13,1,30,6,0,0,6,0,30,3,10,0,13,1,30,4,9,0,13,2,30,4,5,0,9,1,-15,3,1
2,3,17,2,30,10,4,0,14,3,30,6,0,0,6,0,30,3,11,0,14,3,30,6,8,0,14,1,30,4,0,0,4,1,-15,3,1
2,4,17,2,30,10,4,0,14,3,30,6,0,0,6,0,30,3,11,0,14,3,30,6,8,0,14,1,30,4,0,0,4,1,-15,3,1
2,0,19,5,30,4,9,0,13,4,30,3,5,0,8,0,30,4,9,0,13,7,30,6,7,0,13,2,30,8,1,0,9,1,-15,3,1
2,4,19,3,30,4,9,0,13,4,30,3,5,0,8,0,30,4,9,0,13,7,30,6,7,0,13,0,30,8,1,0,9,1,-15,3,1
2,1,23,1,30,6,7,0,13,3,30,6,0,0,6,0,30,6,7,0,13,0,30,6,7,0,13,3,30,6,0,0,6,1,-15,3,1
2,2,23,1,30,6,7,0,13,3,30,6,0,0,6,0,30,6,7,0,13,0,30,6,7,0,13,3,30,6,0,0,6,1,-15,3,1
2,2,25,1,30,11,3,0,14,4,30,6,0,0,6,0,30,6,8,0,14,1,30,5,9,0,14,2,30,4,2,0,6,1,-15,3,1
2,4,25,1,30,11,3,0,14,4,30,6,0,0,6,0,30,6,8,0,14,1,30,5,9,0,14,0,30,4,2,0,6,1,-15,3,1
2,1,27,1,30,4,11,0,15,3,30,2,0,0,2,0,30,9,6,0,15,2,30,5,10,0,15,1,30,5,1,0,6,1,-15,3,1
2,2,27,1,30,4,11,0,15,3,30,2,0,0,2,0,30,9,6,0,15,2,30,5,10,0,15,1,30,5,1,0,6,1,-15,3,1
2,4,27,1,30,4,11,0,15,3,30,2,0,0,2,0,30,9,6,0,15,2,30,5,10,0,15,1,30,5,1,0,6,1,-15,3,1
2,2,29,0,30,6,8,0,14,6,30,10,2,0,12,0,30,4,10,0,14,0,30,1,13,0,14,2,30,9,0,0,9,1,-15,3,1
2,3,29,0,30,6,8,0,14,6,30,10,2,0,12,0,30,4,10,0,14,0,30,1,13,0,14,2,30,9,0,0,9,1,-15,3,1
2,0,31,5,30,6,6,0,12,4,30,8,0,0,8,4,30,11,1,0,12,0,30,3,9,0,12,1,30,6,0,0,6,1,-15,3,1
2,1,31,5,30,6,6,0,12,4,30,8,0,0,8,4,30,11,1,0,12,0,30,3,9,0,12,1,30,6,0,0,6,1,-15,3,1
2,3,31,5,30,6,6,0,12,4,30,8,0,0,8,4,30,11,1,0,12,0,30,3,9,0,12,1,30,6,0,0,6,1,-15,3,1
2,4,31,5,30,6,6,0,12,4,30,8,0,0,8,4,30,11,1,0,12,0,30,3,9,0,12,1,30,6,0,0,6,1,-15,3,1
2,4,32,0,30,9,0,0,9,4,30,2,0,0,2,0,30,8,1,0,9,1,30,2,7,0,9,0,30,2,0,0,2,1,-15,3,1
2,0,4,2,30,7,1,0,8,4,30,4,0,0,4,0,30,3,5,0,8,0,30,5,3,0,8,2,30,4,0,0,4,0,-27,3,0
2,4,4,2,30,7,1,0,8,4,30,4,0,0,4,0,30,3,5,0,8,0,30,5,3,0,8,2,30,4,0,0,4,0,-27,3,0
2,3,8,1,30,7,0,0,7,3,30,2,0,0,2,1,30,4,3,0,7,0,30,4,3,0,7,1,30,3,0,0,3,0,-27,3,0
2,4,17,3,30,8,6,0,14,2,30,6,0,0,6,0,30,9,5,0,14,1,30,5,9,0,14,5,30,4,0,0,4,1,-15,3,1
2,3,19,0,30,3,10,0,13,1,30,8,0,0,8,0,30,7,6,0,13,0,30,5,8,0,13,1,30,7,2,0,9,1,-15,3,1
2,0,21,1,30,5,5,0,10,3,30,5,1,0,6,1,30,3,7,0,10,3,30,5,5,0,10,6,30,4,0,0,4,1,-15,3,1
2,3,23,1,30,7,6,0,13,0,30,6,0,0,6,4,30,12,1,0,13,2,30,6,7,0,13,3,30,6,0,0,6,1,-15,3,1
2,4,25,1,30,8,6,0,14,3,30,6,0,0,6,0,30,9,5,0,14,0,30,4,10,0,14,4,30,5,1,0,6,1,-15,3,1
2,2,27,1,30,4,11,0,15,4,30,2,0,0,2,0,30,4,11,0,15,4,30,6,9,0,15,5,30,6,0,0,6,1,-15,3,1
2,3,27,1,30,4,11,0,15,4,30,2,0,0,2,0,30,4,11,0,15,4,30,6,9,0,15,5,30,6,0,0,6,1,-15,3,1
2,4,27,1,30,4,11,0,15,4,30,2,0,0,2,0,30,4,11,0,15,4,30,6,9,0,15,5,30,6,0,0,6,1,-15,3,1
2,3,35,0,30,8,5,0,13,3,30,1,1,0,2,1,30,11,2,0,13,2,30,4,9,0,13,4,30,8,0,0,8,1,-15,3,1
2,4,5,0,30,2,3,0,5,3,30,4,0,0,4,0,30,1,4,0,5,0,30,1,4,0,5,0,30,0,2,0,2,0,-27,3,0
2,3,11,7,30,5,7,0,12,3,30,4,0,0,4,0,30,3,9,0,12,3,30,4,8,0,12,5,30,4,0,0,4,1,-15,3,1
2,1,13,2,30,7,0,0,7,0,30,4,0,0,4,3,30,6,1,0,7,10,30,5,2,0,7,2,30,4,0,0,4,1,-15,3,1
2,2,19,0,30,2,11,0,13,2,30,6,2,0,8,0,30,5,8,0,13,0,30,6,7,0,13,0,30,9,0,0,9,1,-15,3,1
2,3,19,0,30,2,11,0,13,2,30,6,2,0,8,0,30,5,8,0,13,0,30,6,7,0,13,0,30,9,0,0,9,1,-15,3,1
2,2,23,1,30,3,10,0,13,3,30,6,0,0,6,2,30,11,2,0,13,5,30,8,5,0,13,2,30,5,1,0,6,1,-15,3,1
2,4,23,1,30,3,10,0,13,3,30,6,0,0,6,0,30,11,2,0,13,5,30,8,5,0,13,2,30,5,1,0,6,1,-15,3,1
2,1,6,0,30,7,2,0,9,4,30,2,0,0,2,0,30,3,6,0,9,0,30,5,4,0,9,0,30,4,1,0,5,0,-27,3,0
2,3,6,0,30,7,2,0,9,4,30,2,0,0,2,0,30,3,6,0,9,0,30,5,4,0,9,0,30,4,1,0,5,0,-27,3,0
2,3,7,2,30,4,5,0,9,3,30,4,0,0,4,0,30,5,4,0,9,4,30,2,7,0,9,2,30,4,2,0,6,0,-27,3,0
2,3,8,2,30,7,0,0,7,4,30,2,0,0,2,2,30,5,2,0,7,0,30,6,1,0,7,2,30,3,0,0,3,0,-27,3,0
2,3,15,0,30,6,7,0,13,0,30,6,0,0,6,0,30,5,8,0,13,1,30,1,12,0,13,2,30,8,1,0,9,1,-15,3,1
2,4,15,0,30,6,7,0,13,0,30,6,0,0,6,0,30,5,8,0,13,1,30,1,12,0,13,2,30,8,1,0,9,1,-15,3,1
2,1,17,3,30,8,6,0,14,4,30,6,0,0,6,0,30,3,11,0,14,1,30,9,5,0,14,5,30,4,0,0,4,1,-15,3,1
2,4,17,3,30,8,6,0,14,4,30,6,0,0,6,0,30,3,11,0,14,1,30,9,5,0,14,5,30,4,0,0,4,1,-15,3,1
2,0,19,1,30,5,8,0,13,3,30,5,3,0,8,0,30,4,9,0,13,9,30,6,7,0,13,2,30,9,0,0,9,1,-15,3,1
2,1,29,0,30,6,8,0,14,6,30,12,0,0,12,0,30,2,12,0,14,0,30,1,13,0,14,5,30,9,0,0,9,1,-15,3,1
2,2,29,0,30,6,8,0,14,6,30,12,0,0,12,0,30,2,12,0,14,0,30,1,13,0,14,5,30,9,0,0,9,1,-15,3,1
2,3,29,0,30,6,8,0,14,6,30,12,0,0,12,0,30,2,12,0,14,0,30,1,13,0,14,5,30,9,0,0,9,1,-15,3,1
2,1,33,8,30,6,5,0,11,5,30,4,0,0,4,3,30,11,0,0,11,0,30,3,8,0,11,4,30,4,0,0,4,1,-15,3,1
2,2,33,8,30,6,5,0,11,5,30,4,0,0,4,3,30,11,0,0,11,0,30,3,8,0,11,4,30,4,0,0,4,1,-15,3,1
2,4,35,0,30,5,8,0,13,3,30,2,0,0,2,1,30,2,11,0,13,2,30,1,12,0,13,5,30,8,0,0,8,1,-15,3,1
2,2,38,0,30,9,1,0,10,5,30,6,0,0,6,0,30,8,2,0,10,0,30,2,8,0,10,4,30,6,0,0,6,1,-15,3,1
2,4,38,0,30,9,1,0,10,5,30,6,0,0,6,0,30,8,2,0,10,0,30,2,8,0,10,4,30,6,0,0,6,1,-15,3,1
2,1,5,0,30,3,2,0,5,3,30,2,2,0,4,2,30,1,4,0,5,0,30,1,4,0,5,0,30,0,2,0,2,0,-27,3,0
2,2,5,0,30,3,2,0,5,3,30,2,2,0,4,2,30,1,4,0,5,0,30,1,4,0,5,0,30,0,2,0,2,0,-27,3,0
2,4,5,0,30,3,2,0,5,3,30,2,2,0,4,2,30,1,4,0,5,0,30,1,4,0,5,0,30,0,2,0,2,0,-27,3,0
2,3,8,2,30,7,0,0,7,4,30,2,0,0,2,0,30,3,4,0,7,0,30,5,2,0,7,2,30,3,0,0,3,0,-27,3,0
2,1,13,2,30,6,1,0,7,0,30,4,0,0,4,1,30,5,2,0,7,8,30,6,1,0,7,6,30,4,0,0,4,1,-15,3,1
2,3,23,0,30,2,11,0,13,1,30,6,0,0,6,8,30,13,0,0,13,4,30,5,8,0,13,3,30,6,0,0,6,1,-15,3,1
2,0,27,1,30,3,12,0,15,4,30,1,1,0,2,0,30,5,10,0,15,0,30,3,12,0,15,3,30,6,0,0,6,1,-15,3,1
2,1,27,1,30,3,12,0,15,4,30,1,1,0,2,0,30,5,10,0,15,0,30,3,12,0,15,3,30,6,0,0,6,1,-15,3,1
2,2,27,1,30,3,12,0,15,4,30,1,1,0,2,0,30,5,10,0,15,0,30,3,12,0,15,3,30,6,0,0,6,1,-15,3,1
2,2,29,0,30,5,9,0,14,5,30,10,2,0,12,0,30,6,8,0,14,0,30,0,14,0,14,3,30,9,0,0,9,1,-15,3,1
2,4,31,3,30,6,6,0,12,5,30,8,0,0,8,3,30,7,5,0,12,0,30,3,9,0,12,0,30,5,1,0,6,1,-15,3,1
2,2,33,1,30,2,9,0,11,5,30,4,0,0,4,4,30,11,0,0,11,2,30,3,8,0,11,5,30,4,0,0,4,1,-15,3,1
2,3,43,0,30,5,9,0,14,9,30,6,0,0,6,0,30,4,10,0,14,1,30,6,8,0,14,4,30,5,0,0,5,1,-15,3,1
2,4,43,0,30,5,9,0,14,9,30,6,0,0,6,0,30,4,10,0,14,1,30,6,8,0,14,4,30,5,0,0,5,1,-15,3,1
2,2,4,3,30,6,2,0,8,4,30,4,0,0,4,0,30,5,3,0,8,0,30,5,3,0,8,1,30,4,0,0,4,0,-27,3,0
2,3,4,3,30,6,2,0,8,4,30,4,0,0,4,0,30,5,3,0,8,0,30,5,3,0,8,1,30,4,0,0,4,0,-27,3,0
2,2,5,0,30,4,1,0,5,3,30,3,1,0,4,1,30,0,5,0,5,0,30,1,4,0,5,0,30,0,2,0,2,0,-27,3,0
2,2,11,2,30,5,7,0,12,1,30,4,0,0,4,0,30,4,8,0,12,7,30,4,8,0,12,7,30,4,0,0,4,1,-15,3,1
2,3,13,0,30,6,1,0,7,0,30,4,0,0,4,1,30,6,1,0,7,5,30,5,2,0,7,5,30,4,0,0,4,1,-15,3,1
2,4,13,0,30,6,1,0,7,0,30,4,0,0,4,1,30,6,1,0,7,5,30,5,2,0,7,5,30,4,0,0,4,1,-15,3,1
2,3,15,0,30,4,9,0,13,1,30,6,0,0,6,0,30,5,8,0,13,1,30,9,4,0,13,1,30,5,4,0,9,1,-15,3,1
2,1,17,4,30,10,4,0,14,3,30,6,0,0,6,0,30,4,10,0,14,2,30,6,8,0,14,2,30,4,0,0,4,1,-15,3,1
2,4,17,4,30,10,4,0,14,3,30,6,0,0,6,0,30,4,10,0,14,2,30,6,8,0,14,2,30,4,0,0,4,1,-15,3,1
2,0,21,3,30,8,2,0,10,4,30,5,1,0,6,1,30,3,7,0,10,2,30,5,5,0,10,3,30,4,0,0,4,1,-15,3,1
2,4,23,1,30,7,6,0,13,0,30,6,0,0,6,7,30,13,0,0,13,0,30,5,8,0,13,3,30,6,0,0,6,1,-15,3,1
2,2,25,1,30,4,10,0,14,5,30,6,0,0,6,0,30,9,5,0,14,1,30,4,10,0,14,4,30,6,0,0,6,1,-15,3,1
2,4,25,1,30,4,10,0,14,5,30,6,0,0,6,0,30,9,5,0,14,1,30,4,10,0,14,4,30,6,0,0,6,1,-15,3,1
2,1,27,1,30,3,12,0,15,2,30,2,0,0,2,0,30,6,9,0,15,2,30,5,10,0,15,5,30,6,0,0,6,1,-15,3,1
2,2,27,1,30,3,12,0,15,2,30,2,0,0,2,0,30,6,9,0,15,2,30,5,10,0,15,5,30,6,0,0,6,1,-15,3,1
2,3,27,1,30,3,12,0,15,2,30,2,0,0,2,0,30,6,9,0,15,2,30,5,10,0,15,5,30,6,0,0,6,1,-15,3,1
2,4,27,1,30,3,12,0,15,2,30,2,0,0,2,0,30,6,9,0,15,2,30,5,10,0,15,5,30,6,0,0,6,1,-15,3,1
2,4,32,0,30,5,4,0,9,4,30,2,0,0,2,1,30,9,0,0,9,1,30,2,7,0,9,4,30,2,0,0,2,1,-15,3,1
2,2,17,5,30,11,3,0,14,4,30,6,0,0,6,0,30,4,10,0,14,1,30,6,8,0,14,3,30,4,0,0,4,1,-15,3,1
2,3,17,5,30,11,3,0,14,4,30,6,0,0,6,0,30,4,10,0,14,1,30,6,8,0,14,3,30,4,0,0,4,1,-15,3,1
2,2,19,0,30,6,7,0,13,2,30,6,2,0,8,0,30,4,9,0,13,3,30,5,8,0,13,0,30,8,1,0,9,1,-15,3,1
2,4,19,0,30,6,7,0,13,2,30,6,2,0,8,0,30,4,9,0,13,3,30,5,8,0,13,0,30,8,1,0,9,1,-15,3,1
2,3,23,0,30,5,8,0,13,3,30,6,0,0,6,2,30,12,1,0,13,0,30,6,7,0,13,3,30,5,1,0,6,1,-15,3,1
2,3,25,2,30,12,2,0,14,3,30,6,0,0,6,0,30,6,8,0,14,1,30,5,9,0,14,7,30,5,1,0,6,1,-15,3,1
2,4,27,1,30,4,11,0,15,4,30,2,0,0,2,0,30,6,9,0,15,1,30,4,11,0,15,0,30,6,0,0,6,1,-15,3,1
2,4,29,0,30,8,6,0,14,6,30,12,0,0,12,0,30,5,9,0,14,0,30,2,12,0,14,0,30,8,1,0,9,1,-15,3,1
2,2,31,3,30,8,4,0,12,3,30,8,0,0,8,3,30,9,3,0,12,0,30,3,9,0,12,1,30,2,4,0,6,1,-15,3,1
2,4,31,3,30,8,4,0,12,3,30,8,0,0,8,3,30,9,3,0,12,0,30,3,9,0,12,1,30,2,4,0,6,1,-15,3,1
2,3,8,2,30,7,0,0,7,4,30,2,0,0,2,1,30,4,3,0,7,0,30,5,2,0,7,1,30,3,0,0,3,0,-27,3,0
2,1,13,2,30,6,1,0,7,0,30,4,0,0,4,1,30,6,1,0,7,11,30,6,1,0,7,4,30,4,0,0,4,1,-15,3,1
2,2,13,2,30,6,1,0,7,0,30,4,0,0,4,1,30,6,1,0,7,11,30,6,1,0,7,4,30,4,0,0,4,1,-15,3,1
2,2,17,4,30,10,4,0,14,3,30,6,0,0,6,0,30,5,9,0,14,1,30,5,9,0,14,1,30,3,1,0,4,1,-15,3,1
2,4,17,4,30,10,4,0,14,3,30,6,0,0,6,0,30,5,9,0,14,1,30,5,9,0,14,1,30,3,1,0,4,1,-15,3,1
2,3,19,0,30,3,10,0,13,2,30,8,0,0,8,4,30,4,9,0,13,0,30,3,10,0,13,1,30,6,3,0,9,1,-15,3,1
2,4,19,0,30,3,10,0,13,2,30,8,0,0,8,4,30,4,9,0,13,0,30,3,10,0,13,1,30,6,3,0,9,1,-15,3,1
2,2,25,1,30,3,11,0,14,5,30,6,0,0,6,0,30,8,6,0,14,1,30,6,8,0,14,5,30,6,0,0,6,1,-15,3,1
2,3,25,1,30,3,11,0,14,5,30,6,0,0,6,0,30,8,6,0,14,1,30,6,8,0,14,5,30,6,0,0,6,1,-15,3,1
2,1,27,2,30,4,11,0,15,2,30,1,1,0,2,0,30,3,12,0,15,2,30,3,12,0,15,2,30,6,0,0,6,1,-15,3,1
2,4,27,2,30,4,11,0,15,2,30,1,1,0,2,0,30,3,12,0,15,2,30,3,12,0,15,2,30,6,0,0,6,1,-15,3,1
2,4,29,0,30,6,8,0,14,6,30,12,0,0,12,0,30,3,11,0,14,0,30,2,12,0,14,1,30,9,0,0,9,1,-15,3,1
2,1,35,0,30,6,7,0,13,2,30,2,0,0,2,1,30,13,0,0,13,2,30,1,12,0,13,4,30,8,0,0,8,1,-15,3,1
2,3,35,0,30,6,7,0,13,2,30,2,0,0,2,1,30,13,0,0,13,2,30,1,12,0,13,4,30,8,0,0,8,1,-15,3,1
2,4,35,0,30,6,7,0,13,2,30,2,0,0,2,1,30,13,0,0,13,2,30,1,12,0,13,4,30,8,0,0,8,1,-15,3,1
2,4,4,2,30,6,2,0,8,4,30,4,0,0,4,0,30,2,6,0,8,0,30,0,8,0,8,3,30,4,0,0,4,0,-27,3,0
2,1,5,0,30,5,0,0,5,3,30,2,2,0,4,1,30,1,4,0,5,0,30,1,4,0,5,0,30,2,0,0,2,0,-27,3,0
2,3,5,0,30,5,0,0,5,3,30,2,2,0,4,1,30,1,4,0,5,0,30,1,4,0,5,0,30,2,0,0,2,0,-27,3,0
2,4,7,2,30,4,5,0,9,3,30,4,0,0,4,2,30,6,3,0,9,4,30,2,7,0,9,2,30,5,1,0,6,0,-27,3,0
2,2,11,0,30,4,8,0,12,0,30,4,0,0,4,0,30,6,6,0,12,4,30,4,8,0,12,4,30,4,0,0,4,1,-15,3,1
2,3,11,0,30,4,8,0,12,0,30,4,0,0,4,0,30,6,6,0,12,4,30,4,8,0,12,4,30,4,0,0,4,1,-15,3,1
2,4,11,0,30,4,8,0,12,0,30,4,0,0,4,0,30,6,6,0,12,4,30,4,8,0,12,4,30,4,0,0,4,1,-15,3,1
2,4,13,3,30,7,0,0,7,0,30,4,0,0,4,2,30,6,1,0,7,8,30,5,2,0,7,4,30,4,0,0,4,1,-15,3,1
2,2,17,3,30,10,4,0,14,3,30,6,0,0,6,0,30,4,10,0,14,1,30,4,10,0,14,3,30,4,0,0,4,1,-15,3,1
2,1,19,0,30,2,11,0,13,2,30,5,3,0,8,0,30,4,9,0,13,4,30,8,5,0,13,1,30,8,1,0,9,1,-15,3,1
2,2,19,0,30,2,11,0,13,2,30,5,3,0,8,0,30,4,9,0,13,4,30,8,5,0,13,1,30,8,1,0,9,1,-15,3,1
2,3,23,3,30,5,8,0,13,3,30,6,0,0,6,6,30,13,0,0,13,0,30,7,6,0,13,1,30,6,0,0,6,1,-15,3,1
2,2,25,2,30,6,8,0,14,4,30,6,0,0,6,0,30,6,8,0,14,1,30,7,7,0,14,4,30,5,1,0,6,1,-15,3,1
2,4,25,2,30,6,8,0,14,4,30,6,0,0,6,0,30,6,8,0,14,1,30,7,7,0,14,4,30,5,1,0,6,1,-15,3,1
2,0,27,1,30,5,10,0,15,3,30,2,0,0,2,0,30,3,12,0,15,4,30,6,9,0,15,4,30,6,0,0,6,1,-15,3,1
2,1,27,1,30,5,10,0,15,3,30,2,0,0,2,0,30,3,12,0,15,4,30,6,9,0,15,4,30,6,0,0,6,1,-15,3,1
2,2,27,1,30,5,10,0,15,3,30,2,0,0,2,0,30,3,12,0,15,4,30,6,9,0,15,4,30,6,0,0,6,1,-15,3,1
2,3,31,2,30,10,2,0,12,3,30,8,0,0,8,3,30,10,2,0,12,0,30,3,9,0,12,0,30,2,4,0,6,1,-15,3,1
2,4,31,2,30,10,2,0,12,3,30,8,0,0,8,3,30,10,2,0,12,0,30,3,9,0,12,0,30,2,4,0,6,1,-15,3,1
2,2,11,5,30,3,9,0,12,0,30,4,0,0,4,0,30,9,3,0,12,7,30,2,10,0,12,5,30,4,0,0,4,1,-15,3,1
2,4,11,5,30,3,9,0,12,0,30,4,0,0,4,0,30,9,3,0,12,7,30,2,10,0,12,5,30,4,0,0,4,1,-15,3,1
2,4,19,0,30,3,10,0,13,2,30,6,2,0,8,0,30,7,6,0,13,4,30,5,8,0,13,3,30,9,0,0,9,1,-15,3,1
2,1,21,3,30,8,2,0,10,4,30,6,0,0,6,0,30,3,7,0,10,4,30,5,5,0,10,2,30,4,0,0,4,1,-15,3,1
2,0,27,1,30,8,7,0,15,3,30,2,0,0,2,0,30,8,7,0,15,0,30,4,11,0,15,2,30,3,3,0,6,1,-15,3,1
2,1,27,1,30,8,7,0,15,3,30,2,0,0,2,0,30,8,7,0,15,0,30,4,11,0,15,2,30,3,3,0,6,1,-15,3,1
2,3,35,0,30,11,2,0,13,4,30,2,0,0,2,1,30,6,7,0,13,0,30,1,12,0,13,4,30,8,0,0,8,1,-15,3,1
2,3,43,0,30,5,9,0,14,10,30,6,0,0,6,0,30,4,10,0,14,1,30,9,5,0,14,3,30,5,0,0,5,1,-15,3,1
2,1,4,2,30,7,1,0,8,5,30,4,0,0,4,3,30,1,7,0,8,4,30,8,0,0,8,1,30,3,1,0,4,0,-27,3,0
2,2,4,2,30,7,1,0,8,5,30,4,0,0,4,3,30,1,7,0,8,4,30,8,0,0,8,1,30,3,1,0,4,0,-27,3,0
2,4,4,2,30,7,1,0,8,5,30,4,0,0,4,3,30,1,7,0,8,4,30,8,0,0,8,0,30,3,1,0,4,0,-27,3,0
2,3,8,4,30,7,0,0,7,4,30,2,0,0,2,3,30,4,3,0,7,0,30,6,1,0,7,1,30,3,0,0,3,0,-27,3,0
2,3,19,0,30,5,8,0,13,1,30,7,1,0,8,0,30,7,6,0,13,0,30,3,10,0,13,0,30,7,2,0,9,1,-15,3,1
2,4,19,0,30,5,8,0,13,1,30,7,1,0,8,0,30,7,6,0,13,0,30,3,10,0,13,0,30,7,2,0,9,1,-15,3,1
2,0,27,1,30,3,12,0,15,5,30,2,0,0,2,0,30,2,13,0,15,3,30,4,11,0,15,6,30,6,0,0,6,1,-15,3,1
2,2,27,1,30,3,12,0,15,5,30,2,0,0,2,0,30,2,13,0,15,3,30,4,11,0,15,6,30,6,0,0,6,1,-15,3,1
2,4,27,1,30,3,12,0,15,5,30,2,0,0,2,0,30,2,13,0,15,3,30,4,11,0,15,6,30,6,0,0,6,1,-15,3,1
2,4,29,4,30,8,6,0,14,6,30,7,5,0,12,0,30,3,11,0,14,0,30,1,13,0,14,1,30,9,0,0,9,1,-15,3,1
2,2,5,4,30,2,3,0,5,3,30,2,2,0,4,0,30,0,5,0,5,0,30,1,4,0,5,0,30,1,1,0,2,0,-27,3,0
2,3,5,4,30,2,3,0,5,3,30,2,2,0,4,0,30,0,5,0,5,0,30,1,4,0,5,0,30,1,1,0,2,0,-27,3,0
2,3,8,1,30,7,0,0,7,4,30,2,0,0,2,3,30,3,4,0,7,1,30,7,0,0,7,1,30,3,0,0,3,0,-27,3,0
2,2,17,2,30,9,5,0,14,3,30,6,0,0,6,0,30,5,9,0,14,3,30,9,5,0,14,2,30,4,0,0,4,1,-15,3,1
2,3,17,2,30,9,5,0,14,3,30,6,0,0,6,0,30,5,9,0,14,3,30,9,5,0,14,2,30,4,0,0,4,1,-15,3,1
2,2,19,0,30,5,8,0,13,2,30,8,0,0,8,0,30,6,7,0,13,3,30,2,11,0,13,2,30,8,1,0,9,1,-15,3,1
2,3,19,0,30,5,8,0,13,2,30,8,0,0,8,0,30,6,7,0,13,3,30,2,11,0,13,2,30,8,1,0,9,1,-15,3,1
2,3,23,1,30,5,8,0,13,2,30,6,0,0,6,9,30,10,3,0,13,3,30,6,7,0,13,2,30,6,0,0,6,1,-15,3,1
2,4,23,1,30,5,8,0,13,2,30,6,0,0,6,9,30,10,3,0,13,3,30,6,7,0,13,2,30,6,0,0,6,1,-15,3,1
2,3,25,1,30,11,3,0,14,4,30,6,0,0,6,0,30,6,8,0,14,1,30,5,9,0,14,4,30,5,1,0,6,1,-15,3,1
2,2,31,2,30,9,3,0,12,4,30,8,0,0,8,3,30,8,4,0,12,0,30,4,8,0,12,0,30,3,3,0,6,1,-15,3,1
2,4,31,2,30,9,3,0,12,4,30,8,0,0,8,3,30,8,4,0,12,0,30,4,8,0,12,0,30,3,3,0,6,1,-15,3,1
2,3,33,1,30,2,9,0,11,6,30,4,0,0,4,5,30,8,3,0,11,0,30,3,8,0,11,4,30,4,0,0,4,1,-15,3,1
2,3,39,0,30,4,7,0,11,6,30,6,0,0,6,0,30,4,7,0,11,0,30,2,9,0,11,6,30,5,0,0,5,1,-15,3,1
2,4,43,7,30,5,9,0,14,8,30,6,0,0,6,0,30,4,10,0,14,1,30,1,13,0,14,1,30,5,0,0,5,1,-15,3,1
2,4,4,0,30,7,1,0,8,5,30,4,0,0,4,0,30,1,7,0,8,0,30,7,1,0,8,2,30,3,1,0,4,0,-27,3,0
2,3,13,0,30,6,1,0,7,1,30,4,0,0,4,0,30,5,2,0,7,4,30,7,0,0,7,4,30,4,0,0,4,1,-15,3,1
2,4,13,0,30,6,1,0,7,1,30,4,0,0,4,0,30,5,2,0,7,4,30,7,0,0,7,4,30,4,0,0,4,1,-15,3,1
2,1,19,0,30,2,11,0,13,2,30,5,3,0,8,0,30,4,9,0,13,8,30,8,5,0,13,3,30,9,0,0,9,1,-15,3,1
2,2,19,0,30,2,11,0,13,2,30,5,3,0,8,0,30,4,9,0,13,8,30,8,5,0,13,3,30,9,0,0,9,1,-15,3,1
2,4,19,0,30,2,11,0,13,2,30,5,3,0,8,0,30,4,9,0,13,8,30,8,5,0,13,3,30,9,0,0,9,1,-15,3,1
2,3,22,2,30,8,0,0,8,3,30,2,0,0,2,1,30,4,4,0,8,0,30,4,4,0,8,1,30,4,0,0,4,1,-15,3,1
2,4,22,2,30,8,0,0,8,3,30,2,0,0,2,1,30,4,4,0,8,0,30,4,4,0,8,1,30,4,0,0,4,1,-15,3,1
2,2,25,2,30,8,6,0,14,4,30,6,0,0,6,0,30,8,6,0,14,1,30,7,7,0,14,4,30,5,1,0,6,1,-15,3,1
2,4,25,2,30,8,6,0,14,4,30,6,0,0,6,0,30,8,6,0,14,1,30,7,7,0,14,4,30,5,1,0,6,1,-15,3,1
2,0,27,1,30,6,9,0,15,3,30,2,0,0,2,0,30,6,9,0,15,1,30,10,5,0,15,1,30,2,4,0,6,1,-15,3,1
2,1,27,1,30,6,9,0,15,3,30,2,0,0,2,0,30,6,9,0,15,1,30,10,5,0,15,1,30,2,4,0,6,1,-15,3,1
2,2,27,1,30,6,9,0,15,3,30,2,0,0,2,0,30,6,9,0,15,1,30,10,5,0,15,1,30,2,4,0,6,1,-15,3,1
2,3,29,0,30,11,3,0,14,4,30,10,2,0,12,0,30,4,10,0,14,0,30,1,13,0,14,1,30,9,0,0,9,1,-15,3,1
2,4,29,0,30,11,3,0,14,4,30,10,2,0,12,0,30,4,10,0,14,0,30,1,13,0,14,1,30,9,0,0,9,1,-15,3,1
2,0,37,1,30,8,3,0,11,6,30,8,0,0,8,0,30,5,6,0,11,4,30,4,7,0,11,8,30,6,0,0,6,1,-15,3,1
2,1,37,1,30,8,3,0,11,6,30,8,0,0,8,0,30,5,6,0,11,4,30,4,7,0,11,8,30,6,0,0,6,1,-15,3,1
2,2,37,1,30,8,3,0,11,6,30,8,0,0,8,0,30,5,6,0,11,4,30,4,7,0,11,8,30,6,0,0,6,1,-15,3,1
2,3,37,1,30,8,3,0,11,6,30,8,0,0,8,0,30,5,6,0,11,4,30,4,7,0,11,8,30,6,0,0,6,1,-15,3,1
2,1,6,1,30,9,0,0,9,4,30,2,0,0,2,0,30,2,7,0,9,0,30,4,5,0,9,3,30,3,2,0,5,0,-27,3,0
2,3,6,1,30,9,0,0,9,4,30,2,0,0,2,0,30,2,7,0,9,0,30,4,5,0,9,3,30,3,2,0,5,0,-27,3,0
2,0,14,0,30,4,5,0,9,2,30,6,0,0,6,0,30,5,4,0,9,9,30,9,0,0,9,4,30,4,0,0,4,1,-15,3,1
2,2,14,0,30,4,5,0,9,2,30,6,0,0,6,0,30,5,4,0,9,9,30,9,0,0,9,4,30,4,0,0,4,1,-15,3,1
2,4,14,0,30,4,5,0,9,2,30,6,0,0,6,0,30,5,4,0,9,9,30,9,0,0,9,4,30,4,0,0,4,1,-15,3,1
2,3,17,5,30,10,4,0,14,4,30,6,0,0,6,0,30,5,9,0,14,1,30,6,8,0,14,0,30,4,0,0,4,1,-15,3,1
2,4,17,5,30,10,4,0,14,4,30,6,0,0,6,0,30,5,9,0,14,1,30,6,8,0,14,0,30,4,0,0,4,1,-15,3,1
2,3,23,1,30,7,6,0,13,3,30,6,0,0,6,5,30,12,1,0,13,0,30,6,7,0,13,1,30,6,0,0,6,1,-15,3,1
2,3,29,0,30,3,11,0,14,6,30,12,0,0,12,0,30,6,8,0,14,0,30,0,14,0,14,2,30,9,0,0,9,1,-15,3,1
2,4,29,0,30,3,11,0,14,6,30,12,0,0,12,0,30,6,8,0,14,0,30,0,14,0,14,2,30,9,0,0,9,1,-15,3,1
2,0,43,0,30,7,7,0,14,10,30,6,0,0,6,0,30,4,10,0,14,1,30,8,6,0,14,4,30,5,0,0,5,1,-15,3,1
2,1,13,2,30,7,0,0,7,0,30,4,0,0,4,2,30,6,1,0,7,12,30,6,1,0,7,3,30,4,0,0,4,1,-15,3,1
2,2,13,2,30,7,0,0,7,0,30,4,0,0,4,2,30,6,1,0,7,12,30,6,1,0,7,3,30,4,0,0,4,1,-15,3,1
2,1,17,3,30,9,5,0,14,2,30,6,0,0,6,0,30,8,6,0,14,1,30,6,8,0,14,3,30,4,0,0,4,1,-15,3,1
2,4,19,0,30,5,8,0,13,2,30,8,0,0,8,0,30,4,9,0,13,7,30,4,9,0,13,0,30,8,1,0,9,1,-15,3,1
2,4,23,1,30,6,7,0,13,3,30,6,0,0,6,10,30,13,0,0,13,0,30,6,7,0,13,1,30,6,0,0,6,1,-15,3,1
2,0,25,1,30,8,6,0,14,4,30,6,0,0,6,0,30,9,5,0,14,1,30,7,7,0,14,4,30,6,0,0,6,1,-15,3,1
2,4,25,1,30,8,6,0,14,3,30,6,0,0,6,0,30,9,5,0,14,1,30,7,7,0,14,4,30,6,0,0,6,1,-15,3,1
2,0,27,1,30,4,11,0,15,2,30,2,0,0,2,0,30,3,12,0,15,5,30,5,10,0,15,6,30,5,1,0,6,1,-15,3,1
2,1,27,1,30,4,11,0,15,2,30,2,0,0,2,0,30,3,12,0,15,5,30,5,10,0,15,6,30,5,1,0,6,1,-15,3,1
2,2,27,1,30,4,11,0,15,2,30,2,0,0,2,0,30,3,12,0,15,5,30,5,10,0,15,6,30,5,1,0,6,1,-15,3,1
2,4,31,3,30,7,5,0,12,4,30,8,0,0,8,5,30,10,2,0,12,0,30,3,9,0,12,0,30,2,4,0,6,1,-15,3,1
2,1,4,2,30,8,0,0,8,5,30,4,0,0,4,0,30,1,7,0,8,2,30,5,3,0,8,4,30,3,1,0,4,0,-27,3,0
2,2,4,2,30,8,0,0,8,5,30,4,0,0,4,0,30,1,7,0,8,2,30,5,3,0,8,4,30,3,1,0,4,0,-27,3,0
2,3,4,2,30,8,0,0,8,5,30,4,0,0,4,0,30,1,7,0,8,2,30,5,3,0,8,4,30,3,1,0,4,0,-27,3,0
2,4,4,2,30,8,0,0,8,5,30,4,0,0,4,0,30,1,7,0,8,2,30,5,3,0,8,4,30,3,1,0,4,0,-27,3,0
2,4,6,1,30,8,1,0,9,4,30,2,0,0,2,0,30,3,6,0,9,0,30,4,5,0,9,0,30,2,3,0,5,0,-27,3,0
2,4,11,1,30,3,9,0,12,0,30,4,0,0,4,0,30,8,4,0,12,7,30,3,9,0,12,4,30,3,1,0,4,1,-15,3,1
2,3,13,0,30,7,0,0,7,1,30,4,0,0,4,2,30,6,1,0,7,3,30,5,2,0,7,4,30,4,0,0,4,1,-15,3,1
2,4,17,4,30,10,4,0,14,3,30,6,0,0,6,0,30,6,8,0,14,0,30,5,9,0,14,2,30,4,0,0,4,1,-15,3,1
2,2,23,2,30,7,6,0,13,3,30,6,0,0,6,4,30,12,1,0,13,0,30,6,7,0,13,1,30,6,0,0,6,1,-15,3,1
2,0,25,1,30,6,8,0,14,3,30,6,0,0,6,0,30,7,7,0,14,1,30,7,7,0,14,7,30,6,0,0,6,1,-15,3,1
2,3,31,3,30,6,6,0,12,4,30,8,0,0,8,3,30,11,1,0,12,0,30,3,9,0,12,0,30,4,2,0,6,1,-15,3,1
2,1,33,1,30,2,9,0,11,5,30,4,0,0,4,2,30,10,1,0,11,2,30,5,6,0,11,8,30,4,0,0,4,1,-15,3,1
2,2,33,1,30,2,9,0,11,5,30,4,0,0,4,2,30,10,1,0,11,2,30,5,6,0,11,8,30,4,0,0,4,1,-15,3,1
2,2,39,0,30,4,7,0,11,5,30,6,0,0,6,0,30,7,4,0,11,0,30,4,7,0,11,5,30,5,0,0,5,1,-15,3,1
2,2,6,2,30,9,0,0,9,4,30,2,0,0,2,0,30,2,7,0,9,0,30,4,5,0,9,2,30,4,1,0,5,0,-27,3,0
2,4,6,2,30,9,0,0,9,4,30,2,0,0,2,0,30,2,7,0,9,0,30,4,5,0,9,2,30,4,1,0,5,0,-27,3,0
2,3,13,7,30,7,0,0,7,4,30,4,0,0,4,6,30,5,2,0,7,0,30,5,2,0,7,2,30,4,0,0,4,1,-15,3,1
2,4,13,7,30,7,0,0,7,4,30,4,0,0,4,6,30,5,2,0,7,0,30,5,2,0,7,2,30,4,0,0,4,1,-15,3,1
2,3,23,1,30,6,7,0,13,4,30,6,0,0,6,7,30,11,2,0,13,0,30,4,9,0,13,5,30,6,0,0,6,1,-15,3,1
2,3,25,1,30,5,9,0,14,5,30,6,0,0,6,0,30,7,7,0,14,1,30,7,7,0,14,5,30,6,0,0,6,1,-15,3,1
2,4,25,1,30,5,9,0,14,5,30,6,0,0,6,0,30,7,7,0,14,1,30,7,7,0,14,5,30,6,0,0,6,1,-15,3,1
2,0,27,1,30,5,10,0,15,5,30,1,1,0,2,0,30,2,13,0,15,2,30,6,9,0,15,4,30,6,0,0,6,1,-15,3,1
2,1,27,1,30,5,10,0,15,5,30,1,1,0,2,0,30,2,13,0,15,2,30,6,9,0,15,4,30,6,0,0,6,1,-15,3,1
2,0,31,5,30,5,7,0,12,5,30,8,0,0,8,6,30,10,2,0,12,0,30,3,9,0,12,1,30,2,4,0,6,1,-15,3,1
2,2,31,5,30,5,7,0,12,5,30,8,0,0,8,6,30,10,2,0,12,0,30,3,9,0,12,1,30,2,4,0,6,1,-15,3,1
2,4,8,2,30,7,0,0,7,4,30,2,0,0,2,0,30,4,3,0,7,0,30,4,3,0,7,2,30,3,0,0,3,0,-27,3,0
2,0,13,1,30,7,0,0,7,1,30,4,0,0,4,5,30,6,1,0,7,8,30,7,0,0,7,5,30,4,0,0,4,1,-15,3,1
2,2,13,0,30,7,0,0,7,1,30,4,0,0,4,5,30,6,1,0,7,8,30,7,0,0,7,5,30,4,0,0,4,1,-15,3,1
2,4,13,0,30,7,0,0,7,1,30,4,0,0,4,5,30,6,1,0,7,8,30,7,0,0,7,5,30,4,0,0,4,1,-15,3,1
2,2,17,4,30,10,4,0,14,3,30,6,0,0,6,0,30,4,10,0,14,0,30,6,8,0,14,2,30,4,0,0,4,1,-15,3,1
2,1,19,3,30,4,9,0,13,2,30,7,1,0,8,0,30,6,7,0,13,0,30,6,7,0,13,1,30,9,0,0,9,1,-15,3,1
2,2,19,3,30,4,9,0,13,2,30,7,1,0,8,0,30,6,7,0,13,0,30,6,7,0,13,1,30,9,0,0,9,1,-15,3,1
2,4,19,3,30,4,9,0,13,2,30,7,1,0,8,0,30,6,7,0,13,0,30,6,7,0,13,1,30,9,0,0,9,1,-15,3,1
2,0,27,2,30,6,9,0,15,3,30,2,0,0,2,0,30,2,13,0,15,7,30,6,9,0,15,3,30,6,0,0,6,1,-15,3,1
2,3,3,0,30,1,3,0,4,2,30,4,0,0,4,1,30,2,2,0,4,3,30,0,4,0,4,0,30,2,1,0,3,0,-27,3,0
2,2,17,4,30,9,5,0,14,2,30,6,0,0,6,0,30,6,8,0,14,1,30,5,9,0,14,2,30,3,1,0,4,1,-15,3,1
2,4,17,4,30,9,5,0,14,2,30,6,0,0,6,0,30,6,8,0,14,1,30,5,9,0,14,2,30,3,1,0,4,1,-15,3,1
2,3,23,2,30,6,7,0,13,2,30,6,0,0,6,2,30,10,3,0,13,0,30,6,7,0,13,1,30,6,0,0,6,1,-15,3,1
2,4,23,2,30,6,7,0,13,2,30,6,0,0,6,2,30,10,3,0,13,0,30,6,7,0,13,1,30,6,0,0,6,1,-15,3,1
2,3,31,1,30,6,6,0,12,4,30,8,0,0,8,8,30,10,2,0,12,0,30,3,9,0,12,0,30,4,2,0,6,1,-15,3,1
2,0,37,4,30,7,4,0,11,10,30,8,0,0,8,0,30,2,9,0,11,1,30,5,6,0,11,5,30,6,0,0,6,1,-15,3,1
2,4,39,0,30,5,6,0,11,5,30,6,0,0,6,0,30,8,3,0,11,0,30,2,9,0,11,0,30,3,2,0,5,1,-15,3,1
2,4,3,0,30,1,3,0,4,2,30,4,0,0,4,0,30,0,4,0,4,3,30,0,4,0,4,2,30,3,0,0,3,0,-27,3,0
2,1,13,1,30,3,0,0,3,0,30,2,0,0,2,3,30,3,0,0,3,8,30,2,1,0,3,5,30,2,0,0,2,1,-15,3,1
2,4,13,1,30,3,0,0,3,0,30,2,0,0,2,0,30,3,0,0,3,8,30,2,1,0,3,5,30,2,0,0,2,1,-15,3,1
2,2,13,1,30,7,0,0,7,0,30,4,0,0,4,2,30,6,1,0,7,8,30,6,1,0,7,8,30,4,0,0,4,1,-15,3,1
2,3,17,3,30,7,7,0,14,2,30,6,0,0,6,0,30,7,7,0,14,1,30,6,8,0,14,0,30,2,2,0,4,1,-15,3,1
2,4,17,3,30,7,7,0,14,2,30,6,0,0,6,0,30,7,7,0,14,1,30,6,8,0,14,0,30,2,2,0,4,1,-15,3,1
2,4,21,2,30,8,2,0,10,3,30,6,0,0,6,1,30,4,6,0,10,3,30,4,6,0,10,1,30,3,1,0,4,1,-15,3,1
2,4,23,0,30,4,9,0,13,2,30,6,0,0,6,6,30,12,1,0,13,0,30,6,7,0,13,2,30,5,1,0,6,1,-15,3,1
2,1,25,1,30,3,11,0,14,4,30,6,0,0,6,0,30,5,9,0,14,1,30,9,5,0,14,6,30,5,1,0,6,1,-15,3,1
2,2,25,1,30,3,11,0,14,4,30,6,0,0,6,0,30,5,9,0,14,1,30,9,5,0,14,6,30,5,1,0,6,1,-15,3,1
2,3,25,1,30,3,11,0,14,4,30,6,0,0,6,0,30,5,9,0,14,1,30,9,5,0,14,6,30,5,1,0,6,1,-15,3,1
2,4,25,1,30,3,11,0,14,4,30,6,0,0,6,0,30,5,9,0,14,1,30,9,5,0,14,6,30,5,1,0,6,1,-15,3,1
2,3,29,0,30,7,7,0,14,6,30,12,0,0,12,0,30,3,11,0,14,0,30,0,14,0,14,1,30,9,0,0,9,1,-15,3,1
2,4,29,0,30,7,7,0,14,6,30,12,0,0,12,0,30,3,11,0,14,0,30,0,14,0,14,1,30,9,0,0,9,1,-15,3,1
2,1,9,0,30,2,2,0,4,2,30,2,0,0,2,0,30,2,2,0,4,0,30,1,3,0,4,0,30,1,0,0,1,0,-27,3,0
2,1,17,8,30,9,5,0,14,3,30,6,0,0,6,0,30,6,8,0,14,2,30,7,7,0,14,5,30,4,0,0,4,1,-15,3,1
2,2,17,8,30,9,5,0,14,3,30,6,0,0,6,0,30,6,8,0,14,2,30,7,7,0,14,5,30,4,0,0,4,1,-15,3,1
2,4,17,8,30,9,5,0,14,3,30,6,0,0,6,0,30,6,8,0,14,2,30,7,7,0,14,5,30,4,0,0,4,1,-15,3,1
2,4,19,0,30,7,6,0,13,1,30,6,2,0,8,0,30,4,9,0,13,0,30,3,10,0,13,2,30,8,1,0,9,1,-15,3,1
2,3,21,1,30,6,4,0,10,3,30,6,0,0,6,1,30,4,6,0,10,4,30,4,6,0,10,3,30,4,0,0,4,1,-15,3,1
2,2,23,4,30,3,10,0,13,3,30,6,0,0,6,4,30,13,0,0,13,0,30,7,6,0,13,1,30,5,1,0,6,1,-15,3,1
2,4,23,4,30,3,10,0,13,3,30,6,0,0,6,4,30,13,0,0,13,0,30,7,6,0,13,1,30,5,1,0,6,1,-15,3,1
2,1,25,1,30,7,7,0,14,5,30,6,0,0,6,0,30,3,11,0,14,1,30,5,9,0,14,6,30,6,0,0,6,1,-15,3,1
2,3,25,1,30,7,7,0,14,5,30,6,0,0,6,0,30,3,11,0,14,1,30,5,9,0,14,6,30,6,0,0,6,1,-15,3,1
2,3,27,1,30,4,11,0,15,4,30,2,0,0,2,0,30,6,9,0,15,4,30,4,11,0,15,6,30,6,0,0,6,1,-15,3,1
2,4,27,1,30,4,11,0,15,4,30,2,0,0,2,0,30,6,9,0,15,4,30,4,11,0,15,6,30,6,0,0,6,1,-15,3,1
2,4,29,0,30,6,8,0,14,5,30,7,5,0,12,0,30,9,5,0,14,0,30,3,11,0,14,1,30,9,0,0,9,1,-15,3,1
2,2,31,4,30,8,4,0,12,4,30,8,0,0,8,3,30,8,4,0,12,3,30,3,9,0,12,0,30,2,4,0,6,1,-15,3,1
2,3,31,4,30,8,4,0,12,4,30,8,0,0,8,3,30,8,4,0,12,3,30,3,9,0,12,0,30,2,4,0,6,1,-15,3,1
2,4,31,4,30,8,4,0,12,4,30,8,0,0,8,3,30,8,4,0,12,3,30,3,9,0,12,0,30,2,4,0,6,1,-15,3,1
2,0,5,0,30,0,5,0,5,3,30,1,3,0,4,0,30,0,5,0,5,0,30,1,4,0,5,0,30,1,1,0,2,0,-27,3,0
2,4,5,0,30,0,5,0,5,3,30,1,3,0,4,0,30,0,5,0,5,0,30,1,4,0,5,0,30,1,1,0,2,0,-27,3,0
2,1,17,5,30,10,4,0,14,2,30,6,0,0,6,0,30,7,7,0,14,1,30,6,8,0,14,2,30,4,0,0,4,1,-15,3,1
2,3,23,1,30,5,8,0,13,4,30,6,0,0,6,3,30,11,2,0,13,0,30,5,8,0,13,5,30,6,0,0,6,1,-15,3,1
2,1,25,2,30,9,5,0,14,3,30,6,0,0,6,0,30,6,8,0,14,1,30,9,5,0,14,3,30,6,0,0,6,1,-15,3,1
2,1,31,4,30,5,7,0,12,5,30,8,0,0,8,3,30,10,2,0,12,0,30,3,9,0,12,1,30,5,1,0,6,1,-15,3,1
2,3,32,3,30,7,2,0,9,5,30,2,0,0,2,0,30,7,2,0,9,1,30,3,6,0,9,4,30,2,0,0,2,1,-15,3,1
2,3,33,1,30,2,9,0,11,6,30,4,0,0,4,0,30,6,5,0,11,2,30,5,6,0,11,8,30,4,0,0,4,1,-15,3,1
2,0,39,0,30,5,6,0,11,6,30,6,0,0,6,0,30,4,7,0,11,0,30,2,9,0,11,5,30,5,0,0,5,1,-15,3,1
2,2,17,4,30,11,3,0,14,4,30,6,0,0,6,0,30,3,11,0,14,2,30,7,7,0,14,7,30,4,0,0,4,1,-15,3,1
2,4,19,0,30,8,5,0,13,0,30,5,3,0,8,0,30,4,9,0,13,0,30,3,10,0,13,0,30,6,3,0,9,1,-15,3,1
2,4,22,2,30,8,0,0,8,3,30,2,0,0,2,4,30,5,3,0,8,0,30,5,3,0,8,1,30,2,2,0,4,1,-15,3,1
2,3,25,1,30,8,6,0,14,3,30,6,0,0,6,0,30,8,6,0,14,1,30,5,9,0,14,5,30,6,0,0,6,1,-15,3,1
2,1,27,1,30,4,11,0,15,3,30,2,0,0,2,0,30,7,8,0,15,0,30,4,11,0,15,0,30,2,4,0,6,1,-15,3,1
2,3,27,1,30,4,11,0,15,0,30,2,0,0,2,0,30,7,8,0,15,0,30,4,11,0,15,0,30,2,4,0,6,1,-15,3,1
2,4,27,1,30,4,11,0,15,0,30,2,0,0,2,0,30,7,8,0,15,0,30,4,11,0,15,0,30,2,4,0,6,1,-15,3,1
2,3,9,0,30,6,5,0,11,3,30,6,0,0,6,3,30,6,5,0,11,6,30,4,7,0,11,1,30,4,0,0,4,0,-27,3,0
2,1,13,3,30,7,0,0,7,0,30,4,0,0,4,2,30,5,2,0,7,5,30,4,3,0,7,5,30,4,0,0,4,1,-15,3,1
2,3,19,0,30,3,10,0,13,2,30,8,0,0,8,4,30,4,9,0,13,0,30,3,10,0,13,0,30,7,2,0,9,1,-15,3,1
2,4,23,2,30,8,5,0,13,0,30,6,0,0,6,3,30,12,1,0,13,0,30,6,7,0,13,3,30,6,0,0,6,1,-15,3,1
2,1,25,3,30,6,8,0,14,3,30,6,0,0,6,0,30,6,8,0,14,1,30,6,8,0,14,4,30,5,1,0,6,1,-15,3,1
2,2,25,3,30,6,8,0,14,3,30,6,0,0,6,0,30,6,8,0,14,1,30,6,8,0,14,4,30,5,1,0,6,1,-15,3,1
2,3,25,3,30,6,8,0,14,3,30,6,0,0,6,0,30,6,8,0,14,1,30,6,8,0,14,4,30,5,1,0,6,1,-15,3,1
2,1,26,0,30,6,3,0,9,6,30,4,0,0,4,5,30,0,9,0,9,0,30,2,7,0,9,7,30,3,0,0,3,1,-15,3,1
2,3,27,1,30,5,10,0,15,2,30,1,1,0,2,0,30,7,8,0,15,0,30,4,11,0,15,0,30,6,0,0,6,1,-15,3,1
2,0,29,0,30,5,9,0,14,6,30,9,3,0,12,0,30,7,7,0,14,0,30,0,14,0,14,4,30,9,0,0,9,1,-15,3,1
2,3,36,0,30,7,2,0,9,5,30,2,0,0,2,2,30,5,4,0,9,1,30,2,7,0,9,8,30,3,0,0,3,1,-15,3,1
2,2,39,0,30,3,8,0,11,6,30,6,0,0,6,0,30,8,3,0,11,0,30,3,8,0,11,6,30,5,0,0,5,1,-15,3,1
2,3,39,0,30,3,8,0,11,6,30,6,0,0,6,0,30,8,3,0,11,0,30,3,8,0,11,6,30,5,0,0,5,1,-15,3,1
2,0,4,1,30,6,2,0,8,4,30,2,2,0,4,0,30,2,6,0,8,2,30,7,1,0,8,4,30,4,0,0,4,0,-27,3,0
2,0,5,0,30,4,1,0,5,3,30,0,4,0,4,0,30,0,5,0,5,0,30,1,4,0,5,0,30,2,0,0,2,0,-27,3,0
2,1,5,0,30,4,1,0,5,3,30,0,4,0,4,0,30,0,5,0,5,0,30,1,4,0,5,0,30,2,0,0,2,0,-27,3,0
2,4,5,0,30,4,1,0,5,3,30,0,4,0,4,0,30,0,5,0,5,0,30,1,4,0,5,0,30,2,0,0,2,0,-27,3,0
2,2,13,1,30,4,3,0,7,0,30,4,0,0,4,3,30,7,0,0,7,5,30,6,1,0,7,3,30,4,0,0,4,1,-15,3,1
2,4,13,1,30,4,3,0,7,0,30,4,0,0,4,3,30,7,0,0,7,5,30,6,1,0,7,3,30,4,0,0,4,1,-15,3,1
2,3,15,0,30,4,9,0,13,0,30,6,0,0,6,0,30,5,8,0,13,1,30,6,7,0,13,3,30,8,1,0,9,1,-15,3,1
2,4,15,0,30,4,9,0,13,0,30,6,0,0,6,0,30,5,8,0,13,1,30,6,7,0,13,3,30,8,1,0,9,1,-15,3,1
2,1,17,6,30,9,5,0,14,4,30,6,0,0,6,0,30,3,11,0,14,2,30,3,11,0,14,3,30,4,0,0,4,1,-15,3,1
2,3,22,6,30,8,0,0,8,2,30,2,0,0,2,0,30,4,4,0,8,1,30,2,6,0,8,2,30,1,3,0,4,1,-15,3,1
2,4,23,1,30,12,1,0,13,3,30,6,0,0,6,4,30,10,3,0,13,0,30,6,7,0,13,2,30,6,0,0,6,1,-15,3,1
2,4,29,0,30,7,7,0,14,6,30,11,1,0,12,0,30,3,11,0,14,0,30,1,13,0,14,5,30,9,0,0,9,1,-15,3,1
2,3,8,2,30,7,0,0,7,4,30,2,0,0,2,0,30,4,3,0,7,0,30,5,2,0,7,1,30,3,0,0,3,0,-27,3,0
2,1,13,4,30,5,2,0,7,0,30,4,0,0,4,2,30,6,1,0,7,16,30,6,1,0,7,4,30,4,0,0,4,1,-15,3,1
2,4,19,1,30,5,8,0,13,1,30,5,3,0,8,0,30,9,4,0,13,0,30,4,9,0,13,1,30,7,2,0,9,1,-15,3,1
2,3,23,0,30,5,8,0,13,1,30,6,0,0,6,6,30,13,0,0,13,1,30,5,8,0,13,3,30,6,0,0,6,1,-15,3,1
2,2,25,1,30,5,9,0,14,3,30,6,0,0,6,0,30,5,9,0,14,1,30,9,5,0,14,6,30,6,0,0,6,1,-15,3,1
2,1,27,1,30,4,11,0,15,5,30,2,0,0,2,0,30,3,12,0,15,2,30,3,12,0,15,6,30,6,0,0,6,1,-15,3,1
2,3,27,1,30,4,11,0,15,4,30,2,0,0,2,0,30,3,12,0,15,2,30,3,12,0,15,6,30,6,0,0,6,1,-15,3,1
2,4,27,1,30,4,11,0,15,4,30,2,0,0,2,0,30,3,12,0,15,2,30,3,12,0,15,6,30,6,0,0,6,1,-15,3,1
2,3,29,0,30,5,9,0,14,6,30,12,0,0,12,0,30,3,11,0,14,0,30,2,12,0,14,1,30,9,0,0,9,1,-15,3,1
2,4,29,0,30,5,9,0,14,6,30,12,0,0,12,0,30,3,11,0,14,0,30,2,12,0,14,1,30,9,0,0,9,1,-15,3,1
2,2,33,1,30,2,9,0,11,5,30,4,0,0,4,1,30,9,2,0,11,3,30,4,7,0,11,5,30,4,0,0,4,1,-15,3,1
2,1,13,2,30,6,1,0,7,0,30,4,0,0,4,2,30,5,2,0,7,9,30,6,1,0,7,3,30,4,0,0,4,1,-15,3,1
2,2,13,2,30,6,1,0,7,0,30,4,0,0,4,2,30,5,2,0,7,9,30,6,1,0,7,3,30,4,0,0,4,1,-15,3,1
2,1,17,4,30,10,4,0,14,2,30,6,0,0,6,0,30,6,8,0,14,1,30,5,9,0,14,4,30,4,0,0,4,1,-15,3,1
2,2,17,4,30,10,4,0,14,2,30,6,0,0,6,0,30,6,8,0,14,1,30,5,9,0,14,4,30,4,0,0,4,1,-15,3,1
2,4,19,0,30,2,11,0,13,2,30,8,0,0,8,0,30,4,9,0,13,2,30,5,8,0,13,0,30,9,0,0,9,1,-15,3,1
2,3,23,2,30,5,8,0,13,1,30,6,0,0,6,4,30,13,0,0,13,0,30,5,8,0,13,3,30,6,0,0,6,1,-15,3,1
2,4,23,2,30,5,8,0,13,1,30,6,0,0,6,4,30,13,0,0,13,0,30,5,8,0,13,3,30,6,0,0,6,1,-15,3,1
2,3,25,1,30,4,10,0,14,4,30,6,0,0,6,0,30,3,11,0,14,4,30,6,8,0,14,5,30,6,0,0,6,1,-15,3,1
2,1,27,1,30,5,10,0,15,0,30,1,1,0,2,0,30,5,10,0,15,2,30,6,9,0,15,5,30,6,0,0,6,1,-15,3,1
2,2,27,1,30,5,10,0,15,0,30,1,1,0,2,0,30,5,10,0,15,2,30,6,9,0,15,5,30,6,0,0,6,1,-15,3,1
2,0,5,0,30,4,1,0,5,3,30,3,1,0,4,3,30,0,5,0,5,0,30,1,4,0,5,0,30,0,2,0,2,0,-27,3,0
2,2,6,0,30,5,4,0,9,4,30,2,0,0,2,0,30,2,7,0,9,0,30,4,5,0,9,1,30,4,1,0,5,0,-27,3,0
2,3,6,0,30,5,4,0,9,4,30,2,0,0,2,0,30,2,7,0,9,0,30,4,5,0,9,1,30,4,1,0,5,0,-27,3,0
2,3,7,0,30,1,3,0,4,2,30,2,0,0,2,1,30,1,3,0,4,0,30,1,3,0,4,2,30,2,0,0,2,0,-27,3,0
2,3,8,2,30,7,0,0,7,4,30,2,0,0,2,3,30,2,5,0,7,3,30,6,1,0,7,2,30,3,0,0,3,0,-27,3,0
2,2,9,0,30,1,3,0,4,2,30,2,0,0,2,0,30,1,3,0,4,0,30,0,4,0,4,1,30,1,0,0,1,0,-27,3,0
2,2,11,4,30,4,8,0,12,1,30,4,0,0,4,3,30,4,8,0,12,1,30,2,10,0,12,2,30,3,1,0,4,1,-15,3,1
2,3,11,4,30,4,8,0,12,1,30,4,0,0,4,3,30,4,8,0,12,1,30,2,10,0,12,2,30,3,1,0,4,1,-15,3,1
2,4,13,3,30,5,2,0,7,0,30,4,0,0,4,2,30,6,1,0,7,5,30,6,1,0,7,1,30,4,0,0,4,1,-15,3,1
2,1,17,5,30,8,6,0,14,3,30,6,0,0,6,0,30,6,8,0,14,2,30,5,9,0,14,3,30,4,0,0,4,1,-15,3,1
2,2,17,5,30,8,6,0,14,3,30,6,0,0,6,0,30,6,8,0,14,2,30,5,9,0,14,3,30,4,0,0,4,1,-15,3,1
2,2,19,0,30,4,9,0,13,2,30,4,4,0,8,4,30,4,9,0,13,1,30,6,7,0,13,1,30,7,2,0,9,1,-15,3,1
2,0,21,1,30,7,3,0,10,4,30,5,1,0,6,1,30,3,7,0,10,7,30,7,3,0,10,2,30,4,0,0,4,1,-15,3,1
2,2,21,1,30,7,3,0,10,4,30,5,1,0,6,1,30,3,7,0,10,7,30,7,3,0,10,0,30,4,0,0,4,1,-15,3,1
2,2,25,1,30,11,3,0,14,3,30,6,0,0,6,0,30,7,7,0,14,1,30,5,9,0,14,3,30,5,1,0,6,1,-15,3,1
2,0,29,0,30,6,8,0,14,6,30,10,2,0,12,0,30,2,12,0,14,0,30,2,12,0,14,4,30,9,0,0,9,1,-15,3,1
2,3,31,4,30,7,5,0,12,4,30,8,0,0,8,3,30,10,2,0,12,0,30,4,8,0,12,0,30,2,4,0,6,1,-15,3,1
2,4,32,0,30,8,1,0,9,4,30,2,0,0,2,0,30,7,2,0,9,1,30,2,7,0,9,4,30,2,0,0,2,1,-15,3,1
2,1,37,2,30,5,6,0,11,4,30,4,4,0,8,2,30,11,0,0,11,7,30,3,8,0,11,6,30,6,0,0,6,1,-15,3,1
2,3,9,0,30,6,5,0,11,2,30,6,0,0,6,0,30,9,2,0,11,6,30,3,8,0,11,3,30,4,0,0,4,0,-27,3,0
2,1,13,1,30,6,1,0,7,0,30,4,0,0,4,2,30,5,2,0,7,11,30,5,2,0,7,3,30,4,0,0,4,1,-15,3,1
2,1,23,2,30,5,8,0,13,2,30,6,0,0,6,6,30,11,2,0,13,0,30,5,8,0,13,3,30,6,0,0,6,1,-15,3,1
2,3,23,2,30,5,8,0,13,2,30,6,0,0,6,6,30,11,2,0,13,0,30,5,8,0,13,3,30,6,0,0,6,1,-15,3,1
2,0,25,1,30,4,10,0,14,3,30,6,0,0,6,0,30,5,9,0,14,1,30,8,6,0,14,7,30,6,0,0,6,1,-15,3,1
2,1,25,1,30,4,10,0,14,3,30,6,0,0,6,0,30,5,9,0,14,1,30,8,6,0,14,7,30,6,0,0,6,1,-15,3,1
2,2,25,1,30,4,10,0,14,3,30,6,0,0,6,0,30,5,9,0,14,1,30,8,6,0,14,7,30,6,0,0,6,1,-15,3,1
2,3,25,1,30,4,10,0,14,3,30,6,0,0,6,0,30,5,9,0,14,1,30,8,6,0,14,7,30,6,0,0,6,1,-15,3,1
2,1,27,2,30,5,10,0,15,3,30,2,0,0,2,2,30,9,6,0,15,0,30,4,11,0,15,1,30,3,3,0,6,1,-15,3,1
2,4,27,2,30,5,10,0,15,3,30,2,0,0,2,2,30,9,6,0,15,0,30,4,11,0,15,1,30,3,3,0,6,1,-15,3,1
2,2,31,1,30,8,4,0,12,7,30,8,0,0,8,3,30,4,8,0,12,0,30,5,7,0,12,6,30,6,0,0,6,1,-15,3,1
2,3,31,1,30,8,4,0,12,7,30,8,0,0,8,3,30,4,8,0,12,0,30,5,7,0,12,6,30,6,0,0,6,1,-15,3,1
2,4,31,1,30,8,4,0,12,7,30,8,0,0,8,3,30,4,8,0,12,0,30,5,7,0,12,6,30,6,0,0,6,1,-15,3,1
2,3,6,0,30,7,2,0,9,4,30,2,0,0,2,0,30,2,7,0,9,0,30,4,5,0,9,2,30,2,3,0,5,0,-27,3,0
2,4,6,0,30,7,2,0,9,4,30,2,0,0,2,0,30,2,7,0,9,0,30,4,5,0,9,2,30,2,3,0,5,0,-27,3,0
2,1,11,2,30,7,5,0,12,2,30,4,0,0,4,0,30,6,6,0,12,6,30,5,7,0,12,3,30,4,0,0,4,1,-15,3,1
2,3,11,2,30,7,5,0,12,2,30,4,0,0,4,0,30,6,6,0,12,6,30,5,7,0,12,3,30,4,0,0,4,1,-15,3,1
2,3,13,1,30,6,1,0,7,1,30,4,0,0,4,2,30,6,1,0,7,3,30,5,2,0,7,4,30,4,0,0,4,1,-15,3,1
2,3,17,3,30,9,5,0,14,2,30,6,0,0,6,0,30,8,6,0,14,2,30,6,8,0,14,4,30,4,0,0,4,1,-15,3,1
2,3,19,0,30,3,10,0,13,2,30,8,0,0,8,0,30,5,8,0,13,3,30,4,9,0,13,0,30,6,3,0,9,1,-15,3,1
2,4,27,2,30,5,10,0,15,2,30,1,1,0,2,0,30,5,10,0,15,0,30,6,9,0,15,0,30,6,0,0,6,1,-15,3,1
2,1,31,6,30,8,4,0,12,5,30,8,0,0,8,3,30,8,4,0,12,0,30,3,9,0,12,0,30,2,4,0,6,1,-15,3,1
2,4,5,1,30,2,3,0,5,3,30,2,2,0,4,0,30,1,4,0,5,0,30,1,4,0,5,1,30,0,2,0,2,0,-27,3,0
2,3,6,0,30,7,2,0,9,4,30,2,0,0,2,0,30,2,7,0,9,1,30,4,5,0,9,0,30,4,1,0,5,0,-27,3,0
2,2,19,0,30,4,9,0,13,0,30,8,0,0,8,0,30,6,7,0,13,8,30,4,9,0,13,0,30,8,1,0,9,1,-15,3,1
2,4,19,0,30,4,9,0,13,0,30,8,0,0,8,0,30,6,7,0,13,8,30,4,9,0,13,0,30,8,1,0,9,1,-15,3,1
2,3,23,1,30,8,5,0,13,0,30,6,0,0,6,2,30,13,0,0,13,0,30,5,8,0,13,2,30,6,0,0,6,1,-15,3,1
2,4,23,1,30,8,5,0,13,0,30,6,0,0,6,2,30,13,0,0,13,0,30,5,8,0,13,2,30,6,0,0,6,1,-15,3,1
2,2,27,2,30,5,10,0,15,0,30,1,1,0,2,0,30,10,5,0,15,2,30,4,11,0,15,2,30,6,0,0,6,1,-15,3,1
2,4,27,2,30,5,10,0,15,0,30,1,1,0,2,0,30,10,5,0,15,2,30,4,11,0,15,2,30,6,0,0,6,1,-15,3,1
2,4,39,1,30,11,0,0,11,7,30,6,0,0,6,0,30,4,7,0,11,0,30,2,9,0,11,2,30,2,3,0,5,1,-15,3,1
2,2,13,3,30,7,0,0,7,0,30,4,0,0,4,6,30,7,0,0,7,6,30,4,3,0,7,5,30,4,0,0,4,1,-15,3,1
2,3,13,3,30,7,0,0,7,0,30,4,0,0,4,6,30,7,0,0,7,6,30,4,3,0,7,5,30,4,0,0,4,1,-15,3,1
2,4,13,3,30,7,0,0,7,0,30,4,0,0,4,6,30,7,0,0,7,6,30,4,3,0,7,5,30,4,0,0,4,1,-15,3,1
2,2,17,7,30,11,3,0,14,3,30,6,0,0,6,0,30,5,9,0,14,1,30,5,9,0,14,8,30,4,0,0,4,1,-15,3,1
2,0,19,0,30,3,10,0,13,2,30,6,2,0,8,0,30,5,8,0,13,1,30,5,8,0,13,2,30,9,0,0,9,1,-15,3,1
2,1,19,0,30,3,10,0,13,2,30,6,2,0,8,0,30,5,8,0,13,1,30,5,8,0,13,2,30,9,0,0,9,1,-15,3,1
2,0,27,6,30,4,11,0,15,6,30,2,0,0,2,2,30,4,11,0,15,0,30,7,8,0,15,2,30,2,4,0,6,1,-15,3,1
2,1,27,6,30,4,11,0,15,6,30,2,0,0,2,2,30,4,11,0,15,0,30,7,8,0,15,2,30,2,4,0,6,1,-15,3,1
2,3,27,6,30,4,11,0,15,6,30,2,0,0,2,2,30,4,11,0,15,0,30,7,8,0,15,2,30,2,4,0,6,1,-15,3,1
2,4,27,6,30,4,11,0,15,6,30,2,0,0,2,2,30,4,11,0,15,0,30,7,8,0,15,2,30,2,4,0,6,1,-15,3,1
2,2,6,0,30,7,2,0,9,4,30,2,0,0,2,0,30,2,7,0,9,0,30,3,6,0,9,3,30,5,0,0,5,0,-27,3,0
2,4,6,0,30,7,2,0,9,4,30,2,0,0,2,0,30,2,7,0,9,0,30,3,6,0,9,3,30,5,0,0,5,0,-27,3,0
2,2,11,2,30,3,9,0,12,0,30,4,0,0,4,0,30,6,6,0,12,5,30,6,6,0,12,5,30,4,0,0,4,1,-15,3,1
2,3,11,2,30,3,9,0,12,0,30,4,0,0,4,0,30,6,6,0,12,5,30,6,6,0,12,5,30,4,0,0,4,1,-15,3,1
2,4,11,2,30,3,9,0,12,0,30,4,0,0,4,0,30,6,6,0,12,5,30,6,6,0,12,5,30,4,0,0,4,1,-15,3,1
2,2,13,2,30,3,0,0,3,0,30,2,0,0,2,0,30,2,1,0,3,7,30,2,1,0,3,5,30,2,0,0,2,1,-15,3,1
2,1,13,3,30,7,0,0,7,0,30,4,0,0,4,2,30,5,2,0,7,8,30,6,1,0,7,5,30,4,0,0,4,1,-15,3,1
2,4,13,3,30,7,0,0,7,0,30,4,0,0,4,2,30,5,2,0,7,8,30,6,1,0,7,5,30,4,0,0,4,1,-15,3,1
2,2,17,2,30,8,6,0,14,2,30,6,0,0,6,0,30,8,6,0,14,4,30,4,10,0,14,6,30,4,0,0,4,1,-15,3,1
2,3,17,2,30,8,6,0,14,2,30,6,0,0,6,0,30,8,6,0,14,4,30,4,10,0,14,6,30,4,0,0,4,1,-15,3,1
2,4,17,2,30,8,6,0,14,2,30,6,0,0,6,0,30,8,6,0,14,4,30,4,10,0,14,6,30,4,0,0,4,1,-15,3,1
2,2,19,0,30,3,10,0,13,2,30,8,0,0,8,4,30,6,7,0,13,0,30,4,9,0,13,0,30,7,2,0,9,1,-15,3,1
2,3,19,0,30,3,10,0,13,2,30,8,0,0,8,4,30,6,7,0,13,0,30,4,9,0,13,0,30,7,2,0,9,1,-15,3,1
2,4,19,0,30,3,10,0,13,2,30,8,0,0,8,4,30,6,7,0,13,0,30,4,9,0,13,0,30,7,2,0,9,1,-15,3,1
2,2,23,1,30,7,6,0,13,2,30,6,0,0,6,5,30,10,3,0,13,0,30,5,8,0,13,3,30,6,0,0,6,1,-15,3,1
2,3,25,1,30,11,3,0,14,3,30,6,0,0,6,0,30,6,8,0,14,1,30,5,9,0,14,5,30,6,0,0,6,1,-15,3,1
2,4,25,1,30,11,3,0,14,3,30,6,0,0,6,0,30,6,8,0,14,1,30,5,9,0,14,5,30,6,0,0,6,1,-15,3,1
2,0,33,5,30,5,6,0,11,5,30,4,0,0,4,3,30,11,0,0,11,0,30,4,7,0,11,6,30,4,0,0,4,1,-15,3,1
2,1,33,5,30,5,6,0,11,5,30,4,0,0,4,3,30,11,0,0,11,0,30,4,7,0,11,6,30,4,0,0,4,1,-15,3,1
2,2,35,0,30,7,6,0,13,6,30,2,0,0,2,1,30,2,11,0,13,4,30,3,10,0,13,5,30,8,0,0,8,1,-15,3,1
2,3,35,0,30,7,6,0,13,6,30,2,0,0,2,1,30,2,11,0,13,4,30,3,10,0,13,5,30,8,0,0,8,1,-15,3,1
2,0,4,2,30,7,1,0,8,5,30,4,0,0,4,0,30,2,6,0,8,0,30,8,0,0,8,3,30,3,1,0,4,0,-27,3,0
2,1,4,2,30,7,1,0,8,5,30,4,0,0,4,0,30,2,6,0,8,0,30,8,0,0,8,3,30,3,1,0,4,0,-27,3,0
2,2,4,2,30,7,1,0,8,5,30,4,0,0,4,0,30,2,6,0,8,0,30,8,0,0,8,3,30,3,1,0,4,0,-27,3,0
2,4,4,2,30,7,1,0,8,5,30,4,0,0,4,0,30,2,6,0,8,0,30,8,0,0,8,3,30,3,1,0,4,0,-27,3,0
2,3,11,0,30,5,7,0,12,0,30,3,1,0,4,4,30,7,5,0,12,6,30,4,8,0,12,5,30,4,0,0,4,1,-15,3,1
2,4,11,0,30,5,7,0,12,0,30,3,1,0,4,4,30,7,5,0,12,6,30,4,8,0,12,5,30,4,0,0,4,1,-15,3,1
2,0,13,1,30,6,1,0,7,1,30,4,0,0,4,6,30,6,1,0,7,8,30,6,1,0,7,5,30,4,0,0,4,1,-15,3,1
2,1,13,1,30,6,1,0,7,1,30,4,0,0,4,6,30,6,1,0,7,8,30,6,1,0,7,5,30,4,0,0,4,1,-15,3,1
2,2,17,3,30,9,5,0,14,4,30,6,0,0,6,0,30,3,11,0,14,0,30,9,5,0,14,1,30,4,0,0,4,1,-15,3,1
2,3,17,3,30,9,5,0,14,4,30,6,0,0,6,0,30,3,11,0,14,0,30,9,5,0,14,1,30,4,0,0,4,1,-15,3,1
2,3,19,0,30,8,5,0,13,1,30,5,3,0,8,2,30,5,8,0,13,4,30,4,9,0,13,0,30,8,1,0,9,1,-15,3,1
2,4,23,1,30,5,8,0,13,1,30,6,0,0,6,5,30,11,2,0,13,2,30,6,7,0,13,2,30,6,0,0,6,1,-15,3,1
2,0,31,2,30,6,6,0,12,7,30,8,0,0,8,6,30,4,8,0,12,2,30,8,4,0,12,1,30,6,0,0,6,1,-15,3,1
2,2,31,2,30,6,6,0,12,7,30,8,0,0,8,6,30,4,8,0,12,2,30,8,4,0,12,1,30,6,0,0,6,1,-15,3,1
2,3,31,2,30,6,6,0,12,7,30,8,0,0,8,6,30,4,8,0,12,2,30,8,4,0,12,1,30,6,0,0,6,1,-15,3,1
2,4,31,2,30,6,6,0,12,7,30,8,0,0,8,6,30,4,8,0,12,2,30,8,4,0,12,1,30,6,0,0,6,1,-15,3,1
2,4,6,0,30,7,2,0,9,4,30,2,0,0,2,0,30,2,7,0,9,1,30,4,5,0,9,0,30,4,1,0,5,0,-27,3,0
2,2,13,2,30,7,0,0,7,0,30,4,0,0,4,2,30,7,0,0,7,4,30,7,0,0,7,5,30,4,0,0,4,1,-15,3,1
2,2,23,1,30,4,9,0,13,2,30,5,1,0,6,6,30,12,1,0,13,0,30,6,7,0,13,3,30,6,0,0,6,1,-15,3,1
2,4,23,1,30,4,9,0,13,2,30,5,1,0,6,0,30,12,1,0,13,0,30,6,7,0,13,3,30,6,0,0,6,1,-15,3,1
2,1,29,0,30,5,9,0,14,5,30,12,0,0,12,0,30,6,8,0,14,0,30,1,13,0,14,2,30,9,0,0,9,1,-15,3,1
2,2,29,0,30,5,9,0,14,5,30,12,0,0,12,0,30,6,8,0,14,0,30,1,13,0,14,2,30,9,0,0,9,1,-15,3,1
2,4,29,0,30,5,9,0,14,5,30,12,0,0,12,0,30,6,8,0,14,0,30,1,13,0,14,2,30,9,0,0,9,1,-15,3,1
2,2,35,2,30,9,4,0,13,3,30,2,0,0,2,1,30,8,5,0,13,0,30,1,12,0,13,3,30,8,0,0,8,1,-15,3,1
2,4,35,2,30,9,4,0,13,3,30,2,0,0,2,1,30,8,5,0,13,0,30,1,12,0,13,3,30,8,0,0,8,1,-15,3,1
2,3,37,1,30,5,6,0,11,5,30,8,0,0,8,1,30,7,4,0,11,0,30,3,8,0,11,4,30,6,0,0,6,1,-15,3,1
2,2,38,0,30,2,8,0,10,7,30,6,0,0,6,0,30,2,8,0,10,0,30,4,6,0,10,9,30,6,0,0,6,1,-15,3,1
2,0,5,0,30,2,3,0,5,3,30,2,2,0,4,0,30,1,4,0,5,0,30,1,4,0,5,2,30,2,0,0,2,0,-27,3,0
2,2,5,0,30,2,3,0,5,3,30,2,2,0,4,0,30,1,4,0,5,0,30,1,4,0,5,2,30,2,0,0,2,0,-27,3,0
2,3,5,0,30,2,3,0,5,3,30,2,2,0,4,0,30,1,4,0,5,0,30,1,4,0,5,2,30,2,0,0,2,0,-27,3,0
2,1,13,1,30,5,2,0,7,0,30,4,0,0,4,2,30,7,0,0,7,8,30,5,2,0,7,2,30,4,0,0,4,1,-15,3,1
2,2,13,1,30,5,2,0,7,0,30,4,0,0,4,2,30,7,0,0,7,8,30,5,2,0,7,2,30,4,0,0,4,1,-15,3,1
2,2,17,3,30,9,5,0,14,3,30,6,0,0,6,0,30,5,9,0,14,4,30,6,8,0,14,4,30,4,0,0,4,1,-15,3,1
2,2,19,0,30,2,11,0,13,3,30,4,4,0,8,0,30,4,9,0,13,5,30,8,5,0,13,5,30,9,0,0,9,1,-15,3,1
2,3,23,3,30,7,6,0,13,2,30,6,0,0,6,0,30,12,1,0,13,0,30,5,8,0,13,2,30,5,1,0,6,1,-15,3,1
2,1,27,4,30,6,9,0,15,5,30,2,0,0,2,2,30,6,9,0,15,0,30,3,12,0,15,1,30,4,2,0,6,1,-15,3,1
2,4,39,0,30,2,9,0,11,6,30,6,0,0,6,0,30,8,3,0,11,2,30,4,7,0,11,4,30,5,0,0,5,1,-15,3,1
2,4,7,1,30,3,6,0,9,2,30,4,0,0,4,0,30,7,2,0,9,6,30,5,4,0,9,1,30,6,0,0,6,0,-27,3,0
2,4,11,0,30,5,7,0,12,1,30,4,0,0,4,1,30,7,5,0,12,7,30,2,10,0,12,2,30,4,0,0,4,1,-15,3,1
2,4,17,4,30,9,5,0,14,2,30,6,0,0,6,0,30,7,7,0,14,1,30,5,9,0,14,5,30,4,0,0,4,1,-15,3,1
2,3,19,0,30,3,10,0,13,2,30,7,1,0,8,0,30,4,9,0,13,1,30,4,9,0,13,2,30,9,0,0,9,1,-15,3,1
2,4,19,0,30,3,10,0,13,2,30,7,1,0,8,0,30,4,9,0,13,1,30,4,9,0,13,2,30,9,0,0,9,1,-15,3,1
2,4,23,1,30,8,5,0,13,0,30,6,0,0,6,3,30,13,0,0,13,0,30,5,8,0,13,2,30,6,0,0,6,1,-15,3,1
2,2,25,1,30,4,10,0,14,3,30,6,0,0,6,0,30,10,4,0,14,1,30,6,8,0,14,4,30,6,0,0,6,1,-15,3,1
2,3,25,1,30,4,10,0,14,3,30,6,0,0,6,0,30,10,4,0,14,1,30,6,8,0,14,4,30,6,0,0,6,1,-15,3,1
2,3,27,1,30,4,11,0,15,2,30,1,1,0,2,0,30,7,8,0,15,4,30,6,9,0,15,5,30,6,0,0,6,1,-15,3,1
2,4,27,1,30,4,11,0,15,2,30,1,1,0,2,0,30,7,8,0,15,4,30,6,9,0,15,5,30,6,0,0,6,1,-15,3,1
2,2,17,1,30,10,4,0,14,3,30,6,0,0,6,0,30,4,10,0,14,4,30,9,5,0,14,4,30,4,0,0,4,1,-15,3,1
2,2,19,1,30,4,9,0,13,2,30,6,2,0,8,0,30,6,7,0,13,1,30,6,7,0,13,2,30,6,3,0,9,1,-15,3,1
2,3,19,1,30,4,9,0,13,2,30,6,2,0,8,0,30,6,7,0,13,1,30,6,7,0,13,2,30,6,3,0,9,1,-15,3,1
2,4,22,3,30,7,1,0,8,3,30,2,0,0,2,0,30,5,3,0,8,1,30,2,6,0,8,1,30,2,2,0,4,1,-15,3,1
2,2,25,1,30,7,7,0,14,3,30,6,0,0,6,0,30,8,6,0,14,2,30,9,5,0,14,3,30,5,1,0,6,1,-15,3,1
2,4,27,1,30,5,10,0,15,3,30,2,0,0,2,0,30,5,10,0,15,1,30,7,8,0,15,1,30,6,0,0,6,1,-15,3,1
2,0,35,0,30,7,6,0,13,5,30,2,0,0,2,1,30,2,11,0,13,2,30,6,7,0,13,9,30,8,0,0,8,1,-15,3,1
2,2,35,0,30,7,6,0,13,5,30,2,0,0,2,1,30,2,11,0,13,2,30,6,7,0,13,9,30,8,0,0,8,1,-15,3,1
2,3,35,0,30,7,6,0,13,5,30,2,0,0,2,1,30,2,11,0,13,2,30,6,7,0,13,9,30,8,0,0,8,1,-15,3,1
2,1,19,0,30,1,12,0,13,2,30,4,4,0,8,0,30,12,1,0,13,5,30,4,9,0,13,2,30,8,1,0,9,1,-15,3,1
2,2,19,0,30,1,12,0,13,2,30,4,4,0,8,0,30,12,1,0,13,5,30,4,9,0,13,2,30,8,1,0,9,1,-15,3,1
2,4,22,1,30,6,2,0,8,3,30,2,0,0,2,0,30,3,5,0,8,0,30,1,7,0,8,2,30,4,0,0,4,1,-15,3,1
2,4,23,1,30,4,9,0,13,3,30,6,0,0,6,2,30,11,2,0,13,1,30,9,4,0,13,4,30,6,0,0,6,1,-15,3,1
2,1,25,2,30,6,8,0,14,6,30,6,0,0,6,0,30,3,11,0,14,1,30,9,5,0,14,4,30,6,0,0,6,1,-15,3,1
2,4,25,2,30,6,8,0,14,6,30,6,0,0,6,0,30,3,11,0,14,1,30,9,5,0,14,4,30,6,0,0,6,1,-15,3,1
2,0,27,1,30,6,9,0,15,4,30,1,1,0,2,0,30,5,10,0,15,4,30,6,9,0,15,2,30,6,0,0,6,1,-15,3,1
2,1,27,1,30,6,9,0,15,4,30,1,1,0,2,0,30,5,10,0,15,4,30,6,9,0,15,2,30,6,0,0,6,1,-15,3,1
2,0,31,5,30,8,4,0,12,3,30,8,0,0,8,4,30,12,0,0,12,0,30,3,9,0,12,0,30,2,4,0,6,1,-15,3,1
2,2,31,5,30,8,4,0,12,3,30,8,0,0,8,0,30,12,0,0,12,0,30,3,9,0,12,0,30,2,4,0,6,1,-15,3,1
2,4,31,5,30,8,4,0,12,3,30,8,0,0,8,0,30,12,0,0,12,0,30,3,9,0,12,0,30,2,4,0,6,1,-15,3,1
2,0,47,0,30,0,14,0,14,7,30,4,0,0,4,7,30,10,4,0,14,0,30,2,12,0,14,5,30,7,0,0,7,1,-15,3,1
2,3,47,0,30,0,14,0,14,7,30,4,0,0,4,7,30,10,4,0,14,0,30,2,12,0,14,5,30,7,0,0,7,1,-15,3,1
2,4,47,0,30,0,14,0,14,7,30,4,0,0,4,7,30,10,4,0,14,0,30,2,12,0,14,5,30,7,0,0,7,1,-15,3,1
2,4,5,0,30,1,4,0,5,3,30,2,2,0,4,1,30,0,5,0,5,2,30,2,3,0,5,0,30,0,2,0,2,0,-27,3,0
2,1,13,3,30,7,0,0,7,0,30,4,0,0,4,2,30,6,1,0,7,15,30,6,1,0,7,5,30,4,0,0,4,1,-15,3,1
2,3,17,1,30,11,3,0,14,3,30,6,0,0,6,0,30,4,10,0,14,1,30,4,10,0,14,1,30,3,1,0,4,1,-15,3,1
2,4,19,0,30,3,10,0,13,2,30,7,1,0,8,0,30,7,6,0,13,4,30,6,7,0,13,2,30,9,0,0,9,1,-15,3,1
2,4,23,2,30,6,7,0,13,3,30,6,0,0,6,7,30,10,3,0,13,1,30,6,7,0,13,0,30,6,0,0,6,1,-15,3,1
2,0,27,3,30,7,8,0,15,2,30,2,0,0,2,0,30,14,1,0,15,0,30,3,12,0,15,2,30,3,3,0,6,1,-15,3,1
2,1,27,3,30,7,8,0,15,2,30,2,0,0,2,0,30,14,1,0,15,0,30,3,12,0,15,2,30,3,3,0,6,1,-15,3,1
2,2,43,0,30,6,8,0,14,7,30,6,0,0,6,0,30,4,10,0,14,3,30,4,10,0,14,8,30,5,0,0,5,1,-15,3,1
2,2,1,0,30,7,3,0,10,4,30,2,0,0,2,1,30,5,5,0,10,4,30,10,0,0,10,6,30,6,0,0,6,0,-27,3,0
2,3,1,0,30,7,3,0,10,4,30,2,0,0,2,1,30,5,5,0,10,4,30,10,0,0,10,6,30,6,0,0,6,0,-27,3,0
2,2,4,2,30,5,3,0,8,4,30,4,0,0,4,0,30,4,4,0,8,0,30,5,3,0,8,2,30,4,0,0,4,0,-27,3,0
2,3,4,2,30,5,3,0,8,4,30,4,0,0,4,0,30,4,4,0,8,0,30,5,3,0,8,2,30,4,0,0,4,0,-27,3,0
2,4,5,0,30,2,3,0,5,3,30,2,2,0,4,4,30,0,5,0,5,0,30,1,4,0,5,0,30,0,2,0,2,0,-27,3,0
2,2,6,1,30,6,3,0,9,4,30,2,0,0,2,0,30,2,7,0,9,0,30,4,5,0,9,1,30,5,0,0,5,0,-27,3,0
2,3,23,2,30,7,6,0,13,2,30,6,0,0,6,1,30,9,4,0,13,0,30,5,8,0,13,3,30,6,0,0,6,1,-15,3,1
2,2,25,1,30,5,9,0,14,4,30,6,0,0,6,6,30,11,3,0,14,1,30,7,7,0,14,1,30,5,1,0,6,1,-15,3,1
2,1,27,1,30,4,11,0,15,5,30,2,0,0,2,0,30,5,10,0,15,1,30,6,9,0,15,3,30,6,0,0,6,1,-15,3,1
2,3,27,1,30,4,11,0,15,1,30,2,0,0,2,0,30,5,10,0,15,1,30,6,9,0,15,3,30,6,0,0,6,1,-15,3,1
2,4,27,1,30,4,11,0,15,1,30,2,0,0,2,0,30,5,10,0,15,1,30,6,9,0,15,3,30,6,0,0,6,1,-15,3,1
2,1,31,4,30,5,7,0,12,6,30,8,0,0,8,3,30,6,6,0,12,2,30,7,5,0,12,2,30,6,0,0,6,1,-15,3,1
2,2,31,4,30,5,7,0,12,6,30,8,0,0,8,3,30,6,6,0,12,2,30,7,5,0,12,2,30,6,0,0,6,1,-15,3,1
2,4,31,4,30,5,7,0,12,6,30,8,0,0,8,3,30,6,6,0,12,2,30,7,5,0,12,2,30,6,0,0,6,1,-15,3,1
2,0,33,1,30,6,5,0,11,3,30,4,0,0,4,3,30,11,0,0,11,3,30,4,7,0,11,6,30,4,0,0,4,1,-15,3,1
2,1,33,1,30,6,5,0,11,3,30,4,0,0,4,3,30,11,0,0,11,3,30,4,7,0,11,6,30,4,0,0,4,1,-15,3,1
2,3,35,1,30,8,5,0,13,6,30,2,0,0,2,1,30,2,11,0,13,1,30,4,9,0,13,2,30,7,1,0,8,1,-15,3,1
2,4,35,1,30,8,5,0,13,6,30,2,0,0,2,1,30,2,11,0,13,1,30,4,9,0,13,2,30,7,1,0,8,1,-15,3,1
2,1,4,2,30,5,3,0,8,4,30,4,0,0,4,2,30,1,7,0,8,2,30,4,4,0,8,1,30,3,1,0,4,0,-27,3,0
2,4,4,0,30,5,3,0,8,4,30,4,0,0,4,2,30,1,7,0,8,2,30,4,4,0,8,1,30,3,1,0,4,0,-27,3,0
2,4,17,4,30,8,6,0,14,3,30,6,0,0,6,0,30,6,8,0,14,3,30,3,11,0,14,6,30,4,0,0,4,1,-15,3,1
2,0,19,0,30,2,11,0,13,2,30,4,4,0,8,0,30,7,6,0,13,6,30,5,8,0,13,1,30,9,0,0,9,1,-15,3,1
2,2,19,0,30,2,11,0,13,2,30,4,4,0,8,0,30,7,6,0,13,6,30,5,8,0,13,0,30,9,0,0,9,1,-15,3,1
2,3,25,1,30,6,8,0,14,2,30,6,0,0,6,0,30,14,0,0,14,1,30,5,9,0,14,3,30,4,2,0,6,1,-15,3,1
2,4,25,1,30,6,8,0,14,2,30,6,0,0,6,0,30,14,0,0,14,1,30,5,9,0,14,3,30,4,2,0,6,1,-15,3,1
2,1,27,1,30,4,11,0,15,1,30,1,1,0,2,0,30,6,9,0,15,3,30,7,8,0,15,6,30,6,0,0,6,1,-15,3,1
2,2,27,1,30,4,11,0,15,1,30,1,1,0,2,0,30,6,9,0,15,3,30,7,8,0,15,6,30,6,0,0,6,1,-15,3,1
2,1,13,3,30,6,1,0,7,0,30,4,0,0,4,2,30,6,1,0,7,10,30,7,0,0,7,5,30,4,0,0,4,1,-15,3,1
2,2,17,3,30,10,4,0,14,3,30,6,0,0,6,0,30,4,10,0,14,1,30,7,7,0,14,4,30,4,0,0,4,1,-15,3,1
2,2,23,1,30,6,7,0,13,3,30,6,0,0,6,0,30,10,3,0,13,1,30,10,3,0,13,8,30,6,0,0,6,1,-15,3,1
2,2,25,1,30,6,8,0,14,5,30,5,1,0,6,0,30,4,10,0,14,0,30,10,4,0,14,2,30,6,0,0,6,1,-15,3,1
2,3,27,1,30,6,9,0,15,2,30,2,0,0,2,2,30,6,9,0,15,0,30,4,11,0,15,0,30,3,3,0,6,1,-15,3,1
2,3,29,0,30,7,7,0,14,6,30,9,3,0,12,0,30,5,9,0,14,0,30,1,13,0,14,4,30,9,0,0,9,1,-15,3,1
2,0,35,0,30,8,5,0,13,5,30,1,1,0,2,1,30,2,11,0,13,4,30,1,12,0,13,10,30,8,0,0,8,1,-15,3,1
2,3,45,0,30,7,6,0,13,10,30,10,0,0,10,0,30,2,11,0,13,0,30,6,7,0,13,9,30,5,0,0,5,1,-15,3,1
2,3,7,0,30,4,0,0,4,2,30,2,0,0,2,0,30,1,3,0,4,0,30,0,4,0,4,2,30,1,1,0,2,0,-27,3,0
2,4,15,0,30,5,8,0,13,0,30,5,1,0,6,0,30,4,9,0,13,1,30,4,9,0,13,2,30,9,0,0,9,1,-15,3,1
2,1,17,5,30,11,3,0,14,2,30,6,0,0,6,0,30,7,7,0,14,1,30,6,8,0,14,2,30,4,0,0,4,1,-15,3,1
2,3,17,5,30,11,3,0,14,2,30,6,0,0,6,0,30,7,7,0,14,1,30,6,8,0,14,2,30,4,0,0,4,1,-15,3,1
2,2,19,1,30,5,8,0,13,2,30,8,0,0,8,0,30,5,8,0,13,3,30,5,8,0,13,0,30,7,2,0,9,1,-15,3,1
2,3,19,1,30,5,8,0,13,2,30,8,0,0,8,0,30,5,8,0,13,3,30,5,8,0,13,0,30,7,2,0,9,1,-15,3,1
2,3,23,2,30,7,6,0,13,0,30,6,0,0,6,4,30,12,1,0,13,0,30,5,8,0,13,2,30,6,0,0,6,1,-15,3,1
2,0,29,0,30,5,9,0,14,4,30,12,0,0,12,0,30,8,6,0,14,0,30,1,13,0,14,2,30,9,0,0,9,1,-15,3,1
2,2,29,0,30,5,9,0,14,4,30,12,0,0,12,0,30,8,6,0,14,0,30,1,13,0,14,2,30,9,0,0,9,1,-15,3,1
2,1,33,1,30,3,8,0,11,5,30,4,0,0,4,1,30,10,1,0,11,0,30,4,7,0,11,7,30,4,0,0,4,1,-15,3,1
2,2,33,1,30,3,8,0,11,5,30,4,0,0,4,1,30,10,1,0,11,0,30,4,7,0,11,7,30,4,0,0,4,1,-15,3,1
2,1,38,0,30,1,9,0,10,6,30,6,0,0,6,0,30,2,8,0,10,0,30,4,6,0,10,8,30,6,0,0,6,1,-15,3,1
2,0,5,0,30,2,3,0,5,3,30,3,1,0,4,0,30,0,5,0,5,0,30,3,2,0,5,0,30,1,1,0,2,0,-27,3,0
2,1,5,0,30,2,3,0,5,3,30,3,1,0,4,0,30,0,5,0,5,0,30,3,2,0,5,0,30,1,1,0,2,0,-27,3,0
2,3,8,2,30,7,0,0,7,4,30,2,0,0,2,3,30,3,4,0,7,0,30,4,3,0,7,0,30,3,0,0,3,0,-27,3,0
2,3,15,1,30,4,9,0,13,0,30,6,0,0,6,0,30,5,8,0,13,1,30,5,8,0,13,2,30,8,1,0,9,1,-15,3,1
2,4,15,1,30,4,9,0,13,0,30,6,0,0,6,0,30,5,8,0,13,1,30,5,8,0,13,2,30,8,1,0,9,1,-15,3,1
2,2,17,3,30,9,5,0,14,2,30,6,0,0,6,0,30,7,7,0,14,1,30,7,7,0,14,4,30,4,0,0,4,1,-15,3,1
2,2,19,0,30,5,8,0,13,2,30,6,2,0,8,0,30,4,9,0,13,4,30,6,7,0,13,0,30,8,1,0,9,1,-15,3,1
2,1,23,2,30,5,8,0,13,2,30,6,0,0,6,9,30,10,3,0,13,0,30,5,8,0,13,5,30,6,0,0,6,1,-15,3,1
2,3,23,2,30,5,8,0,13,2,30,6,0,0,6,9,30,10,3,0,13,0,30,5,8,0,13,5,30,6,0,0,6,1,-15,3,1
2,4,25,2,30,8,6,0,14,4,30,6,0,0,6,0,30,8,6,0,14,1,30,5,9,0,14,0,30,6,0,0,6,1,-15,3,1
2,0,27,1,30,3,12,0,15,3,30,2,0,0,2,0,30,10,5,0,15,1,30,5,10,0,15,2,30,6,0,0,6,1,-15,3,1
2,2,38,0,30,7,3,0,10,7,30,6,0,0,6,0,30,1,9,0,10,0,30,2,8,0,10,7,30,6,0,0,6,1,-15,3,1
2,2,43,0,30,4,10,0,14,6,30,6,0,0,6,0,30,6,8,0,14,1,30,5,9,0,14,8,30,5,0,0,5,1,-15,3,1
2,1,13,1,30,5,2,0,7,0,30,4,0,0,4,2,30,6,1,0,7,8,30,7,0,0,7,6,30,4,0,0,4,1,-15,3,1
2,2,17,1,30,8,6,0,14,3,30,6,0,0,6,0,30,4,10,0,14,1,30,8,6,0,14,6,30,4,0,0,4,1,-15,3,1
2,3,17,1,30,8,6,0,14,3,30,6,0,0,6,0,30,4,10,0,14,1,30,8,6,0,14,6,30,4,0,0,4,1,-15,3,1
2,4,17,1,30,8,6,0,14,3,30,6,0,0,6,0,30,4,10,0,14,1,30,8,6,0,14,6,30,4,0,0,4,1,-15,3,1
2,2,25,1,30,5,9,0,14,3,30,6,0,0,6,0,30,6,8,0,14,1,30,6,8,0,14,7,30,5,1,0,6,1,-15,3,1
2,2,29,0,30,8,6,0,14,5,30,11,1,0,12,0,30,10,4,0,14,0,30,1,13,0,14,0,30,8,1,0,9,1,-15,3,1
2,3,29,0,30,8,6,0,14,5,30,11,1,0,12,0,30,10,4,0,14,0,30,1,13,0,14,0,30,8,1,0,9,1,-15,3,1
2,3,31,1,30,8,4,0,12,4,30,8,0,0,8,3,30,6,6,0,12,0,30,3,9,0,12,2,30,3,3,0,6,1,-15,3,1
2,0,35,0,30,4,9,0,13,4,30,2,0,0,2,1,30,2,11,0,13,6,30,6,7,0,13,10,30,8,0,0,8,1,-15,3,1
2,1,35,0,30,4,9,0,13,4,30,2,0,0,2,1,30,2,11,0,13,6,30,6,7,0,13,10,30,8,0,0,8,1,-15,3,1
2,2,35,0,30,4,9,0,13,4,30,2,0,0,2,1,30,2,11,0,13,6,30,6,7,0,13,10,30,8,0,0,8,1,-15,3,1
2,4,3,2,30,4,0,0,4,3,30,4,0,0,4,0,30,1,3,0,4,0,30,0,4,0,4,1,30,2,1,0,3,0,-27,3,0
2,1,4,4,30,8,0,0,8,4,30,2,2,0,4,1,30,2,6,0,8,0,30,4,4,0,8,3,30,4,0,0,4,0,-27,3,0
2,2,4,4,30,8,0,0,8,4,30,2,2,0,4,1,30,2,6,0,8,0,30,4,4,0,8,3,30,4,0,0,4,0,-27,3,0
2,2,21,1,30,9,1,0,10,1,30,6,0,0,6,1,30,9,1,0,10,1,30,3,7,0,10,1,30,4,0,0,4,1,-15,3,1
2,3,23,1,30,4,9,0,13,3,30,6,0,0,6,1,30,11,2,0,13,1,30,6,7,0,13,3,30,6,0,0,6,1,-15,3,1
2,2,25,1,30,7,7,0,14,4,30,6,0,0,6,0,30,7,7,0,14,1,30,9,5,0,14,5,30,6,0,0,6,1,-15,3,1
2,3,25,1,30,7,7,0,14,4,30,6,0,0,6,0,30,7,7,0,14,1,30,9,5,0,14,5,30,6,0,0,6,1,-15,3,1
2,4,25,1,30,7,7,0,14,4,30,6,0,0,6,0,30,7,7,0,14,1,30,9,5,0,14,5,30,6,0,0,6,1,-15,3,1
2,0,27,1,30,5,10,0,15,5,30,2,0,0,2,0,30,6,9,0,15,2,30,6,9,0,15,1,30,6,0,0,6,1,-15,3,1
2,1,27,1,30,5,10,0,15,5,30,2,0,0,2,0,30,6,9,0,15,2,30,6,9,0,15,1,30,6,0,0,6,1,-15,3,1
2,2,27,1,30,5,10,0,15,5,30,2,0,0,2,0,30,6,9,0,15,2,30,6,9,0,15,1,30,6,0,0,6,1,-15,3,1
2,3,27,1,30,5,10,0,15,5,30,2,0,0,2,0,30,6,9,0,15,2,30,6,9,0,15,1,30,6,0,0,6,1,-15,3,1
2,3,29,0,30,9,5,0,14,5,30,12,0,0,12,0,30,3,11,0,14,0,30,1,13,0,14,0,30,9,0,0,9,1,-15,3,1
2,3,32,0,30,6,3,0,9,4,30,2,0,0,2,1,30,9,0,0,9,1,30,3,6,0,9,2,30,2,0,0,2,1,-15,3,1
2,0,4,2,30,6,2,0,8,5,30,4,0,0,4,0,30,2,6,0,8,0,30,7,1,0,8,1,30,4,0,0,4,0,-27,3,0
2,4,7,0,30,4,5,0,9,2,30,4,0,0,4,0,30,8,1,0,9,6,30,2,7,0,9,1,30,4,2,0,6,0,-27,3,0
2,4,11,1,30,3,9,0,12,1,30,4,0,0,4,0,30,8,4,0,12,8,30,2,10,0,12,0,30,4,0,0,4,1,-15,3,1
2,3,13,5,30,7,0,0,7,1,30,4,0,0,4,2,30,6,1,0,7,5,30,6,1,0,7,7,30,4,0,0,4,1,-15,3,1
2,3,15,0,30,4,9,0,13,1,30,6,0,0,6,0,30,3,10,0,13,1,30,6,7,0,13,3,30,9,0,0,9,1,-15,3,1
2,4,19,0,30,4,9,0,13,2,30,4,4,0,8,0,30,6,7,0,13,6,30,6,7,0,13,1,30,8,1,0,9,1,-15,3,1
2,4,25,0,30,5,9,0,14,3,30,6,0,0,6,0,30,13,1,0,14,1,30,6,8,0,14,3,30,6,0,0,6,1,-15,3,1
2,0,27,2,30,5,10,0,15,3,30,1,1,0,2,0,30,6,9,0,15,6,30,3,12,0,15,2,30,6,0,0,6,1,-15,3,1
2,4,27,2,30,5,10,0,15,3,30,1,1,0,2,0,30,6,9,0,15,6,30,3,12,0,15,2,30,6,0,0,6,1,-15,3,1
2,3,32,0,30,5,4,0,9,4,30,2,0,0,2,3,30,9,0,0,9,1,30,4,5,0,9,3,30,2,0,0,2,1,-15,3,1
2,1,4,5,30,8,0,0,8,5,30,4,0,0,4,0,30,2,6,0,8,0,30,7,1,0,8,1,30,4,0,0,4,0,-27,3,0
2,1,13,2,30,7,0,0,7,2,30,4,0,0,4,2,30,5,2,0,7,5,30,6,1,0,7,4,30,4,0,0,4,1,-15,3,1
2,2,13,2,30,7,0,0,7,2,30,4,0,0,4,2,30,5,2,0,7,5,30,6,1,0,7,4,30,4,0,0,4,1,-15,3,1
2,3,13,2,30,7,0,0,7,2,30,4,0,0,4,2,30,5,2,0,7,5,30,6,1,0,7,4,30,4,0,0,4,1,-15,3,1
2,1,17,4,30,9,5,0,14,4,30,6,0,0,6,0,30,2,12,0,14,1,30,8,6,0,14,1,30,4,0,0,4,1,-15,3,1
2,2,17,4,30,9,5,0,14,4,30,6,0,0,6,0,30,2,12,0,14,1,30,8,6,0,14,1,30,4,0,0,4,1,-15,3,1
2,4,19,0,30,4,9,0,13,2,30,6,2,0,8,1,30,8,5,0,13,0,30,6,7,0,13,1,30,8,1,0,9,1,-15,3,1
2,4,21,1,30,6,4,0,10,3,30,6,0,0,6,1,30,5,5,0,10,3,30,5,5,0,10,2,30,4,0,0,4,1,-15,3,1
2,1,27,1,30,6,9,0,15,2,30,2,0,0,2,0,30,5,10,0,15,0,30,2,13,0,15,1,30,4,2,0,6,1,-15,3,1
2,4,32,0,30,4,5,0,9,5,30,2,0,0,2,0,30,4,5,0,9,1,30,3,6,0,9,2,30,2,0,0,2,1,-15,3,1
2,4,35,0,30,6,7,0,13,5,30,2,0,0,2,1,30,2,11,0,13,0,30,2,11,0,13,6,30,8,0,0,8,1,-15,3,1
2,3,3,0,30,0,4,0,4,2,30,4,0,0,4,0,30,0,4,0,4,6,30,0,4,0,4,0,30,1,2,0,3,0,-27,3,0
2,0,5,0,30,3,2,0,5,3,30,3,1,0,4,1,30,0,5,0,5,0,30,1,4,0,5,0,30,0,2,0,2,0,-27,3,0
2,2,5,0,30,3,2,0,5,3,30,3,1,0,4,1,30,0,5,0,5,0,30,1,4,0,5,0,30,0,2,0,2,0,-27,3,0
2,2,6,1,30,7,2,0,9,4,30,2,0,0,2,0,30,2,7,0,9,0,30,4,5,0,9,3,30,5,0,0,5,0,-27,3,0
2,4,13,1,30,6,1,0,7,0,30,4,0,0,4,2,30,7,0,0,7,6,30,6,1,0,7,3,30,4,0,0,4,1,-15,3,1
2,3,15,0,30,5,8,0,13,0,30,5,1,0,6,0,30,4,9,0,13,1,30,3,10,0,13,2,30,8,1,0,9,1,-15,3,1
2,2,19,1,30,2,11,0,13,3,30,8,0,0,8,0,30,5,8,0,13,7,30,4,9,0,13,1,30,8,1,0,9,1,-15,3,1
2,3,22,1,30,7,1,0,8,3,30,2,0,0,2,3,30,4,4,0,8,1,30,5,3,0,8,1,30,3,1,0,4,1,-15,3,1
2,4,22,1,30,7,1,0,8,3,30,2,0,0,2,3,30,4,4,0,8,1,30,5,3,0,8,1,30,3,1,0,4,1,-15,3,1
2,2,23,1,30,8,5,0,13,3,30,6,0,0,6,3,30,8,5,0,13,0,30,6,7,0,13,0,30,5,1,0,6,1,-15,3,1
2,3,23,1,30,8,5,0,13,3,30,6,0,0,6,3,30,8,5,0,13,0,30,6,7,0,13,0,30,5,1,0,6,1,-15,3,1
2,3,27,1,30,4,11,0,15,4,30,2,0,0,2,0,30,5,10,0,15,6,30,4,11,0,15,0,30,6,0,0,6,1,-15,3,1
2,2,29,0,30,8,6,0,14,6,30,11,1,0,12,0,30,3,11,0,14,0,30,1,13,0,14,2,30,9,0,0,9,1,-15,3,1
2,0,39,0,30,4,7,0,11,5,30,6,0,0,6,0,30,7,4,0,11,0,30,2,9,0,11,4,30,5,0,0,5,1,-15,3,1
2,1,7,0,30,2,2,0,4,2,30,1,1,0,2,0,30,1,3,0,4,0,30,1,3,0,4,1,30,2,0,0,2,0,-27,3,0
2,2,7,0,30,2,2,0,4,2,30,1,1,0,2,0,30,1,3,0,4,0,30,1,3,0,4,1,30,2,0,0,2,0,-27,3,0
2,4,7,0,30,2,2,0,4,2,30,1,1,0,2,0,30,1,3,0,4,0,30,1,3,0,4,1,30,2,0,0,2,0,-27,3,0
2,1,11,2,30,7,5,0,12,1,30,4,0,0,4,0,30,5,7,0,12,4,30,4,8,0,12,5,30,4,0,0,4,1,-15,3,1
2,3,11,2,30,7,5,0,12,1,30,4,0,0,4,0,30,5,7,0,12,4,30,4,8,0,12,5,30,4,0,0,4,1,-15,3,1
2,2,19,3,30,3,10,0,13,3,30,8,0,0,8,0,30,5,8,0,13,3,30,4,9,0,13,0,30,8,1,0,9,1,-15,3,1
2,3,19,3,30,3,10,0,13,3,30,8,0,0,8,0,30,5,8,0,13,3,30,4,9,0,13,0,30,8,1,0,9,1,-15,3,1
2,2,25,1,30,7,7,0,14,3,30,6,0,0,6,0,30,8,6,0,14,1,30,7,7,0,14,3,30,6,0,0,6,1,-15,3,1
2,4,27,1,30,5,10,0,15,4,30,2,0,0,2,0,30,5,10,0,15,0,30,6,9,0,15,3,30,6,0,0,6,1,-15,3,1
2,2,29,3,30,10,4,0,14,6,30,8,4,0,12,0,30,2,12,0,14,0,30,1,13,0,14,2,30,9,0,0,9,1,-15,3,1
2,3,29,3,30,10,4,0,14,6,30,8,4,0,12,0,30,2,12,0,14,0,30,1,13,0,14,2,30,9,0,0,9,1,-15,3,1
2,4,29,3,30,10,4,0,14,6,30,8,4,0,12,0,30,2,12,0,14,0,30,1,13,0,14,2,30,9,0,0,9,1,-15,3,1
2,2,39,0,30,4,7,0,11,7,30,6,0,0,6,0,30,5,6,0,11,1,30,5,6,0,11,3,30,5,0,0,5,1,-15,3,1
2,3,4,0,30,6,2,0,8,4,30,3,1,0,4,0,30,2,6,0,8,3,30,6,2,0,8,4,30,4,0,0,4,0,-27,3,0
2,4,4,0,30,6,2,0,8,4,30,3,1,0,4,0,30,2,6,0,8,3,30,6,2,0,8,4,30,4,0,0,4,0,-27,3,0
2,2,17,1,30,8,6,0,14,2,30,6,0,0,6,0,30,4,10,0,14,1,30,6,8,0,14,7,30,4,0,0,4,1,-15,3,1
2,4,22,2,30,8,0,0,8,2,30,2,0,0,2,0,30,4,4,0,8,0,30,3,5,0,8,1,30,1,3,0,4,1,-15,3,1
2,3,25,1,30,7,7,0,14,4,30,6,0,0,6,0,30,8,6,0,14,1,30,5,9,0,14,3,30,5,1,0,6,1,-15,3,1
2,0,26,0,30,8,1,0,9,5,30,4,0,0,4,4,30,1,8,0,9,0,30,2,7,0,9,6,30,3,0,0,3,1,-15,3,1
2,2,26,0,30,8,1,0,9,5,30,4,0,0,4,4,30,1,8,0,9,0,30,2,7,0,9,6,30,3,0,0,3,1,-15,3,1
2,4,26,0,30,8,1,0,9,5,30,4,0,0,4,4,30,1,8,0,9,0,30,2,7,0,9,6,30,3,0,0,3,1,-15,3,1
2,2,27,1,30,4,11,0,15,3,30,2,0,0,2,0,30,5,10,0,15,0,30,6,9,0,15,2,30,6,0,0,6,1,-15,3,1
2,0,31,0,30,6,6,0,12,5,30,8,0,0,8,3,30,10,2,0,12,0,30,5,7,0,12,6,30,4,2,0,6,1,-15,3,1
2,1,31,0,30,6,6,0,12,5,30,8,0,0,8,3,30,10,2,0,12,0,30,5,7,0,12,6,30,4,2,0,6,1,-15,3,1
2,4,35,0,30,7,6,0,13,3,30,2,0,0,2,1,30,8,5,0,13,2,30,1,12,0,13,2,30,7,1,0,8,1,-15,3,1
2,4,39,0,30,3,8,0,11,7,30,6,0,0,6,0,30,5,6,0,11,0,30,4,7,0,11,6,30,5,0,0,5,1,-15,3,1
2,4,1,0,30,7,3,0,10,5,30,2,0,0,2,1,30,3,7,0,10,5,30,9,1,0,10,6,30,6,0,0,6,0,-27,3,0
2,2,5,0,30,1,4,0,5,3,30,1,3,0,4,0,30,0,5,0,5,0,30,1,4,0,5,0,30,1,1,0,2,0,-27,3,0
2,4,5,0,30,1,4,0,5,3,30,1,3,0,4,0,30,0,5,0,5,0,30,1,4,0,5,0,30,1,1,0,2,0,-27,3,0
2,1,6,0,30,7,2,0,9,4,30,2,0,0,2,0,30,2,7,0,9,0,30,4,5,0,9,3,30,5,0,0,5,0,-27,3,0
2,1,11,2,30,6,6,0,12,2,30,4,0,0,4,0,30,5,7,0,12,6,30,5,7,0,12,4,30,3,1,0,4,1,-15,3,1
2,4,15,0,30,5,8,0,13,0,30,6,0,0,6,0,30,4,9,0,13,1,30,4,9,0,13,0,30,5,4,0,9,1,-15,3,1
2,4,17,0,30,9,5,0,14,2,30,6,0,0,6,1,30,6,8,0,14,2,30,6,8,0,14,5,30,4,0,0,4,1,-15,3,1
2,2,25,4,30,7,7,0,14,2,30,6,0,0,6,0,30,12,2,0,14,1,30,6,8,0,14,3,30,5,1,0,6,1,-15,3,1
2,4,27,1,30,5,10,0,15,0,30,2,0,0,2,2,30,6,9,0,15,0,30,4,11,0,15,0,30,5,1,0,6,1,-15,3,1
2,0,4,3,30,7,1,0,8,5,30,4,0,0,4,0,30,2,6,0,8,1,30,8,0,0,8,1,30,3,1,0,4,0,-27,3,0
2,2,6,2,30,8,1,0,9,4,30,2,0,0,2,0,30,2,7,0,9,0,30,4,5,0,9,0,30,2,3,0,5,0,-27,3,0
2,4,6,2,30,8,1,0,9,4,30,2,0,0,2,0,30,2,7,0,9,0,30,4,5,0,9,0,30,2,3,0,5,0,-27,3,0
2,4,7,1,30,5,4,0,9,3,30,4,0,0,4,0,30,5,4,0,9,8,30,2,7,0,9,1,30,6,0,0,6,0,-27,3,0
2,4,13,8,30,7,0,0,7,3,30,4,0,0,4,1,30,6,1,0,7,2,30,7,0,0,7,0,30,4,0,0,4,1,-15,3,1
2,1,17,0,30,6,8,0,14,2,30,6,0,0,6,0,30,6,8,0,14,5,30,8,6,0,14,8,30,4,0,0,4,1,-15,3,1
2,2,17,0,30,6,8,0,14,2,30,6,0,0,6,0,30,6,8,0,14,5,30,8,6,0,14,8,30,4,0,0,4,1,-15,3,1
2,3,17,0,30,6,8,0,14,2,30,6,0,0,6,0,30,6,8,0,14,5,30,8,6,0,14,8,30,4,0,0,4,1,-15,3,1
2,1,19,1,30,5,8,0,13,2,30,7,1,0,8,0,30,6,7,0,13,6,30,5,8,0,13,2,30,9,0,0,9,1,-15,3,1
2,3,19,0,30,5,8,0,13,2,30,7,1,0,8,0,30,6,7,0,13,6,30,5,8,0,13,2,30,9,0,0,9,1,-15,3,1
2,3,25,2,30,5,9,0,14,3,30,6,0,0,6,0,30,5,9,0,14,1,30,9,5,0,14,4,30,6,0,0,6,1,-15,3,1
2,2,27,0,30,4,11,0,15,4,30,2,0,0,2,0,30,7,8,0,15,1,30,4,11,0,15,2,30,6,0,0,6,1,-15,3,1
2,4,29,0,30,7,7,0,14,6,30,12,0,0,12,0,30,2,12,0,14,0,30,1,13,0,14,1,30,9,0,0,9,1,-15,3,1
2,4,31,4,30,7,5,0,12,4,30,8,0,0,8,4,30,10,2,0,12,0,30,3,9,0,12,0,30,3,3,0,6,1,-15,3,1
2,2,8,2,30,7,0,0,7,4,30,2,0,0,2,0,30,4,3,0,7,3,30,7,0,0,7,3,30,3,0,0,3,0,-27,3,0
2,0,17,4,30,8,6,0,14,4,30,6,0,0,6,0,30,5,9,0,14,4,30,8,6,0,14,5,30,4,0,0,4,1,-15,3,1
2,2,17,4,30,8,6,0,14,4,30,6,0,0,6,0,30,5,9,0,14,4,30,8,6,0,14,5,30,4,0,0,4,1,-15,3,1
2,3,17,4,30,8,6,0,14,4,30,6,0,0,6,0,30,5,9,0,14,4,30,8,6,0,14,5,30,4,0,0,4,1,-15,3,1
2,4,19,0,30,5,8,0,13,2,30,8,0,0,8,1,30,4,9,0,13,0,30,4,9,0,13,1,30,6,3,0,9,1,-15,3,1
2,4,25,2,30,13,1,0,14,3,30,6,0,0,6,0,30,8,6,0,14,1,30,6,8,0,14,4,30,4,2,0,6,1,-15,3,1
2,4,27,1,30,4,11,0,15,0,30,2,0,0,2,0,30,6,9,0,15,0,30,3,12,0,15,1,30,5,1,0,6,1,-15,3,1
2,2,29,0,30,7,7,0,14,6,30,6,6,0,12,0,30,4,10,0,14,0,30,6,8,0,14,0,30,8,1,0,9,1,-15,3,1
2,3,29,0,30,7,7,0,14,6,30,6,6,0,12,0,30,4,10,0,14,0,30,6,8,0,14,0,30,8,1,0,9,1,-15,3,1
2,4,29,0,30,7,7,0,14,6,30,6,6,0,12,0,30,4,10,0,14,0,30,6,8,0,14,0,30,8,1,0,9,1,-15,3,1
2,2,31,5,30,10,2,0,12,4,30,8,0,0,8,3,30,10,2,0,12,0,30,2,10,0,12,0,30,3,3,0,6,1,-15,3,1
2,3,39,0,30,4,7,0,11,7,30,6,0,0,6,0,30,4,7,0,11,2,30,4,7,0,11,2,30,5,0,0,5,1,-15,3,1
2,4,39,0,30,4,7,0,11,7,30,6,0,0,6,0,30,4,7,0,11,2,30,4,7,0,11,2,30,5,0,0,5,1,-15,3,1
2,1,4,2,30,7,1,0,8,4,30,4,0,0,4,1,30,2,6,0,8,0,30,4,4,0,8,2,30,4,0,0,4,0,-27,3,0
2,2,4,2,30,7,1,0,8,4,30,4,0,0,4,1,30,2,6,0,8,0,30,4,4,0,8,2,30,4,0,0,4,0,-27,3,0
2,4,13,3,30,7,0,0,7,0,30,4,0,0,4,2,30,6,1,0,7,8,30,3,4,0,7,4,30,4,0,0,4,1,-15,3,1
2,2,23,2,30,6,7,0,13,3,30,6,0,0,6,1,30,12,1,0,13,0,30,6,7,0,13,2,30,6,0,0,6,1,-15,3,1
2,3,23,2,30,6,7,0,13,3,30,6,0,0,6,1,30,12,1,0,13,0,30,6,7,0,13,2,30,6,0,0,6,1,-15,3,1
2,1,25,3,30,9,5,0,14,3,30,6,0,0,6,0,30,4,10,0,14,1,30,6,8,0,14,5,30,6,0,0,6,1,-15,3,1
2,2,27,1,30,4,11,0,15,5,30,1,1,0,2,0,30,3,12,0,15,0,30,4,11,0,15,5,30,6,0,0,6,1,-15,3,1
2,4,27,1,30,4,11,0,15,5,30,1,1,0,2,0,30,3,12,0,15,0,30,4,11,0,15,5,30,6,0,0,6,1,-15,3,1
2,4,32,0,30,7,2,0,9,4,30,2,0,0,2,0,30,7,2,0,9,1,30,3,6,0,9,4,30,2,0,0,2,1,-15,3,1
2,2,37,2,30,6,5,0,11,6,30,8,0,0,8,0,30,5,6,0,11,6,30,3,8,0,11,6,30,6,0,0,6,1,-15,3,1
2,4,37,2,30,6,5,0,11,6,30,8,0,0,8,0,30,5,6,0,11,6,30,3,8,0,11,6,30,6,0,0,6,1,-15,3,1
2,1,4,2,30,7,1,0,8,4,30,4,0,0,4,0,30,3,5,0,8,0,30,5,3,0,8,1,30,4,0,0,4,0,-27,3,0
2,2,4,2,30,7,1,0,8,4,30,4,0,0,4,0,30,3,5,0,8,0,30,5,3,0,8,1,30,4,0,0,4,0,-27,3,0
2,0,17,2,30,4,10,0,14,4,30,6,0,0,6,0,30,3,11,0,14,7,30,8,6,0,14,10,30,4,0,0,4,1,-15,3,1
2,2,19,0,30,3,10,0,13,2,30,4,4,0,8,0,30,7,6,0,13,6,30,5,8,0,13,4,30,9,0,0,9,1,-15,3,1
2,1,27,1,30,6,9,0,15,3,30,2,0,0,2,0,30,7,8,0,15,0,30,5,10,0,15,1,30,6,0,0,6,1,-15,3,1
2,2,27,1,30,6,9,0,15,3,30,2,0,0,2,0,30,7,8,0,15,0,30,5,10,0,15,1,30,6,0,0,6,1,-15,3,1
2,3,27,1,30,6,9,0,15,3,30,2,0,0,2,0,30,7,8,0,15,0,30,5,10,0,15,1,30,6,0,0,6,1,-15,3,1
2,4,27,1,30,6,9,0,15,3,30,2,0,0,2,0,30,7,8,0,15,0,30,5,10,0,15,1,30,6,0,0,6,1,-15,3,1
2,1,5,0,30,2,3,0,5,2,30,1,3,0,4,0,30,3,2,0,5,3,30,2,3,0,5,0,30,0,2,0,2,0,-27,3,0
2,1,17,2,30,9,5,0,14,2,30,6,0,0,6,0,30,5,9,0,14,3,30,5,9,0,14,6,30,4,0,0,4,1,-15,3,1
2,3,23,2,30,6,7,0,13,2,30,6,0,0,6,6,30,12,1,0,13,0,30,4,9,0,13,2,30,5,1,0,6,1,-15,3,1
2,4,23,2,30,6,7,0,13,2,30,6,0,0,6,6,30,12,1,0,13,0,30,4,9,0,13,2,30,5,1,0,6,1,-15,3,1
2,0,25,3,30,5,9,0,14,5,30,6,0,0,6,2,30,7,7,0,14,1,30,5,9,0,14,4,30,5,1,0,6,1,-15,3,1
2,2,27,1,30,3,12,0,15,4,30,2,0,0,2,0,30,5,10,0,15,0,30,10,5,0,15,0,30,3,3,0,6,1,-15,3,1
2,3,27,1,30,3,12,0,15,4,30,2,0,0,2,0,30,5,10,0,15,0,30,10,5,0,15,0,30,3,3,0,6,1,-15,3,1
2,3,29,0,30,12,2,0,14,5,30,9,3,0,12,0,30,4,10,0,14,0,30,1,13,0,14,3,30,9,0,0,9,1,-15,3,1
2,4,29,0,30,12,2,0,14,5,30,9,3,0,12,0,30,4,10,0,14,0,30,1,13,0,14,3,30,9,0,0,9,1,-15,3,1
2,4,39,0,30,3,8,0,11,6,30,6,0,0,6,0,30,4,7,0,11,0,30,2,9,0,11,2,30,5,0,0,5,1,-15,3,1
2,3,8,2,30,7,0,0,7,3,30,2,0,0,2,2,30,7,0,0,7,0,30,5,2,0,7,1,30,3,0,0,3,0,-27,3,0
2,2,13,3,30,7,0,0,7,1,30,4,0,0,4,4,30,7,0,0,7,3,30,7,0,0,7,4,30,4,0,0,4,1,-15,3,1
2,3,13,3,30,7,0,0,7,1,30,4,0,0,4,4,30,7,0,0,7,3,30,7,0,0,7,4,30,4,0,0,4,1,-15,3,1
2,4,13,3,30,7,0,0,7,1,30,4,0,0,4,4,30,7,0,0,7,3,30,7,0,0,7,4,30,4,0,0,4,1,-15,3,1
2,1,19,0,30,3,10,0,13,2,30,5,3,0,8,0,30,4,9,0,13,0,30,6,7,0,13,2,30,8,1,0,9,1,-15,3,1
2,2,19,0,30,3,10,0,13,2,30,5,3,0,8,0,30,4,9,0,13,0,30,6,7,0,13,2,30,8,1,0,9,1,-15,3,1
2,3,19,0,30,3,10,0,13,2,30,5,3,0,8,0,30,4,9,0,13,0,30,6,7,0,13,2,30,8,1,0,9,1,-15,3,1
2,2,31,1,30,4,8,0,12,8,30,8,0,0,8,3,30,4,8,0,12,1,30,10,2,0,12,6,30,6,0,0,6,1,-15,3,1
2,2,35,1,30,7,6,0,13,5,30,2,0,0,2,1,30,2,11,0,13,4,30,3,10,0,13,9,30,8,0,0,8,1,-15,3,1
2,1,17,2,30,10,4,0,14,2,30,6,0,0,6,0,30,4,10,0,14,5,30,6,8,0,14,4,30,4,0,0,4,1,-15,3,1
2,3,17,2,30,10,4,0,14,2,30,6,0,0,6,0,30,4,10,0,14,5,30,6,8,0,14,4,30,4,0,0,4,1,-15,3,1
2,4,22,1,30,5,3,0,8,2,30,2,0,0,2,1,30,4,4,0,8,3,30,4,4,0,8,1,30,2,2,0,4,1,-15,3,1
2,3,23,1,30,5,8,0,13,3,30,6,0,0,6,7,30,12,1,0,13,0,30,5,8,0,13,3,30,6,0,0,6,1,-15,3,1
2,2,27,2,30,8,7,0,15,2,30,2,0,0,2,0,30,6,9,0,15,1,30,3,12,0,15,1,30,4,2,0,6,1,-15,3,1
2,2,39,3,30,7,4,0,11,8,30,5,1,0,6,0,30,4,7,0,11,0,30,2,9,0,11,4,30,5,0,0,5,1,-15,3,1
2,2,43,0,30,5,9,0,14,8,30,6,0,0,6,0,30,5,9,0,14,1,30,3,11,0,14,7,30,5,0,0,5,1,-15,3,1
2,2,5,4,30,2,3,0,5,3,30,0,4,0,4,0,30,1,4,0,5,0,30,1,4,0,5,0,30,0,2,0,2,0,-27,3,0
2,3,5,4,30,2,3,0,5,3,30,0,4,0,4,0,30,1,4,0,5,0,30,1,4,0,5,0,30,0,2,0,2,0,-27,3,0
2,1,11,1,30,5,7,0,12,0,30,4,0,0,4,0,30,11,1,0,12,9,30,5,7,0,12,2,30,4,0,0,4,1,-15,3,1
2,4,13,2,30,7,0,0,7,0,30,4,0,0,4,2,30,5,2,0,7,4,30,3,4,0,7,5,30,4,0,0,4,1,-15,3,1
2,4,17,3,30,7,7,0,14,3,30,6,0,0,6,0,30,6,8,0,14,0,30,8,6,0,14,3,30,4,0,0,4,1,-15,3,1
2,4,19,0,30,2,11,0,13,1,30,7,1,0,8,0,30,13,0,0,13,6,30,4,9,0,13,1,30,5,4,0,9,1,-15,3,1
2,4,23,0,30,7,6,0,13,2,30,6,0,0,6,7,30,13,0,0,13,0,30,4,9,0,13,2,30,6,0,0,6,1,-15,3,1
2,3,26,0,30,4,5,0,9,5,30,4,0,0,4,5,30,1,8,0,9,0,30,2,7,0,9,4,30,2,1,0,3,1,-15,3,1
2,0,33,4,30,7,4,0,11,5,30,4,0,0,4,5,30,9,2,0,11,0,30,3,8,0,11,6,30,4,0,0,4,1,-15,3,1
2,1,33,4,30,7,4,0,11,5,30,4,0,0,4,5,30,9,2,0,11,0,30,3,8,0,11,6,30,4,0,0,4,1,-15,3,1
2,2,33,4,30,7,4,0,11,5,30,4,0,0,4,5,30,9,2,0,11,0,30,3,8,0,11,6,30,4,0,0,4,1,-15,3,1
2,2,35,0,30,6,7,0,13,4,30,2,0,0,2,1,30,2,11,0,13,4,30,5,8,0,13,8,30,8,0,0,8,1,-15,3,1
2,2,43,0,30,9,5,0,14,7,30,6,0,0,6,0,30,4,10,0,14,1,30,5,9,0,14,2,30,5,0,0,5,1,-15,3,1
2,3,47,0,30,1,13,0,14,6,30,4,0,0,4,0,30,3,11,0,14,3,30,3,11,0,14,7,30,7,0,0,7,1,-15,3,1
2,2,13,2,30,6,1,0,7,0,30,4,0,0,4,5,30,6,1,0,7,8,30,7,0,0,7,3,30,4,0,0,4,1,-15,3,1
2,4,13,2,30,6,1,0,7,0,30,4,0,0,4,5,30,6,1,0,7,8,30,7,0,0,7,3,30,4,0,0,4,1,-15,3,1
2,0,25,1,30,6,8,0,14,4,30,6,0,0,6,0,30,7,7,0,14,1,30,7,7,0,14,5,30,6,0,0,6,1,-15,3,1
2,1,25,1,30,6,8,0,14,4,30,6,0,0,6,0,30,7,7,0,14,1,30,7,7,0,14,5,30,6,0,0,6,1,-15,3,1
2,0,27,1,30,4,11,0,15,3,30,2,0,0,2,0,30,3,12,0,15,6,30,3,12,0,15,5,30,6,0,0,6,1,-15,3,1
2,3,27,1,30,4,11,0,15,3,30,2,0,0,2,0,30,3,12,0,15,6,30,3,12,0,15,5,30,6,0,0,6,1,-15,3,1
2,4,27,1,30,4,11,0,15,3,30,2,0,0,2,0,30,3,12,0,15,6,30,3,12,0,15,5,30,6,0,0,6,1,-15,3,1
2,4,7,1,30,6,3,0,9,3,30,4,0,0,4,1,30,7,2,0,9,8,30,3,6,0,9,3,30,6,0,0,6,0,-27,3,0
2,1,13,4,30,3,0,0,3,1,30,2,0,0,2,0,30,3,0,0,3,5,30,2,1,0,3,4,30,2,0,0,2,1,-15,3,1
2,2,13,4,30,3,0,0,3,1,30,2,0,0,2,0,30,3,0,0,3,5,30,2,1,0,3,4,30,2,0,0,2,1,-15,3,1
2,3,13,4,30,3,0,0,3,1,30,2,0,0,2,0,30,3,0,0,3,5,30,2,1,0,3,4,30,2,0,0,2,1,-15,3,1
2,1,17,3,30,8,6,0,14,3,30,6,0,0,6,0,30,6,8,0,14,5,30,5,9,0,14,5,30,4,0,0,4,1,-15,3,1
2,3,17,3,30,8,6,0,14,3,30,6,0,0,6,0,30,6,8,0,14,5,30,5,9,0,14,5,30,4,0,0,4,1,-15,3,1
2,2,19,0,30,4,9,0,13,2,30,3,5,0,8,0,30,6,7,0,13,9,30,4,9,0,13,2,30,9,0,0,9,1,-15,3,1
2,2,25,2,30,8,6,0,14,0,30,6,0,0,6,0,30,11,3,0,14,1,30,5,9,0,14,3,30,5,1,0,6,1,-15,3,1
2,3,25,2,30,8,6,0,14,0,30,6,0,0,6,0,30,11,3,0,14,1,30,5,9,0,14,3,30,5,1,0,6,1,-15,3,1
2,4,25,2,30,8,6,0,14,0,30,6,0,0,6,0,30,11,3,0,14,1,30,5,9,0,14,3,30,5,1,0,6,1,-15,3,1
2,4,29,0,30,5,9,0,14,5,30,11,1,0,12,0,30,2,12,0,14,0,30,2,12,0,14,4,30,9,0,0,9,1,-15,3,1
2,3,39,0,30,3,8,0,11,7,30,6,0,0,6,0,30,4,7,0,11,0,30,4,7,0,11,7,30,5,0,0,5,1,-15,3,1
2,3,8,2,30,7,0,0,7,5,30,2,0,0,2,3,30,2,5,0,7,0,30,7,0,0,7,1,30,3,0,0,3,0,-27,3,0
2,2,13,0,30,5,2,0,7,0,30,4,0,0,4,2,30,6,1,0,7,6,30,6,1,0,7,5,30,4,0,0,4,1,-15,3,1
2,3,13,0,30,5,2,0,7,0,30,4,0,0,4,2,30,6,1,0,7,6,30,6,1,0,7,5,30,4,0,0,4,1,-15,3,1
2,4,13,0,30,5,2,0,7,0,30,4,0,0,4,2,30,6,1,0,7,6,30,6,1,0,7,5,30,4,0,0,4,1,-15,3,1
2,2,17,3,30,10,4,0,14,4,30,6,0,0,6,0,30,3,11,0,14,4,30,7,7,0,14,5,30,4,0,0,4,1,-15,3,1
2,3,17,3,30,10,4,0,14,4,30,6,0,0,6,0,30,3,11,0,14,4,30,7,7,0,14,5,30,4,0,0,4,1,-15,3,1
2,4,17,3,30,10,4,0,14,4,30,6,0,0,6,0,30,3,11,0,14,4,30,7,7,0,14,5,30,4,0,0,4,1,-15,3,1
2,4,22,5,30,8,0,0,8,4,30,2,0,0,2,0,30,4,4,0,8,1,30,2,6,0,8,1,30,2,2,0,4,1,-15,3,1
2,4,23,1,30,7,6,0,13,2,30,6,0,0,6,2,30,12,1,0,13,1,30,5,8,0,13,3,30,6,0,0,6,1,-15,3,1
2,2,25,2,30,6,8,0,14,2,30,6,0,0,6,2,30,14,0,0,14,1,30,5,9,0,14,4,30,5,1,0,6,1,-15,3,1
2,4,31,1,30,4,8,0,12,5,30,8,0,0,8,11,30,9,3,0,12,0,30,5,7,0,12,0,30,3,3,0,6,1,-15,3,1
2,4,39,0,30,3,8,0,11,5,30,6,0,0,6,0,30,8,3,0,11,6,30,4,7,0,11,0,30,1,4,0,5,1,-15,3,1
2,3,41,0,30,8,4,0,12,8,30,8,0,0,8,0,30,3,9,0,12,0,30,3,9,0,12,2,30,7,0,0,7,1,-15,3,1
2,4,41,0,30,8,4,0,12,8,30,8,0,0,8,0,30,3,9,0,12,0,30,3,9,0,12,2,30,7,0,0,7,1,-15,3,1
2,0,6,1,30,8,1,0,9,4,30,2,0,0,2,0,30,2,7,0,9,0,30,4,5,0,9,1,30,2,3,0,5,0,-27,3,0
2,4,13,2,30,6,1,0,7,0,30,4,0,0,4,2,30,7,0,0,7,8,30,5,2,0,7,3,30,4,0,0,4,1,-15,3,1
2,4,15,0,30,3,10,0,13,1,30,6,0,0,6,0,30,3,10,0,13,1,30,7,6,0,13,2,30,3,6,0,9,1,-15,3,1
2,0,17,3,30,10,4,0,14,4,30,6,0,0,6,0,30,2,12,0,14,1,30,6,8,0,14,4,30,4,0,0,4,1,-15,3,1
2,2,19,0,30,4,9,0,13,2,30,6,2,0,8,0,30,5,8,0,13,7,30,5,8,0,13,1,30,8,1,0,9,1,-15,3,1
2,3,23,0,30,5,8,0,13,2,30,6,0,0,6,3,30,13,0,0,13,0,30,6,7,0,13,0,30,6,0,0,6,1,-15,3,1
2,3,25,1,30,5,9,0,14,4,30,6,0,0,6,0,30,4,10,0,14,1,30,5,9,0,14,6,30,6,0,0,6,1,-15,3,1
2,4,25,1,30,5,9,0,14,4,30,6,0,0,6,0,30,4,10,0,14,1,30,5,9,0,14,6,30,6,0,0,6,1,-15,3,1
2,0,27,1,30,7,8,0,15,4,30,1,1,0,2,0,30,8,7,0,15,0,30,4,11,0,15,2,30,6,0,0,6,1,-15,3,1
2,2,27,1,30,7,8,0,15,4,30,1,1,0,2,0,30,8,7,0,15,0,30,4,11,0,15,2,30,6,0,0,6,1,-15,3,1
2,4,27,1,30,7,8,0,15,4,30,1,1,0,2,0,30,8,7,0,15,0,30,4,11,0,15,2,30,6,0,0,6,1,-15,3,1
2,3,37,1,30,6,5,0,11,9,30,8,0,0,8,0,30,2,9,0,11,0,30,7,4,0,11,6,30,6,0,0,6,1,-15,3,1
2,4,37,1,30,6,5,0,11,9,30,8,0,0,8,0,30,2,9,0,11,0,30,7,4,0,11,6,30,6,0,0,6,1,-15,3,1
2,4,17,4,30,10,4,0,14,4,30,6,0,0,6,0,30,3,11,0,14,2,30,8,6,0,14,2,30,4,0,0,4,1,-15,3,1
2,2,25,1,30,4,10,0,14,4,30,6,0,0,6,0,30,6,8,0,14,1,30,9,5,0,14,5,30,6,0,0,6,1,-15,3,1
2,1,27,1,30,5,10,0,15,3,30,2,0,0,2,0,30,4,11,0,15,0,30,4,11,0,15,4,30,6,0,0,6,1,-15,3,1
2,3,27,1,30,5,10,0,15,3,30,2,0,0,2,0,30,4,11,0,15,0,30,4,11,0,15,4,30,6,0,0,6,1,-15,3,1
2,4,30,4,30,5,0,0,5,5,30,2,0,0,2,1,30,2,3,0,5,3,30,1,4,0,5,0,30,3,0,0,3,1,-15,3,1
2,1,31,1,30,4,8,0,12,4,30,8,0,0,8,4,30,11,1,0,12,0,30,3,9,0,12,4,30,2,4,0,6,1,-15,3,1
2,3,35,0,30,6,7,0,13,3,30,2,0,0,2,3,30,10,3,0,13,0,30,4,9,0,13,0,30,6,2,0,8,1,-15,3,1
2,0,39,2,30,1,10,0,11,6,30,6,0,0,6,0,30,8,3,0,11,0,30,2,9,0,11,3,30,5,0,0,5,1,-15,3,1
2,1,39,2,30,1,10,0,11,6,30,6,0,0,6,0,30,8,3,0,11,0,30,2,9,0,11,3,30,5,0,0,5,1,-15,3,1
2,2,39,2,30,1,10,0,11,6,30,6,0,0,6,0,30,8,3,0,11,0,30,2,9,0,11,3,30,5,0,0,5,1,-15,3,1
2,3,39,2,30,1,10,0,11,6,30,6,0,0,6,0,30,8,3,0,11,0,30,2,9,0,11,3,30,5,0,0,5,1,-15,3,1
2,4,11,0,30,4,8,0,12,2,30,4,0,0,4,0,30,2,10,0,12,3,30,5,7,0,12,5,30,4,0,0,4,1,-15,3,1
2,1,13,3,30,5,2,0,7,0,30,4,0,0,4,2,30,5,2,0,7,12,30,6,1,0,7,4,30,4,0,0,4,1,-15,3,1
2,4,13,3,30,5,2,0,7,0,30,4,0,0,4,2,30,5,2,0,7,12,30,6,1,0,7,4,30,4,0,0,4,1,-15,3,1
2,2,19,0,30,5,8,0,13,2,30,3,5,0,8,0,30,8,5,0,13,3,30,4,9,0,13,3,30,8,1,0,9,1,-15,3,1
2,3,19,0,30,5,8,0,13,2,30,3,5,0,8,0,30,8,5,0,13,3,30,4,9,0,13,3,30,8,1,0,9,1,-15,3,1
2,4,19,0,30,5,8,0,13,2,30,3,5,0,8,0,30,8,5,0,13,3,30,4,9,0,13,3,30,8,1,0,9,1,-15,3,1
2,3,23,0,30,5,8,0,13,0,30,6,0,0,6,4,30,11,2,0,13,2,30,6,7,0,13,3,30,6,0,0,6,1,-15,3,1
2,1,25,1,30,6,8,0,14,5,30,6,0,0,6,0,30,7,7,0,14,1,30,7,7,0,14,8,30,6,0,0,6,1,-15,3,1
2,2,25,1,30,6,8,0,14,5,30,6,0,0,6,0,30,7,7,0,14,1,30,7,7,0,14,8,30,6,0,0,6,1,-15,3,1
2,3,25,1,30,6,8,0,14,5,30,6,0,0,6,0,30,7,7,0,14,1,30,7,7,0,14,8,30,6,0,0,6,1,-15,3,1
2,0,27,1,30,4,11,0,15,5,30,2,0,0,2,0,30,3,12,0,15,0,30,5,10,0,15,3,30,6,0,0,6,1,-15,3,1
2,4,29,0,30,8,6,0,14,6,30,12,0,0,12,0,30,5,9,0,14,0,30,1,13,0,14,0,30,9,0,0,9,1,-15,3,1
2,2,39,0,30,4,7,0,11,6,30,6,0,0,6,0,30,8,3,0,11,0,30,2,9,0,11,4,30,5,0,0,5,1,-15,3,1
2,3,39,0,30,4,7,0,11,6,30,6,0,0,6,0,30,8,3,0,11,0,30,2,9,0,11,4,30,5,0,0,5,1,-15,3,1
2,0,4,2,30,5,3,0,8,4,30,4,0,0,4,2,30,1,7,0,8,0,30,6,2,0,8,4,30,4,0,0,4,0,-27,3,0
2,1,5,0,30,2,3,0,5,2,30,4,0,0,4,0,30,1,4,0,5,0,30,2,3,0,5,1,30,1,1,0,2,0,-27,3,0
2,4,15,1,30,4,9,0,13,2,30,6,0,0,6,0,30,3,10,0,13,1,30,6,7,0,13,0,30,9,0,0,9,1,-15,3,1
2,4,17,5,30,12,2,0,14,2,30,6,0,0,6,0,30,6,8,0,14,1,30,5,9,0,14,2,30,2,2,0,4,1,-15,3,1
2,4,22,1,30,8,0,0,8,3,30,2,0,0,2,0,30,5,3,0,8,1,30,4,4,0,8,2,30,3,1,0,4,1,-15,3,1
2,1,23,2,30,5,8,0,13,2,30,6,0,0,6,0,30,12,1,0,13,0,30,5,8,0,13,4,30,6,0,0,6,1,-15,3,1
2,4,25,1,30,11,3,0,14,5,30,6,0,0,6,0,30,3,11,0,14,1,30,6,8,0,14,2,30,6,0,0,6,1,-15,3,1
2,2,27,0,30,6,9,0,15,1,30,2,0,0,2,0,30,9,6,0,15,2,30,4,11,0,15,1,30,4,2,0,6,1,-15,3,1
2,3,27,0,30,6,9,0,15,1,30,2,0,0,2,0,30,9,6,0,15,2,30,4,11,0,15,1,30,4,2,0,6,1,-15,3,1
2,1,33,3,30,7,4,0,11,5,30,4,0,0,4,3,30,11,0,0,11,0,30,3,8,0,11,6,30,4,0,0,4,1,-15,3,1
2,3,33,3,30,7,4,0,11,5,30,4,0,0,4,3,30,11,0,0,11,0,30,3,8,0,11,6,30,4,0,0,4,1,-15,3,1
2,0,4,3,30,7,1,0,8,4,30,4,0,0,4,0,30,2,6,0,8,0,30,5,3,0,8,2,30,4,0,0,4,0,-27,3,0
2,1,4,3,30,7,1,0,8,4,30,4,0,0,4,0,30,2,6,0,8,0,30,5,3,0,8,2,30,4,0,0,4,0,-27,3,0
2,2,6,4,30,9,0,0,9,4,30,2,0,0,2,0,30,2,7,0,9,0,30,3,6,0,9,0,30,3,2,0,5,0,-27,3,0
2,4,6,4,30,9,0,0,9,4,30,2,0,0,2,0,30,2,7,0,9,0,30,3,6,0,9,0,30,3,2,0,5,0,-27,3,0
2,1,13,5,30,7,0,0,7,0,30,4,0,0,4,3,30,5,2,0,7,7,30,6,1,0,7,3,30,4,0,0,4,1,-15,3,1
2,4,13,5,30,7,0,0,7,0,30,4,0,0,4,3,30,5,2,0,7,7,30,6,1,0,7,3,30,4,0,0,4,1,-15,3,1
2,0,19,1,30,3,10,0,13,2,30,6,2,0,8,0,30,7,6,0,13,6,30,5,8,0,13,2,30,8,1,0,9,1,-15,3,1
2,3,23,2,30,4,9,0,13,4,30,6,0,0,6,6,30,11,2,0,13,0,30,8,5,0,13,2,30,6,0,0,6,1,-15,3,1
2,0,27,1,30,5,10,0,15,2,30,2,0,0,2,0,30,7,8,0,15,1,30,5,10,0,15,3,30,6,0,0,6,1,-15,3,1
2,2,27,0,30,5,10,0,15,2,30,2,0,0,2,0,30,7,8,0,15,1,30,5,10,0,15,3,30,6,0,0,6,1,-15,3,1
2,4,3,0,30,0,4,0,4,2,30,4,0,0,4,0,30,0,4,0,4,6,30,0,4,0,4,5,30,3,0,0,3,0,-27,3,0
2,3,4,2,30,6,2,0,8,5,30,4,0,0,4,1,30,2,6,0,8,0,30,5,3,0,8,2,30,4,0,0,4,0,-27,3,0
2,2,9,0,30,7,4,0,11,3,30,6,0,0,6,1,30,7,4,0,11,6,30,4,7,0,11,4,30,3,1,0,4,0,-27,3,0
2,4,9,0,30,7,4,0,11,3,30,6,0,0,6,1,30,7,4,0,11,6,30,4,7,0,11,4,30,3,1,0,4,0,-27,3,0
2,0,21,3,30,6,4,0,10,3,30,5,1,0,6,1,30,5,5,0,10,5,30,5,5,0,10,4,30,4,0,0,4,1,-15,3,1
2,1,21,3,30,6,4,0,10,3,30,5,1,0,6,1,30,5,5,0,10,5,30,5,5,0,10,4,30,4,0,0,4,1,-15,3,1
2,2,21,3,30,6,4,0,10,3,30,5,1,0,6,1,30,5,5,0,10,5,30,5,5,0,10,4,30,4,0,0,4,1,-15,3,1
2,3,21,3,30,6,4,0,10,3,30,5,1,0,6,1,30,5,5,0,10,5,30,5,5,0,10,4,30,4,0,0,4,1,-15,3,1
2,3,27,1,30,4,11,0,15,4,30,2,0,0,2,0,30,5,10,0,15,0,30,6,9,0,15,6,30,6,0,0,6,1,-15,3,1
2,4,27,1,30,4,11,0,15,4,30,2,0,0,2,0,30,5,10,0,15,0,30,6,9,0,15,6,30,6,0,0,6,1,-15,3,1
2,3,43,0,30,6,8,0,14,6,30,6,0,0,6,0,30,4,10,0,14,1,30,6,8,0,14,8,30,5,0,0,5,1,-15,3,1
2,1,13,3,30,6,1,0,7,0,30,4,0,0,4,1,30,7,0,0,7,5,30,6,1,0,7,4,30,4,0,0,4,1,-15,3,1
2,3,13,3,30,6,1,0,7,0,30,4,0,0,4,1,30,7,0,0,7,5,30,6,1,0,7,4,30,4,0,0,4,1,-15,3,1
2,4,13,3,30,6,1,0,7,0,30,4,0,0,4,1,30,7,0,0,7,5,30,6,1,0,7,4,30,4,0,0,4,1,-15,3,1
2,4,22,1,30,8,0,0,8,3,30,2,0,0,2,0,30,4,4,0,8,1,30,6,2,0,8,2,30,3,1,0,4,1,-15,3,1
2,4,23,2,30,6,7,0,13,1,30,6,0,0,6,2,30,13,0,0,13,0,30,4,9,0,13,3,30,6,0,0,6,1,-15,3,1
2,2,25,0,30,7,7,0,14,4,30,6,0,0,6,0,30,8,6,0,14,2,30,6,8,0,14,3,30,5,1,0,6,1,-15,3,1
2,3,25,0,30,7,7,0,14,4,30,6,0,0,6,0,30,8,6,0,14,2,30,6,8,0,14,3,30,5,1,0,6,1,-15,3,1
2,4,25,0,30,7,7,0,14,4,30,6,0,0,6,0,30,8,6,0,14,2,30,6,8,0,14,3,30,5,1,0,6,1,-15,3,1
2,3,27,0,30,5,10,0,15,1,30,2,0,0,2,0,30,11,4,0,15,0,30,4,11,0,15,0,30,2,4,0,6,1,-15,3,1
2,0,29,0,30,8,6,0,14,5,30,12,0,0,12,0,30,4,10,0,14,0,30,1,13,0,14,5,30,9,0,0,9,1,-15,3,1
2,2,29,0,30,8,6,0,14,5,30,12,0,0,12,0,30,4,10,0,14,0,30,1,13,0,14,5,30,9,0,0,9,1,-15,3,1
2,3,29,0,30,8,6,0,14,5,30,12,0,0,12,0,30,4,10,0,14,0,30,1,13,0,14,5,30,9,0,0,9,1,-15,3,1
2,3,8,3,30,7,0,0,7,4,30,2,0,0,2,3,30,2,5,0,7,0,30,5,2,0,7,8,30,3,0,0,3,0,-27,3,0
2,3,17,3,30,7,7,0,14,2,30,6,0,0,6,1,30,8,6,0,14,2,30,6,8,0,14,2,30,2,2,0,4,1,-15,3,1
2,1,23,1,30,5,8,0,13,2,30,6,0,0,6,3,30,7,6,0,13,6,30,6,7,0,13,4,30,6,0,0,6,1,-15,3,1
2,2,25,1,30,10,4,0,14,4,30,6,0,0,6,0,30,3,11,0,14,1,30,7,7,0,14,4,30,6,0,0,6,1,-15,3,1
2,3,25,1,30,10,4,0,14,4,30,6,0,0,6,0,30,3,11,0,14,1,30,7,7,0,14,4,30,6,0,0,6,1,-15,3,1
2,1,27,2,30,4,11,0,15,3,30,1,1,0,2,0,30,8,7,0,15,2,30,3,12,0,15,1,30,6,0,0,6,1,-15,3,1
2,4,27,2,30,4,11,0,15,3,30,1,1,0,2,0,30,8,7,0,15,2,30,3,12,0,15,1,30,6,0,0,6,1,-15,3,1
2,4,31,2,30,3,9,0,12,4,30,8,0,0,8,1,30,10,2,0,12,0,30,6,6,0,12,0,30,5,1,0,6,1,-15,3,1
2,3,35,0,30,7,6,0,13,5,30,2,0,0,2,1,30,4,9,0,13,3,30,2,11,0,13,0,30,8,0,0,8,1,-15,3,1
2,0,4,2,30,8,0,0,8,4,30,2,2,0,4,0,30,5,3,0,8,0,30,4,4,0,8,1,30,4,0,0,4,0,-27,3,0
2,4,4,2,30,8,0,0,8,4,30,2,2,0,4,0,30,5,3,0,8,0,30,4,4,0,8,1,30,4,0,0,4,0,-27,3,0
2,1,5,0,30,1,4,0,5,3,30,3,1,0,4,0,30,0,5,0,5,0,30,5,0,0,5,0,30,0,2,0,2,0,-27,3,0
2,3,5,0,30,1,4,0,5,3,30,3,1,0,4,0,30,0,5,0,5,0,30,5,0,0,5,0,30,0,2,0,2,0,-27,3,0
2,4,5,0,30,1,4,0,5,3,30,3,1,0,4,0,30,0,5,0,5,0,30,5,0,0,5,0,30,0,2,0,2,0,-27,3,0
2,2,13,3,30,6,1,0,7,0,30,4,0,0,4,2,30,6,1,0,7,4,30,7,0,0,7,3,30,4,0,0,4,1,-15,3,1
2,4,13,3,30,6,1,0,7,0,30,4,0,0,4,2,30,6,1,0,7,4,30,7,0,0,7,3,30,4,0,0,4,1,-15,3,1
2,2,17,0,30,8,6,0,14,2,30,6,0,0,6,0,30,5,9,0,14,2,30,5,9,0,14,3,30,4,0,0,4,1,-15,3,1
2,4,17,0,30,8,6,0,14,2,30,6,0,0,6,0,30,5,9,0,14,2,30,5,9,0,14,3,30,4,0,0,4,1,-15,3,1
2,3,23,1,30,6,7,0,13,3,30,6,0,0,6,3,30,12,1,0,13,0,30,7,6,0,13,4,30,6,0,0,6,1,-15,3,1
2,2,25,3,30,8,6,0,14,5,30,6,0,0,6,0,30,8,6,0,14,1,30,5,9,0,14,3,30,5,1,0,6,1,-15,3,1
2,3,27,1,30,4,11,0,15,4,30,2,0,0,2,0,30,9,6,0,15,0,30,7,8,0,15,0,30,6,0,0,6,1,-15,3,1
2,4,27,1,30,4,11,0,15,4,30,2,0,0,2,0,30,9,6,0,15,0,30,7,8,0,15,0,30,6,0,0,6,1,-15,3,1
2,2,4,8,30,8,0,0,8,5,30,4,0,0,4,0,30,1,7,0,8,0,30,0,8,0,8,1,30,3,1,0,4,0,-27,3,0
2,3,4,8,30,8,0,0,8,5,30,4,0,0,4,0,30,1,7,0,8,0,30,0,8,0,8,1,30,3,1,0,4,0,-27,3,0
2,3,9,0,30,7,4,0,11,2,30,6,0,0,6,0,30,9,2,0,11,5,30,3,8,0,11,2,30,3,1,0,4,0,-27,3,0
2,2,17,3,30,8,6,0,14,2,30,6,0,0,6,0,30,8,6,0,14,5,30,5,9,0,14,7,30,4,0,0,4,1,-15,3,1
2,2,21,8,30,8,2,0,10,5,30,6,0,0,6,1,30,3,7,0,10,1,30,5,5,0,10,0,30,3,1,0,4,1,-15,3,1
2,4,23,1,30,8,5,0,13,2,30,6,0,0,6,7,30,10,3,0,13,0,30,6,7,0,13,1,30,5,1,0,6,1,-15,3,1
2,3,25,2,30,8,6,0,14,4,30,6,0,0,6,0,30,10,4,0,14,0,30,5,9,0,14,3,30,5,1,0,6,1,-15,3,1
2,0,27,1,30,6,9,0,15,2,30,2,0,0,2,0,30,8,7,0,15,1,30,5,10,0,15,2,30,6,0,0,6,1,-15,3,1
2,2,27,1,30,6,9,0,15,2,30,2,0,0,2,0,30,8,7,0,15,1,30,5,10,0,15,2,30,6,0,0,6,1,-15,3,1
2,4,27,1,30,6,9,0,15,2,30,2,0,0,2,0,30,8,7,0,15,1,30,5,10,0,15,2,30,6,0,0,6,1,-15,3,1
2,1,29,1,30,6,8,0,14,6,30,7,5,0,12,1,30,8,6,0,14,0,30,1,13,0,14,2,30,9,0,0,9,1,-15,3,1
2,3,7,4,30,3,1,0,4,2,30,2,0,0,2,0,30,1,3,0,4,0,30,0,4,0,4,2,30,1,1,0,2,0,-27,3,0
2,3,8,2,30,6,1,0,7,4,30,2,0,0,2,3,30,2,5,0,7,1,30,4,3,0,7,1,30,3,0,0,3,0,-27,3,0
2,4,8,2,30,6,1,0,7,4,30,2,0,0,2,3,30,2,5,0,7,1,30,4,3,0,7,1,30,3,0,0,3,0,-27,3,0
2,4,13,4,30,3,0,0,3,2,30,2,0,0,2,0,30,2,1,0,3,4,30,2,1,0,3,2,30,2,0,0,2,1,-15,3,1
2,4,13,5,30,7,0,0,7,2,30,4,0,0,4,2,30,5,2,0,7,5,30,6,1,0,7,2,30,4,0,0,4,1,-15,3,1
2,4,15,2,30,4,9,0,13,1,30,6,0,0,6,0,30,4,9,0,13,0,30,2,11,0,13,2,30,7,2,0,9,1,-15,3,1
2,0,19,0,30,3,10,0,13,3,30,8,0,0,8,0,30,4,9,0,13,9,30,4,9,0,13,3,30,9,0,0,9,1,-15,3,1
2,2,19,0,30,3,10,0,13,3,30,8,0,0,8,0,30,4,9,0,13,9,30,4,9,0,13,3,30,9,0,0,9,1,-15,3,1
2,1,25,1,30,7,7,0,14,5,30,6,0,0,6,0,30,6,8,0,14,1,30,5,9,0,14,6,30,5,1,0,6,1,-15,3,1
2,0,27,1,30,3,12,0,15,2,30,1,1,0,2,0,30,5,10,0,15,4,30,8,7,0,15,1,30,6,0,0,6,1,-15,3,1
2,3,29,0,30,9,5,0,14,6,30,11,1,0,12,0,30,3,11,0,14,0,30,0,14,0,14,0,30,9,0,0,9,1,-15,3,1
2,4,29,0,30,9,5,0,14,6,30,11,1,0,12,0,30,3,11,0,14,0,30,0,14,0,14,0,30,9,0,0,9,1,-15,3,1
2,3,13,3,30,7,0,0,7,2,30,4,0,0,4,8,30,6,1,0,7,4,30,5,2,0,7,4,30,4,0,0,4,1,-15,3,1
2,4,13,3,30,7,0,0,7,2,30,4,0,0,4,8,30,6,1,0,7,4,30,5,2,0,7,4,30,4,0,0,4,1,-15,3,1
2,2,18,0,30,4,4,0,8,2,30,4,0,0,4,0,30,1,7,0,8,5,30,3,5,0,8,0,30,2,3,0,5,1,-15,3,1
2,3,22,2,30,8,0,0,8,3,30,2,0,0,2,0,30,4,4,0,8,0,30,5,3,0,8,4,30,4,0,0,4,1,-15,3,1
2,3,25,1,30,12,2,0,14,1,30,6,0,0,6,1,30,10,4,0,14,1,30,5,9,0,14,1,30,5,1,0,6,1,-15,3,1
2,4,25,1,30,12,2,0,14,1,30,6,0,0,6,1,30,10,4,0,14,1,30,5,9,0,14,1,30,5,1,0,6,1,-15,3,1
2,4,27,0,30,4,11,0,15,2,30,1,1,0,2,0,30,10,5,0,15,0,30,4,11,0,15,2,30,6,0,0,6,1,-15,3,1
2,2,39,0,30,5,6,0,11,7,30,6,0,0,6,0,30,5,6,0,11,0,30,4,7,0,11,6,30,5,0,0,5,1,-15,3,1
2,3,39,0,30,5,6,0,11,7,30,6,0,0,6,0,30,5,6,0,11,0,30,4,7,0,11,6,30,5,0,0,5,1,-15,3,1
2,4,39,0,30,5,6,0,11,7,30,6,0,0,6,0,30,5,6,0,11,0,30,4,7,0,11,6,30,5,0,0,5,1,-15,3,1
2,0,4,2,30,7,1,0,8,5,30,4,0,0,4,0,30,1,7,0,8,0,30,5,3,0,8,3,30,4,0,0,4,0,-27,3,0
2,3,11,0,30,8,4,0,12,1,30,4,0,0,4,0,30,5,7,0,12,4,30,5,7,0,12,6,30,4,0,0,4,1,-15,3,1
2,4,17,0,30,9,5,0,14,2,30,6,0,0,6,0,30,5,9,0,14,1,30,5,9,0,14,5,30,4,0,0,4,1,-15,3,1
2,1,25,1,30,8,6,0,14,2,30,6,0,0,6,0,30,14,0,0,14,1,30,4,10,0,14,3,30,5,1,0,6,1,-15,3,1
2,3,25,1,30,8,6,0,14,2,30,6,0,0,6,0,30,14,0,0,14,0,30,4,10,0,14,3,30,5,1,0,6,1,-15,3,1
2,0,27,1,30,2,13,0,15,3,30,1,1,0,2,0,30,5,10,0,15,2,30,5,10,0,15,6,30,6,0,0,6,1,-15,3,1
2,2,27,1,30,2,13,0,15,3,30,1,1,0,2,0,30,5,10,0,15,2,30,5,10,0,15,6,30,6,0,0,6,1,-15,3,1
2,2,29,0,30,6,8,0,14,6,30,10,2,0,12,0,30,3,11,0,14,0,30,5,9,0,14,3,30,9,0,0,9,1,-15,3,1
2,4,29,0,30,6,8,0,14,6,30,10,2,0,12,0,30,3,11,0,14,0,30,5,9,0,14,3,30,9,0,0,9,1,-15,3,1
2,2,31,2,30,7,5,0,12,4,30,8,0,0,8,4,30,9,3,0,12,0,30,3,9,0,12,0,30,3,3,0,6,1,-15,3,1
2,4,13,12,30,3,0,0,3,3,30,2,0,0,2,0,30,3,0,0,3,0,30,1,2,0,3,0,30,2,0,0,2,1,-15,3,1
2,2,13,13,30,7,0,0,7,2,30,4,0,0,4,1,30,6,1,0,7,1,30,5,2,0,7,1,30,4,0,0,4,1,-15,3,1
2,4,13,13,30,7,0,0,7,2,30,4,0,0,4,1,30,6,1,0,7,1,30,5,2,0,7,1,30,4,0,0,4,1,-15,3,1
2,4,17,1,30,4,10,0,14,3,30,6,0,0,6,0,30,7,7,0,14,2,30,8,6,0,14,5,30,4,0,0,4,1,-15,3,1
2,2,25,1,30,5,9,0,14,4,30,6,0,0,6,0,30,6,8,0,14,2,30,5,9,0,14,4,30,6,0,0,6,1,-15,3,1
2,3,25,1,30,5,9,0,14,4,30,6,0,0,6,0,30,6,8,0,14,2,30,5,9,0,14,4,30,6,0,0,6,1,-15,3,1
2,2,26,0,30,7,2,0,9,5,30,4,0,0,4,4,30,1,8,0,9,0,30,4,5,0,9,7,30,3,0,0,3,1,-15,3,1
2,2,27,1,30,5,10,0,15,0,30,1,1,0,2,0,30,5,10,0,15,2,30,4,11,0,15,4,30,6,0,0,6,1,-15,3,1
2,2,33,1,30,2,9,0,11,5,30,4,0,0,4,0,30,6,5,0,11,3,30,6,5,0,11,5,30,4,0,0,4,1,-15,3,1
2,3,33,1,30,2,9,0,11,5,30,4,0,0,4,0,30,6,5,0,11,3,30,6,5,0,11,5,30,4,0,0,4,1,-15,3,1
2,4,33,1,30,2,9,0,11,5,30,4,0,0,4,0,30,6,5,0,11,3,30,6,5,0,11,5,30,4,0,0,4,1,-15,3,1
2,3,35,0,30,6,7,0,13,3,30,2,0,0,2,1,30,9,4,0,13,2,30,3,10,0,13,4,30,8,0,0,8,1,-15,3,1
2,2,13,1,30,6,1,0,7,0,30,4,0,0,4,2,30,5,2,0,7,13,30,6,1,0,7,4,30,4,0,0,4,1,-15,3,1
2,3,19,0,30,4,9,0,13,2,30,5,3,0,8,0,30,7,6,0,13,4,30,4,9,0,13,1,30,8,1,0,9,1,-15,3,1
2,4,19,0,30,4,9,0,13,2,30,5,3,0,8,0,30,7,6,0,13,4,30,4,9,0,13,1,30,8,1,0,9,1,-15,3,1
2,1,21,2,30,6,4,0,10,3,30,4,2,0,6,0,30,3,7,0,10,1,30,4,6,0,10,3,30,4,0,0,4,1,-15,3,1
2,2,21,2,30,6,4,0,10,3,30,4,2,0,6,0,30,3,7,0,10,1,30,4,6,0,10,3,30,4,0,0,4,1,-15,3,1
2,2,25,1,30,6,8,0,14,4,30,6,0,0,6,0,30,7,7,0,14,1,30,8,6,0,14,5,30,6,0,0,6,1,-15,3,1
2,3,25,1,30,6,8,0,14,4,30,6,0,0,6,0,30,7,7,0,14,1,30,8,6,0,14,5,30,6,0,0,6,1,-15,3,1
2,0,27,1,30,9,6,0,15,4,30,2,0,0,2,0,30,5,10,0,15,0,30,5,10,0,15,1,30,6,0,0,6,1,-15,3,1
2,3,6,1,30,7,2,0,9,3,30,2,0,0,2,0,30,5,4,0,9,0,30,3,6,0,9,0,30,5,0,0,5,0,-27,3,0
2,4,6,1,30,7,2,0,9,3,30,2,0,0,2,0,30,5,4,0,9,0,30,3,6,0,9,0,30,5,0,0,5,0,-27,3,0
2,4,13,4,30,7,0,0,7,2,30,4,0,0,4,1,30,5,2,0,7,0,30,4,3,0,7,0,30,4,0,0,4,1,-15,3,1
2,1,19,0,30,4,9,0,13,2,30,4,4,0,8,0,30,4,9,0,13,1,30,6,7,0,13,1,30,8,1,0,9,1,-15,3,1
2,4,19,0,30,4,9,0,13,0,30,4,4,0,8,0,30,4,9,0,13,1,30,6,7,0,13,1,30,8,1,0,9,1,-15,3,1
2,3,23,1,30,5,8,0,13,3,30,6,0,0,6,8,30,11,2,0,13,3,30,6,7,0,13,1,30,5,1,0,6,1,-15,3,1
2,4,23,1,30,5,8,0,13,3,30,6,0,0,6,8,30,11,2,0,13,3,30,6,7,0,13,1,30,5,1,0,6,1,-15,3,1
2,4,25,1,30,12,2,0,14,2,30,6,0,0,6,0,30,7,7,0,14,1,30,5,9,0,14,5,30,4,2,0,6,1,-15,3,1
2,4,29,0,30,4,10,0,14,5,30,7,5,0,12,0,30,8,6,0,14,0,30,0,14,0,14,1,30,9,0,0,9,1,-15,3,1
2,4,3,3,30,7,4,0,11,3,30,7,1,0,8,0,30,2,9,0,11,4,30,1,10,0,11,1,30,5,2,0,7,0,-27,3,0
2,4,8,1,30,7,0,0,7,3,30,2,0,0,2,0,30,5,2,0,7,0,30,5,2,0,7,3,30,3,0,0,3,0,-27,3,0
2,1,13,1,30,6,1,0,7,1,30,4,0,0,4,4,30,5,2,0,7,14,30,6,1,0,7,4,30,4,0,0,4,1,-15,3,1
2,2,13,1,30,6,1,0,7,1,30,4,0,0,4,4,30,5,2,0,7,14,30,6,1,0,7,4,30,4,0,0,4,1,-15,3,1
2,4,13,1,30,6,1,0,7,1,30,4,0,0,4,4,30,5,2,0,7,14,30,6,1,0,7,4,30,4,0,0,4,1,-15,3,1
2,1,17,5,30,9,5,0,14,4,30,6,0,0,6,0,30,4,10,0,14,2,30,6,8,0,14,3,30,4,0,0,4,1,-15,3,1
2,2,17,5,30,9,5,0,14,4,30,6,0,0,6,0,30,4,10,0,14,2,30,6,8,0,14,3,30,4,0,0,4,1,-15,3,1
2,1,19,0,30,7,6,0,13,2,30,8,0,0,8,4,30,7,6,0,13,0,30,4,9,0,13,1,30,7,2,0,9,1,-15,3,1
2,3,19,0,30,7,6,0,13,2,30,8,0,0,8,4,30,7,6,0,13,0,30,4,9,0,13,0,30,7,2,0,9,1,-15,3,1
2,2,23,1,30,6,7,0,13,3,30,6,0,0,6,5,30,10,3,0,13,0,30,7,6,0,13,2,30,6,0,0,6,1,-15,3,1
2,3,25,0,30,5,9,0,14,5,30,6,0,0,6,0,30,5,9,0,14,1,30,4,10,0,14,4,30,5,1,0,6,1,-15,3,1
2,2,27,2,30,6,9,0,15,5,30,2,0,0,2,0,30,3,12,0,15,0,30,5,10,0,15,5,30,6,0,0,6,1,-15,3,1
2,4,27,2,30,6,9,0,15,5,30,2,0,0,2,0,30,3,12,0,15,0,30,5,10,0,15,5,30,6,0,0,6,1,-15,3,1
2,1,29,0,30,6,8,0,14,5,30,11,1,0,12,0,30,9,5,0,14,0,30,1,13,0,14,2,30,9,0,0,9,1,-15,3,1
2,4,29,0,30,6,8,0,14,5,30,11,1,0,12,0,30,9,5,0,14,0,30,1,13,0,14,2,30,9,0,0,9,1,-15,3,1
2,1,13,3,30,5,2,0,7,0,30,4,0,0,4,2,30,7,0,0,7,9,30,6,1,0,7,4,30,4,0,0,4,1,-15,3,1
2,2,13,3,30,5,2,0,7,0,30,4,0,0,4,2,30,7,0,0,7,9,30,6,1,0,7,4,30,4,0,0,4,1,-15,3,1
2,4,17,3,30,12,2,0,14,3,30,6,0,0,6,0,30,3,11,0,14,1,30,4,10,0,14,3,30,4,0,0,4,1,-15,3,1
2,4,22,1,30,8,0,0,8,2,30,2,0,0,2,0,30,5,3,0,8,3,30,3,5,0,8,2,30,2,2,0,4,1,-15,3,1
2,3,23,1,30,5,8,0,13,3,30,6,0,0,6,7,30,12,1,0,13,0,30,6,7,0,13,2,30,6,0,0,6,1,-15,3,1
2,1,27,1,30,3,12,0,15,4,30,2,0,0,2,0,30,3,12,0,15,2,30,5,10,0,15,3,30,6,0,0,6,1,-15,3,1
2,0,31,5,30,9,3,0,12,3,30,7,1,0,8,3,30,11,1,0,12,0,30,3,9,0,12,3,30,2,4,0,6,1,-15,3,1
2,1,31,5,30,9,3,0,12,3,30,7,1,0,8,3,30,11,1,0,12,0,30,3,9,0,12,3,30,2,4,0,6,1,-15,3,1
2,2,31,5,30,9,3,0,12,3,30,7,1,0,8,3,30,11,1,0,12,0,30,3,9,0,12,3,30,2,4,0,6,1,-15,3,1
2,3,3,0,30,0,4,0,4,2,30,4,0,0,4,0,30,1,3,0,4,4,30,2,2,0,4,0,30,1,2,0,3,0,-27,3,0
2,4,3,0,30,0,4,0,4,2,30,4,0,0,4,0,30,1,3,0,4,4,30,2,2,0,4,0,30,1,2,0,3,0,-27,3,0
2,1,4,2,30,8,0,0,8,4,30,4,0,0,4,0,30,2,6,0,8,0,30,2,6,0,8,3,30,4,0,0,4,0,-27,3,0
2,3,4,2,30,8,0,0,8,4,30,4,0,0,4,0,30,2,6,0,8,0,30,2,6,0,8,3,30,4,0,0,4,0,-27,3,0
2,3,17,2,30,8,6,0,14,2,30,6,0,0,6,0,30,6,8,0,14,1,30,7,7,0,14,6,30,4,0,0,4,1,-15,3,1
2,0,19,0,30,4,9,0,13,3,30,4,4,0,8,0,30,4,9,0,13,7,30,7,6,0,13,5,30,9,0,0,9,1,-15,3,1
2,4,25,0,30,8,6,0,14,3,30,6,0,0,6,0,30,10,4,0,14,0,30,5,9,0,14,2,30,5,1,0,6,1,-15,3,1
2,0,27,1,30,4,11,0,15,3,30,2,0,0,2,4,30,9,6,0,15,0,30,8,7,0,15,1,30,3,3,0,6,1,-15,3,1
2,4,29,1,30,9,5,0,14,6,30,7,5,0,12,0,30,5,9,0,14,0,30,1,13,0,14,5,30,9,0,0,9,1,-15,3,1
2,3,35,0,30,7,6,0,13,4,30,2,0,0,2,1,30,4,9,0,13,2,30,4,9,0,13,8,30,8,0,0,8,1,-15,3,1
2,4,39,0,30,2,9,0,11,6,30,6,0,0,6,0,30,7,4,0,11,0,30,2,9,0,11,4,30,5,0,0,5,1,-15,3,1
2,3,4,4,30,8,0,0,8,4,30,4,0,0,4,0,30,6,2,0,8,0,30,5,3,0,8,1,30,4,0,0,4,0,-27,3,0
2,4,4,4,30,8,0,0,8,4,30,4,0,0,4,0,30,6,2,0,8,0,30,5,3,0,8,1,30,4,0,0,4,0,-27,3,0
2,1,13,1,30,5,2,0,7,0,30,4,0,0,4,2,30,6,1,0,7,8,30,5,2,0,7,5,30,4,0,0,4,1,-15,3,1
2,4,13,1,30,5,2,0,7,0,30,4,0,0,4,2,30,6,1,0,7,8,30,5,2,0,7,5,30,4,0,0,4,1,-15,3,1
2,1,17,5,30,7,7,0,14,3,30,6,0,0,6,0,30,6,8,0,14,1,30,8,6,0,14,1,30,4,0,0,4,1,-15,3,1
2,4,17,5,30,7,7,0,14,3,30,6,0,0,6,0,30,6,8,0,14,1,30,8,6,0,14,1,30,4,0,0,4,1,-15,3,1
2,3,19,0,30,3,10,0,13,2,30,5,3,0,8,0,30,8,5,0,13,4,30,4,9,0,13,2,30,8,1,0,9,1,-15,3,1
2,4,19,0,30,3,10,0,13,2,30,5,3,0,8,0,30,8,5,0,13,4,30,4,9,0,13,2,30,8,1,0,9,1,-15,3,1
2,3,27,1,30,4,11,0,15,4,30,1,1,0,2,0,30,5,10,0,15,0,30,4,11,0,15,4,30,6,0,0,6,1,-15,3,1
2,4,27,1,30,4,11,0,15,4,30,1,1,0,2,0,30,5,10,0,15,0,30,4,11,0,15,4,30,6,0,0,6,1,-15,3,1
2,3,29,0,30,6,8,0,14,6,30,10,2,0,12,0,30,5,9,0,14,0,30,0,14,0,14,3,30,9,0,0,9,1,-15,3,1
2,0,4,2,30,6,2,0,8,5,30,4,0,0,4,2,30,1,7,0,8,3,30,8,0,0,8,1,30,3,1,0,4,0,-27,3,0
2,2,4,2,30,6,2,0,8,5,30,4,0,0,4,2,30,1,7,0,8,3,30,8,0,0,8,1,30,3,1,0,4,0,-27,3,0
2,4,4,0,30,6,2,0,8,5,30,4,0,0,4,2,30,1,7,0,8,3,30,8,0,0,8,1,30,3,1,0,4,0,-27,3,0
2,4,8,4,30,7,0,0,7,4,30,2,0,0,2,0,30,1,6,0,7,0,30,4,3,0,7,0,30,3,0,0,3,0,-27,3,0
2,1,13,2,30,3,4,0,7,0,30,4,0,0,4,2,30,5,2,0,7,17,30,6,1,0,7,2,30,4,0,0,4,1,-15,3,1
2,2,13,2,30,3,4,0,7,0,30,4,0,0,4,2,30,5,2,0,7,17,30,6,1,0,7,2,30,4,0,0,4,1,-15,3,1
2,3,17,4,30,9,5,0,14,3,30,6,0,0,6,0,30,6,8,0,14,2,30,6,8,0,14,4,30,4,0,0,4,1,-15,3,1
2,4,17,4,30,9,5,0,14,3,30,6,0,0,6,0,30,6,8,0,14,2,30,6,8,0,14,4,30,4,0,0,4,1,-15,3,1
2,2,19,0,30,3,10,0,13,1,30,5,3,0,8,0,30,4,9,0,13,9,30,5,8,0,13,0,30,9,0,0,9,1,-15,3,1
2,4,19,0,30,3,10,0,13,1,30,5,3,0,8,0,30,4,9,0,13,9,30,5,8,0,13,0,30,9,0,0,9,1,-15,3,1
2,0,21,3,30,8,2,0,10,4,30,6,0,0,6,1,30,3,7,0,10,6,30,6,4,0,10,0,30,4,0,0,4,1,-15,3,1
2,3,21,3,30,8,2,0,10,4,30,6,0,0,6,1,30,3,7,0,10,6,30,6,4,0,10,0,30,4,0,0,4,1,-15,3,1
2,4,21,3,30,8,2,0,10,4,30,6,0,0,6,1,30,3,7,0,10,6,30,6,4,0,10,0,30,4,0,0,4,1,-15,3,1
2,0,27,1,30,6,9,0,15,4,30,1,1,0,2,0,30,7,8,0,15,0,30,3,12,0,15,3,30,6,0,0,6,1,-15,3,1
2,3,27,1,30,6,9,0,15,4,30,1,1,0,2,0,30,7,8,0,15,0,30,3,12,0,15,3,30,6,0,0,6,1,-15,3,1
2,4,27,1,30,6,9,0,15,4,30,1,1,0,2,0,30,7,8,0,15,0,30,3,12,0,15,3,30,6,0,0,6,1,-15,3,1
2,4,7,1,30,5,4,0,9,2,30,4,0,0,4,1,30,7,2,0,9,5,30,5,4,0,9,1,30,4,2,0,6,0,-27,3,0
2,0,17,3,30,9,5,0,14,3,30,6,0,0,6,0,30,4,10,0,14,4,30,5,9,0,14,6,30,4,0,0,4,1,-15,3,1
2,3,17,3,30,9,5,0,14,3,30,6,0,0,6,0,30,4,10,0,14,4,30,5,9,0,14,6,30,4,0,0,4,1,-15,3,1
2,1,19,1,30,3,10,0,13,2,30,6,2,0,8,0,30,4,9,0,13,3,30,9,4,0,13,0,30,6,3,0,9,1,-15,3,1
2,3,21,3,30,8,2,0,10,4,30,6,0,0,6,1,30,3,7,0,10,3,30,4,6,0,10,1,30,4,0,0,4,1,-15,3,1
2,4,21,3,30,8,2,0,10,4,30,6,0,0,6,1,30,3,7,0,10,3,30,4,6,0,10,1,30,4,0,0,4,1,-15,3,1
2,4,23,1,30,6,7,0,13,0,30,6,0,0,6,0,30,10,3,0,13,8,30,5,8,0,13,2,30,5,1,0,6,1,-15,3,1
2,4,25,2,30,10,4,0,14,5,30,6,0,0,6,0,30,5,9,0,14,3,30,6,8,0,14,2,30,5,1,0,6,1,-15,3,1
2,3,27,0,30,7,8,0,15,3,30,2,0,0,2,3,30,6,9,0,15,0,30,4,11,0,15,0,30,4,2,0,6,1,-15,3,1
2,3,39,0,30,6,5,0,11,6,30,6,0,0,6,0,30,7,4,0,11,1,30,3,8,0,11,4,30,5,0,0,5,1,-15,3,1
2,1,6,1,30,7,2,0,9,4,30,2,0,0,2,0,30,2,7,0,9,0,30,4,5,0,9,0,30,4,1,0,5,0,-27,3,0
2,4,7,1,30,6,3,0,9,3,30,4,0,0,4,0,30,5,4,0,9,4,30,3,6,0,9,1,30,4,2,0,6,0,-27,3,0
2,1,11,3,30,6,6,0,12,0,30,4,0,0,4,0,30,9,3,0,12,6,30,3,9,0,12,5,30,4,0,0,4,1,-15,3,1
2,1,13,1,30,6,1,0,7,1,30,4,0,0,4,3,30,6,1,0,7,12,30,6,1,0,7,2,30,4,0,0,4,1,-15,3,1
2,4,13,1,30,6,1,0,7,1,30,4,0,0,4,3,30,6,1,0,7,12,30,6,1,0,7,2,30,4,0,0,4,1,-15,3,1
2,0,17,5,30,11,3,0,14,4,30,6,0,0,6,0,30,3,11,0,14,1,30,5,9,0,14,2,30,4,0,0,4,1,-15,3,1
2,3,17,5,30,11,3,0,14,4,30,6,0,0,6,0,30,3,11,0,14,1,30,5,9,0,14,2,30,4,0,0,4,1,-15,3,1
2,4,17,5,30,11,3,0,14,4,30,6,0,0,6,0,30,3,11,0,14,1,30,5,9,0,14,2,30,4,0,0,4,1,-15,3,1
2,2,19,0,30,4,9,0,13,2,30,7,1,0,8,0,30,7,6,0,13,3,30,5,8,0,13,2,30,9,0,0,9,1,-15,3,1
2,3,19,0,30,4,9,0,13,2,30,7,1,0,8,0,30,7,6,0,13,3,30,5,8,0,13,2,30,9,0,0,9,1,-15,3,1
2,3,25,1,30,5,9,0,14,5,30,6,0,0,6,0,30,5,9,0,14,0,30,9,5,0,14,5,30,6,0,0,6,1,-15,3,1
2,1,26,0,30,7,2,0,9,4,30,4,0,0,4,2,30,0,9,0,9,0,30,1,8,0,9,4,30,1,2,0,3,1,-15,3,1
2,4,29,1,30,7,7,0,14,5,30,9,3,0,12,0,30,3,11,0,14,0,30,1,13,0,14,4,30,9,0,0,9,1,-15,3,1
2,1,13,1,30,6,1,0,7,0,30,4,0,0,4,2,30,6,1,0,7,14,30,7,0,0,7,4,30,4,0,0,4,1,-15,3,1
2,2,13,1,30,6,1,0,7,0,30,4,0,0,4,2,30,6,1,0,7,14,30,7,0,0,7,4,30,4,0,0,4,1,-15,3,1
2,1,17,5,30,10,4,0,14,3,30,6,0,0,6,0,30,6,8,0,14,2,30,6,8,0,14,3,30,4,0,0,4,1,-15,3,1
2,4,17,0,30,10,4,0,14,2,30,6,0,0,6,0,30,6,8,0,14,2,30,6,8,0,14,3,30,4,0,0,4,1,-15,3,1
2,1,21,2,30,6,4,0,10,3,30,4,2,0,6,1,30,5,5,0,10,1,30,4,6,0,10,3,30,4,0,0,4,1,-15,3,1
2,2,25,3,30,5,9,0,14,4,30,6,0,0,6,0,30,12,2,0,14,1,30,4,10,0,14,4,30,5,1,0,6,1,-15,3,1
2,4,25,3,30,5,9,0,14,4,30,6,0,0,6,0,30,12,2,0,14,1,30,4,10,0,14,4,30,5,1,0,6,1,-15,3,1
2,4,32,0,30,5,4,0,9,4,30,2,0,0,2,0,30,8,1,0,9,1,30,2,7,0,9,3,30,2,0,0,2,1,-15,3,1
2,2,35,0,30,6,7,0,13,3,30,2,0,0,2,3,30,8,5,0,13,0,30,3,10,0,13,3,30,8,0,0,8,1,-15,3,1
2,3,35,0,30,6,7,0,13,3,30,2,0,0,2,3,30,8,5,0,13,0,30,3,10,0,13,3,30,8,0,0,8,1,-15,3,1
2,0,6,0,30,7,2,0,9,4,30,2,0,0,2,0,30,2,7,0,9,0,30,4,5,0,9,3,30,4,1,0,5,0,-27,3,0
2,4,6,0,30,7,2,0,9,4,30,2,0,0,2,0,30,2,7,0,9,0,30,4,5,0,9,3,30,4,1,0,5,0,-27,3,0
2,2,17,1,30,7,7,0,14,2,30,6,0,0,6,0,30,7,7,0,14,5,30,6,8,0,14,6,30,4,0,0,4,1,-15,3,1
2,3,17,1,30,7,7,0,14,2,30,6,0,0,6,0,30,7,7,0,14,5,30,6,8,0,14,6,30,4,0,0,4,1,-15,3,1
2,4,17,1,30,7,7,0,14,2,30,6,0,0,6,0,30,7,7,0,14,5,30,6,8,0,14,6,30,4,0,0,4,1,-15,3,1
2,4,19,0,30,4,9,0,13,2,30,4,4,0,8,0,30,5,8,0,13,0,30,5,8,0,13,1,30,9,0,0,9,1,-15,3,1
2,2,21,2,30,8,2,0,10,4,30,5,1,0,6,1,30,3,7,0,10,5,30,5,5,0,10,5,30,4,0,0,4,1,-15,3,1
2,3,21,2,30,8,2,0,10,4,30,5,1,0,6,1,30,3,7,0,10,5,30,5,5,0,10,5,30,4,0,0,4,1,-15,3,1
2,4,21,2,30,8,2,0,10,4,30,5,1,0,6,1,30,3,7,0,10,5,30,5,5,0,10,5,30,4,0,0,4,1,-15,3,1
2,2,29,0,30,8,6,0,14,5,30,11,1,0,12,0,30,8,6,0,14,0,30,4,10,0,14,0,30,9,0,0,9,1,-15,3,1
2,4,29,0,30,8,6,0,14,5,30,11,1,0,12,0,30,8,6,0,14,0,30,4,10,0,14,0,30,9,0,0,9,1,-15,3,1
2,1,41,0,30,6,6,0,12,6,30,8,0,0,8,0,30,7,5,0,12,0,30,3,9,0,12,5,30,7,0,0,7,1,-15,3,1
2,4,41,0,30,6,6,0,12,6,30,8,0,0,8,0,30,7,5,0,12,0,30,3,9,0,12,5,30,7,0,0,7,1,-15,3,1
2,2,13,3,30,6,1,0,7,0,30,4,0,0,4,1,30,6,1,0,7,9,30,6,1,0,7,3,30,4,0,0,4,1,-15,3,1
2,4,13,3,30,6,1,0,7,0,30,4,0,0,4,1,30,6,1,0,7,9,30,6,1,0,7,3,30,4,0,0,4,1,-15,3,1
2,4,15,0,30,3,10,0,13,1,30,6,0,0,6,0,30,3,10,0,13,0,30,3,10,0,13,1,30,8,1,0,9,1,-15,3,1
2,4,17,3,30,9,5,0,14,3,30,6,0,0,6,0,30,7,7,0,14,2,30,6,8,0,14,1,30,4,0,0,4,1,-15,3,1
2,3,25,3,30,7,7,0,14,5,30,6,0,0,6,0,30,7,7,0,14,1,30,5,9,0,14,0,30,5,1,0,6,1,-15,3,1
2,1,26,0,30,7,2,0,9,5,30,4,0,0,4,5,30,0,9,0,9,0,30,2,7,0,9,4,30,2,1,0,3,1,-15,3,1
2,0,27,3,30,9,6,0,15,5,30,2,0,0,2,0,30,4,11,0,15,2,30,4,11,0,15,3,30,4,2,0,6,1,-15,3,1
2,2,27,3,30,9,6,0,15,5,30,2,0,0,2,0,30,4,11,0,15,2,30,4,11,0,15,3,30,4,2,0,6,1,-15,3,1
2,1,31,5,30,6,6,0,12,4,30,8,0,0,8,3,30,12,0,0,12,0,30,3,9,0,12,1,30,3,3,0,6,1,-15,3,1
2,4,43,0,30,8,6,0,14,8,30,6,0,0,6,0,30,4,10,0,14,0,30,1,13,0,14,3,30,5,0,0,5,1,-15,3,1
2,1,5,0,30,0,5,0,5,2,30,2,2,0,4,0,30,0,5,0,5,0,30,2,3,0,5,2,30,2,0,0,2,0,-27,3,0
2,3,5,0,30,0,5,0,5,2,30,2,2,0,4,0,30,0,5,0,5,0,30,2,3,0,5,2,30,2,0,0,2,0,-27,3,0
2,4,5,0,30,0,5,0,5,2,30,2,2,0,4,0,30,0,5,0,5,0,30,2,3,0,5,2,30,2,0,0,2,0,-27,3,0
2,4,8,9,30,7,0,0,7,4,30,2,0,0,2,0,30,1,6,0,7,4,30,6,1,0,7,0,30,3,0,0,3,0,-27,3,0
2,3,9,5,30,4,0,0,4,4,30,2,0,0,2,0,30,0,4,0,4,0,30,1,3,0,4,0,30,1,0,0,1,0,-27,3,0
2,1,11,2,30,7,5,0,12,1,30,4,0,0,4,0,30,7,5,0,12,6,30,5,7,0,12,1,30,4,0,0,4,1,-15,3,1
2,1,17,2,30,8,6,0,14,3,30,6,0,0,6,0,30,4,10,0,14,1,30,7,7,0,14,5,30,4,0,0,4,1,-15,3,1
2,4,17,2,30,8,6,0,14,3,30,6,0,0,6,0,30,4,10,0,14,1,30,7,7,0,14,5,30,4,0,0,4,1,-15,3,1
2,0,19,0,30,4,9,0,13,2,30,6,2,0,8,4,30,4,9,0,13,4,30,7,6,0,13,0,30,8,1,0,9,1,-15,3,1
2,1,19,0,30,4,9,0,13,2,30,6,2,0,8,4,30,4,9,0,13,4,30,7,6,0,13,0,30,8,1,0,9,1,-15,3,1
2,2,19,0,30,4,9,0,13,2,30,6,2,0,8,4,30,4,9,0,13,4,30,7,6,0,13,0,30,8,1,0,9,1,-15,3,1
2,3,19,0,30,4,9,0,13,2,30,6,2,0,8,4,30,4,9,0,13,4,30,7,6,0,13,0,30,8,1,0,9,1,-15,3,1
2,4,19,0,30,4,9,0,13,2,30,6,2,0,8,4,30,4,9,0,13,4,30,7,6,0,13,0,30,8,1,0,9,1,-15,3,1
2,3,23,2,30,7,6,0,13,0,30,6,0,0,6,3,30,13,0,0,13,0,30,6,7,0,13,5,30,6,0,0,6,1,-15,3,1
2,4,23,2,30,7,6,0,13,0,30,6,0,0,6,3,30,13,0,0,13,0,30,6,7,0,13,5,30,6,0,0,6,1,-15,3,1
2,0,27,2,30,3,12,0,15,2,30,1,1,0,2,0,30,6,9,0,15,3,30,5,10,0,15,6,30,6,0,0,6,1,-15,3,1
2,1,27,2,30,3,12,0,15,2,30,1,1,0,2,0,30,6,9,0,15,3,30,5,10,0,15,6,30,6,0,0,6,1,-15,3,1
2,4,27,2,30,3,12,0,15,2,30,1,1,0,2,0,30,6,9,0,15,3,30,5,10,0,15,6,30,6,0,0,6,1,-15,3,1
2,4,31,5,30,7,5,0,12,3,30,8,0,0,8,3,30,12,0,0,12,0,30,3,9,0,12,0,30,1,5,0,6,1,-15,3,1
2,1,4,0,30,6,2,0,8,5,30,4,0,0,4,0,30,1,7,0,8,2,30,8,0,0,8,1,30,3,1,0,4,0,-27,3,0
2,3,13,1,30,4,3,0,7,0,30,4,0,0,4,0,30,6,1,0,7,6,30,6,1,0,7,5,30,4,0,0,4,1,-15,3,1
2,3,15,0,30,4,9,0,13,0,30,6,0,0,6,0,30,3,10,0,13,0,30,6,7,0,13,2,30,9,0,0,9,1,-15,3,1
2,0,17,3,30,10,4,0,14,3,30,6,0,0,6,0,30,5,9,0,14,2,30,5,9,0,14,2,30,4,0,0,4,1,-15,3,1
2,1,17,3,30,10,4,0,14,3,30,6,0,0,6,0,30,5,9,0,14,2,30,5,9,0,14,2,30,4,0,0,4,1,-15,3,1
2,3,19,0,30,2,11,0,13,2,30,6,2,0,8,0,30,5,8,0,13,6,30,5,8,0,13,0,30,9,0,0,9,1,-15,3,1
2,4,23,1,30,4,9,0,13,1,30,6,0,0,6,4,30,13,0,0,13,0,30,5,8,0,13,2,30,6,0,0,6,1,-15,3,1
2,0,31,1,30,6,6,0,12,4,30,8,0,0,8,3,30,8,4,0,12,0,30,3,9,0,12,1,30,2,4,0,6,1,-15,3,1
2,1,31,1,30,6,6,0,12,4,30,8,0,0,8,3,30,8,4,0,12,0,30,3,9,0,12,1,30,2,4,0,6,1,-15,3,1
2,2,31,1,30,6,6,0,12,4,30,8,0,0,8,3,30,8,4,0,12,0,30,3,9,0,12,1,30,2,4,0,6,1,-15,3,1
2,3,31,1,30,6,6,0,12,4,30,8,0,0,8,3,30,8,4,0,12,0,30,3,9,0,12,1,30,2,4,0,6,1,-15,3,1
2,3,38,0,30,4,6,0,10,7,30,6,0,0,6,0,30,1,9,0,10,0,30,2,8,0,10,6,30,6,0,0,6,1,-15,3,1
2,0,5,0,30,2,3,0,5,3,30,1,3,0,4,1,30,0,5,0,5,0,30,1,4,0,5,0,30,2,0,0,2,0,-27,3,0
2,1,5,0,30,2,3,0,5,3,30,1,3,0,4,1,30,0,5,0,5,0,30,1,4,0,5,0,30,2,0,0,2,0,-27,3,0
2,2,5,0,30,2,3,0,5,3,30,1,3,0,4,1,30,0,5,0,5,0,30,1,4,0,5,0,30,2,0,0,2,0,-27,3,0
2,4,5,0,30,2,3,0,5,3,30,1,3,0,4,1,30,0,5,0,5,0,30,1,4,0,5,0,30,2,0,0,2,0,-27,3,0
2,2,13,1,30,5,2,0,7,0,30,4,0,0,4,2,30,6,1,0,7,6,30,5,2,0,7,4,30,4,0,0,4,1,-15,3,1
2,2,17,3,30,9,5,0,14,4,30,6,0,0,6,0,30,4,10,0,14,4,30,6,8,0,14,2,30,4,0,0,4,1,-15,3,1
2,4,23,1,30,6,7,0,13,0,30,6,0,0,6,0,30,11,2,0,13,0,30,6,7,0,13,2,30,6,0,0,6,1,-15,3,1
2,2,25,1,30,6,8,0,14,5,30,6,0,0,6,0,30,6,8,0,14,1,30,7,7,0,14,3,30,4,2,0,6,1,-15,3,1
2,4,25,1,30,6,8,0,14,5,30,6,0,0,6,0,30,6,8,0,14,1,30,7,7,0,14,3,30,4,2,0,6,1,-15,3,1
2,3,27,0,30,6,9,0,15,4,30,2,0,0,2,2,30,5,10,0,15,0,30,3,12,0,15,2,30,5,1,0,6,1,-15,3,1
2,4,27,0,30,6,9,0,15,4,30,2,0,0,2,2,30,5,10,0,15,0,30,3,12,0,15,2,30,5,1,0,6,1,-15,3,1
2,4,31,1,30,1,11,0,12,6,30,8,0,0,8,2,30,6,6,0,12,1,30,7,5,0,12,5,30,6,0,0,6,1,-15,3,1
2,3,35,1,30,9,4,0,13,5,30,2,0,0,2,1,30,2,11,0,13,3,30,6,7,0,13,3,30,8,0,0,8,1,-15,3,1
2,1,37,2,30,11,0,0,11,6,30,7,1,0,8,1,30,5,6,0,11,6,30,3,8,0,11,3,30,6,0,0,6,1,-15,3,1
2,4,41,0,30,8,4,0,12,6,30,8,0,0,8,0,30,7,5,0,12,1,30,3,9,0,12,0,30,7,0,0,7,1,-15,3,1
2,3,8,0,30,7,0,0,7,4,30,2,0,0,2,0,30,1,6,0,7,0,30,6,1,0,7,1,30,3,0,0,3,0,-27,3,0
2,4,10,2,30,9,0,0,9,2,30,4,0,0,4,0,30,1,8,0,9,0,30,0,9,0,9,1,30,3,2,0,5,1,-15,3,1
2,2,13,2,30,6,1,0,7,0,30,4,0,0,4,0,30,6,1,0,7,9,30,7,0,0,7,4,30,4,0,0,4,1,-15,3,1
2,2,17,3,30,10,4,0,14,2,30,6,0,0,6,0,30,6,8,0,14,3,30,5,9,0,14,5,30,4,0,0,4,1,-15,3,1
2,3,17,3,30,10,4,0,14,2,30,6,0,0,6,0,30,6,8,0,14,3,30,5,9,0,14,5,30,4,0,0,4,1,-15,3,1
2,4,17,3,30,10,4,0,14,2,30,6,0,0,6,0,30,6,8,0,14,3,30,5,9,0,14,5,30,4,0,0,4,1,-15,3,1
2,2,25,1,30,2,12,0,14,5,30,6,0,0,6,0,30,11,3,0,14,1,30,7,7,0,14,5,30,6,0,0,6,1,-15,3,1
2,3,25,1,30,2,12,0,14,5,30,6,0,0,6,0,30,11,3,0,14,1,30,7,7,0,14,5,30,6,0,0,6,1,-15,3,1
2,1,27,1,30,5,10,0,15,5,30,2,0,0,2,0,30,3,12,0,15,0,30,6,9,0,15,7,30,6,0,0,6,1,-15,3,1
2,3,29,0,30,7,7,0,14,6,30,12,0,0,12,0,30,4,10,0,14,0,30,1,13,0,14,5,30,9,0,0,9,1,-15,3,1
2,3,31,3,30,5,7,0,12,5,30,8,0,0,8,3,30,10,2,0,12,0,30,3,9,0,12,3,30,4,2,0,6,1,-15,3,1
2,4,31,3,30,5,7,0,12,5,30,8,0,0,8,3,30,10,2,0,12,0,30,3,9,0,12,3,30,4,2,0,6,1,-15,3,1
2,3,4,2,30,6,2,0,8,5,30,2,2,0,4,0,30,2,6,0,8,0,30,7,1,0,8,2,30,3,1,0,4,0,-27,3,0
2,3,15,0,30,5,8,0,13,0,30,6,0,0,6,0,30,4,9,0,13,1,30,4,9,0,13,2,30,6,3,0,9,1,-15,3,1
2,4,15,0,30,5,8,0,13,0,30,6,0,0,6,0,30,4,9,0,13,1,30,4,9,0,13,2,30,6,3,0,9,1,-15,3,1
2,1,17,3,30,9,5,0,14,3,30,6,0,0,6,0,30,4,10,0,14,2,30,6,8,0,14,3,30,4,0,0,4,1,-15,3,1
2,3,17,3,30,9,5,0,14,3,30,6,0,0,6,0,30,4,10,0,14,2,30,6,8,0,14,3,30,4,0,0,4,1,-15,3,1
2,4,17,3,30,9,5,0,14,3,30,6,0,0,6,0,30,4,10,0,14,2,30,6,8,0,14,3,30,4,0,0,4,1,-15,3,1
2,3,23,1,30,6,7,0,13,3,30,6,0,0,6,6,30,11,2,0,13,0,30,5,8,0,13,2,30,5,1,0,6,1,-15,3,1
2,4,25,1,30,7,7,0,14,4,30,6,0,0,6,0,30,6,8,0,14,1,30,5,9,0,14,3,30,5,1,0,6,1,-15,3,1
2,0,27,1,30,4,11,0,15,3,30,1,1,0,2,0,30,5,10,0,15,0,30,6,9,0,15,4,30,6,0,0,6,1,-15,3,1
2,4,27,0,30,4,11,0,15,3,30,1,1,0,2,0,30,5,10,0,15,0,30,6,9,0,15,4,30,6,0,0,6,1,-15,3,1
2,4,31,2,30,8,4,0,12,5,30,8,0,0,8,6,30,7,5,0,12,0,30,6,6,0,12,0,30,3,3,0,6,1,-15,3,1
2,0,5,0,30,2,3,0,5,3,30,4,0,0,4,0,30,0,5,0,5,2,30,2,3,0,5,0,30,0,2,0,2,0,-27,3,0
2,1,5,0,30,2,3,0,5,3,30,4,0,0,4,0,30,0,5,0,5,2,30,2,3,0,5,0,30,0,2,0,2,0,-27,3,0
2,2,5,0,30,2,3,0,5,3,30,4,0,0,4,0,30,0,5,0,5,2,30,2,3,0,5,0,30,0,2,0,2,0,-27,3,0
2,3,5,0,30,2,3,0,5,3,30,4,0,0,4,0,30,0,5,0,5,2,30,2,3,0,5,0,30,0,2,0,2,0,-27,3,0
2,4,5,0,30,2,3,0,5,3,30,4,0,0,4,0,30,0,5,0,5,2,30,2,3,0,5,0,30,0,2,0,2,0,-27,3,0
2,4,7,0,30,4,5,0,9,3,30,4,0,0,4,1,30,5,4,0,9,5,30,3,6,0,9,1,30,5,1,0,6,0,-27,3,0
2,3,8,2,30,7,0,0,7,3,30,2,0,0,2,0,30,5,2,0,7,0,30,6,1,0,7,2,30,3,0,0,3,0,-27,3,0
2,1,13,3,30,5,2,0,7,1,30,4,0,0,4,2,30,6,1,0,7,2,30,6,1,0,7,4,30,4,0,0,4,1,-15,3,1
2,0,27,2,30,6,9,0,15,3,30,2,0,0,2,0,30,2,13,0,15,0,30,3,12,0,15,4,30,6,0,0,6,1,-15,3,1
2,1,27,2,30,6,9,0,15,3,30,2,0,0,2,0,30,2,13,0,15,0,30,3,12,0,15,4,30,6,0,0,6,1,-15,3,1
2,3,27,2,30,6,9,0,15,3,30,2,0,0,2,0,30,2,13,0,15,0,30,3,12,0,15,2,30,6,0,0,6,1,-15,3,1
2,4,27,2,30,6,9,0,15,3,30,2,0,0,2,0,30,2,13,0,15,0,30,3,12,0,15,2,30,6,0,0,6,1,-15,3,1
2,2,31,0,30,6,6,0,12,4,30,8,0,0,8,3,30,12,0,0,12,0,30,3,9,0,12,0,30,6,0,0,6,1,-15,3,1
2,3,32,0,30,2,7,0,9,4,30,2,0,0,2,0,30,7,2,0,9,5,30,4,5,0,9,3,30,2,0,0,2,1,-15,3,1
2,4,32,0,30,2,7,0,9,4,30,2,0,0,2,0,30,7,2,0,9,5,30,4,5,0,9,3,30,2,0,0,2,1,-15,3,1
2,2,39,0,30,5,6,0,11,5,30,6,0,0,6,0,30,8,3,0,11,1,30,4,7,0,11,6,30,5,0,0,5,1,-15,3,1
2,2,5,0,30,2,3,0,5,3,30,3,1,0,4,0,30,0,5,0,5,0,30,2,3,0,5,0,30,2,0,0,2,0,-27,3,0
2,3,17,1,30,5,9,0,14,4,30,6,0,0,6,0,30,4,10,0,14,1,30,10,4,0,14,9,30,4,0,0,4,1,-15,3,1
2,2,19,2,30,6,7,0,13,3,30,4,4,0,8,0,30,4,9,0,13,6,30,8,5,0,13,2,30,9,0,0,9,1,-15,3,1
2,3,19,2,30,6,7,0,13,3,30,4,4,0,8,0,30,4,9,0,13,6,30,8,5,0,13,2,30,9,0,0,9,1,-15,3,1
2,4,19,2,30,6,7,0,13,3,30,4,4,0,8,0,30,4,9,0,13,6,30,8,5,0,13,2,30,9,0,0,9,1,-15,3,1
2,4,22,1,30,7,1,0,8,2,30,2,0,0,2,1,30,6,2,0,8,0,30,4,4,0,8,4,30,2,2,0,4,1,-15,3,1
2,3,27,5,30,5,10,0,15,3,30,1,1,0,2,0,30,5,10,0,15,3,30,5,10,0,15,4,30,6,0,0,6,1,-15,3,1
2,1,29,0,30,4,10,0,14,5,30,9,3,0,12,0,30,3,11,0,14,0,30,5,9,0,14,0,30,8,1,0,9,1,-15,3,1
2,0,31,3,30,7,5,0,12,5,30,8,0,0,8,6,30,6,6,0,12,0,30,3,9,0,12,0,30,2,4,0,6,1,-15,3,1
2,1,31,3,30,7,5,0,12,5,30,8,0,0,8,6,30,6,6,0,12,0,30,3,9,0,12,0,30,2,4,0,6,1,-15,3,1
2,2,31,3,30,7,5,0,12,5,30,8,0,0,8,6,30,6,6,0,12,0,30,3,9,0,12,0,30,2,4,0,6,1,-15,3,1
2,3,31,3,30,7,5,0,12,5,30,8,0,0,8,6,30,6,6,0,12,0,30,3,9,0,12,0,30,2,4,0,6,1,-15,3,1
2,3,11,0,30,4,8,0,12,2,30,4,0,0,4,0,30,5,7,0,12,4,30,7,5,0,12,1,30,4,0,0,4,1,-15,3,1
2,2,19,0,30,2,11,0,13,0,30,6,2,0,8,0,30,6,7,0,13,3,30,7,6,0,13,2,30,9,0,0,9,1,-15,3,1
2,3,19,0,30,2,11,0,13,0,30,6,2,0,8,0,30,6,7,0,13,3,30,7,6,0,13,2,30,9,0,0,9,1,-15,3,1
2,4,19,0,30,2,11,0,13,0,30,6,2,0,8,0,30,6,7,0,13,3,30,7,6,0,13,2,30,9,0,0,9,1,-15,3,1
2,3,21,3,30,8,2,0,10,4,30,6,0,0,6,1,30,3,7,0,10,3,30,3,7,0,10,1,30,4,0,0,4,1,-15,3,1
2,4,25,0,30,5,9,0,14,4,30,6,0,0,6,0,30,6,8,0,14,1,30,4,10,0,14,5,30,5,1,0,6,1,-15,3,1
2,0,27,2,30,4,11,0,15,3,30,1,1,0,2,0,30,5,10,0,15,4,30,5,10,0,15,4,30,6,0,0,6,1,-15,3,1
2,4,32,0,30,9,0,0,9,5,30,2,0,0,2,3,30,7,2,0,9,0,30,2,7,0,9,1,30,2,0,0,2,1,-15,3,1
2,1,4,3,30,5,3,0,8,4,30,2,2,0,4,0,30,3,5,0,8,0,30,4,4,0,8,3,30,4,0,0,4,0,-27,3,0
2,2,4,3,30,5,3,0,8,4,30,2,2,0,4,0,30,3,5,0,8,0,30,4,4,0,8,3,30,4,0,0,4,0,-27,3,0
2,2,8,1,30,7,0,0,7,4,30,2,0,0,2,0,30,4,3,0,7,0,30,6,1,0,7,6,30,3,0,0,3,0,-27,3,0
2,3,8,1,30,7,0,0,7,4,30,2,0,0,2,0,30,4,3,0,7,0,30,6,1,0,7,6,30,3,0,0,3,0,-27,3,0
2,4,13,3,30,7,0,0,7,0,30,4,0,0,4,1,30,6,1,0,7,11,30,6,1,0,7,5,30,4,0,0,4,1,-15,3,1
2,4,15,0,30,4,9,0,13,1,30,6,0,0,6,0,30,3,10,0,13,1,30,4,9,0,13,1,30,6,3,0,9,1,-15,3,1
2,4,25,0,30,3,11,0,14,3,30,6,0,0,6,0,30,10,4,0,14,1,30,9,5,0,14,5,30,6,0,0,6,1,-15,3,1
2,3,27,1,30,9,6,0,15,3,30,2,0,0,2,0,30,3,12,0,15,2,30,2,13,0,15,6,30,4,2,0,6,1,-15,3,1
2,4,27,1,30,9,6,0,15,3,30,2,0,0,2,0,30,3,12,0,15,2,30,2,13,0,15,6,30,4,2,0,6,1,-15,3,1
2,3,31,0,30,3,9,0,12,7,30,8,0,0,8,3,30,6,6,0,12,0,30,9,3,0,12,6,30,6,0,0,6,1,-15,3,1
2,0,41,0,30,10,2,0,12,6,30,5,3,0,8,0,30,3,9,0,12,0,30,3,9,0,12,4,30,6,1,0,7,1,-15,3,1
2,1,41,0,30,10,2,0,12,6,30,5,3,0,8,0,30,3,9,0,12,0,30,3,9,0,12,4,30,6,1,0,7,1,-15,3,1
2,4,1,0,30,7,3,0,10,5,30,2,0,0,2,1,30,4,6,0,10,4,30,10,0,0,10,4,30,6,0,0,6,0,-27,3,0
2,0,5,0,30,0,5,0,5,3,30,0,4,0,4,4,30,0,5,0,5,0,30,3,2,0,5,0,30,0,2,0,2,0,-27,3,0
2,1,5,0,30,0,5,0,5,3,30,0,4,0,4,4,30,0,5,0,5,0,30,3,2,0,5,0,30,0,2,0,2,0,-27,3,0
2,2,5,0,30,0,5,0,5,3,30,0,4,0,4,4,30,0,5,0,5,0,30,3,2,0,5,0,30,0,2,0,2,0,-27,3,0
2,4,5,0,30,0,5,0,5,3,30,0,4,0,4,3,30,0,5,0,5,0,30,3,2,0,5,0,30,0,2,0,2,0,-27,3,0
2,1,13,6,30,7,0,0,7,2,30,4,0,0,4,1,30,5,2,0,7,4,30,4,3,0,7,0,30,4,0,0,4,1,-15,3,1
2,3,13,6,30,7,0,0,7,2,30,4,0,0,4,1,30,5,2,0,7,4,30,4,3,0,7,0,30,4,0,0,4,1,-15,3,1
2,3,15,1,30,4,9,0,13,1,30,6,0,0,6,3,30,4,9,0,13,1,30,4,9,0,13,1,30,4,5,0,9,1,-15,3,1
2,4,15,1,30,4,9,0,13,1,30,6,0,0,6,3,30,4,9,0,13,1,30,4,9,0,13,1,30,4,5,0,9,1,-15,3,1
2,3,17,3,30,9,5,0,14,2,30,6,0,0,6,0,30,7,7,0,14,3,30,6,8,0,14,6,30,4,0,0,4,1,-15,3,1
2,4,19,0,30,4,9,0,13,2,30,3,5,0,8,0,30,4,9,0,13,4,30,5,8,0,13,4,30,9,0,0,9,1,-15,3,1
2,1,25,1,30,4,10,0,14,5,30,6,0,0,6,0,30,6,8,0,14,1,30,9,5,0,14,3,30,5,1,0,6,1,-15,3,1
2,2,25,1,30,4,10,0,14,5,30,6,0,0,6,0,30,6,8,0,14,1,30,9,5,0,14,3,30,5,1,0,6,1,-15,3,1
2,0,27,1,30,6,9,0,15,4,30,2,0,0,2,0,30,3,12,0,15,2,30,6,9,0,15,3,30,6,0,0,6,1,-15,3,1
2,1,27,1,30,6,9,0,15,4,30,2,0,0,2,0,30,3,12,0,15,2,30,6,9,0,15,3,30,6,0,0,6,1,-15,3,1
2,3,27,1,30,6,9,0,15,4,30,2,0,0,2,0,30,3,12,0,15,2,30,6,9,0,15,3,30,6,0,0,6,1,-15,3,1
2,4,27,1,30,6,9,0,15,4,30,2,0,0,2,0,30,3,12,0,15,2,30,6,9,0,15,3,30,6,0,0,6,1,-15,3,1
2,4,29,0,30,8,6,0,14,5,30,12,0,0,12,0,30,3,11,0,14,0,30,1,13,0,14,0,30,8,1,0,9,1,-15,3,1
2,1,38,0,30,1,9,0,10,6,30,4,2,0,6,0,30,3,7,0,10,3,30,4,6,0,10,8,30,6,0,0,6,1,-15,3,1
2,3,43,2,30,4,10,0,14,8,30,6,0,0,6,0,30,4,10,0,14,1,30,3,11,0,14,9,30,5,0,0,5,1,-15,3,1
2,4,3,0,30,0,4,0,4,2,30,4,0,0,4,0,30,2,2,0,4,3,30,3,1,0,4,0,30,1,2,0,3,0,-27,3,0
2,1,14,0,30,8,1,0,9,0,30,6,0,0,6,2,30,5,4,0,9,8,30,1,8,0,9,5,30,3,1,0,4,1,-15,3,1
2,2,14,0,30,8,1,0,9,0,30,6,0,0,6,2,30,5,4,0,9,8,30,1,8,0,9,5,30,3,1,0,4,1,-15,3,1
2,2,17,2,30,6,8,0,14,3,30,6,0,0,6,0,30,3,11,0,14,1,30,9,5,0,14,5,30,4,0,0,4,1,-15,3,1
2,4,17,2,30,6,8,0,14,3,30,6,0,0,6,0,30,3,11,0,14,1,30,9,5,0,14,5,30,4,0,0,4,1,-15,3,1
2,0,19,1,30,6,7,0,13,3,30,5,3,0,8,4,30,4,9,0,13,0,30,3,10,0,13,0,30,9,0,0,9,1,-15,3,1
2,1,19,1,30,6,7,0,13,3,30,5,3,0,8,4,30,4,9,0,13,0,30,3,10,0,13,0,30,9,0,0,9,1,-15,3,1
2,3,23,2,30,4,9,0,13,1,30,6,0,0,6,6,30,13,0,0,13,0,30,6,7,0,13,2,30,6,0,0,6,1,-15,3,1
2,2,27,1,30,6,9,0,15,2,30,2,0,0,2,1,30,6,9,0,15,0,30,4,11,0,15,2,30,2,4,0,6,1,-15,3,1
2,4,27,1,30,6,9,0,15,2,30,2,0,0,2,1,30,6,9,0,15,0,30,4,11,0,15,2,30,2,4,0,6,1,-15,3,1
2,4,31,1,30,3,9,0,12,8,30,8,0,0,8,3,30,4,8,0,12,2,30,9,3,0,12,4,30,6,0,0,6,1,-15,3,1
2,4,39,0,30,4,7,0,11,7,30,6,0,0,6,0,30,3,8,0,11,2,30,4,7,0,11,3,30,5,0,0,5,1,-15,3,1
2,1,4,2,30,5,3,0,8,5,30,4,0,0,4,1,30,1,7,0,8,0,30,5,3,0,8,2,30,4,0,0,4,0,-27,3,0
2,3,4,2,30,5,3,0,8,5,30,4,0,0,4,1,30,1,7,0,8,0,30,5,3,0,8,2,30,4,0,0,4,0,-27,3,0
2,4,4,2,30,5,3,0,8,5,30,4,0,0,4,1,30,1,7,0,8,0,30,5,3,0,8,2,30,4,0,0,4,0,-27,3,0
2,2,13,4,30,7,0,0,7,0,30,4,0,0,4,0,30,6,1,0,7,9,30,7,0,0,7,5,30,4,0,0,4,1,-15,3,1
2,2,17,8,30,9,5,0,14,4,30,6,0,0,6,0,30,5,9,0,14,1,30,8,6,0,14,0,30,3,1,0,4,1,-15,3,1
2,3,17,8,30,9,5,0,14,4,30,6,0,0,6,0,30,5,9,0,14,1,30,8,6,0,14,0,30,3,1,0,4,1,-15,3,1
2,4,17,8,30,9,5,0,14,4,30,6,0,0,6,0,30,5,9,0,14,1,30,8,6,0,14,0,30,3,1,0,4,1,-15,3,1
2,1,19,0,30,6,7,0,13,1,30,7,1,0,8,0,30,7,6,0,13,6,30,4,9,0,13,2,30,7,2,0,9,1,-15,3,1
2,3,19,0,30,6,7,0,13,1,30,7,1,0,8,0,30,7,6,0,13,6,30,4,9,0,13,2,30,7,2,0,9,1,-15,3,1
2,4,19,0,30,6,7,0,13,1,30,7,1,0,8,0,30,7,6,0,13,6,30,4,9,0,13,2,30,7,2,0,9,1,-15,3,1
2,1,25,1,30,6,8,0,14,2,30,6,0,0,6,0,30,11,3,0,14,1,30,5,9,0,14,5,30,6,0,0,6,1,-15,3,1
2,0,27,1,30,4,11,0,15,3,30,1,1,0,2,0,30,2,13,0,15,0,30,6,9,0,15,6,30,6,0,0,6,1,-15,3,1
2,1,27,1,30,4,11,0,15,3,30,1,1,0,2,0,30,2,13,0,15,0,30,6,9,0,15,6,30,6,0,0,6,1,-15,3,1
2,3,27,1,30,4,11,0,15,3,30,1,1,0,2,0,30,2,13,0,15,0,30,6,9,0,15,6,30,6,0,0,6,1,-15,3,1
2,0,29,0,30,5,9,0,14,6,30,11,1,0,12,0,30,2,12,0,14,0,30,2,12,0,14,3,30,9,0,0,9,1,-15,3,1
2,1,29,0,30,5,9,0,14,6,30,11,1,0,12,0,30,2,12,0,14,0,30,2,12,0,14,3,30,9,0,0,9,1,-15,3,1
2,2,29,0,30,5,9,0,14,6,30,11,1,0,12,0,30,2,12,0,14,0,30,2,12,0,14,3,30,9,0,0,9,1,-15,3,1
2,3,29,0,30,5,9,0,14,6,30,11,1,0,12,0,30,2,12,0,14,0,30,2,12,0,14,3,30,9,0,0,9,1,-15,3,1
2,2,35,1,30,11,2,0,13,6,30,2,0,0,2,1,30,2,11,0,13,3,30,4,9,0,13,5,30,8,0,0,8,1,-15,3,1
2,4,35,1,30,11,2,0,13,6,30,2,0,0,2,1,30,2,11,0,13,3,30,4,9,0,13,5,30,8,0,0,8,1,-15,3,1
2,1,37,0,30,7,4,0,11,5,30,6,2,0,8,2,30,8,3,0,11,6,30,3,8,0,11,4,30,6,0,0,6,1,-15,3,1
2,2,37,0,30,7,4,0,11,5,30,6,2,0,8,2,30,8,3,0,11,6,30,3,8,0,11,4,30,6,0,0,6,1,-15,3,1
2,4,37,0,30,7,4,0,11,5,30,6,2,0,8,2,30,8,3,0,11,6,30,3,8,0,11,0,30,6,0,0,6,1,-15,3,1
2,3,39,0,30,4,7,0,11,6,30,6,0,0,6,0,30,6,5,0,11,0,30,3,8,0,11,7,30,3,2,0,5,1,-15,3,1
2,4,43,0,30,6,8,0,14,5,30,6,0,0,6,0,30,8,6,0,14,1,30,1,13,0,14,0,30,5,0,0,5,1,-15,3,1
2,0,47,0,30,7,7,0,14,8,30,4,0,0,4,0,30,2,12,0,14,0,30,2,12,0,14,7,30,7,0,0,7,1,-15,3,1
2,2,47,0,30,7,7,0,14,8,30,4,0,0,4,0,30,2,12,0,14,0,30,2,12,0,14,7,30,7,0,0,7,1,-15,3,1
2,4,13,3,30,7,0,0,7,0,30,4,0,0,4,2,30,6,1,0,7,10,30,6,1,0,7,2,30,4,0,0,4,1,-15,3,1
2,4,23,2,30,4,9,0,13,4,30,6,0,0,6,7,30,11,2,0,13,0,30,6,7,0,13,2,30,5,1,0,6,1,-15,3,1
2,0,27,0,30,2,13,0,15,2,30,1,1,0,2,7,30,11,4,0,15,0,30,3,12,0,15,1,30,5,1,0,6,1,-15,3,1
2,4,27,0,30,2,13,0,15,2,30,1,1,0,2,7,30,11,4,0,15,0,30,3,12,0,15,1,30,5,1,0,6,1,-15,3,1
2,3,31,1,30,5,7,0,12,7,30,8,0,0,8,3,30,4,8,0,12,4,30,7,5,0,12,5,30,6,0,0,6,1,-15,3,1
2,4,31,1,30,5,7,0,12,7,30,8,0,0,8,3,30,4,8,0,12,4,30,7,5,0,12,5,30,6,0,0,6,1,-15,3,1
2,3,35,1,30,9,4,0,13,5,30,2,0,0,2,1,30,2,11,0,13,0,30,2,11,0,13,8,30,8,0,0,8,1,-15,3,1
2,1,5,0,30,0,5,0,5,2,30,3,1,0,4,3,30,0,5,0,5,0,30,3,2,0,5,0,30,0,2,0,2,0,-27,3,0
2,4,5,0,30,0,5,0,5,2,30,3,1,0,4,0,30,0,5,0,5,0,30,3,2,0,5,0,30,0,2,0,2,0,-27,3,0
2,1,6,0,30,8,1,0,9,4,30,2,0,0,2,0,30,3,6,0,9,0,30,4,5,0,9,3,30,5,0,0,5,0,-27,3,0
2,3,7,0,30,2,2,0,4,2,30,2,0,0,2,0,30,1,3,0,4,0,30,0,4,0,4,3,30,2,0,0,2,0,-27,3,0
2,1,13,3,30,5,2,0,7,1,30,4,0,0,4,2,30,6,1,0,7,13,30,5,2,0,7,3,30,4,0,0,4,1,-15,3,1
2,4,13,3,30,5,2,0,7,1,30,4,0,0,4,2,30,6,1,0,7,13,30,5,2,0,7,3,30,4,0,0,4,1,-15,3,1
2,4,17,2,30,8,6,0,14,2,30,6,0,0,6,0,30,8,6,0,14,4,30,7,7,0,14,6,30,4,0,0,4,1,-15,3,1
2,2,23,1,30,5,8,0,13,3,30,6,0,0,6,5,30,13,0,0,13,0,30,4,9,0,13,3,30,6,0,0,6,1,-15,3,1
2,3,25,0,30,7,7,0,14,3,30,6,0,0,6,0,30,6,8,0,14,1,30,5,9,0,14,5,30,5,1,0,6,1,-15,3,1
2,4,25,0,30,7,7,0,14,3,30,6,0,0,6,0,30,6,8,0,14,1,30,5,9,0,14,5,30,5,1,0,6,1,-15,3,1
2,0,27,3,30,4,11,0,15,2,30,2,0,0,2,0,30,9,6,0,15,0,30,4,11,0,15,1,30,4,2,0,6,1,-15,3,1
2,2,27,3,30,4,11,0,15,2,30,2,0,0,2,0,30,9,6,0,15,0,30,4,11,0,15,1,30,4,2,0,6,1,-15,3,1
2,4,27,3,30,4,11,0,15,2,30,2,0,0,2,0,30,9,6,0,15,0,30,4,11,0,15,1,30,4,2,0,6,1,-15,3,1
2,3,39,1,30,4,7,0,11,8,30,6,0,0,6,0,30,4,7,0,11,5,30,4,7,0,11,2,30,4,1,0,5,1,-15,3,1
2,4,39,1,30,4,7,0,11,8,30,6,0,0,6,0,30,4,7,0,11,5,30,4,7,0,11,2,30,4,1,0,5,1,-15,3,1
2,2,47,0,30,0,14,0,14,7,30,4,0,0,4,0,30,4,10,0,14,0,30,2,12,0,14,10,30,7,0,0,7,1,-15,3,1
2,3,47,0,30,0,14,0,14,7,30,4,0,0,4,0,30,4,10,0,14,0,30,2,12,0,14,10,30,7,0,0,7,1,-15,3,1
2,2,1,0,30,7,3,0,10,4,30,2,0,0,2,1,30,6,4,0,10,5,30,7,3,0,10,6,30,6,0,0,6,0,-27,3,0
2,4,3,0,30,0,4,0,4,3,30,4,0,0,4,1,30,0,4,0,4,4,30,2,2,0,4,0,30,3,0,0,3,0,-27,3,0
2,2,11,1,30,4,8,0,12,0,30,4,0,0,4,0,30,8,4,0,12,4,30,5,7,0,12,3,30,4,0,0,4,1,-15,3,1
2,4,15,0,30,4,9,0,13,1,30,6,0,0,6,0,30,3,10,0,13,1,30,5,8,0,13,2,30,9,0,0,9,1,-15,3,1
2,3,17,3,30,8,6,0,14,1,30,6,0,0,6,0,30,8,6,0,14,1,30,7,7,0,14,5,30,4,0,0,4,1,-15,3,1
2,2,19,0,30,3,10,0,13,0,30,8,0,0,8,1,30,5,8,0,13,0,30,3,10,0,13,1,30,9,0,0,9,1,-15,3,1
2,3,23,1,30,9,4,0,13,2,30,6,0,0,6,4,30,13,0,0,13,0,30,3,10,0,13,3,30,5,1,0,6,1,-15,3,1
2,2,25,0,30,6,8,0,14,4,30,6,0,0,6,0,30,8,6,0,14,1,30,5,9,0,14,5,30,5,1,0,6,1,-15,3,1
2,3,25,0,30,6,8,0,14,4,30,6,0,0,6,0,30,8,6,0,14,1,30,5,9,0,14,5,30,5,1,0,6,1,-15,3,1
2,3,35,0,30,8,5,0,13,5,30,2,0,0,2,1,30,4,9,0,13,1,30,2,11,0,13,7,30,8,0,0,8,1,-15,3,1
2,2,13,2,30,5,2,0,7,0,30,4,0,0,4,4,30,7,0,0,7,7,30,5,2,0,7,3,30,4,0,0,4,1,-15,3,1
2,3,17,3,30,9,5,0,14,3,30,6,0,0,6,0,30,4,10,0,14,0,30,8,6,0,14,1,30,4,0,0,4,1,-15,3,1
2,2,27,1,30,5,10,0,15,5,30,2,0,0,2,0,30,3,12,0,15,0,30,5,10,0,15,6,30,6,0,0,6,1,-15,3,1
2,3,27,1,30,5,10,0,15,5,30,2,0,0,2,0,30,3,12,0,15,0,30,5,10,0,15,6,30,6,0,0,6,1,-15,3,1
2,4,27,1,30,5,10,0,15,5,30,2,0,0,2,0,30,3,12,0,15,0,30,5,10,0,15,6,30,6,0,0,6,1,-15,3,1
2,0,29,0,30,6,8,0,14,6,30,12,0,0,12,0,30,3,11,0,14,0,30,3,11,0,14,4,30,9,0,0,9,1,-15,3,1
2,1,29,0,30,6,8,0,14,6,30,12,0,0,12,0,30,3,11,0,14,0,30,3,11,0,14,4,30,9,0,0,9,1,-15,3,1
2,4,29,0,30,6,8,0,14,6,30,12,0,0,12,0,30,3,11,0,14,0,30,3,11,0,14,4,30,9,0,0,9,1,-15,3,1
2,0,37,1,30,5,6,0,11,6,30,8,0,0,8,0,30,6,5,0,11,2,30,5,6,0,11,3,30,6,0,0,6,1,-15,3,1
2,3,37,1,30,5,6,0,11,6,30,8,0,0,8,0,30,6,5,0,11,2,30,5,6,0,11,3,30,6,0,0,6,1,-15,3,1
2,2,47,0,30,0,14,0,14,6,30,4,0,0,4,0,30,3,11,0,14,1,30,3,11,0,14,5,30,7,0,0,7,1,-15,3,1
2,3,47,0,30,0,14,0,14,6,30,4,0,0,4,0,30,3,11,0,14,1,30,3,11,0,14,5,30,7,0,0,7,1,-15,3,1
2,4,47,0,30,0,14,0,14,6,30,4,0,0,4,0,30,3,11,0,14,1,30,3,11,0,14,5,30,7,0,0,7,1,-15,3,1
2,4,3,0,30,1,3,0,4,2,30,4,0,0,4,0,30,0,4,0,4,3,30,3,1,0,4,0,30,1,2,0,3,0,-27,3,0
2,1,4,2,30,6,2,0,8,5,30,4,0,0,4,0,30,2,6,0,8,1,30,6,2,0,8,2,30,3,1,0,4,0,-27,3,0
2,4,4,2,30,6,2,0,8,5,30,4,0,0,4,0,30,2,6,0,8,1,30,6,2,0,8,2,30,3,1,0,4,0,-27,3,0
2,0,6,2,30,8,1,0,9,4,30,2,0,0,2,0,30,2,7,0,9,0,30,4,5,0,9,0,30,3,2,0,5,0,-27,3,0
2,4,15,1,30,7,6,0,13,1,30,6,0,0,6,0,30,3,10,0,13,1,30,4,9,0,13,2,30,5,4,0,9,1,-15,3,1
2,3,17,3,30,10,4,0,14,2,30,6,0,0,6,0,30,6,8,0,14,1,30,6,8,0,14,3,30,4,0,0,4,1,-15,3,1
2,4,17,3,30,10,4,0,14,2,30,6,0,0,6,0,30,6,8,0,14,1,30,6,8,0,14,3,30,4,0,0,4,1,-15,3,1
2,3,19,0,30,3,10,0,13,1,30,8,0,0,8,0,30,9,4,0,13,0,30,4,9,0,13,0,30,7,2,0,9,1,-15,3,1
2,4,19,0,30,3,10,0,13,1,30,8,0,0,8,0,30,9,4,0,13,0,30,4,9,0,13,0,30,7,2,0,9,1,-15,3,1
2,2,26,0,30,7,2,0,9,5,30,4,0,0,4,2,30,1,8,0,9,0,30,2,7,0,9,5,30,2,1,0,3,1,-15,3,1
2,1,27,4,30,5,10,0,15,2,30,2,0,0,2,0,30,9,6,0,15,0,30,6,9,0,15,0,30,3,3,0,6,1,-15,3,1
2,2,27,4,30,5,10,0,15,2,30,2,0,0,2,0,30,9,6,0,15,0,30,6,9,0,15,0,30,3,3,0,6,1,-15,3,1
2,4,27,4,30,5,10,0,15,2,30,2,0,0,2,0,30,9,6,0,15,0,30,6,9,0,15,0,30,3,3,0,6,1,-15,3,1
2,1,29,0,30,7,7,0,14,5,30,12,0,0,12,0,30,8,6,0,14,0,30,1,13,0,14,4,30,9,0,0,9,1,-15,3,1
2,2,29,0,30,7,7,0,14,5,30,12,0,0,12,0,30,8,6,0,14,0,30,1,13,0,14,4,30,9,0,0,9,1,-15,3,1
2,1,5,0,30,1,4,0,5,3,30,0,4,0,4,0,30,1,4,0,5,0,30,3,2,0,5,0,30,0,2,0,2,0,-27,3,0
2,2,8,6,30,7,0,0,7,5,30,2,0,0,2,3,30,3,4,0,7,0,30,5,2,0,7,3,30,3,0,0,3,0,-27,3,0
2,4,8,5,30,7,0,0,7,5,30,2,0,0,2,3,30,3,4,0,7,0,30,5,2,0,7,3,30,3,0,0,3,0,-27,3,0
2,2,9,1,30,7,4,0,11,4,30,6,0,0,6,3,30,4,7,0,11,5,30,3,8,0,11,4,30,4,0,0,4,0,-27,3,0
2,3,9,1,30,7,4,0,11,4,30,6,0,0,6,3,30,4,7,0,11,5,30,3,8,0,11,4,30,4,0,0,4,0,-27,3,0
2,4,9,1,30,7,4,0,11,4,30,6,0,0,6,3,30,4,7,0,11,5,30,3,8,0,11,4,30,4,0,0,4,0,-27,3,0
2,1,11,2,30,6,6,0,12,2,30,4,0,0,4,0,30,6,6,0,12,7,30,7,5,0,12,4,30,4,0,0,4,1,-15,3,1
2,4,11,2,30,6,6,0,12,2,30,4,0,0,4,0,30,6,6,0,12,7,30,7,5,0,12,4,30,4,0,0,4,1,-15,3,1
2,4,13,3,30,7,0,0,7,0,30,4,0,0,4,0,30,5,2,0,7,7,30,6,1,0,7,4,30,4,0,0,4,1,-15,3,1
2,3,25,3,30,6,8,0,14,1,30,6,0,0,6,0,30,10,4,0,14,1,30,5,9,0,14,4,30,5,1,0,6,1,-15,3,1
2,1,27,1,30,4,11,0,15,4,30,2,0,0,2,0,30,4,11,0,15,2,30,6,9,0,15,6,30,6,0,0,6,1,-15,3,1
2,3,27,1,30,4,11,0,15,4,30,2,0,0,2,0,30,4,11,0,15,2,30,6,9,0,15,6,30,6,0,0,6,1,-15,3,1
2,4,27,1,30,4,11,0,15,4,30,2,0,0,2,0,30,4,11,0,15,2,30,6,9,0,15,6,30,6,0,0,6,1,-15,3,1
2,2,5,1,30,1,4,0,5,3,30,2,2,0,4,0,30,1,4,0,5,0,30,1,4,0,5,0,30,0,2,0,2,0,-27,3,0
2,3,5,1,30,1,4,0,5,3,30,2,2,0,4,0,30,1,4,0,5,0,30,1,4,0,5,0,30,0,2,0,2,0,-27,3,0
2,3,7,1,30,7,2,0,9,3,30,3,1,0,4,0,30,5,4,0,9,4,30,3,6,0,9,2,30,5,1,0,6,0,-27,3,0
2,3,11,0,30,1,3,0,4,0,30,0,0,0,0,0,30,3,1,0,4,3,30,3,1,0,4,0,30,1,0,0,1,1,-15,3,1
2,4,11,0,30,1,3,0,4,0,30,0,0,0,0,0,30,3,1,0,4,3,30,3,1,0,4,0,30,1,0,0,1,1,-15,3,1
2,1,13,4,30,7,0,0,7,1,30,4,0,0,4,2,30,5,2,0,7,6,30,5,2,0,7,0,30,4,0,0,4,1,-15,3,1
2,2,13,4,30,7,0,0,7,1,30,4,0,0,4,2,30,5,2,0,7,6,30,5,2,0,7,0,30,4,0,0,4,1,-15,3,1
2,4,13,4,30,7,0,0,7,1,30,4,0,0,4,2,30,5,2,0,7,6,30,5,2,0,7,0,30,4,0,0,4,1,-15,3,1
2,0,17,3,30,9,5,0,14,3,30,6,0,0,6,0,30,5,9,0,14,2,30,6,8,0,14,4,30,4,0,0,4,1,-15,3,1
2,3,17,3,30,9,5,0,14,3,30,6,0,0,6,0,30,5,9,0,14,2,30,6,8,0,14,4,30,4,0,0,4,1,-15,3,1
2,4,17,3,30,9,5,0,14,3,30,6,0,0,6,0,30,5,9,0,14,2,30,6,8,0,14,4,30,4,0,0,4,1,-15,3,1
2,1,25,1,30,8,6,0,14,3,30,5,1,0,6,0,30,9,5,0,14,1,30,4,10,0,14,4,30,5,1,0,6,1,-15,3,1
2,2,25,1,30,8,6,0,14,3,30,5,1,0,6,0,30,9,5,0,14,1,30,4,10,0,14,4,30,5,1,0,6,1,-15,3,1
2,0,27,0,30,5,10,0,15,5,30,1,1,0,2,0,30,2,13,0,15,2,30,5,10,0,15,5,30,6,0,0,6,1,-15,3,1
2,2,27,0,30,5,10,0,15,5,30,1,1,0,2,0,30,2,13,0,15,2,30,5,10,0,15,5,30,6,0,0,6,1,-15,3,1
2,3,27,0,30,5,10,0,15,5,30,1,1,0,2,0,30,2,13,0,15,2,30,5,10,0,15,5,30,6,0,0,6,1,-15,3,1
2,4,29,0,30,4,10,0,14,6,30,8,4,0,12,9,30,8,6,0,14,0,30,0,14,0,14,0,30,5,4,0,9,1,-15,3,1
2,3,35,0,30,8,5,0,13,1,30,2,0,0,2,3,30,13,0,0,13,5,30,2,11,0,13,1,30,8,0,0,8,1,-15,3,1
2,2,4,3,30,7,1,0,8,4,30,4,0,0,4,0,30,3,5,0,8,0,30,2,6,0,8,3,30,4,0,0,4,0,-27,3,0
2,4,4,3,30,7,1,0,8,4,30,4,0,0,4,0,30,3,5,0,8,0,30,2,6,0,8,3,30,4,0,0,4,0,-27,3,0
2,2,6,0,30,5,4,0,9,4,30,2,0,0,2,0,30,2,7,0,9,0,30,4,5,0,9,1,30,5,0,0,5,0,-27,3,0
2,4,8,1,30,7,0,0,7,3,30,2,0,0,2,4,30,4,3,0,7,1,30,6,1,0,7,4,30,3,0,0,3,0,-27,3,0
2,3,17,3,30,9,5,0,14,3,30,6,0,0,6,0,30,7,7,0,14,5,30,5,9,0,14,2,30,4,0,0,4,1,-15,3,1
2,4,17,3,30,9,5,0,14,3,30,6,0,0,6,0,30,7,7,0,14,5,30,5,9,0,14,2,30,4,0,0,4,1,-15,3,1
2,1,19,0,30,2,11,0,13,2,30,8,0,0,8,2,30,4,9,0,13,0,30,6,7,0,13,1,30,6,3,0,9,1,-15,3,1
2,3,19,0,30,2,11,0,13,2,30,8,0,0,8,2,30,4,9,0,13,0,30,6,7,0,13,1,30,6,3,0,9,1,-15,3,1
2,4,19,0,30,2,11,0,13,2,30,8,0,0,8,2,30,4,9,0,13,0,30,6,7,0,13,1,30,6,3,0,9,1,-15,3,1
2,4,23,1,30,4,9,0,13,3,30,6,0,0,6,7,30,12,1,0,13,0,30,6,7,0,13,3,30,6,0,0,6,1,-15,3,1
2,1,27,1,30,7,8,0,15,3,30,2,0,0,2,0,30,6,9,0,15,0,30,4,11,0,15,0,30,6,0,0,6,1,-15,3,1
2,3,27,0,30,7,8,0,15,3,30,2,0,0,2,0,30,6,9,0,15,0,30,4,11,0,15,0,30,6,0,0,6,1,-15,3,1
2,0,4,3,30,8,0,0,8,5,30,4,0,0,4,1,30,1,7,0,8,0,30,6,2,0,8,1,30,2,2,0,4,0,-27,3,0
2,3,4,3,30,8,0,0,8,5,30,4,0,0,4,1,30,1,7,0,8,0,30,6,2,0,8,1,30,2,2,0,4,0,-27,3,0
2,4,4,3,30,8,0,0,8,5,30,4,0,0,4,1,30,1,7,0,8,0,30,6,2,0,8,1,30,2,2,0,4,0,-27,3,0
2,2,6,0,30,9,0,0,9,4,30,2,0,0,2,0,30,2,7,0,9,0,30,3,6,0,9,1,30,5,0,0,5,0,-27,3,0
2,3,6,0,30,9,0,0,9,4,30,2,0,0,2,0,30,2,7,0,9,0,30,3,6,0,9,1,30,5,0,0,5,0,-27,3,0
2,4,8,4,30,7,0,0,7,5,30,2,0,0,2,0,30,1,6,0,7,3,30,7,0,0,7,1,30,3,0,0,3,0,-27,3,0
2,2,13,3,30,7,0,0,7,0,30,4,0,0,4,2,30,5,2,0,7,9,30,7,0,0,7,6,30,4,0,0,4,1,-15,3,1
2,4,13,3,30,7,0,0,7,0,30,4,0,0,4,2,30,5,2,0,7,9,30,7,0,0,7,6,30,4,0,0,4,1,-15,3,1
2,2,17,3,30,8,6,0,14,2,30,6,0,0,6,0,30,8,6,0,14,1,30,5,9,0,14,6,30,4,0,0,4,1,-15,3,1
2,3,17,3,30,8,6,0,14,2,30,6,0,0,6,0,30,8,6,0,14,1,30,5,9,0,14,6,30,4,0,0,4,1,-15,3,1
2,4,17,3,30,8,6,0,14,2,30,6,0,0,6,0,30,8,6,0,14,1,30,5,9,0,14,6,30,4,0,0,4,1,-15,3,1
2,1,19,0,30,7,6,0,13,2,30,7,1,0,8,4,30,5,8,0,13,3,30,4,9,0,13,0,30,7,2,0,9,1,-15,3,1
2,2,19,0,30,7,6,0,13,2,30,7,1,0,8,4,30,5,8,0,13,3,30,4,9,0,13,0,30,7,2,0,9,1,-15,3,1
2,1,24,0,30,3,3,0,6,3,30,4,0,0,4,0,30,1,5,0,6,4,30,1,5,0,6,4,30,4,0,0,4,1,-15,3,1
2,1,27,1,30,4,11,0,15,3,30,2,0,0,2,0,30,3,12,0,15,0,30,6,9,0,15,6,30,6,0,0,6,1,-15,3,1
2,3,27,1,30,4,11,0,15,3,30,2,0,0,2,0,30,3,12,0,15,0,30,6,9,0,15,6,30,6,0,0,6,1,-15,3,1
2,4,27,1,30,4,11,0,15,3,30,2,0,0,2,0,30,3,12,0,15,0,30,6,9,0,15,6,30,6,0,0,6,1,-15,3,1
2,3,11,3,30,10,2,0,12,2,30,4,0,0,4,0,30,3,9,0,12,0,30,4,8,0,12,3,30,3,1,0,4,1,-15,3,1
2,4,17,3,30,11,3,0,14,2,30,6,0,0,6,0,30,6,8,0,14,5,30,5,9,0,14,1,30,4,0,0,4,1,-15,3,1
2,2,19,0,30,6,7,0,13,1,30,4,4,0,8,0,30,5,8,0,13,3,30,4,9,0,13,0,30,8,1,0,9,1,-15,3,1
2,4,19,0,30,6,7,0,13,1,30,4,4,0,8,0,30,5,8,0,13,3,30,4,9,0,13,0,30,8,1,0,9,1,-15,3,1
2,2,21,2,30,7,3,0,10,3,30,5,1,0,6,1,30,4,6,0,10,2,30,4,6,0,10,4,30,4,0,0,4,1,-15,3,1
2,3,21,2,30,7,3,0,10,3,30,5,1,0,6,1,30,4,6,0,10,2,30,4,6,0,10,4,30,4,0,0,4,1,-15,3,1
2,2,23,1,30,5,8,0,13,3,30,6,0,0,6,6,30,10,3,0,13,0,30,4,9,0,13,3,30,6,0,0,6,1,-15,3,1
2,3,23,1,30,5,8,0,13,3,30,6,0,0,6,6,30,10,3,0,13,0,30,4,9,0,13,3,30,6,0,0,6,1,-15,3,1
2,2,25,3,30,7,7,0,14,3,30,6,0,0,6,0,30,5,9,0,14,1,30,5,9,0,14,3,30,5,1,0,6,1,-15,3,1
2,4,25,3,30,7,7,0,14,3,30,6,0,0,6,0,30,5,9,0,14,1,30,5,9,0,14,3,30,5,1,0,6,1,-15,3,1
2,0,27,1,30,5,10,0,15,4,30,2,0,0,2,0,30,2,13,0,15,4,30,3,12,0,15,2,30,6,0,0,6,1,-15,3,1
2,1,27,1,30,5,10,0,15,4,30,2,0,0,2,0,30,2,13,0,15,4,30,3,12,0,15,2,30,6,0,0,6,1,-15,3,1
2,4,27,1,30,5,10,0,15,4,30,2,0,0,2,0,30,2,13,0,15,4,30,3,12,0,15,2,30,6,0,0,6,1,-15,3,1
2,3,39,2,30,4,7,0,11,6,30,6,0,0,6,3,30,7,4,0,11,0,30,2,9,0,11,1,30,1,4,0,5,1,-15,3,1
2,2,43,0,30,6,8,0,14,8,30,6,0,0,6,0,30,4,10,0,14,1,30,1,13,0,14,5,30,5,0,0,5,1,-15,3,1
2,3,43,0,30,6,8,0,14,8,30,6,0,0,6,0,30,4,10,0,14,1,30,1,13,0,14,5,30,5,0,0,5,1,-15,3,1
2,1,4,2,30,5,3,0,8,4,30,4,0,0,4,0,30,2,6,0,8,0,30,5,3,0,8,5,30,4,0,0,4,0,-27,3,0
2,3,11,0,30,3,9,0,12,0,30,4,0,0,4,0,30,5,7,0,12,4,30,3,9,0,12,0,30,4,0,0,4,1,-15,3,1
2,4,11,0,30,3,9,0,12,0,30,4,0,0,4,0,30,5,7,0,12,4,30,3,9,0,12,0,30,4,0,0,4,1,-15,3,1
2,4,13,9,30,7,0,0,7,4,30,4,0,0,4,9,30,7,0,0,7,0,30,4,3,0,7,1,30,4,0,0,4,1,-15,3,1
2,1,19,0,30,3,10,0,13,1,30,7,1,0,8,0,30,11,2,0,13,1,30,6,7,0,13,0,30,9,0,0,9,1,-15,3,1
2,3,19,0,30,3,10,0,13,1,30,7,1,0,8,0,30,11,2,0,13,1,30,6,7,0,13,0,30,9,0,0,9,1,-15,3,1
2,1,21,2,30,7,3,0,10,4,30,6,0,0,6,1,30,3,7,0,10,1,30,5,5,0,10,5,30,4,0,0,4,1,-15,3,1
2,4,21,2,30,7,3,0,10,4,30,6,0,0,6,1,30,3,7,0,10,1,30,5,5,0,10,5,30,4,0,0,4,1,-15,3,1
2,1,25,1,30,7,7,0,14,3,30,6,0,0,6,0,30,6,8,0,14,4,30,9,5,0,14,4,30,5,1,0,6,1,-15,3,1
2,2,25,1,30,7,7,0,14,3,30,6,0,0,6,0,30,6,8,0,14,4,30,9,5,0,14,4,30,5,1,0,6,1,-15,3,1
2,3,25,1,30,7,7,0,14,3,30,6,0,0,6,0,30,6,8,0,14,4,30,9,5,0,14,4,30,5,1,0,6,1,-15,3,1
2,0,27,4,30,5,10,0,15,4,30,2,0,0,2,0,30,2,13,0,15,2,30,4,11,0,15,1,30,4,2,0,6,1,-15,3,1
2,3,27,4,30,5,10,0,15,4,30,2,0,0,2,0,30,2,13,0,15,2,30,4,11,0,15,1,30,4,2,0,6,1,-15,3,1
2,4,27,4,30,5,10,0,15,4,30,2,0,0,2,0,30,2,13,0,15,2,30,4,11,0,15,1,30,4,2,0,6,1,-15,3,1
2,4,35,0,30,5,8,0,13,1,30,2,0,0,2,1,30,10,3,0,13,2,30,1,12,0,13,0,30,8,0,0,8,1,-15,3,1
2,0,11,1,30,4,8,0,12,2,30,4,0,0,4,0,30,6,6,0,12,6,30,9,3,0,12,5,30,4,0,0,4,1,-15,3,1
2,1,11,1,30,4,8,0,12,2,30,4,0,0,4,0,30,6,6,0,12,6,30,9,3,0,12,5,30,4,0,0,4,1,-15,3,1
2,3,11,1,30,4,8,0,12,2,30,4,0,0,4,0,30,6,6,0,12,6,30,9,3,0,12,5,30,4,0,0,4,1,-15,3,1
2,4,13,1,30,7,0,0,7,2,30,4,0,0,4,2,30,5,2,0,7,6,30,5,2,0,7,3,30,4,0,0,4,1,-15,3,1
2,4,15,0,30,5,8,0,13,0,30,6,0,0,6,0,30,6,7,0,13,1,30,5,8,0,13,2,30,7,2,0,9,1,-15,3,1
2,0,17,4,30,10,4,0,14,4,30,6,0,0,6,0,30,4,10,0,14,3,30,6,8,0,14,5,30,4,0,0,4,1,-15,3,1
2,2,17,4,30,10,4,0,14,4,30,6,0,0,6,0,30,4,10,0,14,3,30,6,8,0,14,5,30,4,0,0,4,1,-15,3,1
2,3,17,4,30,10,4,0,14,4,30,6,0,0,6,0,30,4,10,0,14,3,30,6,8,0,14,5,30,4,0,0,4,1,-15,3,1
2,4,17,4,30,10,4,0,14,4,30,6,0,0,6,0,30,4,10,0,14,3,30,6,8,0,14,5,30,4,0,0,4,1,-15,3,1
2,2,19,0,30,4,9,0,13,2,30,5,3,0,8,0,30,4,9,0,13,3,30,7,6,0,13,1,30,9,0,0,9,1,-15,3,1
2,2,25,1,30,8,6,0,14,5,30,6,0,0,6,0,30,6,8,0,14,1,30,4,10,0,14,5,30,5,1,0,6,1,-15,3,1
2,4,25,1,30,8,6,0,14,5,30,6,0,0,6,0,30,6,8,0,14,1,30,4,10,0,14,5,30,5,1,0,6,1,-15,3,1
2,3,32,0,30,5,4,0,9,4,30,2,0,0,2,1,30,8,1,0,9,1,30,2,7,0,9,3,30,2,0,0,2,1,-15,3,1
2,4,32,0,30,5,4,0,9,4,30,2,0,0,2,1,30,8,1,0,9,1,30,2,7,0,9,3,30,2,0,0,2,1,-15,3,1
2,0,4,2,30,7,1,0,8,5,30,4,0,0,4,1,30,1,7,0,8,1,30,8,0,0,8,1,30,3,1,0,4,0,-27,3,0
2,2,13,3,30,6,1,0,7,0,30,4,0,0,4,1,30,6,1,0,7,5,30,7,0,0,7,4,30,4,0,0,4,1,-15,3,1
2,3,15,1,30,4,9,0,13,1,30,6,0,0,6,0,30,3,10,0,13,1,30,4,9,0,13,1,30,7,2,0,9,1,-15,3,1
2,2,27,1,30,4,11,0,15,3,30,2,0,0,2,0,30,12,3,0,15,5,30,6,9,0,15,2,30,4,2,0,6,1,-15,3,1
2,2,31,1,30,7,5,0,12,7,30,8,0,0,8,3,30,4,8,0,12,2,30,7,5,0,12,3,30,6,0,0,6,1,-15,3,1
2,4,31,1,30,7,5,0,12,7,30,8,0,0,8,3,30,4,8,0,12,2,30,7,5,0,12,3,30,6,0,0,6,1,-15,3,1
2,2,33,6,30,5,6,0,11,6,30,4,0,0,4,3,30,8,3,0,11,0,30,3,8,0,11,5,30,4,0,0,4,1,-15,3,1
2,3,33,6,30,5,6,0,11,6,30,4,0,0,4,3,30,8,3,0,11,0,30,3,8,0,11,5,30,4,0,0,4,1,-15,3,1
2,4,33,6,30,5,6,0,11,6,30,4,0,0,4,3,30,8,3,0,11,0,30,3,8,0,11,5,30,4,0,0,4,1,-15,3,1
2,3,35,1,30,10,3,0,13,4,30,2,0,0,2,1,30,2,11,0,13,0,30,1,12,0,13,4,30,7,1,0,8,1,-15,3,1
2,4,35,1,30,10,3,0,13,4,30,2,0,0,2,1,30,2,11,0,13,0,30,1,12,0,13,4,30,7,1,0,8,1,-15,3,1
2,3,13,4,30,6,1,0,7,1,30,4,0,0,4,1,30,6,1,0,7,2,30,5,2,0,7,2,30,4,0,0,4,1,-15,3,1
2,4,13,4,30,6,1,0,7,1,30,4,0,0,4,1,30,6,1,0,7,2,30,5,2,0,7,2,30,4,0,0,4,1,-15,3,1
2,1,25,1,30,6,8,0,14,3,30,6,0,0,6,0,30,7,7,0,14,1,30,7,7,0,14,5,30,6,0,0,6,1,-15,3,1
2,2,25,1,30,6,8,0,14,3,30,6,0,0,6,0,30,7,7,0,14,1,30,7,7,0,14,5,30,6,0,0,6,1,-15,3,1
2,0,27,1,30,4,11,0,15,5,30,1,1,0,2,0,30,5,10,0,15,2,30,4,11,0,15,4,30,6,0,0,6,1,-15,3,1
2,4,27,1,30,4,11,0,15,4,30,1,1,0,2,0,30,5,10,0,15,2,30,4,11,0,15,3,30,6,0,0,6,1,-15,3,1
2,4,31,5,30,7,5,0,12,4,30,8,0,0,8,3,30,10,2,0,12,0,30,3,9,0,12,0,30,3,3,0,6,1,-15,3,1
2,3,39,0,30,5,6,0,11,7,30,6,0,0,6,0,30,5,6,0,11,2,30,4,7,0,11,2,30,5,0,0,5,1,-15,3,1
2,4,39,0,30,5,6,0,11,7,30,6,0,0,6,0,30,5,6,0,11,2,30,4,7,0,11,2,30,5,0,0,5,1,-15,3,1
2,4,5,0,30,1,4,0,5,3,30,0,4,0,4,0,30,2,3,0,5,0,30,1,4,0,5,0,30,0,2,0,2,0,-27,3,0
2,2,6,0,30,5,4,0,9,4,30,2,0,0,2,0,30,3,6,0,9,1,30,6,3,0,9,1,30,4,1,0,5,0,-27,3,0
2,3,6,0,30,5,4,0,9,4,30,2,0,0,2,0,30,3,6,0,9,1,30,6,3,0,9,1,30,4,1,0,5,0,-27,3,0
2,1,13,3,30,5,2,0,7,0,30,4,0,0,4,3,30,6,1,0,7,5,30,7,0,0,7,6,30,4,0,0,4,1,-15,3,1
2,2,13,3,30,5,2,0,7,0,30,4,0,0,4,3,30,6,1,0,7,5,30,7,0,0,7,6,30,4,0,0,4,1,-15,3,1
2,4,17,4,30,10,4,0,14,2,30,6,0,0,6,0,30,6,8,0,14,1,30,3,11,0,14,4,30,4,0,0,4,1,-15,3,1
2,2,19,0,30,3,10,0,13,0,30,4,4,0,8,0,30,6,7,0,13,8,30,5,8,0,13,2,30,9,0,0,9,1,-15,3,1
2,4,19,0,30,3,10,0,13,0,30,4,4,0,8,0,30,6,7,0,13,8,30,5,8,0,13,2,30,9,0,0,9,1,-15,3,1
2,4,25,0,30,6,8,0,14,1,30,6,0,0,6,0,30,11,3,0,14,1,30,5,9,0,14,3,30,5,1,0,6,1,-15,3,1
2,2,27,7,30,4,11,0,15,3,30,2,0,0,2,0,30,7,8,0,15,0,30,5,10,0,15,3,30,5,1,0,6,1,-15,3,1
2,3,27,7,30,4,11,0,15,3,30,2,0,0,2,0,30,7,8,0,15,0,30,5,10,0,15,3,30,5,1,0,6,1,-15,3,1
2,2,38,0,30,2,8,0,10,7,30,6,0,0,6,0,30,1,9,0,10,0,30,4,6,0,10,9,30,5,1,0,6,1,-15,3,1
2,4,13,4,30,7,0,0,7,0,30,4,0,0,4,0,30,6,1,0,7,4,30,6,1,0,7,2,30,4,0,0,4,1,-15,3,1
2,3,17,2,30,9,5,0,14,3,30,6,0,0,6,0,30,6,8,0,14,1,30,8,6,0,14,6,30,4,0,0,4,1,-15,3,1
2,4,17,2,30,9,5,0,14,3,30,6,0,0,6,0,30,6,8,0,14,1,30,8,6,0,14,6,30,4,0,0,4,1,-15,3,1
2,2,19,1,30,5,8,0,13,2,30,6,2,0,8,0,30,5,8,0,13,0,30,6,7,0,13,3,30,9,0,0,9,1,-15,3,1
2,1,21,0,30,6,4,0,10,3,30,6,0,0,6,0,30,3,7,0,10,4,30,4,6,0,10,4,30,4,0,0,4,1,-15,3,1
2,4,23,1,30,10,3,0,13,1,30,6,0,0,6,0,30,11,2,0,13,1,30,5,8,0,13,1,30,6,0,0,6,1,-15,3,1
2,4,25,1,30,6,8,0,14,3,30,6,0,0,6,0,30,8,6,0,14,1,30,5,9,0,14,2,30,4,2,0,6,1,-15,3,1
2,0,26,0,30,8,1,0,9,4,30,3,1,0,4,7,30,1,8,0,9,0,30,2,7,0,9,4,30,3,0,0,3,1,-15,3,1
2,4,26,0,30,8,1,0,9,4,30,3,1,0,4,5,30,1,8,0,9,0,30,2,7,0,9,4,30,3,0,0,3,1,-15,3,1
2,3,27,0,30,4,11,0,15,3,30,2,0,0,2,0,30,6,9,0,15,2,30,6,9,0,15,0,30,6,0,0,6,1,-15,3,1
2,0,29,0,30,6,8,0,14,6,30,11,1,0,12,0,30,3,11,0,14,0,30,1,13,0,14,2,30,9,0,0,9,1,-15,3,1
2,3,9,0,30,5,6,0,11,3,30,6,0,0,6,2,30,7,4,0,11,5,30,4,7,0,11,3,30,4,0,0,4,0,-27,3,0
2,4,15,0,30,3,10,0,13,0,30,6,0,0,6,0,30,5,8,0,13,1,30,6,7,0,13,2,30,6,3,0,9,1,-15,3,1
2,4,17,3,30,11,3,0,14,0,30,6,0,0,6,0,30,7,7,0,14,3,30,5,9,0,14,1,30,4,0,0,4,1,-15,3,1
2,4,23,2,30,5,8,0,13,4,30,6,0,0,6,8,30,10,3,0,13,0,30,6,7,0,13,1,30,5,1,0,6,1,-15,3,1
2,0,27,1,30,4,11,0,15,3,30,2,0,0,2,0,30,5,10,0,15,1,30,5,10,0,15,5,30,6,0,0,6,1,-15,3,1
2,1,27,1,30,4,11,0,15,3,30,2,0,0,2,0,30,5,10,0,15,1,30,5,10,0,15,5,30,6,0,0,6,1,-15,3,1
2,2,27,1,30,4,11,0,15,3,30,2,0,0,2,0,30,5,10,0,15,1,30,5,10,0,15,5,30,6,0,0,6,1,-15,3,1
2,1,7,1,30,3,1,0,4,2,30,2,0,0,2,1,30,3,1,0,4,0,30,0,4,0,4,1,30,1,1,0,2,0,-27,3,0
2,2,7,1,30,3,1,0,4,2,30,2,0,0,2,1,30,3,1,0,4,0,30,0,4,0,4,1,30,1,1,0,2,0,-27,3,0
2,2,13,3,30,7,0,0,7,0,30,4,0,0,4,1,30,6,1,0,7,5,30,7,0,0,7,4,30,4,0,0,4,1,-15,3,1
2,4,17,4,30,9,5,0,14,4,30,6,0,0,6,0,30,3,11,0,14,4,30,5,9,0,14,0,30,4,0,0,4,1,-15,3,1
2,0,19,0,30,5,8,0,13,2,30,5,3,0,8,4,30,4,9,0,13,1,30,6,7,0,13,0,30,8,1,0,9,1,-15,3,1
2,1,19,0,30,5,8,0,13,2,30,5,3,0,8,4,30,4,9,0,13,1,30,6,7,0,13,0,30,8,1,0,9,1,-15,3,1
2,3,25,1,30,6,8,0,14,4,30,6,0,0,6,0,30,6,8,0,14,1,30,5,9,0,14,3,30,6,0,0,6,1,-15,3,1
2,4,26,1,30,7,2,0,9,5,30,4,0,0,4,4,30,1,8,0,9,0,30,4,5,0,9,6,30,3,0,0,3,1,-15,3,1
2,1,27,1,30,3,12,0,15,5,30,1,1,0,2,0,30,5,10,0,15,0,30,5,10,0,15,3,30,6,0,0,6,1,-15,3,1
2,4,27,1,30,3,12,0,15,5,30,1,1,0,2,0,30,5,10,0,15,0,30,5,10,0,15,3,30,6,0,0,6,1,-15,3,1
2,2,4,9,30,8,0,0,8,5,30,2,2,0,4,0,30,1,7,0,8,3,30,1,7,0,8,1,30,3,1,0,4,0,-27,3,0
2,2,13,1,30,5,2,0,7,0,30,4,0,0,4,3,30,5,2,0,7,4,30,7,0,0,7,7,30,4,0,0,4,1,-15,3,1
2,1,17,5,30,8,6,0,14,2,30,6,0,0,6,0,30,8,6,0,14,5,30,6,8,0,14,3,30,3,1,0,4,1,-15,3,1
2,3,17,5,30,8,6,0,14,2,30,6,0,0,6,0,30,8,6,0,14,5,30,6,8,0,14,3,30,3,1,0,4,1,-15,3,1
2,4,23,2,30,4,9,0,13,0,30,6,0,0,6,1,30,13,0,0,13,2,30,6,7,0,13,5,30,6,0,0,6,1,-15,3,1
2,2,25,2,30,8,6,0,14,3,30,6,0,0,6,0,30,8,6,0,14,1,30,4,10,0,14,3,30,6,0,0,6,1,-15,3,1
2,3,25,2,30,8,6,0,14,3,30,6,0,0,6,0,30,8,6,0,14,1,30,4,10,0,14,3,30,6,0,0,6,1,-15,3,1
2,0,27,1,30,3,12,0,15,5,30,2,0,0,2,0,30,2,13,0,15,4,30,4,11,0,15,3,30,6,0,0,6,1,-15,3,1
2,4,27,1,30,3,12,0,15,5,30,2,0,0,2,0,30,2,13,0,15,4,30,4,11,0,15,3,30,6,0,0,6,1,-15,3,1
2,2,31,3,30,7,5,0,12,4,30,8,0,0,8,3,30,11,1,0,12,0,30,3,9,0,12,0,30,4,2,0,6,1,-15,3,1
2,4,31,3,30,7,5,0,12,3,30,8,0,0,8,3,30,11,1,0,12,0,30,3,9,0,12,0,30,4,2,0,6,1,-15,3,1
2,3,33,1,30,2,9,0,11,4,30,4,0,0,4,1,30,10,1,0,11,0,30,3,8,0,11,0,30,4,0,0,4,1,-15,3,1
2,2,4,2,30,7,1,0,8,5,30,4,0,0,4,1,30,2,6,0,8,0,30,7,1,0,8,3,30,4,0,0,4,0,-27,3,0
2,4,4,2,30,7,1,0,8,5,30,4,0,0,4,1,30,2,6,0,8,0,30,7,1,0,8,3,30,4,0,0,4,0,-27,3,0
2,4,8,1,30,7,0,0,7,3,30,2,0,0,2,1,30,4,3,0,7,2,30,7,0,0,7,2,30,3,0,0,3,0,-27,3,0
2,2,11,1,30,4,8,0,12,0,30,4,0,0,4,0,30,6,6,0,12,1,30,6,6,0,12,3,30,4,0,0,4,1,-15,3,1
2,4,11,1,30,4,8,0,12,0,30,4,0,0,4,0,30,6,6,0,12,1,30,6,6,0,12,3,30,4,0,0,4,1,-15,3,1
2,2,13,4,30,7,0,0,7,1,30,4,0,0,4,2,30,6,1,0,7,5,30,5,2,0,7,5,30,4,0,0,4,1,-15,3,1
2,3,13,4,30,7,0,0,7,1,30,4,0,0,4,2,30,6,1,0,7,5,30,5,2,0,7,5,30,4,0,0,4,1,-15,3,1
2,4,17,2,30,8,6,0,14,2,30,6,0,0,6,0,30,6,8,0,14,1,30,5,9,0,14,5,30,4,0,0,4,1,-15,3,1
2,1,23,1,30,7,6,0,13,0,30,6,0,0,6,8,30,12,1,0,13,0,30,5,8,0,13,4,30,5,1,0,6,1,-15,3,1
2,3,23,1,30,7,6,0,13,0,30,6,0,0,6,8,30,12,1,0,13,0,30,5,8,0,13,4,30,5,1,0,6,1,-15,3,1
2,3,25,1,30,9,5,0,14,4,30,6,0,0,6,0,30,7,7,0,14,1,30,4,10,0,14,5,30,5,1,0,6,1,-15,3,1
2,4,25,1,30,9,5,0,14,4,30,6,0,0,6,0,30,7,7,0,14,1,30,4,10,0,14,5,30,5,1,0,6,1,-15,3,1
2,0,27,1,30,4,11,0,15,4,30,2,0,0,2,2,30,8,7,0,15,2,30,3,12,0,15,1,30,4,2,0,6,1,-15,3,1
2,1,27,1,30,4,11,0,15,4,30,2,0,0,2,2,30,8,7,0,15,2,30,3,12,0,15,1,30,4,2,0,6,1,-15,3,1
2,1,29,0,30,5,9,0,14,3,30,10,2,0,12,0,30,9,5,0,14,0,30,1,13,0,14,1,30,9,0,0,9,1,-15,3,1
2,3,29,0,30,5,9,0,14,3,30,10,2,0,12,0,30,9,5,0,14,0,30,1,13,0,14,1,30,9,0,0,9,1,-15,3,1
2,4,29,0,30,5,9,0,14,3,30,10,2,0,12,0,30,9,5,0,14,0,30,1,13,0,14,1,30,9,0,0,9,1,-15,3,1
2,3,31,3,30,6,6,0,12,4,30,8,0,0,8,3,30,8,4,0,12,0,30,3,9,0,12,3,30,4,2,0,6,1,-15,3,1
2,1,4,2,30,7,1,0,8,4,30,4,0,0,4,0,30,1,7,0,8,0,30,4,4,0,8,2,30,3,1,0,4,0,-27,3,0
2,2,7,3,30,3,1,0,4,3,30,2,0,0,2,0,30,1,3,0,4,0,30,0,4,0,4,1,30,2,0,0,2,0,-27,3,0
2,4,7,3,30,3,1,0,4,3,30,2,0,0,2,0,30,1,3,0,4,0,30,0,4,0,4,1,30,2,0,0,2,0,-27,3,0
2,3,11,0,30,5,7,0,12,1,30,4,0,0,4,0,30,6,6,0,12,3,30,8,4,0,12,6,30,4,0,0,4,1,-15,3,1
2,1,13,3,30,5,2,0,7,0,30,4,0,0,4,2,30,6,1,0,7,8,30,7,0,0,7,5,30,4,0,0,4,1,-15,3,1
2,2,13,3,30,5,2,0,7,0,30,4,0,0,4,2,30,6,1,0,7,8,30,7,0,0,7,5,30,4,0,0,4,1,-15,3,1
2,4,13,3,30,5,2,0,7,0,30,4,0,0,4,2,30,6,1,0,7,8,30,7,0,0,7,5,30,4,0,0,4,1,-15,3,1
2,3,17,3,30,8,6,0,14,3,30,6,0,0,6,0,30,6,8,0,14,1,30,6,8,0,14,1,30,3,1,0,4,1,-15,3,1
2,4,19,2,30,5,8,0,13,0,30,5,3,0,8,0,30,6,7,0,13,7,30,4,9,0,13,3,30,8,1,0,9,1,-15,3,1
2,4,21,2,30,7,3,0,10,4,30,6,0,0,6,1,30,3,7,0,10,2,30,4,6,0,10,0,30,4,0,0,4,1,-15,3,1
2,3,25,0,30,5,9,0,14,2,30,6,0,0,6,0,30,9,5,0,14,1,30,5,9,0,14,4,30,5,1,0,6,1,-15,3,1
2,4,25,0,30,5,9,0,14,2,30,6,0,0,6,0,30,9,5,0,14,1,30,5,9,0,14,4,30,5,1,0,6,1,-15,3,1
2,1,27,1,30,7,8,0,15,4,30,1,1,0,2,0,30,6,9,0,15,0,30,5,10,0,15,6,30,6,0,0,6,1,-15,3,1
2,2,27,1,30,7,8,0,15,4,30,1,1,0,2,0,30,6,9,0,15,0,30,5,10,0,15,6,30,6,0,0,6,1,-15,3,1
2,2,31,1,30,5,7,0,12,4,30,8,0,0,8,6,30,9,3,0,12,0,30,7,5,0,12,0,30,3,3,0,6,1,-15,3,1
2,3,31,1,30,5,7,0,12,4,30,8,0,0,8,6,30,9,3,0,12,0,30,7,5,0,12,0,30,3,3,0,6,1,-15,3,1
2,3,33,0,30,4,7,0,11,5,30,4,0,0,4,1,30,9,2,0,11,1,30,4,7,0,11,7,30,4,0,0,4,1,-15,3,1
2,1,4,0,30,7,1,0,8,5,30,4,0,0,4,1,30,2,6,0,8,0,30,7,1,0,8,3,30,4,0,0,4,0,-27,3,0
2,4,4,0,30,7,1,0,8,5,30,4,0,0,4,1,30,2,6,0,8,0,30,7,1,0,8,3,30,4,0,0,4,0,-27,3,0
2,1,5,0,30,2,3,0,5,2,30,4,0,0,4,0,30,1,4,0,5,1,30,2,3,0,5,1,30,1,1,0,2,0,-27,3,0
2,3,5,0,30,2,3,0,5,2,30,4,0,0,4,0,30,1,4,0,5,1,30,2,3,0,5,1,30,1,1,0,2,0,-27,3,0
2,3,8,1,30,7,0,0,7,4,30,2,0,0,2,0,30,5,2,0,7,0,30,7,0,0,7,1,30,3,0,0,3,0,-27,3,0
2,3,13,5,30,6,1,0,7,0,30,4,0,0,4,2,30,6,1,0,7,4,30,5,2,0,7,4,30,4,0,0,4,1,-15,3,1
2,4,19,0,30,2,11,0,13,2,30,4,4,0,8,0,30,7,6,0,13,1,30,4,9,0,13,1,30,8,1,0,9,1,-15,3,1
2,2,25,1,30,5,9,0,14,4,30,6,0,0,6,0,30,8,6,0,14,1,30,4,10,0,14,3,30,5,1,0,6,1,-15,3,1
2,3,25,1,30,5,9,0,14,4,30,6,0,0,6,0,30,8,6,0,14,1,30,4,10,0,14,3,30,5,1,0,6,1,-15,3,1
2,3,27,1,30,4,11,0,15,3,30,1,1,0,2,0,30,5,10,0,15,1,30,7,8,0,15,4,30,6,0,0,6,1,-15,3,1
2,4,29,0,30,7,7,0,14,5,30,7,5,0,12,0,30,2,12,0,14,0,30,0,14,0,14,3,30,9,0,0,9,1,-15,3,1
2,4,31,9,30,7,5,0,12,5,30,8,0,0,8,3,30,11,1,0,12,0,30,3,9,0,12,0,30,4,2,0,6,1,-15,3,1
2,3,8,1,30,7,0,0,7,4,30,2,0,0,2,3,30,4,3,0,7,2,30,7,0,0,7,0,30,3,0,0,3,0,-27,3,0
2,2,11,1,30,4,8,0,12,1,30,4,0,0,4,0,30,6,6,0,12,4,30,7,5,0,12,4,30,4,0,0,4,1,-15,3,1
2,4,11,1,30,4,8,0,12,1,30,4,0,0,4,0,30,6,6,0,12,4,30,7,5,0,12,4,30,4,0,0,4,1,-15,3,1
2,4,15,1,30,5,8,0,13,1,30,6,0,0,6,0,30,3,10,0,13,0,30,4,9,0,13,2,30,7,2,0,9,1,-15,3,1
2,1,19,0,30,2,11,0,13,2,30,6,2,0,8,0,30,6,7,0,13,8,30,6,7,0,13,1,30,7,2,0,9,1,-15,3,1
2,2,19,0,30,2,11,0,13,2,30,6,2,0,8,0,30,6,7,0,13,8,30,6,7,0,13,1,30,7,2,0,9,1,-15,3,1
2,0,25,1,30,7,7,0,14,4,30,6,0,0,6,0,30,6,8,0,14,4,30,7,7,0,14,3,30,5,1,0,6,1,-15,3,1
2,2,25,1,30,7,7,0,14,4,30,6,0,0,6,0,30,6,8,0,14,4,30,7,7,0,14,3,30,5,1,0,6,1,-15,3,1
2,3,25,1,30,7,7,0,14,4,30,6,0,0,6,0,30,6,8,0,14,4,30,7,7,0,14,3,30,5,1,0,6,1,-15,3,1
2,1,27,1,30,5,10,0,15,4,30,2,0,0,2,0,30,2,13,0,15,0,30,8,7,0,15,6,30,3,3,0,6,1,-15,3,1
2,4,27,1,30,5,10,0,15,4,30,2,0,0,2,0,30,2,13,0,15,0,30,8,7,0,15,6,30,3,3,0,6,1,-15,3,1
2,3,29,0,30,7,7,0,14,5,30,9,3,0,12,0,30,6,8,0,14,0,30,1,13,0,14,2,30,9,0,0,9,1,-15,3,1
2,3,31,1,30,8,4,0,12,5,30,8,0,0,8,3,30,9,3,0,12,0,30,3,9,0,12,2,30,5,1,0,6,1,-15,3,1
2,4,31,1,30,8,4,0,12,5,30,8,0,0,8,3,30,9,3,0,12,0,30,3,9,0,12,2,30,5,1,0,6,1,-15,3,1
2,3,39,0,30,5,6,0,11,6,30,6,0,0,6,0,30,6,5,0,11,0,30,2,9,0,11,5,30,5,0,0,5,1,-15,3,1
2,4,39,0,30,5,6,0,11,6,30,6,0,0,6,0,30,6,5,0,11,0,30,2,9,0,11,5,30,5,0,0,5,1,-15,3,1
2,2,43,0,30,7,7,0,14,6,30,6,0,0,6,0,30,9,5,0,14,1,30,2,12,0,14,4,30,5,0,0,5,1,-15,3,1
2,3,43,0,30,7,7,0,14,6,30,6,0,0,6,0,30,9,5,0,14,1,30,2,12,0,14,4,30,5,0,0,5,1,-15,3,1
2,3,15,0,30,4,9,0,13,0,30,6,0,0,6,0,30,7,6,0,13,1,30,7,6,0,13,5,30,6,3,0,9,1,-15,3,1
2,4,15,0,30,4,9,0,13,0,30,6,0,0,6,0,30,7,6,0,13,1,30,7,6,0,13,5,30,6,3,0,9,1,-15,3,1
2,3,23,2,30,7,6,0,13,4,30,6,0,0,6,6,30,6,7,0,13,0,30,8,5,0,13,0,30,5,1,0,6,1,-15,3,1
2,1,25,1,30,7,7,0,14,4,30,6,0,0,6,0,30,6,8,0,14,1,30,5,9,0,14,4,30,4,2,0,6,1,-15,3,1
2,1,27,1,30,4,11,0,15,5,30,1,1,0,2,0,30,7,8,0,15,0,30,6,9,0,15,4,30,6,0,0,6,1,-15,3,1
2,2,27,1,30,4,11,0,15,5,30,1,1,0,2,0,30,7,8,0,15,0,30,6,9,0,15,4,30,6,0,0,6,1,-15,3,1
2,2,38,4,30,3,7,0,10,7,30,6,0,0,6,0,30,1,9,0,10,0,30,0,10,0,10,6,30,6,0,0,6,1,-15,3,1
2,3,38,4,30,3,7,0,10,7,30,6,0,0,6,0,30,1,9,0,10,0,30,0,10,0,10,6,30,6,0,0,6,1,-15,3,1
2,3,8,2,30,7,0,0,7,4,30,2,0,0,2,3,30,4,3,0,7,2,30,7,0,0,7,2,30,3,0,0,3,0,-27,3,0
2,4,13,1,30,5,2,0,7,1,30,4,0,0,4,2,30,5,2,0,7,9,30,6,1,0,7,5,30,4,0,0,4,1,-15,3,1
2,4,19,0,30,3,10,0,13,1,30,5,3,0,8,0,30,6,7,0,13,3,30,4,9,0,13,0,30,6,3,0,9,1,-15,3,1
2,4,23,1,30,7,6,0,13,1,30,6,0,0,6,1,30,12,1,0,13,0,30,4,9,0,13,3,30,6,0,0,6,1,-15,3,1
2,1,25,1,30,5,9,0,14,2,30,6,0,0,6,0,30,9,5,0,14,2,30,8,6,0,14,5,30,6,0,0,6,1,-15,3,1
2,4,25,1,30,5,9,0,14,2,30,6,0,0,6,0,30,9,5,0,14,2,30,8,6,0,14,5,30,6,0,0,6,1,-15,3,1
2,1,27,1,30,6,9,0,15,3,30,1,1,0,2,0,30,5,10,0,15,0,30,4,11,0,15,3,30,6,0,0,6,1,-15,3,1
2,4,27,1,30,6,9,0,15,3,30,1,1,0,2,0,30,5,10,0,15,0,30,4,11,0,15,0,30,6,0,0,6,1,-15,3,1
2,2,29,0,30,5,9,0,14,4,30,12,0,0,12,0,30,3,11,0,14,0,30,0,14,0,14,3,30,9,0,0,9,1,-15,3,1
2,3,29,0,30,5,9,0,14,4,30,12,0,0,12,0,30,3,11,0,14,0,30,0,14,0,14,3,30,9,0,0,9,1,-15,3,1
2,4,31,1,30,8,4,0,12,4,30,8,0,0,8,5,30,12,0,0,12,0,30,3,9,0,12,0,30,5,1,0,6,1,-15,3,1
2,1,1,0,30,7,3,0,10,3,30,2,0,0,2,7,30,6,4,0,10,3,30,7,3,0,10,2,30,6,0,0,6,0,-27,3,0
2,3,1,0,30,7,3,0,10,3,30,2,0,0,2,7,30,6,4,0,10,3,30,7,3,0,10,2,30,6,0,0,6,0,-27,3,0
2,3,4,2,30,6,2,0,8,4,30,4,0,0,4,0,30,2,6,0,8,0,30,3,5,0,8,2,30,4,0,0,4,0,-27,3,0
2,2,6,1,30,6,3,0,9,4,30,2,0,0,2,0,30,2,7,0,9,0,30,3,6,0,9,5,30,2,3,0,5,0,-27,3,0
2,3,6,1,30,6,3,0,9,4,30,2,0,0,2,0,30,2,7,0,9,0,30,3,6,0,9,5,30,2,3,0,5,0,-27,3,0
2,1,9,0,30,7,4,0,11,4,30,6,0,0,6,3,30,4,7,0,11,6,30,4,7,0,11,5,30,4,0,0,4,0,-27,3,0
2,2,17,3,30,9,5,0,14,0,30,6,0,0,6,0,30,6,8,0,14,1,30,6,8,0,14,6,30,4,0,0,4,1,-15,3,1
2,3,23,1,30,3,10,0,13,4,30,6,0,0,6,7,30,10,3,0,13,0,30,5,8,0,13,3,30,6,0,0,6,1,-15,3,1
2,3,25,1,30,10,4,0,14,3,30,6,0,0,6,0,30,7,7,0,14,1,30,5,9,0,14,2,30,5,1,0,6,1,-15,3,1
2,4,29,0,30,6,8,0,14,6,30,12,0,0,12,0,30,6,8,0,14,0,30,1,13,0,14,2,30,9,0,0,9,1,-15,3,1
2,4,1,0,30,7,3,0,10,4,30,2,0,0,2,1,30,4,6,0,10,4,30,6,4,0,10,3,30,6,0,0,6,0,-27,3,0
2,3,8,2,30,7,0,0,7,4,30,2,0,0,2,0,30,4,3,0,7,0,30,4,3,0,7,1,30,3,0,0,3,0,-27,3,0
2,4,8,2,30,7,0,0,7,4,30,2,0,0,2,0,30,4,3,0,7,0,30,4,3,0,7,1,30,3,0,0,3,0,-27,3,0
2,2,11,1,30,5,7,0,12,0,30,4,0,0,4,0,30,7,5,0,12,3,30,6,6,0,12,5,30,4,0,0,4,1,-15,3,1
2,3,11,1,30,5,7,0,12,0,30,4,0,0,4,0,30,7,5,0,12,3,30,6,6,0,12,5,30,4,0,0,4,1,-15,3,1
2,2,17,2,30,10,4,0,14,2,30,6,0,0,6,0,30,8,6,0,14,4,30,6,8,0,14,6,30,4,0,0,4,1,-15,3,1
2,2,25,1,30,5,9,0,14,4,30,6,0,0,6,0,30,11,3,0,14,1,30,4,10,0,14,4,30,5,1,0,6,1,-15,3,1
2,3,25,1,30,5,9,0,14,4,30,6,0,0,6,0,30,11,3,0,14,1,30,4,10,0,14,4,30,5,1,0,6,1,-15,3,1
2,4,25,1,30,5,9,0,14,4,30,6,0,0,6,0,30,11,3,0,14,1,30,4,10,0,14,4,30,5,1,0,6,1,-15,3,1
2,0,27,1,30,4,11,0,15,4,30,1,1,0,2,0,30,3,12,0,15,6,30,4,11,0,15,5,30,6,0,0,6,1,-15,3,1
2,2,27,1,30,4,11,0,15,4,30,1,1,0,2,0,30,3,12,0,15,6,30,4,11,0,15,5,30,6,0,0,6,1,-15,3,1
2,2,29,3,30,9,5,0,14,5,30,7,5,0,12,0,30,3,11,0,14,0,30,0,14,0,14,3,30,9,0,0,9,1,-15,3,1
2,3,29,3,30,9,5,0,14,5,30,7,5,0,12,0,30,3,11,0,14,0,30,0,14,0,14,3,30,9,0,0,9,1,-15,3,1
2,1,31,2,30,6,6,0,12,5,30,8,0,0,8,4,30,9,3,0,12,0,30,4,8,0,12,2,30,5,1,0,6,1,-15,3,1
2,2,31,2,30,6,6,0,12,5,30,8,0,0,8,4,30,9,3,0,12,0,30,4,8,0,12,2,30,5,1,0,6,1,-15,3,1
2,0,38,0,30,2,8,0,10,6,30,6,0,0,6,0,30,1,9,0,10,0,30,3,7,0,10,8,30,6,0,0,6,1,-15,3,1
2,1,38,0,30,2,8,0,10,6,30,6,0,0,6,0,30,1,9,0,10,0,30,3,7,0,10,8,30,6,0,0,6,1,-15,3,1
2,3,6,1,30,6,3,0,9,4,30,2,0,0,2,0,30,5,4,0,9,0,30,6,3,0,9,1,30,5,0,0,5,0,-27,3,0
2,2,8,3,30,7,0,0,7,4,30,2,0,0,2,3,30,4,3,0,7,0,30,7,0,0,7,4,30,3,0,0,3,0,-27,3,0
2,3,8,3,30,7,0,0,7,4,30,2,0,0,2,3,30,4,3,0,7,0,30,7,0,0,7,4,30,3,0,0,3,0,-27,3,0
2,4,8,3,30,7,0,0,7,4,30,2,0,0,2,3,30,4,3,0,7,0,30,7,0,0,7,4,30,3,0,0,3,0,-27,3,0
2,1,13,3,30,6,1,0,7,0,30,4,0,0,4,2,30,6,1,0,7,14,30,4,3,0,7,1,30,4,0,0,4,1,-15,3,1
2,2,13,3,30,6,1,0,7,0,30,4,0,0,4,2,30,6,1,0,7,14,30,4,3,0,7,1,30,4,0,0,4,1,-15,3,1
2,4,13,3,30,6,1,0,7,0,30,4,0,0,4,2,30,6,1,0,7,14,30,4,3,0,7,1,30,4,0,0,4,1,-15,3,1
2,2,17,6,30,11,3,0,14,4,30,6,0,0,6,0,30,3,11,0,14,1,30,5,9,0,14,2,30,4,0,0,4,1,-15,3,1
2,4,19,0,30,3,10,0,13,0,30,7,1,0,8,0,30,8,5,0,13,2,30,4,9,0,13,2,30,8,1,0,9,1,-15,3,1
2,4,23,0,30,5,8,0,13,3,30,6,0,0,6,4,30,13,0,0,13,0,30,5,8,0,13,2,30,6,0,0,6,1,-15,3,1
2,1,25,3,30,5,9,0,14,6,30,6,0,0,6,0,30,5,9,0,14,1,30,7,7,0,14,5,30,6,0,0,6,1,-15,3,1
2,2,25,3,30,5,9,0,14,6,30,6,0,0,6,0,30,5,9,0,14,1,30,7,7,0,14,5,30,6,0,0,6,1,-15,3,1
2,4,25,3,30,5,9,0,14,6,30,6,0,0,6,0,30,5,9,0,14,1,30,7,7,0,14,5,30,6,0,0,6,1,-15,3,1
2,1,35,1,30,9,4,0,13,6,30,2,0,0,2,1,30,2,11,0,13,2,30,7,6,0,13,8,30,8,0,0,8,1,-15,3,1
2,3,35,1,30,9,4,0,13,6,30,2,0,0,2,1,30,2,11,0,13,0,30,7,6,0,13,8,30,8,0,0,8,1,-15,3,1
2,4,37,1,30,8,3,0,11,5,30,8,0,0,8,1,30,9,2,0,11,4,30,3,8,0,11,0,30,6,0,0,6,1,-15,3,1
2,1,13,2,30,6,1,0,7,0,30,4,0,0,4,2,30,7,0,0,7,7,30,4,3,0,7,4,30,4,0,0,4,1,-15,3,1
2,3,17,8,30,9,5,0,14,2,30,6,0,0,6,1,30,8,6,0,14,0,30,4,10,0,14,4,30,2,2,0,4,1,-15,3,1
2,4,17,8,30,9,5,0,14,2,30,6,0,0,6,1,30,8,6,0,14,0,30,4,10,0,14,4,30,2,2,0,4,1,-15,3,1
2,4,19,0,30,4,9,0,13,2,30,5,3,0,8,0,30,5,8,0,13,0,30,3,10,0,13,0,30,8,1,0,9,1,-15,3,1
2,1,21,0,30,6,4,0,10,3,30,6,0,0,6,1,30,3,7,0,10,3,30,4,6,0,10,4,30,4,0,0,4,1,-15,3,1
2,2,21,0,30,6,4,0,10,3,30,6,0,0,6,1,30,3,7,0,10,3,30,4,6,0,10,4,30,4,0,0,4,1,-15,3,1
2,4,21,0,30,6,4,0,10,3,30,6,0,0,6,1,30,3,7,0,10,3,30,4,6,0,10,4,30,4,0,0,4,1,-15,3,1
2,3,25,0,30,3,11,0,14,5,30,6,0,0,6,0,30,6,8,0,14,1,30,7,7,0,14,7,30,6,0,0,6,1,-15,3,1
2,4,27,0,30,4,11,0,15,4,30,2,0,0,2,1,30,6,9,0,15,0,30,4,11,0,15,1,30,4,2,0,6,1,-15,3,1
2,2,29,0,30,7,7,0,14,6,30,9,3,0,12,0,30,5,9,0,14,0,30,1,13,0,14,4,30,9,0,0,9,1,-15,3,1
2,2,31,2,30,7,5,0,12,6,30,8,0,0,8,3,30,8,4,0,12,0,30,5,7,0,12,4,30,6,0,0,6,1,-15,3,1
2,0,47,0,30,0,14,0,14,7,30,4,0,0,4,0,30,6,8,0,14,5,30,3,11,0,14,6,30,7,0,0,7,1,-15,3,1
2,2,47,0,30,0,14,0,14,7,30,4,0,0,4,0,30,6,8,0,14,5,30,3,11,0,14,6,30,7,0,0,7,1,-15,3,1
2,3,47,0,30,0,14,0,14,7,30,4,0,0,4,0,30,6,8,0,14,5,30,3,11,0,14,6,30,7,0,0,7,1,-15,3,1
2,4,47,0,30,0,14,0,14,7,30,4,0,0,4,0,30,6,8,0,14,5,30,3,11,0,14,6,30,7,0,0,7,1,-15,3,1
2,3,13,2,30,5,2,0,7,0,30,4,0,0,4,0,30,7,0,0,7,6,30,6,1,0,7,6,30,4,0,0,4,1,-15,3,1
2,0,17,4,30,9,5,0,14,3,30,6,0,0,6,0,30,4,10,0,14,1,30,8,6,0,14,3,30,4,0,0,4,1,-15,3,1
2,1,17,4,30,9,5,0,14,3,30,6,0,0,6,0,30,4,10,0,14,1,30,8,6,0,14,3,30,4,0,0,4,1,-15,3,1
2,2,17,4,30,9,5,0,14,3,30,6,0,0,6,0,30,4,10,0,14,1,30,8,6,0,14,3,30,4,0,0,4,1,-15,3,1
2,3,17,4,30,9,5,0,14,3,30,6,0,0,6,0,30,4,10,0,14,1,30,8,6,0,14,3,30,4,0,0,4,1,-15,3,1
2,2,19,1,30,6,7,0,13,2,30,7,1,0,8,0,30,4,9,0,13,3,30,5,8,0,13,4,30,8,1,0,9,1,-15,3,1
2,3,27,1,30,4,11,0,15,4,30,1,1,0,2,0,30,5,10,0,15,2,30,7,8,0,15,5,30,6,0,0,6,1,-15,3,1
2,4,27,1,30,4,11,0,15,4,30,1,1,0,2,0,30,5,10,0,15,2,30,7,8,0,15,5,30,6,0,0,6,1,-15,3,1
2,4,29,0,30,4,10,0,14,5,30,10,2,0,12,6,30,7,7,0,14,0,30,0,14,0,14,0,30,6,3,0,9,1,-15,3,1
2,0,31,4,30,7,5,0,12,5,30,8,0,0,8,3,30,8,4,0,12,0,30,3,9,0,12,2,30,5,1,0,6,1,-15,3,1
2,4,32,0,30,5,4,0,9,4,30,2,0,0,2,0,30,7,2,0,9,1,30,2,7,0,9,3,30,2,0,0,2,1,-15,3,1
2,2,35,1,30,6,7,0,13,4,30,2,0,0,2,1,30,8,5,0,13,3,30,2,11,0,13,5,30,8,0,0,8,1,-15,3,1
2,4,35,1,30,6,7,0,13,4,30,2,0,0,2,1,30,8,5,0,13,3,30,2,11,0,13,5,30,8,0,0,8,1,-15,3,1
2,0,39,4,30,4,7,0,11,8,30,6,0,0,6,0,30,3,8,0,11,0,30,4,7,0,11,6,30,5,0,0,5,1,-15,3,1
2,1,4,2,30,7,1,0,8,4,30,3,1,0,4,0,30,1,7,0,8,0,30,4,4,0,8,3,30,3,1,0,4,0,-27,3,0
2,3,4,2,30,7,1,0,8,4,30,3,1,0,4,0,30,1,7,0,8,0,30,4,4,0,8,3,30,3,1,0,4,0,-27,3,0
2,1,11,2,30,4,8,0,12,1,30,4,0,0,4,0,30,5,7,0,12,7,30,6,6,0,12,6,30,4,0,0,4,1,-15,3,1
2,3,15,1,30,4,9,0,13,0,30,6,0,0,6,0,30,3,10,0,13,1,30,3,10,0,13,2,30,6,3,0,9,1,-15,3,1
2,3,17,3,30,10,4,0,14,2,30,6,0,0,6,0,30,7,7,0,14,3,30,3,11,0,14,2,30,4,0,0,4,1,-15,3,1
2,2,19,0,30,3,10,0,13,2,30,4,4,0,8,0,30,8,5,0,13,4,30,4,9,0,13,2,30,8,1,0,9,1,-15,3,1
2,3,19,0,30,3,10,0,13,2,30,4,4,0,8,0,30,8,5,0,13,4,30,4,9,0,13,2,30,8,1,0,9,1,-15,3,1
2,3,25,1,30,8,6,0,14,4,30,6,0,0,6,0,30,6,8,0,14,1,30,5,9,0,14,6,30,5,1,0,6,1,-15,3,1
2,0,27,2,30,5,10,0,15,2,30,1,1,0,2,0,30,8,7,0,15,2,30,8,7,0,15,1,30,6,0,0,6,1,-15,3,1
2,1,27,2,30,5,10,0,15,2,30,1,1,0,2,0,30,8,7,0,15,2,30,8,7,0,15,1,30,6,0,0,6,1,-15,3,1
2,2,27,2,30,5,10,0,15,2,30,1,1,0,2,0,30,8,7,0,15,2,30,8,7,0,15,1,30,6,0,0,6,1,-15,3,1
2,4,27,2,30,5,10,0,15,2,30,1,1,0,2,0,30,8,7,0,15,2,30,8,7,0,15,1,30,6,0,0,6,1,-15,3,1
2,3,29,0,30,7,7,0,14,6,30,11,1,0,12,0,30,3,11,0,14,0,30,0,14,0,14,2,30,9,0,0,9,1,-15,3,1
2,4,29,0,30,7,7,0,14,6,30,11,1,0,12,0,30,3,11,0,14,0,30,0,14,0,14,2,30,9,0,0,9,1,-15,3,1
2,2,5,0,30,2,3,0,5,3,30,0,4,0,4,1,30,0,5,0,5,0,30,1,4,0,5,0,30,2,0,0,2,0,-27,3,0
2,4,11,1,30,5,7,0,12,1,30,4,0,0,4,0,30,5,7,0,12,7,30,3,9,0,12,4,30,3,1,0,4,1,-15,3,1
2,4,13,2,30,7,0,0,7,0,30,4,0,0,4,0,30,6,1,0,7,10,30,6,1,0,7,4,30,4,0,0,4,1,-15,3,1
2,0,17,4,30,10,4,0,14,3,30,6,0,0,6,0,30,6,8,0,14,2,30,6,8,0,14,1,30,2,2,0,4,1,-15,3,1
2,3,17,4,30,10,4,0,14,3,30,6,0,0,6,0,30,6,8,0,14,2,30,6,8,0,14,1,30,2,2,0,4,1,-15,3,1
2,2,19,0,30,5,8,0,13,2,30,6,2,0,8,0,30,4,9,0,13,0,30,4,9,0,13,1,30,8,1,0,9,1,-15,3,1
2,4,19,0,30,5,8,0,13,2,30,6,2,0,8,0,30,4,9,0,13,0,30,4,9,0,13,1,30,8,1,0,9,1,-15,3,1
2,4,23,2,30,4,9,0,13,3,30,6,0,0,6,4,30,13,0,0,13,0,30,6,7,0,13,2,30,5,1,0,6,1,-15,3,1
2,4,25,1,30,3,11,0,14,5,30,6,0,0,6,0,30,8,6,0,14,1,30,7,7,0,14,4,30,6,0,0,6,1,-15,3,1
2,0,27,1,30,5,10,0,15,2,30,1,1,0,2,0,30,6,9,0,15,4,30,6,9,0,15,4,30,6,0,0,6,1,-15,3,1
2,3,31,3,30,7,5,0,12,4,30,8,0,0,8,0,30,12,0,0,12,0,30,3,9,0,12,0,30,5,1,0,6,1,-15,3,1
2,0,4,3,30,6,2,0,8,3,30,2,2,0,4,0,30,4,4,0,8,0,30,6,2,0,8,3,30,4,0,0,4,0,-27,3,0
2,1,4,3,30,6,2,0,8,3,30,2,2,0,4,0,30,4,4,0,8,0,30,6,2,0,8,3,30,4,0,0,4,0,-27,3,0
2,4,23,1,30,4,9,0,13,3,30,6,0,0,6,6,30,13,0,0,13,0,30,6,7,0,13,2,30,5,1,0,6,1,-15,3,1
2,1,25,1,30,4,10,0,14,3,30,6,0,0,6,0,30,6,8,0,14,2,30,8,6,0,14,5,30,5,1,0,6,1,-15,3,1
2,0,27,1,30,6,9,0,15,4,30,2,0,0,2,0,30,6,9,0,15,1,30,5,10,0,15,4,30,6,0,0,6,1,-15,3,1
2,3,32,0,30,5,4,0,9,4,30,2,0,0,2,2,30,8,1,0,9,1,30,3,6,0,9,2,30,2,0,0,2,1,-15,3,1
2,1,33,1,30,2,9,0,11,4,30,4,0,0,4,0,30,11,0,0,11,1,30,4,7,0,11,7,30,4,0,0,4,1,-15,3,1
2,3,33,1,30,2,9,0,11,4,30,4,0,0,4,0,30,11,0,0,11,1,30,4,7,0,11,7,30,4,0,0,4,1,-15,3,1
2,2,35,0,30,7,6,0,13,5,30,2,0,0,2,0,30,3,10,0,13,2,30,1,12,0,13,7,30,8,0,0,8,1,-15,3,1
2,3,35,0,30,7,6,0,13,5,30,2,0,0,2,0,30,3,10,0,13,2,30,1,12,0,13,7,30,8,0,0,8,1,-15,3,1
2,2,3,3,30,2,2,0,4,3,30,4,0,0,4,2,30,1,3,0,4,0,30,0,4,0,4,0,30,1,2,0,3,0,-27,3,0
2,4,3,4,30,9,2,0,11,2,30,8,0,0,8,0,30,5,6,0,11,3,30,1,10,0,11,1,30,2,5,0,7,0,-27,3,0
2,2,4,3,30,8,0,0,8,4,30,4,0,0,4,1,30,1,7,0,8,0,30,3,5,0,8,1,30,4,0,0,4,0,-27,3,0
2,3,4,3,30,8,0,0,8,4,30,4,0,0,4,1,30,1,7,0,8,0,30,3,5,0,8,1,30,4,0,0,4,0,-27,3,0
2,4,4,3,30,8,0,0,8,4,30,4,0,0,4,1,30,1,7,0,8,0,30,3,5,0,8,1,30,4,0,0,4,0,-27,3,0
2,4,13,2,30,6,1,0,7,0,30,4,0,0,4,2,30,6,1,0,7,9,30,6,1,0,7,6,30,4,0,0,4,1,-15,3,1
2,1,17,2,30,11,3,0,14,2,30,6,0,0,6,0,30,6,8,0,14,2,30,6,8,0,14,6,30,4,0,0,4,1,-15,3,1
2,2,17,2,30,11,3,0,14,2,30,6,0,0,6,0,30,6,8,0,14,2,30,6,8,0,14,6,30,4,0,0,4,1,-15,3,1
2,3,23,1,30,6,7,0,13,1,30,6,0,0,6,3,30,9,4,0,13,5,30,5,8,0,13,1,30,6,0,0,6,1,-15,3,1
2,4,25,1,30,9,5,0,14,4,30,6,0,0,6,0,30,6,8,0,14,1,30,5,9,0,14,5,30,4,2,0,6,1,-15,3,1
2,2,27,1,30,3,12,0,15,4,30,2,0,0,2,0,30,6,9,0,15,0,30,3,12,0,15,2,30,6,0,0,6,1,-15,3,1
2,4,27,1,30,3,12,0,15,4,30,2,0,0,2,0,30,6,9,0,15,0,30,3,12,0,15,2,30,6,0,0,6,1,-15,3,1
2,2,29,0,30,5,9,0,14,6,30,11,1,0,12,0,30,6,8,0,14,0,30,1,13,0,14,3,30,9,0,0,9,1,-15,3,1
2,3,31,0,30,8,4,0,12,4,30,8,0,0,8,3,30,10,2,0,12,0,30,3,9,0,12,0,30,5,1,0,6,1,-15,3,1
2,4,31,0,30,8,4,0,12,4,30,8,0,0,8,3,30,10,2,0,12,0,30,3,9,0,12,0,30,5,1,0,6,1,-15,3,1
2,3,35,0,30,5,8,0,13,3,30,2,0,0,2,1,30,13,0,0,13,3,30,4,9,0,13,4,30,8,0,0,8,1,-15,3,1
2,1,11,2,30,5,7,0,12,1,30,4,0,0,4,0,30,5,7,0,12,7,30,5,7,0,12,7,30,4,0,0,4,1,-15,3,1
2,4,13,3,30,7,0,0,7,0,30,4,0,0,4,2,30,6,1,0,7,6,30,5,2,0,7,2,30,4,0,0,4,1,-15,3,1
2,4,17,4,30,11,3,0,14,2,30,6,0,0,6,0,30,6,8,0,14,1,30,5,9,0,14,4,30,4,0,0,4,1,-15,3,1
2,1,19,1,30,6,7,0,13,2,30,5,3,0,8,0,30,5,8,0,13,8,30,4,9,0,13,0,30,8,1,0,9,1,-15,3,1
2,1,26,0,30,5,4,0,9,5,30,4,0,0,4,4,30,1,8,0,9,0,30,4,5,0,9,6,30,3,0,0,3,1,-15,3,1
2,2,26,0,30,5,4,0,9,5,30,4,0,0,4,4,30,1,8,0,9,0,30,4,5,0,9,6,30,3,0,0,3,1,-15,3,1
2,0,27,1,30,5,10,0,15,5,30,1,1,0,2,0,30,5,10,0,15,1,30,7,8,0,15,3,30,6,0,0,6,1,-15,3,1
2,1,27,1,30,5,10,0,15,5,30,1,1,0,2,0,30,5,10,0,15,1,30,7,8,0,15,3,30,6,0,0,6,1,-15,3,1
2,2,27,1,30,5,10,0,15,5,30,1,1,0,2,0,30,5,10,0,15,1,30,7,8,0,15,3,30,6,0,0,6,1,-15,3,1
2,4,27,1,30,5,10,0,15,5,30,1,1,0,2,0,30,5,10,0,15,1,30,7,8,0,15,3,30,6,0,0,6,1,-15,3,1
2,3,31,5,30,10,2,0,12,5,30,8,0,0,8,3,30,4,8,0,12,0,30,3,9,0,12,0,30,3,3,0,6,1,-15,3,1
2,4,39,0,30,1,10,0,11,6,30,6,0,0,6,0,30,5,6,0,11,0,30,2,9,0,11,4,30,5,0,0,5,1,-15,3,1
2,0,5,0,30,1,4,0,5,3,30,2,2,0,4,0,30,0,5,0,5,0,30,4,1,0,5,0,30,0,2,0,2,0,-27,3,0
2,2,5,0,30,1,4,0,5,3,30,2,2,0,4,0,30,0,5,0,5,0,30,4,1,0,5,0,30,0,2,0,2,0,-27,3,0
2,4,5,0,30,1,4,0,5,3,30,2,2,0,4,0,30,0,5,0,5,0,30,4,1,0,5,0,30,0,2,0,2,0,-27,3,0
2,4,8,5,30,7,0,0,7,5,30,2,0,0,2,7,30,2,5,0,7,0,30,4,3,0,7,0,30,3,0,0,3,0,-27,3,0
2,1,13,1,30,6,1,0,7,0,30,4,0,0,4,8,30,7,0,0,7,7,30,5,2,0,7,2,30,4,0,0,4,1,-15,3,1
2,3,29,0,30,6,8,0,14,5,30,12,0,0,12,0,30,7,7,0,14,0,30,0,14,0,14,2,30,9,0,0,9,1,-15,3,1
2,4,29,0,30,6,8,0,14,5,30,12,0,0,12,0,30,7,7,0,14,0,30,0,14,0,14,2,30,9,0,0,9,1,-15,3,1
2,2,17,2,30,6,8,0,14,3,30,6,0,0,6,0,30,4,10,0,14,5,30,6,8,0,14,6,30,4,0,0,4,1,-15,3,1
2,4,17,2,30,6,8,0,14,3,30,6,0,0,6,0,30,4,10,0,14,5,30,6,8,0,14,6,30,4,0,0,4,1,-15,3,1
2,3,19,0,30,3,10,0,13,2,30,5,3,0,8,0,30,7,6,0,13,1,30,5,8,0,13,1,30,9,0,0,9,1,-15,3,1
2,3,23,2,30,6,7,0,13,4,30,6,0,0,6,7,30,9,4,0,13,0,30,5,8,0,13,1,30,6,0,0,6,1,-15,3,1
2,0,29,0,30,4,10,0,14,5,30,12,0,0,12,0,30,2,12,0,14,0,30,3,11,0,14,2,30,9,0,0,9,1,-15,3,1
2,3,29,0,30,4,10,0,14,5,30,12,0,0,12,0,30,2,12,0,14,0,30,3,11,0,14,2,30,9,0,0,9,1,-15,3,1
2,3,33,1,30,3,8,0,11,6,30,4,0,0,4,7,30,9,2,0,11,1,30,3,8,0,11,7,30,4,0,0,4,1,-15,3,1
2,0,11,2,30,6,6,0,12,3,30,4,0,0,4,0,30,1,11,0,12,3,30,5,7,0,12,5,30,4,0,0,4,1,-15,3,1
2,1,11,2,30,6,6,0,12,3,30,4,0,0,4,0,30,1,11,0,12,3,30,5,7,0,12,5,30,4,0,0,4,1,-15,3,1
2,4,11,2,30,6,6,0,12,3,30,4,0,0,4,0,30,1,11,0,12,3,30,5,7,0,12,5,30,4,0,0,4,1,-15,3,1
2,0,17,3,30,9,5,0,14,3,30,6,0,0,6,1,30,7,7,0,14,3,30,8,6,0,14,2,30,3,1,0,4,1,-15,3,1
2,1,17,3,30,9,5,0,14,3,30,6,0,0,6,1,30,7,7,0,14,3,30,8,6,0,14,2,30,3,1,0,4,1,-15,3,1
2,2,17,3,30,9,5,0,14,3,30,6,0,0,6,1,30,7,7,0,14,3,30,8,6,0,14,2,30,3,1,0,4,1,-15,3,1
2,3,17,3,30,9,5,0,14,3,30,6,0,0,6,1,30,7,7,0,14,3,30,8,6,0,14,2,30,3,1,0,4,1,-15,3,1
2,2,19,1,30,6,7,0,13,2,30,6,2,0,8,0,30,4,9,0,13,5,30,5,8,0,13,2,30,8,1,0,9,1,-15,3,1
2,3,19,1,30,6,7,0,13,2,30,6,2,0,8,0,30,4,9,0,13,5,30,5,8,0,13,2,30,8,1,0,9,1,-15,3,1
2,4,21,0,30,8,2,0,10,3,30,6,0,0,6,1,30,4,6,0,10,2,30,4,6,0,10,1,30,4,0,0,4,1,-15,3,1
2,3,25,2,30,9,5,0,14,3,30,6,0,0,6,0,30,8,6,0,14,1,30,5,9,0,14,4,30,5,1,0,6,1,-15,3,1
2,4,25,2,30,9,5,0,14,3,30,6,0,0,6,0,30,8,6,0,14,1,30,5,9,0,14,4,30,5,1,0,6,1,-15,3,1
2,1,27,1,30,5,10,0,15,3,30,1,1,0,2,0,30,5,10,0,15,2,30,4,11,0,15,3,30,6,0,0,6,1,-15,3,1
2,4,43,0,30,5,9,0,14,8,30,6,0,0,6,0,30,4,10,0,14,1,30,1,13,0,14,5,30,5,0,0,5,1,-15,3,1
2,2,1,0,30,4,6,0,10,4,30,2,0,0,2,4,30,4,6,0,10,2,30,8,2,0,10,6,30,6,0,0,6,0,-27,3,0
2,3,1,0,30,4,6,0,10,4,30,2,0,0,2,4,30,4,6,0,10,2,30,8,2,0,10,6,30,6,0,0,6,0,-27,3,0
2,3,4,2,30,7,1,0,8,5,30,4,0,0,4,0,30,2,6,0,8,0,30,5,3,0,8,7,30,3,1,0,4,0,-27,3,0
2,1,11,2,30,5,7,0,12,2,30,4,0,0,4,0,30,4,8,0,12,7,30,5,7,0,12,7,30,4,0,0,4,1,-15,3,1
2,2,13,5,30,7,0,0,7,2,30,4,0,0,4,2,30,5,2,0,7,0,30,7,0,0,7,3,30,4,0,0,4,1,-15,3,1
2,2,19,0,30,2,11,0,13,0,30,7,1,0,8,0,30,7,6,0,13,1,30,6,7,0,13,0,30,6,3,0,9,1,-15,3,1
2,4,19,0,30,2,11,0,13,0,30,7,1,0,8,0,30,7,6,0,13,1,30,6,7,0,13,0,30,6,3,0,9,1,-15,3,1
2,2,25,3,30,3,11,0,14,6,30,6,0,0,6,0,30,8,6,0,14,2,30,5,9,0,14,4,30,6,0,0,6,1,-15,3,1
2,3,27,1,30,5,10,0,15,4,30,2,0,0,2,0,30,3,12,0,15,0,30,8,7,0,15,4,30,6,0,0,6,1,-15,3,1
2,4,27,1,30,5,10,0,15,4,30,2,0,0,2,0,30,3,12,0,15,0,30,8,7,0,15,4,30,6,0,0,6,1,-15,3,1
2,0,5,0,30,2,3,0,5,3,30,2,2,0,4,3,30,0,5,0,5,1,30,4,1,0,5,0,30,0,2,0,2,0,-27,3,0
2,1,5,0,30,2,3,0,5,3,30,2,2,0,4,3,30,0,5,0,5,1,30,4,1,0,5,0,30,0,2,0,2,0,-27,3,0
2,3,5,0,30,2,3,0,5,2,30,2,2,0,4,3,30,0,5,0,5,1,30,4,1,0,5,0,30,0,2,0,2,0,-27,3,0
2,4,5,0,30,2,3,0,5,2,30,2,2,0,4,3,30,0,5,0,5,1,30,4,1,0,5,0,30,0,2,0,2,0,-27,3,0
2,0,13,4,30,7,0,0,7,2,30,4,0,0,4,2,30,6,1,0,7,6,30,6,1,0,7,3,30,4,0,0,4,1,-15,3,1
2,1,13,4,30,7,0,0,7,2,30,4,0,0,4,2,30,6,1,0,7,6,30,6,1,0,7,3,30,4,0,0,4,1,-15,3,1
2,2,13,4,30,7,0,0,7,2,30,4,0,0,4,2,30,6,1,0,7,6,30,6,1,0,7,3,30,4,0,0,4,1,-15,3,1
2,4,13,4,30,7,0,0,7,2,30,4,0,0,4,2,30,6,1,0,7,6,30,6,1,0,7,3,30,4,0,0,4,1,-15,3,1
2,4,17,5,30,9,5,0,14,3,30,6,0,0,6,0,30,6,8,0,14,2,30,5,9,0,14,2,30,4,0,0,4,1,-15,3,1
2,1,23,1,30,5,8,0,13,2,30,6,0,0,6,6,30,11,2,0,13,2,30,5,8,0,13,4,30,6,0,0,6,1,-15,3,1
2,3,23,1,30,5,8,0,13,2,30,6,0,0,6,6,30,11,2,0,13,2,30,5,8,0,13,4,30,6,0,0,6,1,-15,3,1
2,3,25,1,30,8,6,0,14,4,30,6,0,0,6,0,30,6,8,0,14,1,30,5,9,0,14,3,30,5,1,0,6,1,-15,3,1
2,4,25,1,30,8,6,0,14,4,30,6,0,0,6,0,30,6,8,0,14,1,30,5,9,0,14,3,30,5,1,0,6,1,-15,3,1
2,0,27,1,30,4,11,0,15,3,30,2,0,0,2,0,30,8,7,0,15,2,30,5,10,0,15,2,30,6,0,0,6,1,-15,3,1
2,1,27,1,30,4,11,0,15,3,30,2,0,0,2,0,30,8,7,0,15,2,30,5,10,0,15,2,30,6,0,0,6,1,-15,3,1
2,2,27,1,30,4,11,0,15,3,30,2,0,0,2,0,30,8,7,0,15,2,30,5,10,0,15,2,30,6,0,0,6,1,-15,3,1
2,4,27,1,30,4,11,0,15,3,30,2,0,0,2,0,30,8,7,0,15,2,30,5,10,0,15,2,30,6,0,0,6,1,-15,3,1
2,4,29,0,30,7,7,0,14,6,30,11,1,0,12,0,30,3,11,0,14,0,30,1,13,0,14,4,30,9,0,0,9,1,-15,3,1
2,3,4,3,30,8,0,0,8,3,30,4,0,0,4,0,30,4,4,0,8,0,30,0,8,0,8,1,30,3,1,0,4,0,-27,3,0
2,1,5,0,30,1,4,0,5,2,30,4,0,0,4,1,30,2,3,0,5,0,30,1,4,0,5,0,30,0,2,0,2,0,-27,3,0
2,2,8,2,30,7,0,0,7,5,30,2,0,0,2,2,30,3,4,0,7,3,30,7,0,0,7,3,30,3,0,0,3,0,-27,3,0
2,4,8,2,30,7,0,0,7,5,30,2,0,0,2,2,30,3,4,0,7,3,30,7,0,0,7,3,30,3,0,0,3,0,-27,3,0
2,3,23,2,30,6,7,0,13,0,30,6,0,0,6,0,30,13,0,0,13,0,30,5,8,0,13,2,30,5,1,0,6,1,-15,3,1
2,4,23,2,30,6,7,0,13,0,30,6,0,0,6,0,30,13,0,0,13,0,30,5,8,0,13,2,30,5,1,0,6,1,-15,3,1
2,2,25,1,30,5,9,0,14,5,30,6,0,0,6,0,30,7,7,0,14,1,30,4,10,0,14,3,30,6,0,0,6,1,-15,3,1
2,0,26,1,30,5,4,0,9,5,30,4,0,0,4,4,30,1,8,0,9,0,30,5,4,0,9,6,30,3,0,0,3,1,-15,3,1
2,1,26,1,30,5,4,0,9,5,30,4,0,0,4,4,30,1,8,0,9,0,30,5,4,0,9,6,30,3,0,0,3,1,-15,3,1
2,2,26,1,30,5,4,0,9,5,30,4,0,0,4,4,30,1,8,0,9,0,30,5,4,0,9,6,30,3,0,0,3,1,-15,3,1
2,2,29,0,30,5,9,0,14,6,30,11,1,0,12,0,30,5,9,0,14,0,30,3,11,0,14,1,30,9,0,0,9,1,-15,3,1
2,3,31,0,30,8,4,0,12,5,30,8,0,0,8,3,30,9,3,0,12,0,30,3,9,0,12,4,30,3,3,0,6,1,-15,3,1
2,1,37,2,30,10,1,0,11,6,30,6,2,0,8,0,30,4,7,0,11,4,30,3,8,0,11,7,30,6,0,0,6,1,-15,3,1
2,2,6,0,30,8,1,0,9,4,30,2,0,0,2,0,30,2,7,0,9,1,30,5,4,0,9,1,30,3,2,0,5,0,-27,3,0
2,1,13,1,30,5,2,0,7,0,30,4,0,0,4,2,30,7,0,0,7,10,30,6,1,0,7,6,30,4,0,0,4,1,-15,3,1
2,3,17,3,30,9,5,0,14,0,30,6,0,0,6,0,30,8,6,0,14,2,30,5,9,0,14,4,30,4,0,0,4,1,-15,3,1
2,4,17,3,30,9,5,0,14,0,30,6,0,0,6,0,30,8,6,0,14,2,30,5,9,0,14,4,30,4,0,0,4,1,-15,3,1
2,2,19,0,30,2,11,0,13,2,30,6,2,0,8,0,30,7,6,0,13,5,30,4,9,0,13,0,30,7,2,0,9,1,-15,3,1
2,3,19,0,30,2,11,0,13,2,30,6,2,0,8,0,30,7,6,0,13,5,30,4,9,0,13,0,30,7,2,0,9,1,-15,3,1
2,4,23,2,30,5,8,0,13,1,30,6,0,0,6,5,30,13,0,0,13,0,30,5,8,0,13,2,30,6,0,0,6,1,-15,3,1
2,3,25,1,30,4,10,0,14,4,30,6,0,0,6,0,30,3,11,0,14,3,30,8,6,0,14,4,30,6,0,0,6,1,-15,3,1
2,2,29,0,30,4,10,0,14,6,30,12,0,0,12,0,30,5,9,0,14,0,30,0,14,0,14,3,30,9,0,0,9,1,-15,3,1
2,4,29,0,30,4,10,0,14,6,30,12,0,0,12,0,30,5,9,0,14,0,30,0,14,0,14,3,30,9,0,0,9,1,-15,3,1
2,2,31,4,30,7,5,0,12,4,30,8,0,0,8,3,30,10,2,0,12,0,30,3,9,0,12,2,30,2,4,0,6,1,-15,3,1
2,2,33,1,30,2,9,0,11,5,30,4,0,0,4,1,30,9,2,0,11,0,30,3,8,0,11,6,30,4,0,0,4,1,-15,3,1
2,3,35,0,30,6,7,0,13,6,30,2,0,0,2,8,30,3,10,0,13,0,30,4,9,0,13,5,30,7,1,0,8,1,-15,3,1
2,4,6,0,30,9,0,0,9,4,30,2,0,0,2,0,30,3,6,0,9,0,30,4,5,0,9,0,30,4,1,0,5,0,-27,3,0
2,3,8,2,30,7,0,0,7,3,30,2,0,0,2,2,30,5,2,0,7,1,30,7,0,0,7,2,30,3,0,0,3,0,-27,3,0
2,4,8,2,30,7,0,0,7,3,30,2,0,0,2,2,30,5,2,0,7,1,30,7,0,0,7,2,30,3,0,0,3,0,-27,3,0
2,2,13,0,30,6,1,0,7,0,30,4,0,0,4,2,30,6,1,0,7,6,30,6,1,0,7,5,30,4,0,0,4,1,-15,3,1
2,4,13,0,30,6,1,0,7,0,30,4,0,0,4,2,30,6,1,0,7,6,30,6,1,0,7,5,30,4,0,0,4,1,-15,3,1
2,3,17,5,30,8,6,0,14,3,30,6,0,0,6,0,30,7,7,0,14,3,30,7,7,0,14,3,30,4,0,0,4,1,-15,3,1
2,4,17,5,30,8,6,0,14,3,30,6,0,0,6,0,30,7,7,0,14,3,30,7,7,0,14,3,30,4,0,0,4,1,-15,3,1
2,1,19,0,30,4,9,0,13,2,30,7,1,0,8,0,30,4,9,0,13,3,30,4,9,0,13,0,30,8,1,0,9,1,-15,3,1
2,0,21,3,30,8,2,0,10,4,30,4,2,0,6,5,30,3,7,0,10,1,30,5,5,0,10,0,30,3,1,0,4,1,-15,3,1
2,3,23,1,30,5,8,0,13,0,30,6,0,0,6,4,30,13,0,0,13,3,30,6,7,0,13,2,30,6,0,0,6,1,-15,3,1
2,3,27,1,30,6,9,0,15,4,30,2,0,0,2,0,30,5,10,0,15,2,30,5,10,0,15,5,30,6,0,0,6,1,-15,3,1
2,3,29,0,30,4,10,0,14,6,30,12,0,0,12,0,30,4,10,0,14,0,30,1,13,0,14,3,30,9,0,0,9,1,-15,3,1
2,4,29,0,30,4,10,0,14,6,30,12,0,0,12,0,30,4,10,0,14,0,30,1,13,0,14,3,30,9,0,0,9,1,-15,3,1
2,3,31,4,30,6,6,0,12,5,30,8,0,0,8,3,30,10,2,0,12,0,30,3,9,0,12,0,30,6,0,0,6,1,-15,3,1
2,4,31,4,30,6,6,0,12,5,30,8,0,0,8,3,30,10,2,0,12,0,30,3,9,0,12,0,30,6,0,0,6,1,-15,3,1
2,3,35,0,30,7,6,0,13,4,30,2,0,0,2,1,30,2,11,0,13,2,30,3,10,0,13,9,30,8,0,0,8,1,-15,3,1
2,0,4,2,30,7,1,0,8,5,30,4,0,0,4,3,30,1,7,0,8,0,30,8,0,0,8,2,30,3,1,0,4,0,-27,3,0
2,2,4,2,30,7,1,0,8,5,30,4,0,0,4,3,30,1,7,0,8,0,30,8,0,0,8,0,30,3,1,0,4,0,-27,3,0
2,3,4,2,30,7,1,0,8,5,30,4,0,0,4,3,30,1,7,0,8,0,30,8,0,0,8,0,30,3,1,0,4,0,-27,3,0
2,2,13,2,30,5,2,0,7,0,30,4,0,0,4,3,30,7,0,0,7,4,30,6,1,0,7,7,30,4,0,0,4,1,-15,3,1
2,3,13,2,30,5,2,0,7,0,30,4,0,0,4,3,30,7,0,0,7,4,30,6,1,0,7,7,30,4,0,0,4,1,-15,3,1
2,4,17,3,30,10,4,0,14,3,30,6,0,0,6,0,30,5,9,0,14,1,30,6,8,0,14,0,30,4,0,0,4,1,-15,3,1
2,3,19,1,30,6,7,0,13,2,30,8,0,0,8,0,30,4,9,0,13,3,30,4,9,0,13,0,30,7,2,0,9,1,-15,3,1
2,2,23,2,30,5,8,0,13,3,30,6,0,0,6,0,30,11,2,0,13,0,30,9,4,0,13,1,30,6,0,0,6,1,-15,3,1
2,4,23,2,30,5,8,0,13,3,30,6,0,0,6,0,30,11,2,0,13,0,30,9,4,0,13,1,30,6,0,0,6,1,-15,3,1
2,1,26,0,30,7,2,0,9,5,30,4,0,0,4,5,30,1,8,0,9,0,30,2,7,0,9,3,30,3,0,0,3,1,-15,3,1
2,1,27,1,30,7,8,0,15,1,30,2,0,0,2,0,30,13,2,0,15,0,30,4,11,0,15,0,30,3,3,0,6,1,-15,3,1
2,4,27,1,30,7,8,0,15,1,30,2,0,0,2,0,30,13,2,0,15,0,30,4,11,0,15,0,30,3,3,0,6,1,-15,3,1
2,0,31,4,30,4,8,0,12,8,30,8,0,0,8,3,30,4,8,0,12,0,30,9,3,0,12,3,30,6,0,0,6,1,-15,3,1
2,4,31,4,30,4,8,0,12,8,30,8,0,0,8,3,30,4,8,0,12,0,30,9,3,0,12,3,30,6,0,0,6,1,-15,3,1
2,3,35,0,30,7,6,0,13,4,30,2,0,0,2,0,30,2,11,0,13,6,30,1,12,0,13,6,30,8,0,0,8,1,-15,3,1
2,4,35,0,30,7,6,0,13,4,30,2,0,0,2,0,30,2,11,0,13,6,30,1,12,0,13,6,30,8,0,0,8,1,-15,3,1
2,4,6,0,30,7,2,0,9,4,30,2,0,0,2,0,30,3,6,0,9,2,30,5,4,0,9,0,30,4,1,0,5,0,-27,3,0
2,1,7,0,30,2,7,0,9,2,30,4,0,0,4,0,30,8,1,0,9,8,30,5,4,0,9,1,30,5,1,0,6,0,-27,3,0
2,2,7,0,30,2,7,0,9,2,30,4,0,0,4,0,30,8,1,0,9,8,30,5,4,0,9,1,30,5,1,0,6,0,-27,3,0
2,4,7,0,30,2,7,0,9,2,30,4,0,0,4,0,30,8,1,0,9,8,30,5,4,0,9,1,30,5,1,0,6,0,-27,3,0
2,1,17,5,30,9,5,0,14,3,30,6,0,0,6,0,30,3,11,0,14,0,30,6,8,0,14,2,30,4,0,0,4,1,-15,3,1
2,2,17,5,30,9,5,0,14,3,30,6,0,0,6,0,30,3,11,0,14,0,30,6,8,0,14,2,30,4,0,0,4,1,-15,3,1
2,3,17,5,30,9,5,0,14,3,30,6,0,0,6,0,30,3,11,0,14,0,30,6,8,0,14,2,30,4,0,0,4,1,-15,3,1
2,4,19,0,30,5,8,0,13,1,30,7,1,0,8,0,30,6,7,0,13,1,30,4,9,0,13,0,30,6,3,0,9,1,-15,3,1
2,3,22,2,30,8,0,0,8,3,30,2,0,0,2,3,30,5,3,0,8,1,30,4,4,0,8,1,30,3,1,0,4,1,-15,3,1
2,4,22,2,30,8,0,0,8,3,30,2,0,0,2,3,30,5,3,0,8,1,30,4,4,0,8,1,30,3,1,0,4,1,-15,3,1
2,3,23,2,30,4,9,0,13,1,30,6,0,0,6,0,30,11,2,0,13,3,30,6,7,0,13,2,30,6,0,0,6,1,-15,3,1
2,2,27,1,30,5,10,0,15,2,30,1,1,0,2,0,30,9,6,0,15,0,30,8,7,0,15,0,30,3,3,0,6,1,-15,3,1
2,3,27,1,30,5,10,0,15,2,30,1,1,0,2,0,30,9,6,0,15,0,30,8,7,0,15,0,30,3,3,0,6,1,-15,3,1
2,4,27,1,30,5,10,0,15,2,30,1,1,0,2,0,30,9,6,0,15,0,30,8,7,0,15,0,30,3,3,0,6,1,-15,3,1
2,1,17,3,30,9,5,0,14,3,30,6,0,0,6,0,30,5,9,0,14,2,30,6,8,0,14,3,30,4,0,0,4,1,-15,3,1
2,2,25,2,30,6,8,0,14,4,30,6,0,0,6,0,30,8,6,0,14,0,30,6,8,0,14,0,30,6,0,0,6,1,-15,3,1
2,3,25,2,30,6,8,0,14,4,30,6,0,0,6,0,30,8,6,0,14,0,30,6,8,0,14,0,30,6,0,0,6,1,-15,3,1
2,3,26,0,30,5,4,0,9,4,30,4,0,0,4,2,30,0,9,0,9,1,30,1,8,0,9,5,30,2,1,0,3,1,-15,3,1
2,4,13,2,30,5,2,0,7,0,30,4,0,0,4,0,30,5,2,0,7,10,30,6,1,0,7,2,30,4,0,0,4,1,-15,3,1
2,3,23,1,30,8,5,0,13,2,30,6,0,0,6,5,30,13,0,0,13,0,30,5,8,0,13,2,30,6,0,0,6,1,-15,3,1
2,4,25,0,30,3,11,0,14,4,30,6,0,0,6,0,30,7,7,0,14,1,30,7,7,0,14,4,30,6,0,0,6,1,-15,3,1
2,0,27,1,30,4,11,0,15,5,30,2,0,0,2,0,30,4,11,0,15,2,30,4,11,0,15,4,30,6,0,0,6,1,-15,3,1
2,2,27,1,30,4,11,0,15,5,30,2,0,0,2,0,30,4,11,0,15,2,30,4,11,0,15,0,30,6,0,0,6,1,-15,3,1
2,4,27,1,30,4,11,0,15,5,30,2,0,0,2,0,30,4,11,0,15,2,30,4,11,0,15,0,30,6,0,0,6,1,-15,3,1
2,4,2,3,30,10,0,0,10,2,30,3,1,0,4,3,30,4,6,0,10,4,30,2,8,0,10,1,30,2,6,0,8,0,-27,3,0
2,2,19,0,30,8,5,0,13,1,30,5,3,0,8,0,30,4,9,0,13,0,30,4,9,0,13,0,30,8,1,0,9,1,-15,3,1
2,4,19,0,30,8,5,0,13,1,30,5,3,0,8,0,30,4,9,0,13,0,30,4,9,0,13,0,30,8,1,0,9,1,-15,3,1
2,4,21,2,30,5,5,0,10,4,30,6,0,0,6,0,30,3,7,0,10,4,30,4,6,0,10,2,30,4,0,0,4,1,-15,3,1
2,3,23,4,30,5,8,0,13,0,30,6,0,0,6,1,30,12,1,0,13,0,30,5,8,0,13,1,30,6,0,0,6,1,-15,3,1
2,4,23,4,30,5,8,0,13,0,30,6,0,0,6,1,30,12,1,0,13,0,30,5,8,0,13,1,30,6,0,0,6,1,-15,3,1
2,0,25,1,30,6,8,0,14,6,30,6,0,0,6,0,30,3,11,0,14,1,30,11,3,0,14,7,30,6,0,0,6,1,-15,3,1
2,4,29,0,30,7,7,0,14,6,30,11,1,0,12,0,30,4,10,0,14,0,30,1,13,0,14,4,30,9,0,0,9,1,-15,3,1
2,4,32,0,30,3,6,0,9,4,30,2,0,0,2,0,30,5,4,0,9,0,30,2,7,0,9,5,30,2,0,0,2,1,-15,3,1
2,3,43,0,30,6,8,0,14,7,30,6,0,0,6,0,30,4,10,0,14,1,30,3,11,0,14,3,30,5,0,0,5,1,-15,3,1
2,1,5,0,30,2,3,0,5,3,30,3,1,0,4,0,30,1,4,0,5,1,30,2,3,0,5,0,30,2,0,0,2,0,-27,3,0
2,2,5,0,30,2,3,0,5,3,30,3,1,0,4,0,30,1,4,0,5,1,30,2,3,0,5,0,30,2,0,0,2,0,-27,3,0
2,3,8,0,30,7,0,0,7,5,30,2,0,0,2,0,30,1,6,0,7,0,30,4,3,0,7,6,30,3,0,0,3,0,-27,3,0
2,4,8,0,30,7,0,0,7,5,30,2,0,0,2,0,30,1,6,0,7,0,30,4,3,0,7,6,30,3,0,0,3,0,-27,3,0
2,2,13,0,30,7,0,0,7,0,30,4,0,0,4,2,30,6,1,0,7,10,30,4,3,0,7,3,30,4,0,0,4,1,-15,3,1
2,4,15,1,30,4,9,0,13,1,30,6,0,0,6,0,30,3,10,0,13,1,30,4,9,0,13,0,30,5,4,0,9,1,-15,3,1
2,1,19,0,30,3,10,0,13,2,30,7,1,0,8,0,30,4,9,0,13,4,30,7,6,0,13,0,30,8,1,0,9,1,-15,3,1
2,2,23,1,30,6,7,0,13,0,30,6,0,0,6,6,30,13,0,0,13,0,30,5,8,0,13,4,30,6,0,0,6,1,-15,3,1
2,2,27,1,30,5,10,0,15,5,30,2,0,0,2,0,30,2,13,0,15,1,30,7,8,0,15,4,30,6,0,0,6,1,-15,3,1
2,3,27,1,30,5,10,0,15,5,30,2,0,0,2,0,30,2,13,0,15,1,30,7,8,0,15,4,30,6,0,0,6,1,-15,3,1
2,4,39,0,30,5,6,0,11,7,30,6,0,0,6,0,30,4,7,0,11,0,30,5,6,0,11,2,30,5,0,0,5,1,-15,3,1
2,3,8,6,30,7,0,0,7,4,30,2,0,0,2,3,30,6,1,0,7,0,30,5,2,0,7,1,30,3,0,0,3,0,-27,3,0
2,4,9,0,30,8,3,0,11,3,30,6,0,0,6,3,30,6,5,0,11,1,30,3,8,0,11,4,30,4,0,0,4,0,-27,3,0
2,4,13,1,30,6,1,0,7,0,30,4,0,0,4,2,30,6,1,0,7,7,30,6,1,0,7,2,30,4,0,0,4,1,-15,3,1
2,1,17,3,30,10,4,0,14,3,30,6,0,0,6,0,30,4,10,0,14,1,30,5,9,0,14,1,30,3,1,0,4,1,-15,3,1
2,3,17,3,30,10,4,0,14,3,30,6,0,0,6,0,30,4,10,0,14,1,30,5,9,0,14,1,30,3,1,0,4,1,-15,3,1
2,2,25,1,30,5,9,0,14,5,30,6,0,0,6,0,30,8,6,0,14,2,30,7,7,0,14,4,30,6,0,0,6,1,-15,3,1
2,3,25,1,30,5,9,0,14,5,30,6,0,0,6,0,30,8,6,0,14,2,30,7,7,0,14,4,30,6,0,0,6,1,-15,3,1
2,4,25,1,30,5,9,0,14,5,30,6,0,0,6,0,30,8,6,0,14,2,30,7,7,0,14,4,30,6,0,0,6,1,-15,3,1
2,0,26,0,30,7,2,0,9,5,30,4,0,0,4,2,30,0,9,0,9,0,30,3,6,0,9,7,30,3,0,0,3,1,-15,3,1
2,1,27,1,30,4,11,0,15,4,30,1,1,0,2,0,30,3,12,0,15,1,30,6,9,0,15,3,30,6,0,0,6,1,-15,3,1
2,2,27,1,30,4,11,0,15,4,30,1,1,0,2,0,30,3,12,0,15,1,30,6,9,0,15,3,30,6,0,0,6,1,-15,3,1
2,4,27,1,30,4,11,0,15,2,30,1,1,0,2,0,30,3,12,0,15,1,30,6,9,0,15,3,30,6,0,0,6,1,-15,3,1
2,1,31,3,30,8,4,0,12,5,30,8,0,0,8,3,30,8,4,0,12,0,30,7,5,0,12,2,30,6,0,0,6,1,-15,3,1
2,4,1,0,30,7,3,0,10,5,30,2,0,0,2,1,30,3,7,0,10,3,30,8,2,0,10,5,30,6,0,0,6,0,-27,3,0
2,1,4,2,30,6,2,0,8,4,30,4,0,0,4,3,30,2,6,0,8,0,30,4,4,0,8,2,30,4,0,0,4,0,-27,3,0
2,1,15,0,30,4,9,0,13,0,30,6,0,0,6,0,30,6,7,0,13,1,30,4,9,0,13,3,30,6,3,0,9,1,-15,3,1
2,2,15,0,30,4,9,0,13,0,30,6,0,0,6,0,30,6,7,0,13,1,30,4,9,0,13,3,30,6,3,0,9,1,-15,3,1
2,2,23,4,30,5,8,0,13,2,30,6,0,0,6,0,30,12,1,0,13,2,30,5,8,0,13,4,30,6,0,0,6,1,-15,3,1
2,3,23,4,30,5,8,0,13,2,30,6,0,0,6,0,30,12,1,0,13,2,30,5,8,0,13,4,30,6,0,0,6,1,-15,3,1
2,4,23,4,30,5,8,0,13,2,30,6,0,0,6,0,30,12,1,0,13,2,30,5,8,0,13,4,30,6,0,0,6,1,-15,3,1
2,2,25,1,30,5,9,0,14,5,30,6,0,0,6,0,30,3,11,0,14,4,30,10,4,0,14,0,30,6,0,0,6,1,-15,3,1
2,4,27,1,30,11,4,0,15,1,30,2,0,0,2,0,30,2,13,0,15,0,30,2,13,0,15,2,30,6,0,0,6,1,-15,3,1
2,0,41,1,30,7,5,0,12,7,30,8,0,0,8,0,30,6,6,0,12,1,30,5,7,0,12,4,30,7,0,0,7,1,-15,3,1
2,2,41,1,30,7,5,0,12,7,30,8,0,0,8,0,30,6,6,0,12,1,30,5,7,0,12,4,30,7,0,0,7,1,-15,3,1
2,4,41,1,30,7,5,0,12,7,30,8,0,0,8,0,30,6,6,0,12,1,30,5,7,0,12,4,30,7,0,0,7,1,-15,3,1
2,0,5,0,30,5,0,0,5,3,30,0,4,0,4,0,30,3,2,0,5,0,30,1,4,0,5,1,30,0,2,0,2,0,-27,3,0
2,3,5,0,30,5,0,0,5,3,30,0,4,0,4,0,30,3,2,0,5,0,30,1,4,0,5,1,30,0,2,0,2,0,-27,3,0
2,1,17,3,30,11,3,0,14,3,30,6,0,0,6,0,30,4,10,0,14,1,30,5,9,0,14,4,30,4,0,0,4,1,-15,3,1
2,1,19,8,30,2,11,0,13,4,30,6,2,0,8,1,30,4,9,0,13,0,30,6,7,0,13,1,30,7,2,0,9,1,-15,3,1
2,4,19,8,30,2,11,0,13,4,30,6,2,0,8,1,30,4,9,0,13,0,30,6,7,0,13,1,30,7,2,0,9,1,-15,3,1
2,2,25,1,30,6,8,0,14,2,30,6,0,0,6,0,30,9,5,0,14,1,30,5,9,0,14,5,30,6,0,0,6,1,-15,3,1
2,3,25,1,30,6,8,0,14,2,30,6,0,0,6,0,30,9,5,0,14,1,30,5,9,0,14,5,30,6,0,0,6,1,-15,3,1
2,4,25,1,30,6,8,0,14,2,30,6,0,0,6,0,30,9,5,0,14,1,30,5,9,0,14,5,30,6,0,0,6,1,-15,3,1
2,0,27,1,30,5,10,0,15,3,30,2,0,0,2,0,30,6,9,0,15,2,30,6,9,0,15,6,30,6,0,0,6,1,-15,3,1
2,1,27,1,30,5,10,0,15,3,30,2,0,0,2,0,30,6,9,0,15,2,30,6,9,0,15,6,30,6,0,0,6,1,-15,3,1
2,3,27,1,30,5,10,0,15,3,30,2,0,0,2,0,30,6,9,0,15,2,30,6,9,0,15,6,30,6,0,0,6,1,-15,3,1
2,4,27,1,30,5,10,0,15,3,30,2,0,0,2,0,30,6,9,0,15,2,30,6,9,0,15,6,30,6,0,0,6,1,-15,3,1
2,3,29,0,30,4,10,0,14,6,30,12,0,0,12,0,30,3,11,0,14,0,30,6,8,0,14,0,30,9,0,0,9,1,-15,3,1
2,4,31,1,30,8,4,0,12,3,30,8,0,0,8,0,30,9,3,0,12,3,30,3,9,0,12,0,30,1,5,0,6,1,-15,3,1
2,3,8,0,30,7,0,0,7,3,30,2,0,0,2,0,30,6,1,0,7,0,30,5,2,0,7,3,30,3,0,0,3,0,-27,3,0
2,2,11,1,30,5,7,0,12,1,30,4,0,0,4,0,30,5,7,0,12,8,30,5,7,0,12,6,30,4,0,0,4,1,-15,3,1
2,3,13,2,30,7,0,0,7,1,30,4,0,0,4,0,30,5,2,0,7,4,30,4,3,0,7,4,30,4,0,0,4,1,-15,3,1
2,0,19,0,30,3,10,0,13,2,30,6,2,0,8,0,30,5,8,0,13,0,30,3,10,0,13,1,30,9,0,0,9,1,-15,3,1
2,4,25,0,30,8,6,0,14,3,30,6,0,0,6,0,30,10,4,0,14,1,30,4,10,0,14,4,30,5,1,0,6,1,-15,3,1
2,2,27,0,30,4,11,0,15,2,30,1,1,0,2,0,30,6,9,0,15,2,30,5,10,0,15,4,30,6,0,0,6,1,-15,3,1
2,4,27,0,30,4,11,0,15,2,30,1,1,0,2,0,30,6,9,0,15,2,30,5,10,0,15,4,30,6,0,0,6,1,-15,3,1
2,2,33,13,30,6,5,0,11,6,30,4,0,0,4,1,30,9,2,0,11,0,30,3,8,0,11,5,30,4,0,0,4,1,-15,3,1
2,3,35,0,30,12,1,0,13,4,30,2,0,0,2,5,30,2,11,0,13,0,30,1,12,0,13,4,30,8,0,0,8,1,-15,3,1
2,4,35,0,30,12,1,0,13,4,30,2,0,0,2,5,30,2,11,0,13,0,30,1,12,0,13,4,30,8,0,0,8,1,-15,3,1
2,2,39,0,30,1,10,0,11,6,30,6,0,0,6,0,30,5,6,0,11,0,30,2,9,0,11,6,30,5,0,0,5,1,-15,3,1
2,2,6,0,30,7,2,0,9,3,30,2,0,0,2,0,30,4,5,0,9,0,30,3,6,0,9,2,30,5,0,0,5,0,-27,3,0
2,4,8,0,30,7,0,0,7,4,30,2,0,0,2,3,30,3,4,0,7,0,30,5,2,0,7,6,30,3,0,0,3,0,-27,3,0
2,2,17,4,30,9,5,0,14,3,30,6,0,0,6,0,30,5,9,0,14,3,30,6,8,0,14,4,30,4,0,0,4,1,-15,3,1
2,3,17,4,30,9,5,0,14,3,30,6,0,0,6,0,30,5,9,0,14,3,30,6,8,0,14,4,30,4,0,0,4,1,-15,3,1
2,4,19,0,30,4,9,0,13,1,30,6,2,0,8,0,30,10,3,0,13,1,30,5,8,0,13,0,30,9,0,0,9,1,-15,3,1
2,0,25,1,30,8,6,0,14,5,30,6,0,0,6,0,30,3,11,0,14,1,30,9,5,0,14,6,30,6,0,0,6,1,-15,3,1
2,2,25,1,30,8,6,0,14,5,30,6,0,0,6,0,30,3,11,0,14,1,30,9,5,0,14,6,30,6,0,0,6,1,-15,3,1
2,3,25,1,30,8,6,0,14,5,30,6,0,0,6,0,30,3,11,0,14,1,30,9,5,0,14,6,30,6,0,0,6,1,-15,3,1
2,4,25,1,30,8,6,0,14,5,30,6,0,0,6,0,30,3,11,0,14,1,30,9,5,0,14,6,30,6,0,0,6,1,-15,3,1
2,2,27,1,30,4,11,0,15,4,30,1,1,0,2,1,30,9,6,0,15,0,30,4,11,0,15,1,30,6,0,0,6,1,-15,3,1
2,3,27,1,30,4,11,0,15,4,30,1,1,0,2,1,30,9,6,0,15,0,30,4,11,0,15,1,30,6,0,0,6,1,-15,3,1
2,4,27,1,30,4,11,0,15,4,30,1,1,0,2,1,30,9,6,0,15,0,30,4,11,0,15,1,30,6,0,0,6,1,-15,3,1
2,4,29,0,30,5,9,0,14,6,30,7,5,0,12,0,30,4,10,0,14,0,30,3,11,0,14,1,30,9,0,0,9,1,-15,3,1
2,3,35,0,30,3,10,0,13,5,30,2,0,0,2,0,30,6,7,0,13,3,30,2,11,0,13,5,30,8,0,0,8,1,-15,3,1
2,0,39,0,30,7,4,0,11,5,30,6,0,0,6,0,30,6,5,0,11,0,30,2,9,0,11,4,30,5,0,0,5,1,-15,3,1
2,0,19,0,30,4,9,0,13,2,30,4,4,0,8,0,30,4,9,0,13,12,30,6,7,0,13,1,30,8,1,0,9,1,-15,3,1
2,1,19,0,30,4,9,0,13,2,30,4,4,0,8,0,30,4,9,0,13,12,30,6,7,0,13,1,30,8,1,0,9,1,-15,3,1
2,4,19,0,30,4,9,0,13,2,30,4,4,0,8,0,30,4,9,0,13,12,30,6,7,0,13,1,30,8,1,0,9,1,-15,3,1
2,4,25,4,30,5,9,0,14,2,30,6,0,0,6,0,30,9,5,0,14,1,30,5,9,0,14,5,30,5,1,0,6,1,-15,3,1
2,3,31,4,30,9,3,0,12,3,30,8,0,0,8,5,30,12,0,0,12,0,30,3,9,0,12,0,30,2,4,0,6,1,-15,3,1
2,0,4,0,30,7,1,0,8,5,30,4,0,0,4,0,30,1,7,0,8,1,30,8,0,0,8,2,30,4,0,0,4,0,-27,3,0
2,1,11,4,30,4,8,0,12,2,30,4,0,0,4,0,30,6,6,0,12,3,30,7,5,0,12,3,30,4,0,0,4,1,-15,3,1
2,2,11,4,30,4,8,0,12,2,30,4,0,0,4,0,30,6,6,0,12,3,30,7,5,0,12,3,30,4,0,0,4,1,-15,3,1
2,3,11,4,30,4,8,0,12,2,30,4,0,0,4,0,30,6,6,0,12,3,30,7,5,0,12,3,30,4,0,0,4,1,-15,3,1
2,4,15,0,30,3,10,0,13,1,30,6,0,0,6,0,30,4,9,0,13,1,30,4,9,0,13,2,30,7,2,0,9,1,-15,3,1
2,1,17,4,30,9,5,0,14,3,30,6,0,0,6,0,30,5,9,0,14,2,30,6,8,0,14,2,30,4,0,0,4,1,-15,3,1
2,4,17,4,30,9,5,0,14,3,30,6,0,0,6,0,30,5,9,0,14,2,30,6,8,0,14,2,30,4,0,0,4,1,-15,3,1
2,1,21,2,30,5,5,0,10,2,30,5,1,0,6,1,30,7,3,0,10,6,30,5,5,0,10,4,30,4,0,0,4,1,-15,3,1
2,3,21,2,30,5,5,0,10,2,30,5,1,0,6,1,30,7,3,0,10,6,30,5,5,0,10,4,30,4,0,0,4,1,-15,3,1
2,4,25,1,30,7,7,0,14,5,30,6,0,0,6,0,30,3,11,0,14,1,30,9,5,0,14,3,30,6,0,0,6,1,-15,3,1
2,0,27,2,30,5,10,0,15,4,30,2,0,0,2,0,30,6,9,0,15,2,30,4,11,0,15,1,30,5,1,0,6,1,-15,3,1
2,1,27,2,30,5,10,0,15,4,30,2,0,0,2,0,30,6,9,0,15,2,30,4,11,0,15,1,30,5,1,0,6,1,-15,3,1
2,4,27,2,30,5,10,0,15,4,30,2,0,0,2,0,30,6,9,0,15,2,30,4,11,0,15,1,30,5,1,0,6,1,-15,3,1
2,0,31,2,30,9,3,0,12,5,30,8,0,0,8,6,30,7,5,0,12,0,30,3,9,0,12,0,30,3,3,0,6,1,-15,3,1
2,3,39,0,30,5,6,0,11,7,30,6,0,0,6,0,30,4,7,0,11,1,30,5,6,0,11,3,30,5,0,0,5,1,-15,3,1
2,4,4,2,30,7,1,0,8,4,30,4,0,0,4,0,30,3,5,0,8,0,30,1,7,0,8,3,30,4,0,0,4,0,-27,3,0
2,2,8,1,30,7,0,0,7,4,30,2,0,0,2,3,30,2,5,0,7,2,30,7,0,0,7,4,30,3,0,0,3,0,-27,3,0
2,1,9,0,30,6,5,0,11,2,30,5,1,0,6,1,30,9,2,0,11,5,30,3,8,0,11,4,30,4,0,0,4,0,-27,3,0
2,1,13,2,30,7,0,0,7,0,30,4,0,0,4,2,30,5,2,0,7,10,30,7,0,0,7,3,30,4,0,0,4,1,-15,3,1
2,2,13,2,30,7,0,0,7,0,30,4,0,0,4,2,30,5,2,0,7,10,30,7,0,0,7,3,30,4,0,0,4,1,-15,3,1
2,4,13,2,30,7,0,0,7,0,30,4,0,0,4,2,30,5,2,0,7,10,30,7,0,0,7,3,30,4,0,0,4,1,-15,3,1
2,4,17,4,30,10,4,0,14,2,30,6,0,0,6,0,30,7,7,0,14,2,30,6,8,0,14,5,30,4,0,0,4,1,-15,3,1
2,4,19,0,30,5,8,0,13,1,30,7,1,0,8,0,30,5,8,0,13,0,30,4,9,0,13,0,30,8,1,0,9,1,-15,3,1
2,3,22,1,30,5,3,0,8,3,30,2,0,0,2,4,30,5,3,0,8,1,30,4,4,0,8,4,30,3,1,0,4,1,-15,3,1
2,1,27,2,30,5,10,0,15,4,30,1,1,0,2,0,30,2,13,0,15,0,30,6,9,0,15,4,30,6,0,0,6,1,-15,3,1
2,0,31,5,30,7,5,0,12,5,30,8,0,0,8,7,30,8,4,0,12,0,30,3,9,0,12,0,30,2,4,0,6,1,-15,3,1
2,3,31,5,30,7,5,0,12,5,30,8,0,0,8,7,30,8,4,0,12,0,30,3,9,0,12,0,30,2,4,0,6,1,-15,3,1
2,2,35,2,30,6,7,0,13,6,30,2,0,0,2,1,30,6,7,0,13,2,30,6,7,0,13,4,30,8,0,0,8,1,-15,3,1
2,4,35,2,30,6,7,0,13,6,30,2,0,0,2,1,30,6,7,0,13,2,30,6,7,0,13,4,30,8,0,0,8,1,-15,3,1
2,1,13,1,30,6,1,0,7,0,30,4,0,0,4,2,30,5,2,0,7,5,30,6,1,0,7,2,30,4,0,0,4,1,-15,3,1
2,3,13,1,30,6,1,0,7,0,30,4,0,0,4,2,30,5,2,0,7,5,30,6,1,0,7,2,30,4,0,0,4,1,-15,3,1
2,4,17,0,30,10,4,0,14,2,30,6,0,0,6,0,30,7,7,0,14,1,30,6,8,0,14,3,30,4,0,0,4,1,-15,3,1
2,3,19,0,30,3,10,0,13,2,30,5,3,0,8,0,30,7,6,0,13,4,30,4,9,0,13,2,30,8,1,0,9,1,-15,3,1
2,4,19,0,30,3,10,0,13,2,30,5,3,0,8,0,30,7,6,0,13,4,30,4,9,0,13,2,30,8,1,0,9,1,-15,3,1
2,2,27,1,30,5,10,0,15,2,30,1,1,0,2,0,30,12,3,0,15,0,30,5,10,0,15,0,30,5,1,0,6,1,-15,3,1
2,2,29,0,30,5,9,0,14,6,30,12,0,0,12,0,30,4,10,0,14,5,30,1,13,0,14,1,30,9,0,0,9,1,-15,3,1
2,4,29,0,30,5,9,0,14,6,30,12,0,0,12,0,30,4,10,0,14,5,30,1,13,0,14,1,30,9,0,0,9,1,-15,3,1
2,0,31,3,30,6,6,0,12,5,30,8,0,0,8,8,30,9,3,0,12,0,30,3,9,0,12,2,30,2,4,0,6,1,-15,3,1
2,4,31,3,30,6,6,0,12,5,30,8,0,0,8,8,30,9,3,0,12,0,30,3,9,0,12,1,30,2,4,0,6,1,-15,3,1
2,0,39,0,30,5,6,0,11,8,30,6,0,0,6,0,30,4,7,0,11,0,30,7,4,0,11,6,30,5,0,0,5,1,-15,3,1
2,2,39,0,30,5,6,0,11,8,30,6,0,0,6,0,30,4,7,0,11,0,30,7,4,0,11,6,30,5,0,0,5,1,-15,3,1
2,3,39,0,30,5,6,0,11,8,30,6,0,0,6,0,30,4,7,0,11,0,30,7,4,0,11,6,30,5,0,0,5,1,-15,3,1
2,3,6,2,30,7,2,0,9,4,30,2,0,0,2,0,30,2,7,0,9,0,30,4,5,0,9,0,30,4,1,0,5,0,-27,3,0
2,4,7,1,30,6,3,0,9,2,30,4,0,0,4,0,30,7,2,0,9,8,30,3,6,0,9,1,30,4,2,0,6,0,-27,3,0
2,3,11,0,30,4,8,0,12,1,30,4,0,0,4,3,30,6,6,0,12,4,30,5,7,0,12,3,30,4,0,0,4,1,-15,3,1
2,4,15,0,30,7,6,0,13,0,30,5,1,0,6,0,30,3,10,0,13,2,30,4,9,0,13,2,30,9,0,0,9,1,-15,3,1
2,3,19,1,30,7,6,0,13,2,30,3,5,0,8,0,30,6,7,0,13,2,30,5,8,0,13,1,30,8,1,0,9,1,-15,3,1
2,4,23,1,30,7,6,0,13,3,30,6,0,0,6,4,30,10,3,0,13,2,30,5,8,0,13,2,30,6,0,0,6,1,-15,3,1
2,2,11,0,30,1,3,0,4,0,30,0,0,0,0,2,30,2,2,0,4,5,30,1,3,0,4,2,30,1,0,0,1,1,-15,3,1
2,4,17,3,30,11,3,0,14,2,30,6,0,0,6,0,30,7,7,0,14,1,30,5,9,0,14,2,30,4,0,0,4,1,-15,3,1
2,4,25,4,30,7,7,0,14,3,30,6,0,0,6,0,30,9,5,0,14,1,30,5,9,0,14,0,30,5,1,0,6,1,-15,3,1
2,1,27,1,30,6,9,0,15,2,30,1,1,0,2,0,30,10,5,0,15,0,30,4,11,0,15,1,30,4,2,0,6,1,-15,3,1
2,2,1,0,30,7,3,0,10,4,30,2,0,0,2,1,30,4,6,0,10,5,30,8,2,0,10,6,30,6,0,0,6,0,-27,3,0
2,0,4,2,30,8,0,0,8,4,30,4,0,0,4,5,30,1,7,0,8,0,30,7,1,0,8,3,30,4,0,0,4,0,-27,3,0
2,1,4,2,30,8,0,0,8,4,30,4,0,0,4,5,30,1,7,0,8,0,30,7,1,0,8,3,30,4,0,0,4,0,-27,3,0
2,4,4,2,30,8,0,0,8,4,30,4,0,0,4,5,30,1,7,0,8,0,30,7,1,0,8,3,30,4,0,0,4,0,-27,3,0
2,4,11,2,30,4,8,0,12,1,30,4,0,0,4,0,30,6,6,0,12,6,30,5,7,0,12,4,30,4,0,0,4,1,-15,3,1
2,2,19,0,30,4,9,0,13,2,30,6,2,0,8,0,30,4,9,0,13,6,30,8,5,0,13,1,30,8,1,0,9,1,-15,3,1
2,3,19,0,30,4,9,0,13,2,30,6,2,0,8,0,30,4,9,0,13,6,30,8,5,0,13,1,30,8,1,0,9,1,-15,3,1
2,4,19,0,30,4,9,0,13,2,30,6,2,0,8,0,30,4,9,0,13,6,30,8,5,0,13,1,30,8,1,0,9,1,-15,3,1
2,3,23,3,30,5,8,0,13,3,30,6,0,0,6,5,30,13,0,0,13,0,30,6,7,0,13,0,30,5,1,0,6,1,-15,3,1
2,4,25,0,30,6,8,0,14,3,30,6,0,0,6,0,30,5,9,0,14,1,30,5,9,0,14,6,30,6,0,0,6,1,-15,3,1
2,0,27,1,30,4,11,0,15,4,30,2,0,0,2,0,30,6,9,0,15,3,30,4,11,0,15,6,30,6,0,0,6,1,-15,3,1
2,1,27,1,30,4,11,0,15,4,30,2,0,0,2,0,30,6,9,0,15,3,30,4,11,0,15,6,30,6,0,0,6,1,-15,3,1
2,0,41,1,30,6,6,0,12,6,30,6,2,0,8,0,30,7,5,0,12,0,30,3,9,0,12,4,30,7,0,0,7,1,-15,3,1
2,4,1,0,30,6,4,0,10,4,30,2,0,0,2,1,30,3,7,0,10,0,30,7,3,0,10,5,30,6,0,0,6,0,-27,3,0
2,0,4,3,30,5,3,0,8,3,30,3,1,0,4,0,30,4,4,0,8,1,30,6,2,0,8,3,30,4,0,0,4,0,-27,3,0
2,1,11,1,30,4,8,0,12,0,30,4,0,0,4,0,30,7,5,0,12,7,30,4,8,0,12,6,30,4,0,0,4,1,-15,3,1
2,2,11,1,30,4,8,0,12,0,30,4,0,0,4,0,30,7,5,0,12,7,30,4,8,0,12,6,30,4,0,0,4,1,-15,3,1
2,4,11,1,30,4,8,0,12,0,30,4,0,0,4,0,30,7,5,0,12,7,30,4,8,0,12,6,30,4,0,0,4,1,-15,3,1
2,2,13,3,30,7,0,0,7,0,30,4,0,0,4,4,30,7,0,0,7,7,30,7,0,0,7,5,30,4,0,0,4,1,-15,3,1
2,4,19,0,30,6,7,0,13,2,30,6,2,0,8,4,30,9,4,0,13,1,30,5,8,0,13,2,30,7,2,0,9,1,-15,3,1
2,1,21,1,30,5,5,0,10,3,30,5,1,0,6,1,30,3,7,0,10,6,30,4,6,0,10,1,30,4,0,0,4,1,-15,3,1
2,2,21,1,30,5,5,0,10,3,30,5,1,0,6,1,30,3,7,0,10,6,30,4,6,0,10,1,30,4,0,0,4,1,-15,3,1
2,3,21,1,30,5,5,0,10,3,30,5,1,0,6,1,30,3,7,0,10,6,30,4,6,0,10,1,30,4,0,0,4,1,-15,3,1
2,3,25,1,30,5,9,0,14,4,30,6,0,0,6,0,30,8,6,0,14,1,30,5,9,0,14,3,30,6,0,0,6,1,-15,3,1
2,4,29,5,30,7,7,0,14,6,30,8,4,0,12,0,30,3,11,0,14,0,30,4,10,0,14,0,30,9,0,0,9,1,-15,3,1
2,3,8,2,30,7,0,0,7,3,30,2,0,0,2,2,30,5,2,0,7,0,30,6,1,0,7,3,30,3,0,0,3,0,-27,3,0
2,4,13,0,30,6,1,0,7,0,30,4,0,0,4,2,30,6,1,0,7,8,30,6,1,0,7,5,30,4,0,0,4,1,-15,3,1
2,4,22,1,30,7,1,0,8,3,30,2,0,0,2,0,30,4,4,0,8,1,30,3,5,0,8,1,30,4,0,0,4,1,-15,3,1
2,3,25,1,30,3,11,0,14,4,30,6,0,0,6,0,30,8,6,0,14,1,30,10,4,0,14,6,30,5,1,0,6,1,-15,3,1
2,4,25,1,30,3,11,0,14,4,30,6,0,0,6,0,30,8,6,0,14,1,30,10,4,0,14,6,30,5,1,0,6,1,-15,3,1
2,4,29,0,30,5,9,0,14,6,30,8,4,0,12,0,30,5,9,0,14,0,30,0,14,0,14,1,30,9,0,0,9,1,-15,3,1
2,4,31,1,30,9,3,0,12,4,30,8,0,0,8,3,30,10,2,0,12,0,30,3,9,0,12,1,30,4,2,0,6,1,-15,3,1
2,4,17,3,30,10,4,0,14,3,30,6,0,0,6,0,30,5,9,0,14,3,30,4,10,0,14,0,30,3,1,0,4,1,-15,3,1
2,1,19,0,30,2,11,0,13,2,30,8,0,0,8,4,30,9,4,0,13,0,30,7,6,0,13,2,30,8,1,0,9,1,-15,3,1
2,2,19,0,30,2,11,0,13,2,30,8,0,0,8,4,30,9,4,0,13,0,30,7,6,0,13,2,30,8,1,0,9,1,-15,3,1
2,2,25,1,30,4,10,0,14,4,30,6,0,0,6,0,30,8,6,0,14,1,30,10,4,0,14,4,30,6,0,0,6,1,-15,3,1
2,4,25,1,30,4,10,0,14,4,30,6,0,0,6,0,30,8,6,0,14,1,30,10,4,0,14,4,30,6,0,0,6,1,-15,3,1
2,1,27,1,30,11,4,0,15,3,30,2,0,0,2,0,30,5,10,0,15,0,30,3,12,0,15,0,30,2,4,0,6,1,-15,3,1
2,4,27,1,30,11,4,0,15,3,30,2,0,0,2,0,30,5,10,0,15,0,30,3,12,0,15,0,30,2,4,0,6,1,-15,3,1
2,4,29,0,30,6,8,0,14,6,30,10,2,0,12,0,30,6,8,0,14,0,30,1,13,0,14,3,30,9,0,0,9,1,-15,3,1
2,3,31,1,30,3,9,0,12,5,30,8,0,0,8,3,30,9,3,0,12,0,30,7,5,0,12,3,30,6,0,0,6,1,-15,3,1
2,3,35,0,30,6,7,0,13,4,30,0,2,0,2,1,30,8,5,0,13,0,30,1,12,0,13,2,30,8,0,0,8,1,-15,3,1
2,0,4,3,30,8,0,0,8,5,30,4,0,0,4,0,30,3,5,0,8,0,30,8,0,0,8,2,30,3,1,0,4,0,-27,3,0
2,2,4,3,30,8,0,0,8,5,30,4,0,0,4,0,30,3,5,0,8,0,30,8,0,0,8,2,30,3,1,0,4,0,-27,3,0
2,3,4,3,30,8,0,0,8,5,30,4,0,0,4,0,30,3,5,0,8,0,30,8,0,0,8,2,30,3,1,0,4,0,-27,3,0
2,4,8,0,30,7,0,0,7,3,30,2,0,0,2,0,30,7,0,0,7,0,30,7,0,0,7,2,30,3,0,0,3,0,-27,3,0
2,2,17,4,30,12,2,0,14,3,30,6,0,0,6,0,30,6,8,0,14,2,30,3,11,0,14,0,30,4,0,0,4,1,-15,3,1
2,3,17,4,30,12,2,0,14,3,30,6,0,0,6,0,30,6,8,0,14,2,30,3,11,0,14,0,30,4,0,0,4,1,-15,3,1
2,3,19,0,30,1,12,0,13,2,30,8,0,0,8,0,30,4,9,0,13,1,30,4,9,0,13,1,30,8,1,0,9,1,-15,3,1
2,0,27,1,30,6,9,0,15,4,30,1,1,0,2,1,30,9,6,0,15,0,30,4,11,0,15,1,30,6,0,0,6,1,-15,3,1
2,1,27,1,30,6,9,0,15,4,30,1,1,0,2,1,30,9,6,0,15,0,30,4,11,0,15,1,30,6,0,0,6,1,-15,3,1
2,2,27,1,30,6,9,0,15,4,30,1,1,0,2,1,30,9,6,0,15,0,30,4,11,0,15,1,30,6,0,0,6,1,-15,3,1
2,1,31,1,30,6,6,0,12,5,30,8,0,0,8,6,30,8,4,0,12,0,30,3,9,0,12,2,30,3,3,0,6,1,-15,3,1
2,3,31,1,30,6,6,0,12,5,30,8,0,0,8,6,30,8,4,0,12,0,30,3,9,0,12,2,30,3,3,0,6,1,-15,3,1
2,4,32,0,30,8,1,0,9,4,30,2,0,0,2,2,30,9,0,0,9,1,30,2,7,0,9,3,30,2,0,0,2,1,-15,3,1
2,2,37,1,30,7,4,0,11,7,30,8,0,0,8,0,30,2,9,0,11,4,30,5,6,0,11,10,30,6,0,0,6,1,-15,3,1
2,1,7,4,30,3,1,0,4,2,30,2,0,0,2,0,30,2,2,0,4,0,30,1,3,0,4,2,30,1,1,0,2,0,-27,3,0
2,2,7,4,30,3,1,0,4,2,30,2,0,0,2,0,30,2,2,0,4,0,30,1,3,0,4,2,30,1,1,0,2,0,-27,3,0
2,3,7,4,30,3,1,0,4,2,30,2,0,0,2,0,30,2,2,0,4,0,30,1,3,0,4,2,30,1,1,0,2,0,-27,3,0
2,1,13,3,30,5,2,0,7,0,30,4,0,0,4,2,30,6,1,0,7,10,30,7,0,0,7,3,30,4,0,0,4,1,-15,3,1
2,1,17,4,30,11,3,0,14,3,30,6,0,0,6,0,30,6,8,0,14,1,30,7,7,0,14,4,30,4,0,0,4,1,-15,3,1
2,2,17,4,30,11,3,0,14,3,30,6,0,0,6,0,30,6,8,0,14,1,30,7,7,0,14,4,30,4,0,0,4,1,-15,3,1
2,3,17,4,30,11,3,0,14,3,30,6,0,0,6,0,30,6,8,0,14,1,30,7,7,0,14,4,30,4,0,0,4,1,-15,3,1
2,4,17,4,30,11,3,0,14,3,30,6,0,0,6,0,30,6,8,0,14,1,30,7,7,0,14,4,30,4,0,0,4,1,-15,3,1
2,2,19,0,30,3,10,0,13,2,30,6,2,0,8,0,30,7,6,0,13,8,30,3,10,0,13,1,30,9,0,0,9,1,-15,3,1
2,4,23,1,30,3,10,0,13,3,30,6,0,0,6,9,30,13,0,0,13,0,30,5,8,0,13,2,30,6,0,0,6,1,-15,3,1
2,0,25,1,30,6,8,0,14,5,30,6,0,0,6,0,30,6,8,0,14,2,30,6,8,0,14,5,30,6,0,0,6,1,-15,3,1
2,3,25,1,30,6,8,0,14,4,30,6,0,0,6,0,30,6,8,0,14,0,30,6,8,0,14,5,30,6,0,0,6,1,-15,3,1
2,4,25,1,30,6,8,0,14,4,30,6,0,0,6,0,30,6,8,0,14,0,30,6,8,0,14,5,30,6,0,0,6,1,-15,3,1
2,0,27,1,30,4,11,0,15,4,30,2,0,0,2,0,30,3,12,0,15,0,30,4,11,0,15,4,30,6,0,0,6,1,-15,3,1
2,3,38,0,30,1,9,0,10,7,30,6,0,0,6,4,30,1,9,0,10,0,30,4,6,0,10,7,30,6,0,0,6,1,-15,3,1
2,4,5,0,30,2,3,0,5,3,30,1,3,0,4,2,30,1,4,0,5,0,30,1,4,0,5,0,30,0,2,0,2,0,-27,3,0
2,3,19,0,30,5,8,0,13,2,30,4,4,0,8,0,30,6,7,0,13,0,30,4,9,0,13,3,30,6,3,0,9,1,-15,3,1
2,4,19,0,30,5,8,0,13,2,30,4,4,0,8,0,30,6,7,0,13,0,30,4,9,0,13,3,30,6,3,0,9,1,-15,3,1
2,2,25,1,30,10,4,0,14,4,30,6,0,0,6,0,30,6,8,0,14,1,30,5,9,0,14,5,30,4,2,0,6,1,-15,3,1
2,4,25,1,30,10,4,0,14,4,30,6,0,0,6,0,30,6,8,0,14,1,30,5,9,0,14,5,30,4,2,0,6,1,-15,3,1
2,3,29,0,30,9,5,0,14,5,30,8,4,0,12,0,30,3,11,0,14,0,30,1,13,0,14,0,30,9,0,0,9,1,-15,3,1
2,2,31,2,30,8,4,0,12,4,30,8,0,0,8,3,30,8,4,0,12,0,30,3,9,0,12,1,30,3,3,0,6,1,-15,3,1
2,3,31,2,30,8,4,0,12,4,30,8,0,0,8,3,30,8,4,0,12,0,30,3,9,0,12,1,30,3,3,0,6,1,-15,3,1
2,4,31,2,30,8,4,0,12,4,30,8,0,0,8,3,30,8,4,0,12,0,30,3,9,0,12,1,30,3,3,0,6,1,-15,3,1
2,4,35,1,30,10,3,0,13,4,30,2,0,0,2,1,30,8,5,0,13,0,30,2,11,0,13,0,30,8,0,0,8,1,-15,3,1
2,0,38,0,30,3,7,0,10,8,30,6,0,0,6,0,30,1,9,0,10,0,30,6,4,0,10,9,30,6,0,0,6,1,-15,3,1
2,3,1,1,30,6,4,0,10,4,30,2,0,0,2,1,30,4,6,0,10,3,30,7,3,0,10,6,30,6,0,0,6,0,-27,3,0
2,4,1,1,30,6,4,0,10,4,30,2,0,0,2,1,30,4,6,0,10,3,30,7,3,0,10,6,30,6,0,0,6,0,-27,3,0
2,3,4,2,30,5,3,0,8,5,30,4,0,0,4,0,30,2,6,0,8,0,30,8,0,0,8,2,30,4,0,0,4,0,-27,3,0
2,4,4,2,30,5,3,0,8,5,30,4,0,0,4,0,30,2,6,0,8,0,30,8,0,0,8,2,30,4,0,0,4,0,-27,3,0
2,2,17,4,30,9,5,0,14,3,30,6,0,0,6,0,30,6,8,0,14,1,30,7,7,0,14,6,30,4,0,0,4,1,-15,3,1
2,2,19,0,30,4,9,0,13,2,30,6,2,0,8,0,30,5,8,0,13,0,30,3,10,0,13,1,30,9,0,0,9,1,-15,3,1
2,3,19,0,30,4,9,0,13,2,30,6,2,0,8,0,30,5,8,0,13,0,30,3,10,0,13,1,30,9,0,0,9,1,-15,3,1
2,4,23,1,30,6,7,0,13,0,30,6,0,0,6,5,30,13,0,0,13,0,30,6,7,0,13,2,30,6,0,0,6,1,-15,3,1
2,2,25,0,30,4,10,0,14,5,30,6,0,0,6,0,30,6,8,0,14,1,30,4,10,0,14,5,30,5,1,0,6,1,-15,3,1
2,3,25,0,30,4,10,0,14,5,30,6,0,0,6,0,30,6,8,0,14,1,30,4,10,0,14,5,30,5,1,0,6,1,-15,3,1
2,4,25,0,30,4,10,0,14,5,30,6,0,0,6,0,30,6,8,0,14,1,30,4,10,0,14,5,30,5,1,0,6,1,-15,3,1
2,3,35,1,30,6,7,0,13,4,30,2,0,0,2,1,30,6,7,0,13,1,30,2,11,0,13,3,30,8,0,0,8,1,-15,3,1
2,4,35,1,30,6,7,0,13,4,30,2,0,0,2,1,30,6,7,0,13,1,30,2,11,0,13,3,30,8,0,0,8,1,-15,3,1
2,2,39,0,30,3,8,0,11,6,30,6,0,0,6,0,30,4,7,0,11,1,30,3,8,0,11,5,30,5,0,0,5,1,-15,3,1
2,1,4,2,30,7,1,0,8,4,30,4,0,0,4,2,30,2,6,0,8,0,30,5,3,0,8,1,30,3,1,0,4,0,-27,3,0
2,1,5,0,30,2,3,0,5,2,30,4,0,0,4,0,30,1,4,0,5,0,30,1,4,0,5,0,30,1,1,0,2,0,-27,3,0
2,1,11,1,30,4,8,0,12,1,30,4,0,0,4,0,30,7,5,0,12,7,30,6,6,0,12,4,30,4,0,0,4,1,-15,3,1
2,2,11,1,30,4,8,0,12,1,30,4,0,0,4,0,30,7,5,0,12,7,30,6,6,0,12,4,30,4,0,0,4,1,-15,3,1
2,2,13,2,30,7,0,0,7,1,30,4,0,0,4,0,30,5,2,0,7,9,30,5,2,0,7,3,30,4,0,0,4,1,-15,3,1
2,3,17,6,30,11,3,0,14,4,30,6,0,0,6,0,30,4,10,0,14,1,30,5,9,0,14,1,30,4,0,0,4,1,-15,3,1
2,2,19,0,30,4,9,0,13,1,30,6,2,0,8,0,30,7,6,0,13,3,30,4,9,0,13,0,30,8,1,0,9,1,-15,3,1
2,3,19,0,30,4,9,0,13,1,30,6,2,0,8,0,30,7,6,0,13,3,30,4,9,0,13,0,30,8,1,0,9,1,-15,3,1
2,4,19,0,30,4,9,0,13,1,30,6,2,0,8,0,30,7,6,0,13,3,30,4,9,0,13,0,30,8,1,0,9,1,-15,3,1
2,4,25,1,30,5,9,0,14,5,30,6,0,0,6,0,30,4,10,0,14,1,30,9,5,0,14,6,30,5,1,0,6,1,-15,3,1
2,1,27,1,30,5,10,0,15,4,30,2,0,0,2,0,30,8,7,0,15,0,30,5,10,0,15,2,30,6,0,0,6,1,-15,3,1
2,3,29,1,30,8,6,0,14,6,30,11,1,0,12,0,30,3,11,0,14,0,30,1,13,0,14,2,30,9,0,0,9,1,-15,3,1
2,3,31,1,30,5,7,0,12,5,30,8,0,0,8,3,30,4,8,0,12,2,30,3,9,0,12,6,30,5,1,0,6,1,-15,3,1
2,4,31,1,30,5,7,0,12,5,30,8,0,0,8,3,30,4,8,0,12,2,30,3,9,0,12,6,30,5,1,0,6,1,-15,3,1
2,2,4,2,30,6,2,0,8,4,30,4,0,0,4,0,30,3,5,0,8,1,30,5,3,0,8,1,30,4,0,0,4,0,-27,3,0
2,4,13,1,30,5,2,0,7,0,30,4,0,0,4,1,30,7,0,0,7,14,30,4,3,0,7,0,30,4,0,0,4,1,-15,3,1
2,3,19,0,30,4,9,0,13,1,30,7,1,0,8,0,30,7,6,0,13,4,30,4,9,0,13,0,30,7,2,0,9,1,-15,3,1
2,3,23,1,30,3,10,0,13,4,30,6,0,0,6,0,30,8,5,0,13,5,30,12,1,0,13,3,30,6,0,0,6,1,-15,3,1
2,1,25,1,30,12,2,0,14,3,30,6,0,0,6,1,30,4,10,0,14,1,30,6,8,0,14,3,30,4,2,0,6,1,-15,3,1
2,2,25,1,30,12,2,0,14,3,30,6,0,0,6,1,30,4,10,0,14,1,30,6,8,0,14,3,30,4,2,0,6,1,-15,3,1
2,3,25,1,30,12,2,0,14,3,30,6,0,0,6,1,30,4,10,0,14,1,30,6,8,0,14,3,30,4,2,0,6,1,-15,3,1
2,4,25,1,30,12,2,0,14,3,30,6,0,0,6,1,30,4,10,0,14,1,30,6,8,0,14,3,30,4,2,0,6,1,-15,3,1
2,1,27,3,30,6,9,0,15,3,30,2,0,0,2,0,30,4,11,0,15,0,30,5,10,0,15,2,30,5,1,0,6,1,-15,3,1
2,3,27,3,30,6,9,0,15,3,30,2,0,0,2,0,30,4,11,0,15,0,30,5,10,0,15,2,30,5,1,0,6,1,-15,3,1
2,4,27,3,30,6,9,0,15,3,30,2,0,0,2,0,30,4,11,0,15,0,30,5,10,0,15,2,30,5,1,0,6,1,-15,3,1
2,0,37,0,30,3,8,0,11,7,30,8,0,0,8,0,30,2,9,0,11,9,30,6,5,0,11,8,30,6,0,0,6,1,-15,3,1
2,3,23,1,30,5,8,0,13,1,30,6,0,0,6,5,30,13,0,0,13,0,30,6,7,0,13,1,30,5,1,0,6,1,-15,3,1
2,2,25,1,30,5,9,0,14,4,30,6,0,0,6,0,30,6,8,0,14,1,30,7,7,0,14,4,30,5,1,0,6,1,-15,3,1
2,3,25,1,30,5,9,0,14,4,30,6,0,0,6,0,30,6,8,0,14,1,30,7,7,0,14,4,30,5,1,0,6,1,-15,3,1
2,4,25,1,30,5,9,0,14,4,30,6,0,0,6,0,30,6,8,0,14,1,30,7,7,0,14,4,30,5,1,0,6,1,-15,3,1
2,4,31,1,30,7,5,0,12,3,30,8,0,0,8,3,30,12,0,0,12,0,30,3,9,0,12,0,30,4,2,0,6,1,-15,3,1
2,4,4,0,30,7,1,0,8,4,30,4,0,0,4,0,30,2,6,0,8,0,30,4,4,0,8,0,30,4,0,0,4,0,-27,3,0
2,2,5,0,30,1,4,0,5,3,30,4,0,0,4,0,30,0,5,0,5,0,30,1,4,0,5,3,30,1,1,0,2,0,-27,3,0
2,4,11,1,30,5,7,0,12,1,30,4,0,0,4,1,30,4,8,0,12,0,30,6,6,0,12,3,30,4,0,0,4,1,-15,3,1
2,4,13,0,30,3,0,0,3,0,30,2,0,0,2,0,30,3,0,0,3,9,30,2,1,0,3,2,30,2,0,0,2,1,-15,3,1
2,1,13,0,30,6,1,0,7,0,30,4,0,0,4,5,30,6,1,0,7,5,30,6,1,0,7,4,30,4,0,0,4,1,-15,3,1
2,4,17,0,30,8,6,0,14,0,30,6,0,0,6,0,30,8,6,0,14,0,30,7,7,0,14,3,30,4,0,0,4,1,-15,3,1
2,3,23,3,30,5,8,0,13,3,30,6,0,0,6,9,30,9,4,0,13,0,30,4,9,0,13,0,30,5,1,0,6,1,-15,3,1
2,4,23,3,30,5,8,0,13,3,30,6,0,0,6,9,30,9,4,0,13,0,30,4,9,0,13,0,30,5,1,0,6,1,-15,3,1
2,3,25,4,30,7,7,0,14,1,30,6,0,0,6,0,30,9,5,0,14,1,30,5,9,0,14,3,30,4,2,0,6,1,-15,3,1
2,4,25,4,30,7,7,0,14,1,30,6,0,0,6,0,30,9,5,0,14,1,30,5,9,0,14,3,30,4,2,0,6,1,-15,3,1
2,4,35,0,30,5,8,0,13,6,30,2,0,0,2,9,30,2,11,0,13,0,30,6,7,0,13,2,30,8,0,0,8,1,-15,3,1
2,3,47,0,30,0,14,0,14,7,30,4,0,0,4,0,30,7,7,0,14,0,30,2,12,0,14,9,30,7,0,0,7,1,-15,3,1
2,4,7,0,30,6,3,0,9,1,30,4,0,0,4,0,30,8,1,0,9,8,30,3,6,0,9,1,30,4,2,0,6,0,-27,3,0
2,4,15,2,30,6,7,0,13,0,30,5,1,0,6,0,30,8,5,0,13,1,30,4,9,0,13,4,30,5,4,0,9,1,-15,3,1
2,1,17,2,30,11,3,0,14,3,30,6,0,0,6,0,30,4,10,0,14,4,30,4,10,0,14,7,30,4,0,0,4,1,-15,3,1
2,2,17,2,30,11,3,0,14,3,30,6,0,0,6,0,30,4,10,0,14,4,30,4,10,0,14,7,30,4,0,0,4,1,-15,3,1
2,3,17,2,30,11,3,0,14,3,30,6,0,0,6,0,30,4,10,0,14,4,30,4,10,0,14,7,30,4,0,0,4,1,-15,3,1
2,1,19,0,30,2,11,0,13,3,30,8,0,0,8,0,30,5,8,0,13,6,30,9,4,0,13,3,30,9,0,0,9,1,-15,3,1
2,4,19,0,30,2,11,0,13,3,30,8,0,0,8,0,30,5,8,0,13,6,30,9,4,0,13,3,30,9,0,0,9,1,-15,3,1
2,3,23,2,30,8,5,0,13,1,30,6,0,0,6,5,30,11,2,0,13,0,30,5,8,0,13,1,30,6,0,0,6,1,-15,3,1
2,4,23,2,30,8,5,0,13,1,30,6,0,0,6,5,30,11,2,0,13,0,30,5,8,0,13,1,30,6,0,0,6,1,-15,3,1
2,1,25,2,30,9,5,0,14,2,30,6,0,0,6,0,30,7,7,0,14,1,30,6,8,0,14,4,30,5,1,0,6,1,-15,3,1
2,4,25,2,30,9,5,0,14,2,30,6,0,0,6,0,30,7,7,0,14,0,30,6,8,0,14,0,30,5,1,0,6,1,-15,3,1
2,1,27,1,30,9,6,0,15,1,30,2,0,0,2,0,30,5,10,0,15,0,30,3,12,0,15,1,30,6,0,0,6,1,-15,3,1
2,3,27,1,30,9,6,0,15,1,30,2,0,0,2,0,30,5,10,0,15,0,30,3,12,0,15,1,30,6,0,0,6,1,-15,3,1
2,2,29,0,30,5,9,0,14,6,30,10,2,0,12,0,30,5,9,0,14,0,30,1,13,0,14,0,30,9,0,0,9,1,-15,3,1
2,1,13,1,30,6,1,0,7,0,30,4,0,0,4,2,30,6,1,0,7,8,30,5,2,0,7,3,30,4,0,0,4,1,-15,3,1
2,3,17,3,30,9,5,0,14,3,30,6,0,0,6,0,30,4,10,0,14,1,30,7,7,0,14,2,30,4,0,0,4,1,-15,3,1
2,4,17,3,30,9,5,0,14,3,30,6,0,0,6,0,30,4,10,0,14,1,30,7,7,0,14,2,30,4,0,0,4,1,-15,3,1
2,4,19,0,30,3,10,0,13,0,30,6,2,0,8,0,30,7,6,0,13,4,30,4,9,0,13,1,30,6,3,0,9,1,-15,3,1
2,4,23,1,30,9,4,0,13,2,30,6,0,0,6,7,30,10,3,0,13,0,30,3,10,0,13,1,30,5,1,0,6,1,-15,3,1
2,3,25,0,30,3,11,0,14,3,30,6,0,0,6,1,30,11,3,0,14,1,30,6,8,0,14,3,30,5,1,0,6,1,-15,3,1
2,2,31,1,30,6,6,0,12,7,30,8,0,0,8,3,30,4,8,0,12,4,30,8,4,0,12,2,30,6,0,0,6,1,-15,3,1
2,3,31,1,30,6,6,0,12,7,30,8,0,0,8,3,30,4,8,0,12,4,30,8,4,0,12,2,30,6,0,0,6,1,-15,3,1
2,4,31,1,30,6,6,0,12,7,30,8,0,0,8,3,30,4,8,0,12,4,30,8,4,0,12,2,30,6,0,0,6,1,-15,3,1
2,3,39,0,30,4,7,0,11,6,30,6,0,0,6,0,30,8,3,0,11,0,30,5,6,0,11,4,30,4,1,0,5,1,-15,3,1
2,4,39,0,30,4,7,0,11,6,30,6,0,0,6,0,30,8,3,0,11,0,30,5,6,0,11,4,30,4,1,0,5,1,-15,3,1
2,2,4,0,30,7,1,0,8,3,30,2,2,0,4,0,30,1,7,0,8,0,30,4,4,0,8,4,30,4,0,0,4,0,-27,3,0
2,4,8,1,30,7,0,0,7,4,30,2,0,0,2,4,30,4,3,0,7,0,30,6,1,0,7,3,30,3,0,0,3,0,-27,3,0
2,2,13,1,30,6,1,0,7,0,30,4,0,0,4,2,30,5,2,0,7,15,30,5,2,0,7,2,30,4,0,0,4,1,-15,3,1
2,2,17,6,30,10,4,0,14,3,30,6,0,0,6,0,30,5,9,0,14,1,30,6,8,0,14,6,30,4,0,0,4,1,-15,3,1
2,3,17,6,30,10,4,0,14,3,30,6,0,0,6,0,30,5,9,0,14,1,30,6,8,0,14,6,30,4,0,0,4,1,-15,3,1
2,4,17,6,30,10,4,0,14,3,30,6,0,0,6,0,30,5,9,0,14,1,30,6,8,0,14,6,30,4,0,0,4,1,-15,3,1
2,3,19,0,30,6,7,0,13,2,30,8,0,0,8,4,30,5,8,0,13,0,30,7,6,0,13,1,30,6,3,0,9,1,-15,3,1
2,2,31,3,30,7,5,0,12,3,30,8,0,0,8,3,30,12,0,0,12,0,30,3,9,0,12,2,30,2,4,0,6,1,-15,3,1
2,4,35,0,30,9,4,0,13,4,30,2,0,0,2,0,30,2,11,0,13,4,30,3,10,0,13,4,30,8,0,0,8,1,-15,3,1
2,0,37,0,30,7,4,0,11,5,30,5,3,0,8,0,30,11,0,0,11,2,30,2,9,0,11,3,30,6,0,0,6,1,-15,3,1
2,3,13,8,30,7,0,0,7,1,30,4,0,0,4,0,30,6,1,0,7,3,30,5,2,0,7,2,30,4,0,0,4,1,-15,3,1
2,4,25,0,30,5,9,0,14,2,30,6,0,0,6,0,30,10,4,0,14,0,30,4,10,0,14,3,30,5,1,0,6,1,-15,3,1
2,2,11,0,30,1,3,0,4,0,30,0,0,0,0,0,30,1,3,0,4,4,30,2,2,0,4,2,30,1,0,0,1,1,-15,3,1
2,3,11,0,30,1,3,0,4,0,30,0,0,0,0,0,30,1,3,0,4,4,30,2,2,0,4,2,30,1,0,0,1,1,-15,3,1
2,4,11,0,30,1,3,0,4,0,30,0,0,0,0,0,30,1,3,0,4,4,30,2,2,0,4,2,30,1,0,0,1,1,-15,3,1
2,1,17,7,30,12,2,0,14,2,30,6,0,0,6,0,30,5,9,0,14,2,30,4,10,0,14,4,30,4,0,0,4,1,-15,3,1
2,3,17,7,30,12,2,0,14,2,30,6,0,0,6,0,30,5,9,0,14,2,30,4,10,0,14,4,30,4,0,0,4,1,-15,3,1
2,3,19,0,30,4,9,0,13,2,30,7,1,0,8,0,30,4,9,0,13,3,30,7,6,0,13,0,30,8,1,0,9,1,-15,3,1
2,4,23,1,30,6,7,0,13,3,30,5,1,0,6,7,30,13,0,0,13,0,30,5,8,0,13,2,30,5,1,0,6,1,-15,3,1
2,0,25,2,30,9,5,0,14,5,30,6,0,0,6,0,30,6,8,0,14,1,30,6,8,0,14,7,30,5,1,0,6,1,-15,3,1
2,1,25,2,30,9,5,0,14,5,30,6,0,0,6,0,30,6,8,0,14,1,30,6,8,0,14,7,30,5,1,0,6,1,-15,3,1
2,3,13,0,30,4,3,0,7,0,30,4,0,0,4,2,30,7,0,0,7,5,30,7,0,0,7,7,30,4,0,0,4,1,-15,3,1
2,3,17,4,30,9,5,0,14,4,30,6,0,0,6,0,30,3,11,0,14,5,30,7,7,0,14,4,30,4,0,0,4,1,-15,3,1
2,0,21,2,30,8,2,0,10,4,30,4,2,0,6,6,30,3,7,0,10,1,30,5,5,0,10,2,30,4,0,0,4,1,-15,3,1
2,1,21,2,30,8,2,0,10,4,30,4,2,0,6,6,30,3,7,0,10,1,30,5,5,0,10,2,30,4,0,0,4,1,-15,3,1
2,2,21,2,30,8,2,0,10,4,30,4,2,0,6,6,30,3,7,0,10,1,30,5,5,0,10,2,30,4,0,0,4,1,-15,3,1
2,4,23,0,30,8,5,0,13,3,30,6,0,0,6,6,30,9,4,0,13,0,30,6,7,0,13,1,30,6,0,0,6,1,-15,3,1
2,4,25,1,30,8,6,0,14,4,30,6,0,0,6,1,30,5,9,0,14,1,30,5,9,0,14,4,30,5,1,0,6,1,-15,3,1
2,0,27,1,30,3,12,0,15,1,30,2,0,0,2,2,30,6,9,0,15,1,30,5,10,0,15,4,30,6,0,0,6,1,-15,3,1
2,4,27,0,30,3,12,0,15,1,30,2,0,0,2,0,30,6,9,0,15,0,30,5,10,0,15,4,30,6,0,0,6,1,-15,3,1
2,0,41,0,30,9,3,0,12,7,30,8,0,0,8,0,30,3,9,0,12,3,30,4,8,0,12,6,30,7,0,0,7,1,-15,3,1
2,4,1,0,30,7,3,0,10,4,30,2,0,0,2,1,30,3,7,0,10,0,30,4,6,0,10,5,30,6,0,0,6,0,-27,3,0
2,0,5,0,30,1,4,0,5,3,30,0,4,0,4,0,30,1,4,0,5,2,30,2,3,0,5,2,30,2,0,0,2,0,-27,3,0
2,1,5,0,30,1,4,0,5,3,30,0,4,0,4,0,30,1,4,0,5,2,30,2,3,0,5,2,30,2,0,0,2,0,-27,3,0
2,3,9,0,30,3,1,0,4,2,30,2,0,0,2,0,30,2,2,0,4,1,30,4,0,0,4,4,30,1,0,0,1,0,-27,3,0
2,4,9,0,30,3,1,0,4,2,30,2,0,0,2,0,30,2,2,0,4,1,30,4,0,0,4,4,30,1,0,0,1,0,-27,3,0
2,1,13,4,30,7,0,0,7,1,30,4,0,0,4,2,30,7,0,0,7,2,30,7,0,0,7,3,30,4,0,0,4,1,-15,3,1
2,3,13,4,30,7,0,0,7,1,30,4,0,0,4,2,30,7,0,0,7,2,30,7,0,0,7,3,30,4,0,0,4,1,-15,3,1
2,4,17,2,30,7,7,0,14,2,30,6,0,0,6,0,30,8,6,0,14,4,30,5,9,0,14,5,30,4,0,0,4,1,-15,3,1
2,0,19,0,30,3,10,0,13,3,30,4,4,0,8,0,30,5,8,0,13,9,30,6,7,0,13,1,30,9,0,0,9,1,-15,3,1
2,4,23,2,30,6,7,0,13,3,30,6,0,0,6,2,30,10,3,0,13,0,30,4,9,0,13,1,30,6,0,0,6,1,-15,3,1
2,0,27,1,30,4,11,0,15,3,30,2,0,0,2,0,30,11,4,0,15,2,30,5,10,0,15,2,30,6,0,0,6,1,-15,3,1
2,2,27,1,30,4,11,0,15,3,30,2,0,0,2,0,30,11,4,0,15,2,30,5,10,0,15,2,30,6,0,0,6,1,-15,3,1
2,4,27,1,30,4,11,0,15,3,30,2,0,0,2,0,30,11,4,0,15,2,30,5,10,0,15,2,30,6,0,0,6,1,-15,3,1
2,3,5,0,30,0,5,0,5,2,30,2,2,0,4,1,30,2,3,0,5,0,30,1,4,0,5,0,30,0,2,0,2,0,-27,3,0
2,4,5,0,30,0,5,0,5,2,30,2,2,0,4,1,30,2,3,0,5,0,30,1,4,0,5,0,30,0,2,0,2,0,-27,3,0
2,4,8,1,30,7,0,0,7,4,30,2,0,0,2,1,30,2,5,0,7,0,30,5,2,0,7,6,30,3,0,0,3,0,-27,3,0
2,4,13,0,30,7,0,0,7,0,30,4,0,0,4,1,30,6,1,0,7,6,30,4,3,0,7,1,30,4,0,0,4,1,-15,3,1
2,4,17,0,30,10,4,0,14,3,30,6,0,0,6,0,30,4,10,0,14,2,30,8,6,0,14,2,30,4,0,0,4,1,-15,3,1
2,3,19,0,30,4,9,0,13,2,30,4,4,0,8,0,30,6,7,0,13,4,30,5,8,0,13,1,30,9,0,0,9,1,-15,3,1
2,4,19,0,30,4,9,0,13,2,30,4,4,0,8,0,30,6,7,0,13,4,30,5,8,0,13,1,30,9,0,0,9,1,-15,3,1
2,4,23,1,30,5,8,0,13,3,30,6,0,0,6,7,30,10,3,0,13,0,30,5,8,0,13,1,30,6,0,0,6,1,-15,3,1
2,2,26,0,30,6,3,0,9,5,30,4,0,0,4,4,30,1,8,0,9,0,30,2,7,0,9,5,30,3,0,0,3,1,-15,3,1
2,3,26,0,30,6,3,0,9,5,30,4,0,0,4,4,30,1,8,0,9,0,30,2,7,0,9,5,30,3,0,0,3,1,-15,3,1
2,4,32,0,30,5,4,0,9,4,30,2,0,0,2,2,30,8,1,0,9,1,30,3,6,0,9,4,30,2,0,0,2,1,-15,3,1
2,2,35,0,30,5,8,0,13,5,30,2,0,0,2,1,30,5,8,0,13,7,30,3,10,0,13,4,30,8,0,0,8,1,-15,3,1
2,4,35,0,30,5,8,0,13,5,30,2,0,0,2,1,30,5,8,0,13,7,30,3,10,0,13,4,30,8,0,0,8,1,-15,3,1
2,0,41,0,30,8,4,0,12,5,30,6,2,0,8,1,30,8,4,0,12,0,30,3,9,0,12,3,30,4,3,0,7,1,-15,3,1
2,2,41,0,30,8,4,0,12,5,30,6,2,0,8,0,30,8,4,0,12,0,30,3,9,0,12,3,30,4,3,0,7,1,-15,3,1
2,3,41,0,30,8,4,0,12,5,30,6,2,0,8,0,30,8,4,0,12,0,30,3,9,0,12,3,30,4,3,0,7,1,-15,3,1
2,1,17,4,30,11,3,0,14,3,30,6,0,0,6,0,30,4,10,0,14,1,30,5,9,0,14,0,30,4,0,0,4,1,-15,3,1
2,2,17,4,30,11,3,0,14,3,30,6,0,0,6,0,30,4,10,0,14,1,30,5,9,0,14,0,30,4,0,0,4,1,-15,3,1
2,4,17,4,30,11,3,0,14,3,30,6,0,0,6,0,30,4,10,0,14,1,30,5,9,0,14,0,30,4,0,0,4,1,-15,3,1
2,3,19,0,30,3,10,0,13,2,30,8,0,0,8,0,30,11,2,0,13,0,30,3,10,0,13,1,30,8,1,0,9,1,-15,3,1
2,2,25,1,30,10,4,0,14,4,30,6,0,0,6,0,30,4,10,0,14,1,30,6,8,0,14,4,30,5,1,0,6,1,-15,3,1
2,2,29,0,30,5,9,0,14,6,30,11,1,0,12,0,30,4,10,0,14,0,30,3,11,0,14,3,30,9,0,0,9,1,-15,3,1
2,4,29,0,30,5,9,0,14,6,30,11,1,0,12,0,30,4,10,0,14,0,30,3,11,0,14,3,30,9,0,0,9,1,-15,3,1
2,3,43,0,30,7,7,0,14,7,30,6,0,0,6,0,30,4,10,0,14,1,30,1,13,0,14,3,30,5,0,0,5,1,-15,3,1
2,1,19,0,30,3,10,0,13,2,30,6,2,0,8,0,30,7,6,0,13,3,30,7,6,0,13,0,30,8,1,0,9,1,-15,3,1
2,4,27,1,30,6,9,0,15,5,30,2,0,0,2,0,30,5,10,0,15,2,30,6,9,0,15,1,30,6,0,0,6,1,-15,3,1
2,3,29,0,30,8,6,0,14,6,30,12,0,0,12,1,30,5,9,0,14,0,30,1,13,0,14,0,30,8,1,0,9,1,-15,3,1
2,4,29,0,30,8,6,0,14,6,30,12,0,0,12,1,30,5,9,0,14,0,30,1,13,0,14,0,30,8,1,0,9,1,-15,3,1
2,3,39,0,30,3,8,0,11,6,30,6,0,0,6,0,30,8,3,0,11,0,30,1,10,0,11,4,30,5,0,0,5,1,-15,3,1
2,2,4,5,30,8,0,0,8,4,30,4,0,0,4,0,30,1,7,0,8,7,30,1,7,0,8,1,30,3,1,0,4,0,-27,3,0
2,4,8,4,30,7,0,0,7,4,30,2,0,0,2,1,30,4,3,0,7,0,30,3,4,0,7,1,30,3,0,0,3,0,-27,3,0
2,4,15,0,30,5,8,0,13,0,30,6,0,0,6,0,30,4,9,0,13,1,30,5,8,0,13,2,30,7,2,0,9,1,-15,3,1
2,3,17,4,30,11,3,0,14,4,30,6,0,0,6,0,30,3,11,0,14,1,30,7,7,0,14,2,30,3,1,0,4,1,-15,3,1
2,4,17,4,30,11,3,0,14,4,30,6,0,0,6,0,30,3,11,0,14,1,30,7,7,0,14,2,30,3,1,0,4,1,-15,3,1
2,2,19,0,30,4,9,0,13,2,30,3,5,0,8,0,30,9,4,0,13,3,30,3,10,0,13,2,30,7,2,0,9,1,-15,3,1
2,4,19,0,30,4,9,0,13,2,30,3,5,0,8,0,30,9,4,0,13,3,30,3,10,0,13,2,30,7,2,0,9,1,-15,3,1
2,2,23,2,30,5,8,0,13,5,30,6,0,0,6,0,30,5,8,0,13,7,30,8,5,0,13,3,30,6,0,0,6,1,-15,3,1
2,4,23,2,30,5,8,0,13,5,30,6,0,0,6,0,30,5,8,0,13,7,30,8,5,0,13,3,30,6,0,0,6,1,-15,3,1
2,0,27,1,30,4,11,0,15,4,30,2,0,0,2,0,30,6,9,0,15,2,30,6,9,0,15,3,30,6,0,0,6,1,-15,3,1
2,3,27,0,30,4,11,0,15,4,30,2,0,0,2,0,30,6,9,0,15,2,30,6,9,0,15,3,30,6,0,0,6,1,-15,3,1
2,4,27,0,30,4,11,0,15,4,30,2,0,0,2,0,30,6,9,0,15,2,30,6,9,0,15,3,30,6,0,0,6,1,-15,3,1
2,0,29,0,30,5,9,0,14,6,30,11,1,0,12,0,30,4,10,0,14,0,30,1,13,0,14,4,30,9,0,0,9,1,-15,3,1
2,1,29,0,30,5,9,0,14,6,30,11,1,0,12,0,30,4,10,0,14,0,30,1,13,0,14,4,30,9,0,0,9,1,-15,3,1
2,3,31,4,30,6,6,0,12,5,30,8,0,0,8,4,30,9,3,0,12,2,30,5,7,0,12,0,30,4,2,0,6,1,-15,3,1
2,2,33,1,30,2,9,0,11,3,30,4,0,0,4,0,30,10,1,0,11,0,30,3,8,0,11,5,30,4,0,0,4,1,-15,3,1
2,3,33,1,30,2,9,0,11,3,30,4,0,0,4,0,30,10,1,0,11,0,30,3,8,0,11,5,30,4,0,0,4,1,-15,3,1
2,4,35,1,30,7,6,0,13,4,30,2,0,0,2,1,30,8,5,0,13,0,30,2,11,0,13,0,30,8,0,0,8,1,-15,3,1
2,3,17,1,30,10,4,0,14,3,30,6,0,0,6,0,30,3,11,0,14,3,30,5,9,0,14,7,30,4,0,0,4,1,-15,3,1
2,2,19,0,30,3,10,0,13,2,30,5,3,0,8,0,30,4,9,0,13,3,30,5,8,0,13,3,30,9,0,0,9,1,-15,3,1
2,3,19,0,30,3,10,0,13,2,30,5,3,0,8,0,30,4,9,0,13,3,30,5,8,0,13,3,30,9,0,0,9,1,-15,3,1
2,4,19,0,30,3,10,0,13,2,30,5,3,0,8,0,30,4,9,0,13,3,30,5,8,0,13,3,30,9,0,0,9,1,-15,3,1
2,0,27,1,30,4,11,0,15,3,30,1,1,0,2,0,30,4,11,0,15,3,30,4,11,0,15,3,30,6,0,0,6,1,-15,3,1
2,2,29,0,30,6,8,0,14,6,30,11,1,0,12,0,30,3,11,0,14,0,30,0,14,0,14,2,30,9,0,0,9,1,-15,3,1
2,2,31,9,30,7,5,0,12,5,30,8,0,0,8,3,30,9,3,0,12,0,30,3,9,0,12,0,30,3,3,0,6,1,-15,3,1
2,3,31,9,30,7,5,0,12,5,30,8,0,0,8,3,30,9,3,0,12,0,30,3,9,0,12,0,30,3,3,0,6,1,-15,3,1
2,4,39,0,30,2,9,0,11,6,30,6,0,0,6,0,30,8,3,0,11,0,30,4,7,0,11,2,30,5,0,0,5,1,-15,3,1
2,0,5,0,30,2,3,0,5,3,30,0,4,0,4,2,30,1,4,0,5,0,30,1,4,0,5,0,30,1,1,0,2,0,-27,3,0
2,2,5,0,30,2,3,0,5,3,30,0,4,0,4,2,30,1,4,0,5,0,30,1,4,0,5,0,30,1,1,0,2,0,-27,3,0
2,4,8,1,30,7,0,0,7,5,30,2,0,0,2,0,30,1,6,0,7,0,30,7,0,0,7,1,30,3,0,0,3,0,-27,3,0
2,1,17,2,30,10,4,0,14,2,30,6,0,0,6,0,30,2,12,0,14,1,30,6,8,0,14,7,30,4,0,0,4,1,-15,3,1
2,4,19,0,30,4,9,0,13,2,30,4,4,0,8,0,30,4,9,0,13,7,30,3,10,0,13,4,30,9,0,0,9,1,-15,3,1
2,0,27,1,30,3,12,0,15,3,30,1,1,0,2,0,30,8,7,0,15,0,30,6,9,0,15,4,30,6,0,0,6,1,-15,3,1
2,3,27,1,30,3,12,0,15,3,30,1,1,0,2,0,30,8,7,0,15,0,30,6,9,0,15,4,30,6,0,0,6,1,-15,3,1
2,4,27,1,30,3,12,0,15,3,30,1,1,0,2,0,30,8,7,0,15,0,30,6,9,0,15,4,30,6,0,0,6,1,-15,3,1
2,2,35,0,30,7,6,0,13,4,30,2,0,0,2,1,30,4,9,0,13,0,30,7,6,0,13,8,30,8,0,0,8,1,-15,3,1
2,3,35,0,30,7,6,0,13,4,30,2,0,0,2,1,30,4,9,0,13,0,30,7,6,0,13,8,30,8,0,0,8,1,-15,3,1
2,1,4,2,30,6,2,0,8,4,30,4,0,0,4,0,30,2,6,0,8,0,30,5,3,0,8,1,30,3,1,0,4,0,-27,3,0
2,1,5,0,30,4,1,0,5,3,30,0,4,0,4,0,30,1,4,0,5,0,30,1,4,0,5,0,30,0,2,0,2,0,-27,3,0
2,4,5,0,30,4,1,0,5,1,30,0,4,0,4,0,30,1,4,0,5,0,30,1,4,0,5,0,30,0,2,0,2,0,-27,3,0
2,4,7,3,30,1,3,0,4,3,30,2,0,0,2,1,30,1,3,0,4,0,30,1,3,0,4,2,30,1,1,0,2,0,-27,3,0
2,4,7,0,30,6,3,0,9,3,30,4,0,0,4,3,30,6,3,0,9,5,30,3,6,0,9,2,30,5,1,0,6,0,-27,3,0
2,1,13,2,30,7,0,0,7,0,30,4,0,0,4,5,30,7,0,0,7,11,30,5,2,0,7,1,30,4,0,0,4,1,-15,3,1
2,4,13,2,30,7,0,0,7,0,30,4,0,0,4,5,30,7,0,0,7,11,30,5,2,0,7,1,30,4,0,0,4,1,-15,3,1
2,4,15,0,30,5,8,0,13,1,30,6,0,0,6,0,30,3,10,0,13,1,30,4,9,0,13,0,30,9,0,0,9,1,-15,3,1
2,1,17,2,30,7,7,0,14,2,30,6,0,0,6,0,30,6,8,0,14,7,30,7,7,0,14,4,30,4,0,0,4,1,-15,3,1
2,4,17,2,30,7,7,0,14,2,30,6,0,0,6,0,30,6,8,0,14,7,30,7,7,0,14,4,30,4,0,0,4,1,-15,3,1
2,4,19,0,30,4,9,0,13,0,30,3,5,0,8,0,30,6,7,0,13,4,30,3,10,0,13,1,30,8,1,0,9,1,-15,3,1
2,1,25,5,30,9,5,0,14,5,30,6,0,0,6,0,30,6,8,0,14,1,30,7,7,0,14,4,30,6,0,0,6,1,-15,3,1
2,1,26,1,30,9,0,0,9,4,30,4,0,0,4,2,30,0,9,0,9,0,30,1,8,0,9,7,30,3,0,0,3,1,-15,3,1
2,2,27,1,30,8,7,0,15,4,30,2,0,0,2,0,30,2,13,0,15,4,30,3,12,0,15,1,30,6,0,0,6,1,-15,3,1
2,4,27,0,30,8,7,0,15,4,30,2,0,0,2,0,30,2,13,0,15,4,30,3,12,0,15,1,30,6,0,0,6,1,-15,3,1
2,2,1,0,30,7,3,0,10,4,30,2,0,0,2,1,30,4,6,0,10,3,30,5,5,0,10,8,30,6,0,0,6,0,-27,3,0
2,2,4,0,30,6,2,0,8,4,30,4,0,0,4,1,30,2,6,0,8,0,30,4,4,0,8,2,30,4,0,0,4,0,-27,3,0
2,4,4,0,30,6,2,0,8,4,30,4,0,0,4,1,30,2,6,0,8,0,30,4,4,0,8,2,30,4,0,0,4,0,-27,3,0
2,0,19,0,30,7,6,0,13,2,30,5,3,0,8,4,30,4,9,0,13,1,30,4,9,0,13,0,30,8,1,0,9,1,-15,3,1
2,3,19,0,30,7,6,0,13,1,30,5,3,0,8,0,30,4,9,0,13,1,30,4,9,0,13,0,30,8,1,0,9,1,-15,3,1
2,4,19,0,30,7,6,0,13,1,30,5,3,0,8,0,30,4,9,0,13,1,30,4,9,0,13,0,30,8,1,0,9,1,-15,3,1
2,3,23,2,30,6,7,0,13,0,30,6,0,0,6,2,30,13,0,0,13,0,30,5,8,0,13,2,30,5,1,0,6,1,-15,3,1
2,1,25,1,30,11,3,0,14,3,30,6,0,0,6,0,30,6,8,0,14,1,30,4,10,0,14,5,30,6,0,0,6,1,-15,3,1
2,3,25,1,30,11,3,0,14,3,30,6,0,0,6,0,30,6,8,0,14,1,30,4,10,0,14,5,30,6,0,0,6,1,-15,3,1
2,4,29,0,30,6,8,0,14,5,30,12,0,0,12,0,30,7,7,0,14,0,30,2,12,0,14,0,30,8,1,0,9,1,-15,3,1
2,4,31,1,30,9,3,0,12,3,30,8,0,0,8,3,30,10,2,0,12,0,30,3,9,0,12,0,30,4,2,0,6,1,-15,3,1
2,3,4,2,30,7,1,0,8,5,30,1,3,0,4,0,30,3,5,0,8,0,30,4,4,0,8,4,30,3,1,0,4,0,-27,3,0
2,1,6,0,30,5,4,0,9,3,30,2,0,0,2,0,30,4,5,0,9,0,30,4,5,0,9,0,30,4,1,0,5,0,-27,3,0
2,2,6,0,30,5,4,0,9,3,30,2,0,0,2,0,30,4,5,0,9,0,30,4,5,0,9,0,30,4,1,0,5,0,-27,3,0
2,4,13,0,30,7,0,0,7,0,30,4,0,0,4,2,30,5,2,0,7,4,30,5,2,0,7,4,30,4,0,0,4,1,-15,3,1
2,4,15,0,30,5,8,0,13,0,30,6,0,0,6,0,30,6,7,0,13,1,30,3,10,0,13,2,30,9,0,0,9,1,-15,3,1
2,2,17,3,30,8,6,0,14,3,30,6,0,0,6,0,30,5,9,0,14,1,30,4,10,0,14,7,30,4,0,0,4,1,-15,3,1
2,3,17,3,30,8,6,0,14,3,30,6,0,0,6,0,30,5,9,0,14,1,30,4,10,0,14,7,30,4,0,0,4,1,-15,3,1
2,3,25,1,30,8,6,0,14,0,30,6,0,0,6,2,30,12,2,0,14,1,30,5,9,0,14,2,30,5,1,0,6,1,-15,3,1
2,4,25,1,30,8,6,0,14,0,30,6,0,0,6,2,30,12,2,0,14,1,30,5,9,0,14,2,30,5,1,0,6,1,-15,3,1
2,2,27,3,30,7,8,0,15,3,30,1,1,0,2,0,30,9,6,0,15,0,30,3,12,0,15,3,30,6,0,0,6,1,-15,3,1
2,1,35,0,30,9,4,0,13,6,30,1,1,0,2,1,30,2,11,0,13,0,30,5,8,0,13,8,30,8,0,0,8,1,-15,3,1
2,2,47,0,30,2,12,0,14,6,30,4,0,0,4,0,30,3,11,0,14,0,30,3,11,0,14,7,30,7,0,0,7,1,-15,3,1
2,2,13,2,30,7,0,0,7,0,30,4,0,0,4,2,30,5,2,0,7,13,30,6,1,0,7,3,30,4,0,0,4,1,-15,3,1
2,3,23,2,30,11,2,0,13,1,30,6,0,0,6,5,30,12,1,0,13,0,30,5,8,0,13,2,30,6,0,0,6,1,-15,3,1
2,2,25,1,30,6,8,0,14,4,30,6,0,0,6,0,30,8,6,0,14,1,30,5,9,0,14,4,30,5,1,0,6,1,-15,3,1
2,0,27,1,30,8,7,0,15,2,30,2,0,0,2,0,30,4,11,0,15,0,30,5,10,0,15,4,30,6,0,0,6,1,-15,3,1
2,3,27,1,30,8,7,0,15,2,30,2,0,0,2,0,30,4,11,0,15,0,30,5,10,0,15,4,30,6,0,0,6,1,-15,3,1
2,4,27,1,30,8,7,0,15,2,30,2,0,0,2,0,30,4,11,0,15,0,30,5,10,0,15,4,30,6,0,0,6,1,-15,3,1
2,2,13,2,30,5,2,0,7,0,30,4,0,0,4,2,30,6,1,0,7,6,30,5,2,0,7,4,30,4,0,0,4,1,-15,3,1
2,3,17,3,30,9,5,0,14,2,30,6,0,0,6,0,30,5,9,0,14,1,30,5,9,0,14,3,30,4,0,0,4,1,-15,3,1
2,1,19,0,30,2,11,0,13,2,30,7,1,0,8,4,30,5,8,0,13,0,30,3,10,0,13,1,30,7,2,0,9,1,-15,3,1
2,4,19,0,30,2,11,0,13,2,30,7,1,0,8,4,30,5,8,0,13,0,30,3,10,0,13,1,30,7,2,0,9,1,-15,3,1
2,3,35,0,30,8,5,0,13,6,30,2,0,0,2,1,30,2,11,0,13,3,30,4,9,0,13,9,30,8,0,0,8,1,-15,3,1
2,2,47,0,30,0,14,0,14,7,30,4,0,0,4,0,30,5,9,0,14,0,30,2,12,0,14,9,30,7,0,0,7,1,-15,3,1
2,3,47,0,30,0,14,0,14,7,30,4,0,0,4,0,30,5,9,0,14,0,30,2,12,0,14,9,30,7,0,0,7,1,-15,3,1
2,2,8,2,30,7,0,0,7,3,30,2,0,0,2,0,30,5,2,0,7,0,30,6,1,0,7,3,30,3,0,0,3,0,-27,3,0
2,3,8,2,30,7,0,0,7,3,30,2,0,0,2,0,30,5,2,0,7,0,30,6,1,0,7,3,30,3,0,0,3,0,-27,3,0
2,4,13,3,30,7,0,0,7,0,30,4,0,0,4,2,30,7,0,0,7,8,30,4,3,0,7,4,30,4,0,0,4,1,-15,3,1
2,0,25,5,30,4,10,0,14,4,30,6,0,0,6,0,30,10,4,0,14,1,30,7,7,0,14,3,30,5,1,0,6,1,-15,3,1
2,1,25,5,30,4,10,0,14,4,30,6,0,0,6,0,30,10,4,0,14,1,30,7,7,0,14,3,30,5,1,0,6,1,-15,3,1
2,1,27,1,30,4,11,0,15,5,30,2,0,0,2,0,30,2,13,0,15,6,30,6,9,0,15,7,30,6,0,0,6,1,-15,3,1
2,2,29,0,30,10,4,0,14,5,30,8,4,0,12,0,30,3,11,0,14,0,30,1,13,0,14,2,30,9,0,0,9,1,-15,3,1
2,2,35,0,30,6,7,0,13,4,30,2,0,0,2,5,30,7,6,0,13,3,30,2,11,0,13,6,30,8,0,0,8,1,-15,3,1
2,2,43,0,30,6,8,0,14,8,30,6,0,0,6,0,30,4,10,0,14,1,30,3,11,0,14,2,30,5,0,0,5,1,-15,3,1
2,4,8,3,30,7,0,0,7,4,30,2,0,0,2,0,30,6,1,0,7,1,30,7,0,0,7,6,30,3,0,0,3,0,-27,3,0
2,2,13,9,30,7,0,0,7,0,30,4,0,0,4,2,30,6,1,0,7,10,30,6,1,0,7,0,30,3,1,0,4,1,-15,3,1
2,4,13,9,30,7,0,0,7,0,30,4,0,0,4,2,30,6,1,0,7,10,30,6,1,0,7,0,30,3,1,0,4,1,-15,3,1
2,2,19,0,30,2,11,0,13,2,30,6,2,0,8,0,30,5,8,0,13,2,30,4,9,0,13,1,30,9,0,0,9,1,-15,3,1
2,3,19,0,30,2,11,0,13,2,30,6,2,0,8,0,30,5,8,0,13,2,30,4,9,0,13,1,30,9,0,0,9,1,-15,3,1
2,4,19,0,30,2,11,0,13,2,30,6,2,0,8,0,30,5,8,0,13,2,30,4,9,0,13,1,30,9,0,0,9,1,-15,3,1
2,1,25,1,30,5,9,0,14,5,30,6,0,0,6,0,30,6,8,0,14,1,30,5,9,0,14,5,30,6,0,0,6,1,-15,3,1
2,2,25,1,30,5,9,0,14,5,30,6,0,0,6,0,30,6,8,0,14,1,30,5,9,0,14,5,30,6,0,0,6,1,-15,3,1
2,0,26,2,30,7,2,0,9,5,30,4,0,0,4,2,30,0,9,0,9,0,30,4,5,0,9,8,30,3,0,0,3,1,-15,3,1
2,4,27,1,30,4,11,0,15,3,30,2,0,0,2,0,30,3,12,0,15,0,30,6,9,0,15,4,30,6,0,0,6,1,-15,3,1
2,3,47,0,30,1,13,0,14,7,30,4,0,0,4,0,30,3,11,0,14,0,30,2,12,0,14,9,30,7,0,0,7,1,-15,3,1
2,2,4,2,30,8,0,0,8,4,30,4,0,0,4,0,30,5,3,0,8,0,30,6,2,0,8,1,30,4,0,0,4,0,-27,3,0
2,4,4,2,30,8,0,0,8,4,30,4,0,0,4,0,30,5,3,0,8,0,30,6,2,0,8,1,30,4,0,0,4,0,-27,3,0
2,4,8,1,30,7,0,0,7,4,30,2,0,0,2,0,30,4,3,0,7,0,30,5,2,0,7,4,30,3,0,0,3,0,-27,3,0
2,2,13,5,30,7,0,0,7,2,30,4,0,0,4,2,30,5,2,0,7,1,30,6,1,0,7,2,30,4,0,0,4,1,-15,3,1
2,3,13,5,30,7,0,0,7,2,30,4,0,0,4,2,30,5,2,0,7,1,30,6,1,0,7,2,30,4,0,0,4,1,-15,3,1
2,4,19,0,30,2,11,0,13,1,30,7,1,0,8,0,30,4,9,0,13,6,30,6,7,0,13,4,30,9,0,0,9,1,-15,3,1
2,4,23,3,30,6,7,0,13,3,30,6,0,0,6,7,30,13,0,0,13,0,30,4,9,0,13,1,30,5,1,0,6,1,-15,3,1
2,3,25,0,30,6,8,0,14,3,30,6,0,0,6,0,30,7,7,0,14,1,30,5,9,0,14,4,30,6,0,0,6,1,-15,3,1
2,4,25,0,30,6,8,0,14,3,30,6,0,0,6,0,30,7,7,0,14,1,30,5,9,0,14,4,30,6,0,0,6,1,-15,3,1
2,3,27,1,30,4,11,0,15,3,30,2,0,0,2,0,30,4,11,0,15,0,30,4,11,0,15,5,30,6,0,0,6,1,-15,3,1
2,4,27,1,30,4,11,0,15,3,30,2,0,0,2,0,30,4,11,0,15,0,30,4,11,0,15,5,30,6,0,0,6,1,-15,3,1
2,1,29,0,30,7,7,0,14,6,30,12,0,0,12,0,30,4,10,0,14,0,30,2,12,0,14,3,30,9,0,0,9,1,-15,3,1
2,3,29,0,30,7,7,0,14,6,30,12,0,0,12,0,30,4,10,0,14,0,30,2,12,0,14,3,30,9,0,0,9,1,-15,3,1
2,4,29,0,30,7,7,0,14,6,30,12,0,0,12,0,30,4,10,0,14,0,30,2,12,0,14,3,30,9,0,0,9,1,-15,3,1
2,3,31,1,30,7,5,0,12,4,30,8,0,0,8,8,30,9,3,0,12,0,30,3,9,0,12,1,30,3,3,0,6,1,-15,3,1
2,0,33,1,30,2,9,0,11,6,30,4,0,0,4,0,30,3,8,0,11,1,30,7,4,0,11,10,30,4,0,0,4,1,-15,3,1
2,2,35,0,30,12,1,0,13,6,30,2,0,0,2,1,30,2,11,0,13,0,30,7,6,0,13,3,30,7,1,0,8,1,-15,3,1
2,4,35,0,30,12,1,0,13,6,30,2,0,0,2,1,30,2,11,0,13,0,30,7,6,0,13,3,30,7,1,0,8,1,-15,3,1
2,1,4,1,30,7,1,0,8,5,30,4,0,0,4,0,30,2,6,0,8,1,30,8,0,0,8,2,30,4,0,0,4,0,-27,3,0
2,2,4,1,30,7,1,0,8,5,30,4,0,0,4,0,30,2,6,0,8,1,30,8,0,0,8,2,30,4,0,0,4,0,-27,3,0
2,4,8,2,30,7,0,0,7,3,30,2,0,0,2,1,30,5,2,0,7,0,30,5,2,0,7,0,30,3,0,0,3,0,-27,3,0
2,1,13,2,30,5,2,0,7,0,30,4,0,0,4,2,30,6,1,0,7,4,30,5,2,0,7,4,30,4,0,0,4,1,-15,3,1
2,3,13,2,30,5,2,0,7,0,30,4,0,0,4,2,30,6,1,0,7,4,30,5,2,0,7,4,30,4,0,0,4,1,-15,3,1
2,1,17,3,30,11,3,0,14,2,30,6,0,0,6,0,30,5,9,0,14,2,30,5,9,0,14,1,30,4,0,0,4,1,-15,3,1
2,2,17,3,30,11,3,0,14,2,30,6,0,0,6,0,30,5,9,0,14,2,30,5,9,0,14,1,30,4,0,0,4,1,-15,3,1
2,4,23,2,30,8,5,0,13,4,30,6,0,0,6,2,30,7,6,0,13,0,30,3,10,0,13,4,30,6,0,0,6,1,-15,3,1
2,4,25,0,30,7,7,0,14,4,30,6,0,0,6,0,30,8,6,0,14,1,30,5,9,0,14,4,30,4,2,0,6,1,-15,3,1
2,4,27,1,30,4,11,0,15,3,30,2,0,0,2,0,30,3,12,0,15,6,30,9,6,0,15,5,30,6,0,0,6,1,-15,3,1
2,1,33,9,30,5,6,0,11,6,30,4,0,0,4,5,30,9,2,0,11,0,30,3,8,0,11,3,30,4,0,0,4,1,-15,3,1
2,2,33,9,30,5,6,0,11,6,30,4,0,0,4,5,30,9,2,0,11,0,30,3,8,0,11,3,30,4,0,0,4,1,-15,3,1
2,3,35,0,30,7,6,0,13,4,30,2,0,0,2,1,30,2,11,0,13,0,30,5,8,0,13,8,30,8,0,0,8,1,-15,3,1
2,3,5,0,30,0,5,0,5,3,30,0,4,0,4,1,30,0,5,0,5,0,30,1,4,0,5,2,30,0,2,0,2,0,-27,3,0
2,4,5,0,30,0,5,0,5,3,30,0,4,0,4,1,30,0,5,0,5,0,30,1,4,0,5,2,30,0,2,0,2,0,-27,3,0
2,4,7,0,30,2,2,0,4,2,30,1,1,0,2,0,30,1,3,0,4,0,30,1,3,0,4,3,30,2,0,0,2,0,-27,3,0
2,4,11,0,30,4,8,0,12,0,30,3,1,0,4,0,30,10,2,0,12,5,30,6,6,0,12,3,30,4,0,0,4,1,-15,3,1
2,1,19,0,30,4,9,0,13,2,30,8,0,0,8,0,30,4,9,0,13,7,30,8,5,0,13,2,30,9,0,0,9,1,-15,3,1
2,2,19,0,30,4,9,0,13,2,30,8,0,0,8,0,30,4,9,0,13,7,30,8,5,0,13,2,30,9,0,0,9,1,-15,3,1
2,1,25,1,30,3,11,0,14,5,30,6,0,0,6,0,30,9,5,0,14,2,30,9,5,0,14,6,30,6,0,0,6,1,-15,3,1
2,3,25,1,30,3,11,0,14,5,30,6,0,0,6,0,30,9,5,0,14,2,30,9,5,0,14,6,30,6,0,0,6,1,-15,3,1
2,4,1,0,30,9,1,0,10,4,30,2,0,0,2,0,30,4,6,0,10,5,30,7,3,0,10,6,30,6,0,0,6,0,-27,3,0
2,4,2,0,30,7,3,0,10,4,30,4,0,0,4,4,30,2,8,0,10,0,30,6,4,0,10,1,30,8,0,0,8,0,-27,3,0
2,3,17,3,30,10,4,0,14,3,30,6,0,0,6,4,30,7,7,0,14,1,30,3,11,0,14,5,30,4,0,0,4,1,-15,3,1
2,4,17,3,30,10,4,0,14,3,30,6,0,0,6,4,30,7,7,0,14,1,30,3,11,0,14,5,30,4,0,0,4,1,-15,3,1
2,2,23,2,30,5,8,0,13,4,30,6,0,0,6,6,30,10,3,0,13,0,30,6,7,0,13,5,30,6,0,0,6,1,-15,3,1
2,4,23,2,30,5,8,0,13,4,30,6,0,0,6,6,30,10,3,0,13,0,30,6,7,0,13,0,30,6,0,0,6,1,-15,3,1
2,0,27,2,30,9,6,0,15,3,30,1,1,0,2,0,30,2,13,0,15,3,30,5,10,0,15,4,30,6,0,0,6,1,-15,3,1
2,4,27,2,30,9,6,0,15,3,30,1,1,0,2,0,30,2,13,0,15,3,30,5,10,0,15,0,30,6,0,0,6,1,-15,3,1
2,0,31,5,30,7,5,0,12,5,30,8,0,0,8,6,30,7,5,0,12,0,30,3,9,0,12,1,30,2,4,0,6,1,-15,3,1
2,1,31,5,30,7,5,0,12,5,30,8,0,0,8,6,30,7,5,0,12,0,30,3,9,0,12,1,30,2,4,0,6,1,-15,3,1
2,4,31,5,30,7,5,0,12,5,30,8,0,0,8,6,30,7,5,0,12,0,30,3,9,0,12,1,30,2,4,0,6,1,-15,3,1
2,3,35,0,30,8,5,0,13,5,30,2,0,0,2,1,30,2,11,0,13,4,30,2,11,0,13,9,30,8,0,0,8,1,-15,3,1
2,3,47,0,30,0,14,0,14,7,30,4,0,0,4,0,30,3,11,0,14,0,30,2,12,0,14,2,30,7,0,0,7,1,-15,3,1
2,2,13,3,30,5,2,0,7,0,30,4,0,0,4,3,30,7,0,0,7,6,30,6,1,0,7,2,30,4,0,0,4,1,-15,3,1
2,3,13,3,30,5,2,0,7,0,30,4,0,0,4,3,30,7,0,0,7,6,30,6,1,0,7,2,30,4,0,0,4,1,-15,3,1
2,4,13,3,30,5,2,0,7,0,30,4,0,0,4,3,30,7,0,0,7,6,30,6,1,0,7,2,30,4,0,0,4,1,-15,3,1
2,0,25,1,30,4,10,0,14,5,30,6,0,0,6,0,30,7,7,0,14,1,30,5,9,0,14,4,30,4,2,0,6,1,-15,3,1
2,1,25,1,30,4,10,0,14,5,30,6,0,0,6,0,30,7,7,0,14,1,30,5,9,0,14,4,30,4,2,0,6,1,-15,3,1
2,4,29,1,30,9,5,0,14,5,30,8,4,0,12,0,30,4,10,0,14,0,30,1,13,0,14,0,30,7,2,0,9,1,-15,3,1
2,1,31,3,30,6,6,0,12,4,30,8,0,0,8,3,30,10,2,0,12,0,30,3,9,0,12,0,30,5,1,0,6,1,-15,3,1
2,2,31,3,30,6,6,0,12,4,30,8,0,0,8,3,30,10,2,0,12,0,30,3,9,0,12,0,30,5,1,0,6,1,-15,3,1
2,2,43,0,30,4,10,0,14,7,30,6,0,0,6,0,30,4,10,0,14,4,30,2,12,0,14,6,30,5,0,0,5,1,-15,3,1
2,4,47,0,30,1,13,0,14,8,30,4,0,0,4,0,30,3,11,0,14,7,30,3,11,0,14,0,30,7,0,0,7,1,-15,3,1
2,3,5,1,30,2,3,0,5,3,30,4,0,0,4,0,30,1,4,0,5,0,30,2,3,0,5,3,30,2,0,0,2,0,-27,3,0
2,4,5,1,30,2,3,0,5,3,30,4,0,0,4,0,30,1,4,0,5,0,30,2,3,0,5,3,30,2,0,0,2,0,-27,3,0
2,2,8,3,30,7,0,0,7,4,30,2,0,0,2,1,30,2,5,0,7,0,30,6,1,0,7,4,30,3,0,0,3,0,-27,3,0
2,4,8,3,30,7,0,0,7,4,30,2,0,0,2,1,30,2,5,0,7,0,30,6,1,0,7,0,30,3,0,0,3,0,-27,3,0
2,2,9,0,30,7,4,0,11,3,30,6,0,0,6,2,30,7,4,0,11,5,30,3,8,0,11,3,30,4,0,0,4,0,-27,3,0
2,3,9,0,30,7,4,0,11,3,30,6,0,0,6,2,30,7,4,0,11,5,30,3,8,0,11,3,30,4,0,0,4,0,-27,3,0
2,3,11,0,30,4,8,0,12,0,30,4,0,0,4,0,30,9,3,0,12,5,30,4,8,0,12,2,30,4,0,0,4,1,-15,3,1
2,4,11,0,30,4,8,0,12,0,30,4,0,0,4,0,30,9,3,0,12,5,30,4,8,0,12,2,30,4,0,0,4,1,-15,3,1
2,2,17,3,30,7,7,0,14,2,30,6,0,0,6,0,30,7,7,0,14,1,30,7,7,0,14,1,30,4,0,0,4,1,-15,3,1
2,3,19,0,30,2,11,0,13,2,30,7,1,0,8,0,30,4,9,0,13,3,30,5,8,0,13,3,30,8,1,0,9,1,-15,3,1
2,4,19,0,30,2,11,0,13,2,30,7,1,0,8,0,30,4,9,0,13,3,30,5,8,0,13,3,30,8,1,0,9,1,-15,3,1
2,0,21,3,30,7,3,0,10,4,30,5,1,0,6,1,30,3,7,0,10,3,30,5,5,0,10,2,30,4,0,0,4,1,-15,3,1
2,2,21,3,30,7,3,0,10,4,30,5,1,0,6,1,30,3,7,0,10,3,30,5,5,0,10,2,30,4,0,0,4,1,-15,3,1
2,2,23,2,30,6,7,0,13,3,30,6,0,0,6,6,30,13,0,0,13,0,30,5,8,0,13,3,30,6,0,0,6,1,-15,3,1
2,3,25,1,30,5,9,0,14,5,30,6,0,0,6,0,30,5,9,0,14,1,30,8,6,0,14,4,30,5,1,0,6,1,-15,3,1
2,3,26,1,30,9,0,0,9,5,30,4,0,0,4,5,30,0,9,0,9,0,30,2,7,0,9,6,30,3,0,0,3,1,-15,3,1
2,0,27,1,30,3,12,0,15,3,30,2,0,0,2,0,30,5,10,0,15,0,30,3,12,0,15,2,30,6,0,0,6,1,-15,3,1
2,4,27,1,30,3,12,0,15,3,30,2,0,0,2,0,30,5,10,0,15,0,30,3,12,0,15,0,30,6,0,0,6,1,-15,3,1
2,4,4,2,30,6,2,0,8,5,30,4,0,0,4,1,30,1,7,0,8,4,30,5,3,0,8,1,30,3,1,0,4,0,-27,3,0
2,3,5,0,30,1,4,0,5,2,30,3,1,0,4,0,30,2,3,0,5,0,30,1,4,0,5,1,30,0,2,0,2,0,-27,3,0
2,4,13,2,30,6,1,0,7,0,30,4,0,0,4,3,30,7,0,0,7,6,30,5,2,0,7,4,30,4,0,0,4,1,-15,3,1
2,2,17,4,30,10,4,0,14,3,30,6,0,0,6,0,30,5,9,0,14,1,30,8,6,0,14,5,30,4,0,0,4,1,-15,3,1
2,4,19,0,30,3,10,0,13,2,30,7,1,0,8,0,30,9,4,0,13,4,30,4,9,0,13,2,30,8,1,0,9,1,-15,3,1
2,4,23,2,30,4,9,0,13,3,30,6,0,0,6,4,30,12,1,0,13,0,30,6,7,0,13,0,30,6,0,0,6,1,-15,3,1
2,0,25,2,30,2,12,0,14,4,30,6,0,0,6,0,30,6,8,0,14,1,30,5,9,0,14,6,30,5,1,0,6,1,-15,3,1
2,2,25,2,30,2,12,0,14,4,30,6,0,0,6,0,30,6,8,0,14,1,30,5,9,0,14,6,30,5,1,0,6,1,-15,3,1
2,0,27,1,30,6,9,0,15,5,30,1,1,0,2,5,30,3,12,0,15,0,30,4,11,0,15,1,30,4,2,0,6,1,-15,3,1
2,1,27,1,30,6,9,0,15,5,30,1,1,0,2,5,30,3,12,0,15,0,30,4,11,0,15,1,30,4,2,0,6,1,-15,3,1
2,2,27,1,30,6,9,0,15,5,30,1,1,0,2,5,30,3,12,0,15,0,30,4,11,0,15,1,30,4,2,0,6,1,-15,3,1
2,0,31,1,30,8,4,0,12,5,30,8,0,0,8,4,30,9,3,0,12,0,30,3,9,0,12,3,30,4,2,0,6,1,-15,3,1
2,1,31,1,30,8,4,0,12,5,30,8,0,0,8,4,30,9,3,0,12,0,30,3,9,0,12,3,30,4,2,0,6,1,-15,3,1
2,3,31,1,30,8,4,0,12,5,30,8,0,0,8,4,30,9,3,0,12,0,30,3,9,0,12,3,30,4,2,0,6,1,-15,3,1
2,2,37,1,30,6,5,0,11,7,30,8,0,0,8,0,30,2,9,0,11,6,30,5,6,0,11,10,30,6,0,0,6,1,-15,3,1
2,2,39,0,30,6,5,0,11,6,30,6,0,0,6,0,30,5,6,0,11,0,30,2,9,0,11,4,30,4,1,0,5,1,-15,3,1
2,3,39,0,30,6,5,0,11,6,30,6,0,0,6,0,30,5,6,0,11,0,30,2,9,0,11,4,30,4,1,0,5,1,-15,3,1
2,4,39,0,30,6,5,0,11,6,30,6,0,0,6,0,30,5,6,0,11,0,30,2,9,0,11,4,30,4,1,0,5,1,-15,3,1
2,4,2,0,30,8,2,0,10,3,30,3,1,0,4,3,30,3,7,0,10,1,30,5,5,0,10,1,30,3,5,0,8,0,-27,3,0
2,1,4,2,30,5,3,0,8,4,30,2,2,0,4,0,30,3,5,0,8,0,30,4,4,0,8,3,30,4,0,0,4,0,-27,3,0
2,4,5,0,30,4,1,0,5,3,30,2,2,0,4,0,30,0,5,0,5,0,30,1,4,0,5,0,30,2,0,0,2,0,-27,3,0
2,0,19,0,30,4,9,0,13,2,30,4,4,0,8,0,30,6,7,0,13,8,30,5,8,0,13,0,30,9,0,0,9,1,-15,3,1
2,2,19,0,30,4,9,0,13,2,30,4,4,0,8,0,30,6,7,0,13,8,30,5,8,0,13,0,30,9,0,0,9,1,-15,3,1
2,1,25,3,30,7,7,0,14,3,30,6,0,0,6,0,30,7,7,0,14,1,30,5,9,0,14,5,30,5,1,0,6,1,-15,3,1
2,2,25,3,30,7,7,0,14,3,30,6,0,0,6,0,30,7,7,0,14,1,30,5,9,0,14,5,30,5,1,0,6,1,-15,3,1
2,3,25,3,30,7,7,0,14,3,30,6,0,0,6,0,30,7,7,0,14,1,30,5,9,0,14,5,30,5,1,0,6,1,-15,3,1
2,4,25,3,30,7,7,0,14,3,30,6,0,0,6,0,30,7,7,0,14,1,30,5,9,0,14,5,30,5,1,0,6,1,-15,3,1
2,1,31,2,30,6,6,0,12,4,30,8,0,0,8,5,30,11,1,0,12,0,30,3,9,0,12,2,30,5,1,0,6,1,-15,3,1
2,2,31,2,30,6,6,0,12,4,30,8,0,0,8,5,30,11,1,0,12,0,30,3,9,0,12,2,30,5,1,0,6,1,-15,3,1
2,4,31,2,30,6,6,0,12,4,30,8,0,0,8,5,30,11,1,0,12,0,30,3,9,0,12,2,30,5,1,0,6,1,-15,3,1
2,2,43,0,30,6,8,0,14,7,30,6,0,0,6,0,30,4,10,0,14,1,30,2,12,0,14,6,30,5,0,0,5,1,-15,3,1
2,2,6,0,30,9,0,0,9,3,30,2,0,0,2,0,30,4,5,0,9,0,30,4,5,0,9,0,30,2,3,0,5,0,-27,3,0
2,1,13,1,30,6,1,0,7,0,30,4,0,0,4,2,30,7,0,0,7,14,30,5,2,0,7,2,30,4,0,0,4,1,-15,3,1
2,2,13,1,30,6,1,0,7,0,30,4,0,0,4,2,30,7,0,0,7,14,30,5,2,0,7,2,30,4,0,0,4,1,-15,3,1
2,4,15,0,30,4,9,0,13,1,30,5,1,0,6,0,30,3,10,0,13,1,30,6,7,0,13,2,30,7,2,0,9,1,-15,3,1
2,2,17,5,30,10,4,0,14,2,30,6,0,0,6,0,30,5,9,0,14,0,30,3,11,0,14,5,30,4,0,0,4,1,-15,3,1
2,3,17,5,30,10,4,0,14,2,30,6,0,0,6,0,30,5,9,0,14,0,30,3,11,0,14,5,30,4,0,0,4,1,-15,3,1
2,4,17,5,30,10,4,0,14,2,30,6,0,0,6,0,30,5,9,0,14,0,30,3,11,0,14,5,30,4,0,0,4,1,-15,3,1
2,3,19,0,30,3,10,0,13,2,30,8,0,0,8,0,30,5,8,0,13,0,30,4,9,0,13,0,30,8,1,0,9,1,-15,3,1
2,4,19,0,30,3,10,0,13,2,30,8,0,0,8,0,30,5,8,0,13,0,30,4,9,0,13,0,30,8,1,0,9,1,-15,3,1
2,3,21,0,30,7,3,0,10,3,30,5,1,0,6,1,30,4,6,0,10,3,30,5,5,0,10,4,30,4,0,0,4,1,-15,3,1
2,2,23,0,30,5,8,0,13,2,30,6,0,0,6,6,30,13,0,0,13,0,30,6,7,0,13,3,30,6,0,0,6,1,-15,3,1
2,2,25,3,30,3,11,0,14,6,30,6,0,0,6,0,30,7,7,0,14,3,30,7,7,0,14,7,30,6,0,0,6,1,-15,3,1
2,3,27,0,30,5,10,0,15,1,30,1,1,0,2,0,30,3,12,0,15,4,30,6,9,0,15,5,30,6,0,0,6,1,-15,3,1
2,4,27,0,30,5,10,0,15,1,30,1,1,0,2,0,30,3,12,0,15,4,30,6,9,0,15,5,30,6,0,0,6,1,-15,3,1
2,0,31,5,30,8,4,0,12,4,30,8,0,0,8,3,30,11,1,0,12,0,30,3,9,0,12,1,30,5,1,0,6,1,-15,3,1
2,3,31,5,30,8,4,0,12,4,30,8,0,0,8,3,30,11,1,0,12,0,30,3,9,0,12,1,30,5,1,0,6,1,-15,3,1
2,4,31,5,30,8,4,0,12,4,30,8,0,0,8,3,30,11,1,0,12,0,30,3,9,0,12,1,30,5,1,0,6,1,-15,3,1
2,0,47,0,30,1,13,0,14,8,30,4,0,0,4,0,30,2,12,0,14,0,30,6,8,0,14,13,30,7,0,0,7,1,-15,3,1
2,2,47,0,30,1,13,0,14,8,30,4,0,0,4,0,30,2,12,0,14,0,30,6,8,0,14,13,30,7,0,0,7,1,-15,3,1
2,2,7,0,30,2,2,0,4,2,30,2,0,0,2,0,30,2,2,0,4,0,30,1,3,0,4,1,30,2,0,0,2,0,-27,3,0
2,4,8,1,30,7,0,0,7,3,30,2,0,0,2,1,30,6,1,0,7,0,30,4,3,0,7,1,30,3,0,0,3,0,-27,3,0
2,1,11,0,30,6,6,0,12,0,30,4,0,0,4,0,30,6,6,0,12,4,30,5,7,0,12,5,30,4,0,0,4,1,-15,3,1
2,1,17,0,30,8,6,0,14,2,30,6,0,0,6,0,30,6,8,0,14,5,30,6,8,0,14,4,30,4,0,0,4,1,-15,3,1
2,2,17,0,30,8,6,0,14,2,30,6,0,0,6,0,30,6,8,0,14,5,30,6,8,0,14,4,30,4,0,0,4,1,-15,3,1
2,3,17,0,30,8,6,0,14,2,30,6,0,0,6,0,30,6,8,0,14,5,30,6,8,0,14,4,30,4,0,0,4,1,-15,3,1
2,3,19,0,30,2,11,0,13,1,30,8,0,0,8,0,30,6,7,0,13,0,30,3,10,0,13,0,30,7,2,0,9,1,-15,3,1
2,4,19,0,30,2,11,0,13,1,30,8,0,0,8,0,30,6,7,0,13,0,30,3,10,0,13,0,30,7,2,0,9,1,-15,3,1
2,0,27,1,30,3,12,0,15,3,30,1,1,0,2,0,30,6,9,0,15,2,30,5,10,0,15,6,30,6,0,0,6,1,-15,3,1
2,3,32,0,30,2,7,0,9,4,30,2,0,0,2,4,30,8,1,0,9,5,30,5,4,0,9,2,30,2,0,0,2,1,-15,3,1
2,4,32,0,30,2,7,0,9,4,30,2,0,0,2,4,30,8,1,0,9,5,30,5,4,0,9,2,30,2,0,0,2,1,-15,3,1
2,3,35,1,30,7,6,0,13,5,30,2,0,0,2,1,30,2,11,0,13,3,30,3,10,0,13,4,30,8,0,0,8,1,-15,3,1
2,4,35,1,30,7,6,0,13,5,30,2,0,0,2,1,30,2,11,0,13,3,30,3,10,0,13,4,30,8,0,0,8,1,-15,3,1
2,3,45,0,30,3,10,0,13,8,30,10,0,0,10,0,30,4,9,0,13,0,30,4,9,0,13,5,30,5,0,0,5,1,-15,3,1
2,1,13,1,30,7,0,0,7,0,30,4,0,0,4,1,30,6,1,0,7,10,30,7,0,0,7,7,30,4,0,0,4,1,-15,3,1
2,2,13,1,30,7,0,0,7,0,30,4,0,0,4,1,30,6,1,0,7,10,30,7,0,0,7,7,30,4,0,0,4,1,-15,3,1
2,2,17,2,30,10,4,0,14,2,30,6,0,0,6,1,30,6,8,0,14,1,30,4,10,0,14,4,30,4,0,0,4,1,-15,3,1
2,4,17,2,30,10,4,0,14,2,30,6,0,0,6,1,30,6,8,0,14,1,30,4,10,0,14,4,30,4,0,0,4,1,-15,3,1
2,4,23,1,30,4,9,0,13,1,30,6,0,0,6,0,30,11,2,0,13,1,30,6,7,0,13,2,30,6,0,0,6,1,-15,3,1
2,4,27,4,30,9,6,0,15,1,30,2,0,0,2,4,30,10,5,0,15,0,30,3,12,0,15,0,30,4,2,0,6,1,-15,3,1
2,3,29,0,30,4,10,0,14,6,30,11,1,0,12,0,30,4,10,0,14,0,30,1,13,0,14,3,30,9,0,0,9,1,-15,3,1
2,4,29,0,30,4,10,0,14,6,30,11,1,0,12,0,30,4,10,0,14,0,30,1,13,0,14,3,30,9,0,0,9,1,-15,3,1
2,2,39,6,30,7,4,0,11,7,30,6,0,0,6,6,30,7,4,0,11,0,30,1,10,0,11,0,30,2,3,0,5,1,-15,3,1
2,1,4,3,30,7,1,0,8,5,30,4,0,0,4,0,30,2,6,0,8,0,30,8,0,0,8,2,30,3,1,0,4,0,-27,3,0
2,2,4,3,30,7,1,0,8,5,30,4,0,0,4,0,30,2,6,0,8,0,30,8,0,0,8,2,30,3,1,0,4,0,-27,3,0
2,0,17,4,30,7,7,0,14,2,30,6,0,0,6,0,30,7,7,0,14,2,30,5,9,0,14,5,30,4,0,0,4,1,-15,3,1
2,1,17,4,30,7,7,0,14,2,30,6,0,0,6,0,30,7,7,0,14,2,30,5,9,0,14,5,30,4,0,0,4,1,-15,3,1
2,3,17,4,30,7,7,0,14,2,30,6,0,0,6,0,30,7,7,0,14,2,30,5,9,0,14,5,30,4,0,0,4,1,-15,3,1
2,4,17,4,30,7,7,0,14,2,30,6,0,0,6,0,30,7,7,0,14,2,30,5,9,0,14,5,30,4,0,0,4,1,-15,3,1
2,0,21,2,30,7,3,0,10,4,30,6,0,0,6,1,30,3,7,0,10,3,30,5,5,0,10,4,30,4,0,0,4,1,-15,3,1
2,2,21,2,30,7,3,0,10,4,30,6,0,0,6,1,30,3,7,0,10,3,30,5,5,0,10,4,30,4,0,0,4,1,-15,3,1
2,4,23,0,30,5,8,0,13,4,30,6,0,0,6,7,30,11,2,0,13,0,30,6,7,0,13,4,30,6,0,0,6,1,-15,3,1
2,1,25,2,30,5,9,0,14,2,30,6,0,0,6,0,30,9,5,0,14,1,30,5,9,0,14,3,30,5,1,0,6,1,-15,3,1
2,1,27,1,30,7,8,0,15,0,30,2,0,0,2,0,30,9,6,0,15,1,30,4,11,0,15,2,30,6,0,0,6,1,-15,3,1
2,2,27,1,30,7,8,0,15,0,30,2,0,0,2,0,30,9,6,0,15,1,30,4,11,0,15,2,30,6,0,0,6,1,-15,3,1
2,2,5,0,30,2,3,0,5,2,30,0,4,0,4,0,30,5,0,0,5,2,30,2,3,0,5,1,30,0,2,0,2,0,-27,3,0
2,3,5,0,30,2,3,0,5,2,30,0,4,0,4,0,30,5,0,0,5,2,30,2,3,0,5,1,30,0,2,0,2,0,-27,3,0
2,4,5,0,30,2,3,0,5,2,30,0,4,0,4,0,30,5,0,0,5,2,30,2,3,0,5,1,30,0,2,0,2,0,-27,3,0
2,0,19,0,30,3,10,0,13,2,30,4,4,0,8,1,30,6,7,0,13,1,30,4,9,0,13,1,30,9,0,0,9,1,-15,3,1
2,1,19,0,30,3,10,0,13,2,30,4,4,0,8,1,30,6,7,0,13,1,30,4,9,0,13,1,30,9,0,0,9,1,-15,3,1
2,2,19,0,30,3,10,0,13,2,30,4,4,0,8,1,30,6,7,0,13,1,30,4,9,0,13,1,30,9,0,0,9,1,-15,3,1
2,1,23,1,30,4,9,0,13,5,30,6,0,0,6,14,30,10,3,0,13,0,30,5,8,0,13,1,30,5,1,0,6,1,-15,3,1
2,1,25,1,30,7,7,0,14,2,30,6,0,0,6,0,30,14,0,0,14,1,30,5,9,0,14,3,30,5,1,0,6,1,-15,3,1
2,2,25,1,30,7,7,0,14,2,30,6,0,0,6,0,30,14,0,0,14,1,30,5,9,0,14,3,30,5,1,0,6,1,-15,3,1
2,3,25,1,30,7,7,0,14,2,30,6,0,0,6,0,30,14,0,0,14,1,30,5,9,0,14,3,30,5,1,0,6,1,-15,3,1
2,4,25,1,30,7,7,0,14,2,30,6,0,0,6,0,30,14,0,0,14,1,30,5,9,0,14,3,30,5,1,0,6,1,-15,3,1
2,2,31,1,30,4,8,0,12,6,30,8,0,0,8,3,30,6,6,0,12,0,30,7,5,0,12,4,30,6,0,0,6,1,-15,3,1
2,4,31,1,30,4,8,0,12,6,30,8,0,0,8,3,30,6,6,0,12,0,30,7,5,0,12,4,30,6,0,0,6,1,-15,3,1
2,4,17,3,30,7,7,0,14,2,30,6,0,0,6,0,30,7,7,0,14,4,30,6,8,0,14,5,30,4,0,0,4,1,-15,3,1
2,1,19,0,30,5,8,0,13,2,30,3,5,0,8,0,30,4,9,0,13,2,30,7,6,0,13,2,30,9,0,0,9,1,-15,3,1
2,3,19,0,30,5,8,0,13,2,30,3,5,0,8,0,30,4,9,0,13,2,30,7,6,0,13,2,30,9,0,0,9,1,-15,3,1
2,4,19,0,30,5,8,0,13,2,30,3,5,0,8,0,30,4,9,0,13,2,30,7,6,0,13,2,30,9,0,0,9,1,-15,3,1
2,4,25,2,30,10,4,0,14,1,30,6,0,0,6,0,30,7,7,0,14,1,30,5,9,0,14,4,30,5,1,0,6,1,-15,3,1
2,0,27,1,30,3,12,0,15,2,30,2,0,0,2,0,30,8,7,0,15,0,30,4,11,0,15,3,30,6,0,0,6,1,-15,3,1
2,1,27,1,30,3,12,0,15,2,30,2,0,0,2,0,30,8,7,0,15,0,30,4,11,0,15,3,30,6,0,0,6,1,-15,3,1
2,3,27,1,30,3,12,0,15,2,30,2,0,0,2,0,30,8,7,0,15,0,30,4,11,0,15,3,30,6,0,0,6,1,-15,3,1
2,4,27,1,30,3,12,0,15,2,30,2,0,0,2,0,30,8,7,0,15,0,30,4,11,0,15,3,30,6,0,0,6,1,-15,3,1
2,0,31,3,30,7,5,0,12,4,30,8,0,0,8,4,30,12,0,0,12,0,30,3,9,0,12,3,30,3,3,0,6,1,-15,3,1
2,2,31,3,30,7,5,0,12,4,30,8,0,0,8,4,30,12,0,0,12,0,30,3,9,0,12,3,30,3,3,0,6,1,-15,3,1
2,4,32,0,30,5,4,0,9,4,30,2,0,0,2,0,30,8,1,0,9,1,30,3,6,0,9,6,30,2,0,0,2,1,-15,3,1
2,3,33,1,30,2,9,0,11,5,30,4,0,0,4,1,30,9,2,0,11,0,30,3,8,0,11,5,30,4,0,0,4,1,-15,3,1
2,0,11,1,30,6,6,0,12,3,30,4,0,0,4,0,30,2,10,0,12,7,30,6,6,0,12,2,30,4,0,0,4,1,-15,3,1
2,1,11,1,30,6,6,0,12,3,30,4,0,0,4,0,30,2,10,0,12,7,30,6,6,0,12,2,30,4,0,0,4,1,-15,3,1
2,2,13,4,30,7,0,0,7,0,30,4,0,0,4,6,30,7,0,0,7,6,30,5,2,0,7,4,30,4,0,0,4,1,-15,3,1
2,3,13,4,30,7,0,0,7,0,30,4,0,0,4,6,30,7,0,0,7,6,30,5,2,0,7,4,30,4,0,0,4,1,-15,3,1
2,2,17,2,30,6,8,0,14,3,30,6,0,0,6,0,30,7,7,0,14,2,30,8,6,0,14,8,30,4,0,0,4,1,-15,3,1
2,3,17,2,30,6,8,0,14,3,30,6,0,0,6,0,30,7,7,0,14,2,30,8,6,0,14,8,30,4,0,0,4,1,-15,3,1
2,1,19,0,30,4,9,0,13,2,30,5,3,0,8,0,30,5,8,0,13,3,30,6,7,0,13,5,30,9,0,0,9,1,-15,3,1
2,2,19,0,30,4,9,0,13,2,30,5,3,0,8,0,30,5,8,0,13,3,30,6,7,0,13,5,30,9,0,0,9,1,-15,3,1
2,3,19,0,30,4,9,0,13,2,30,5,3,0,8,0,30,5,8,0,13,3,30,6,7,0,13,5,30,9,0,0,9,1,-15,3,1
2,2,25,1,30,5,9,0,14,3,30,6,0,0,6,0,30,13,1,0,14,1,30,7,7,0,14,2,30,5,1,0,6,1,-15,3,1
2,3,25,1,30,5,9,0,14,3,30,6,0,0,6,0,30,13,1,0,14,1,30,7,7,0,14,2,30,5,1,0,6,1,-15,3,1
2,2,29,1,30,6,8,0,14,6,30,10,2,0,12,0,30,4,10,0,14,0,30,2,12,0,14,2,30,9,0,0,9,1,-15,3,1
2,3,29,1,30,6,8,0,14,6,30,10,2,0,12,0,30,4,10,0,14,0,30,2,12,0,14,2,30,9,0,0,9,1,-15,3,1
2,2,31,2,30,6,6,0,12,5,30,8,0,0,8,6,30,9,3,0,12,0,30,3,9,0,12,0,30,5,1,0,6,1,-15,3,1
2,2,39,3,30,5,6,0,11,6,30,6,0,0,6,4,30,7,4,0,11,2,30,2,9,0,11,0,30,3,2,0,5,1,-15,3,1
2,1,5,0,30,1,4,0,5,2,30,4,0,0,4,0,30,2,3,0,5,0,30,1,4,0,5,0,30,0,2,0,2,0,-27,3,0
2,2,5,0,30,1,4,0,5,2,30,4,0,0,4,0,30,2,3,0,5,0,30,1,4,0,5,0,30,0,2,0,2,0,-27,3,0
2,3,5,0,30,1,4,0,5,2,30,4,0,0,4,0,30,2,3,0,5,0,30,1,4,0,5,0,30,0,2,0,2,0,-27,3,0
2,4,8,0,30,7,0,0,7,3,30,2,0,0,2,0,30,4,3,0,7,0,30,4,3,0,7,2,30,3,0,0,3,0,-27,3,0
2,1,11,1,30,4,8,0,12,0,30,4,0,0,4,2,30,7,5,0,12,5,30,5,7,0,12,3,30,4,0,0,4,1,-15,3,1
2,2,11,1,30,4,8,0,12,0,30,4,0,0,4,2,30,7,5,0,12,5,30,5,7,0,12,3,30,4,0,0,4,1,-15,3,1
2,3,11,1,30,4,8,0,12,0,30,4,0,0,4,2,30,7,5,0,12,5,30,5,7,0,12,3,30,4,0,0,4,1,-15,3,1
2,4,17,2,30,8,6,0,14,2,30,6,0,0,6,0,30,9,5,0,14,1,30,6,8,0,14,0,30,4,0,0,4,1,-15,3,1
2,4,19,0,30,4,9,0,13,2,30,4,4,0,8,0,30,6,7,0,13,3,30,6,7,0,13,1,30,8,1,0,9,1,-15,3,1
2,0,27,1,30,6,9,0,15,3,30,2,0,0,2,0,30,11,4,0,15,0,30,6,9,0,15,1,30,4,2,0,6,1,-15,3,1
2,1,27,1,30,6,9,0,15,3,30,2,0,0,2,0,30,11,4,0,15,0,30,6,9,0,15,1,30,4,2,0,6,1,-15,3,1
2,4,29,0,30,7,7,0,14,6,30,11,1,0,12,0,30,3,11,0,14,0,30,1,13,0,14,1,30,9,0,0,9,1,-15,3,1
2,2,4,2,30,6,2,0,8,4,30,4,0,0,4,0,30,1,7,0,8,0,30,5,3,0,8,6,30,4,0,0,4,0,-27,3,0
2,4,11,0,30,5,7,0,12,2,30,4,0,0,4,0,30,4,8,0,12,1,30,8,4,0,12,5,30,4,0,0,4,1,-15,3,1
2,1,13,5,30,7,0,0,7,0,30,4,0,0,4,2,30,7,0,0,7,4,30,5,2,0,7,5,30,4,0,0,4,1,-15,3,1
2,3,17,1,30,6,8,0,14,2,30,6,0,0,6,0,30,6,8,0,14,1,30,6,8,0,14,5,30,4,0,0,4,1,-15,3,1
2,3,23,1,30,5,8,0,13,3,30,6,0,0,6,6,30,12,1,0,13,0,30,6,7,0,13,2,30,6,0,0,6,1,-15,3,1
2,3,25,0,30,8,6,0,14,4,30,6,0,0,6,0,30,6,8,0,14,2,30,6,8,0,14,4,30,5,1,0,6,1,-15,3,1
2,0,27,1,30,5,10,0,15,2,30,2,0,0,2,0,30,4,11,0,15,5,30,5,10,0,15,4,30,6,0,0,6,1,-15,3,1
2,1,27,1,30,5,10,0,15,2,30,2,0,0,2,0,30,4,11,0,15,5,30,5,10,0,15,4,30,6,0,0,6,1,-15,3,1
2,2,27,1,30,5,10,0,15,2,30,2,0,0,2,0,30,4,11,0,15,5,30,5,10,0,15,4,30,6,0,0,6,1,-15,3,1
2,4,27,1,30,5,10,0,15,2,30,2,0,0,2,0,30,4,11,0,15,5,30,5,10,0,15,4,30,6,0,0,6,1,-15,3,1
2,1,41,0,30,4,8,0,12,5,30,8,0,0,8,0,30,10,2,0,12,2,30,5,7,0,12,1,30,6,1,0,7,1,-15,3,1
2,2,41,0,30,4,8,0,12,5,30,8,0,0,8,0,30,10,2,0,12,2,30,5,7,0,12,1,30,6,1,0,7,1,-15,3,1
2,4,45,0,30,8,5,0,13,10,30,10,0,0,10,2,30,1,12,0,13,0,30,4,9,0,13,2,30,5,0,0,5,1,-15,3,1
2,0,47,0,30,1,13,0,14,6,30,4,0,0,4,0,30,8,6,0,14,0,30,3,11,0,14,7,30,7,0,0,7,1,-15,3,1
2,4,13,11,30,7,0,0,7,0,30,4,0,0,4,1,30,7,0,0,7,4,30,4,3,0,7,0,30,4,0,0,4,1,-15,3,1
2,2,17,1,30,7,7,0,14,2,30,6,0,0,6,0,30,6,8,0,14,2,30,8,6,0,14,1,30,4,0,0,4,1,-15,3,1
2,3,17,1,30,7,7,0,14,2,30,6,0,0,6,0,30,6,8,0,14,2,30,8,6,0,14,1,30,4,0,0,4,1,-15,3,1
2,2,19,1,30,5,8,0,13,1,30,7,1,0,8,4,30,8,5,0,13,0,30,6,7,0,13,0,30,6,3,0,9,1,-15,3,1
2,3,19,1,30,5,8,0,13,1,30,7,1,0,8,4,30,8,5,0,13,0,30,6,7,0,13,0,30,6,3,0,9,1,-15,3,1
2,3,23,2,30,4,9,0,13,4,30,6,0,0,6,3,30,11,2,0,13,0,30,5,8,0,13,2,30,6,0,0,6,1,-15,3,1
2,4,23,2,30,4,9,0,13,4,30,6,0,0,6,3,30,11,2,0,13,0,30,5,8,0,13,2,30,6,0,0,6,1,-15,3,1
2,4,25,1,30,9,5,0,14,4,30,6,0,0,6,0,30,8,6,0,14,1,30,5,9,0,14,4,30,5,1,0,6,1,-15,3,1
2,2,27,1,30,6,9,0,15,0,30,2,0,0,2,0,30,4,11,0,15,0,30,4,11,0,15,3,30,5,1,0,6,1,-15,3,1
2,2,29,0,30,6,8,0,14,6,30,8,4,0,12,0,30,5,9,0,14,0,30,1,13,0,14,3,30,9,0,0,9,1,-15,3,1
2,3,35,1,30,7,6,0,13,5,30,2,0,0,2,1,30,2,11,0,13,5,30,4,9,0,13,7,30,8,0,0,8,1,-15,3,1
2,4,1,0,30,7,3,0,10,5,30,2,0,0,2,1,30,4,6,0,10,0,30,10,0,0,10,5,30,6,0,0,6,0,-27,3,0
2,4,7,0,30,4,0,0,4,2,30,2,0,0,2,0,30,1,3,0,4,0,30,0,4,0,4,1,30,1,1,0,2,0,-27,3,0
2,3,8,0,30,7,0,0,7,3,30,2,0,0,2,2,30,4,3,0,7,0,30,5,2,0,7,0,30,2,1,0,3,0,-27,3,0
2,4,15,0,30,5,8,0,13,1,30,6,0,0,6,0,30,3,10,0,13,1,30,4,9,0,13,3,30,9,0,0,9,1,-15,3,1
2,1,17,4,30,10,4,0,14,3,30,6,0,0,6,0,30,5,9,0,14,2,30,6,8,0,14,0,30,4,0,0,4,1,-15,3,1
2,4,17,4,30,10,4,0,14,3,30,6,0,0,6,0,30,5,9,0,14,1,30,6,8,0,14,0,30,4,0,0,4,1,-15,3,1
2,2,23,1,30,6,7,0,13,3,30,6,0,0,6,3,30,12,1,0,13,0,30,5,8,0,13,3,30,6,0,0,6,1,-15,3,1
2,4,25,1,30,8,6,0,14,5,30,6,0,0,6,0,30,7,7,0,14,0,30,5,9,0,14,4,30,5,1,0,6,1,-15,3,1
2,0,27,1,30,4,11,0,15,3,30,1,1,0,2,0,30,9,6,0,15,4,30,3,12,0,15,2,30,6,0,0,6,1,-15,3,1
2,1,27,1,30,4,11,0,15,3,30,1,1,0,2,0,30,9,6,0,15,4,30,3,12,0,15,2,30,6,0,0,6,1,-15,3,1
2,2,27,1,30,4,11,0,15,3,30,1,1,0,2,0,30,9,6,0,15,4,30,3,12,0,15,2,30,6,0,0,6,1,-15,3,1
2,2,35,0,30,5,8,0,13,2,30,2,0,0,2,1,30,13,0,0,13,3,30,2,11,0,13,3,30,8,0,0,8,1,-15,3,1
2,3,35,0,30,5,8,0,13,2,30,2,0,0,2,1,30,13,0,0,13,3,30,2,11,0,13,3,30,8,0,0,8,1,-15,3,1
2,4,35,0,30,5,8,0,13,2,30,2,0,0,2,1,30,13,0,0,13,3,30,2,11,0,13,3,30,8,0,0,8,1,-15,3,1
2,3,8,0,30,7,0,0,7,4,30,2,0,0,2,3,30,3,4,0,7,0,30,5,2,0,7,5,30,3,0,0,3,0,-27,3,0
2,4,8,0,30,7,0,0,7,4,30,2,0,0,2,3,30,3,4,0,7,0,30,5,2,0,7,5,30,3,0,0,3,0,-27,3,0
2,2,11,2,30,7,5,0,12,2,30,4,0,0,4,0,30,5,7,0,12,11,30,6,6,0,12,3,30,4,0,0,4,1,-15,3,1
2,2,13,4,30,7,0,0,7,0,30,4,0,0,4,1,30,5,2,0,7,7,30,7,0,0,7,5,30,4,0,0,4,1,-15,3,1
2,4,13,4,30,7,0,0,7,0,30,4,0,0,4,1,30,5,2,0,7,7,30,7,0,0,7,5,30,4,0,0,4,1,-15,3,1
2,4,17,5,30,8,6,0,14,3,30,6,0,0,6,0,30,6,8,0,14,2,30,4,10,0,14,4,30,4,0,0,4,1,-15,3,1
2,1,19,0,30,3,10,0,13,1,30,4,4,0,8,1,30,9,4,0,13,7,30,6,7,0,13,1,30,9,0,0,9,1,-15,3,1
2,2,19,0,30,3,10,0,13,1,30,4,4,0,8,1,30,9,4,0,13,7,30,6,7,0,13,1,30,9,0,0,9,1,-15,3,1
2,3,23,1,30,7,6,0,13,1,30,6,0,0,6,0,30,13,0,0,13,0,30,5,8,0,13,3,30,5,1,0,6,1,-15,3,1
2,3,25,1,30,4,10,0,14,4,30,6,0,0,6,0,30,9,5,0,14,1,30,6,8,0,14,2,30,5,1,0,6,1,-15,3,1
2,0,41,0,30,6,6,0,12,6,30,4,4,0,8,0,30,7,5,0,12,4,30,5,7,0,12,1,30,4,3,0,7,1,-15,3,1
2,3,4,2,30,3,5,0,8,4,30,4,0,0,4,0,30,4,4,0,8,2,30,8,0,0,8,0,30,3,1,0,4,0,-27,3,0
2,4,4,2,30,3,5,0,8,4,30,4,0,0,4,0,30,4,4,0,8,2,30,8,0,0,8,0,30,3,1,0,4,0,-27,3,0
2,1,11,1,30,5,7,0,12,1,30,4,0,0,4,2,30,8,4,0,12,5,30,7,5,0,12,3,30,4,0,0,4,1,-15,3,1
2,2,11,1,30,5,7,0,12,1,30,4,0,0,4,2,30,8,4,0,12,5,30,7,5,0,12,3,30,4,0,0,4,1,-15,3,1
2,4,15,0,30,4,9,0,13,1,30,6,0,0,6,0,30,3,10,0,13,1,30,5,8,0,13,4,30,8,1,0,9,1,-15,3,1
2,4,17,5,30,8,6,0,14,4,30,6,0,0,6,0,30,5,9,0,14,5,30,5,9,0,14,0,30,4,0,0,4,1,-15,3,1
2,2,19,4,30,4,9,0,13,0,30,8,0,0,8,2,30,9,4,0,13,0,30,5,8,0,13,0,30,5,4,0,9,1,-15,3,1
2,1,23,3,30,9,4,0,13,2,30,6,0,0,6,4,30,11,2,0,13,0,30,5,8,0,13,2,30,6,0,0,6,1,-15,3,1
2,3,23,3,30,9,4,0,13,2,30,6,0,0,6,4,30,11,2,0,13,0,30,5,8,0,13,2,30,6,0,0,6,1,-15,3,1
2,2,26,0,30,7,2,0,9,5,30,4,0,0,4,4,30,2,7,0,9,0,30,2,7,0,9,6,30,3,0,0,3,1,-15,3,1
2,3,26,0,30,7,2,0,9,5,30,4,0,0,4,4,30,2,7,0,9,0,30,2,7,0,9,6,30,3,0,0,3,1,-15,3,1
2,4,26,0,30,7,2,0,9,5,30,4,0,0,4,4,30,2,7,0,9,0,30,2,7,0,9,6,30,3,0,0,3,1,-15,3,1
2,0,27,1,30,5,10,0,15,5,30,2,0,0,2,0,30,5,10,0,15,4,30,4,11,0,15,4,30,6,0,0,6,1,-15,3,1
2,3,27,0,30,5,10,0,15,0,30,2,0,0,2,0,30,5,10,0,15,4,30,4,11,0,15,4,30,6,0,0,6,1,-15,3,1
2,0,29,0,30,7,7,0,14,6,30,10,2,0,12,0,30,6,8,0,14,0,30,2,12,0,14,0,30,9,0,0,9,1,-15,3,1
2,2,29,0,30,7,7,0,14,6,30,10,2,0,12,0,30,6,8,0,14,0,30,2,12,0,14,0,30,9,0,0,9,1,-15,3,1
2,3,29,0,30,7,7,0,14,6,30,10,2,0,12,0,30,6,8,0,14,0,30,2,12,0,14,0,30,9,0,0,9,1,-15,3,1
2,3,33,1,30,5,6,0,11,4,30,4,0,0,4,1,30,10,1,0,11,3,30,4,7,0,11,7,30,4,0,0,4,1,-15,3,1
2,1,4,2,30,7,1,0,8,4,30,4,0,0,4,0,30,5,3,0,8,0,30,5,3,0,8,2,30,4,0,0,4,0,-27,3,0
2,3,8,4,30,7,0,0,7,4,30,2,0,0,2,6,30,3,4,0,7,0,30,6,1,0,7,2,30,3,0,0,3,0,-27,3,0
2,4,8,4,30,7,0,0,7,4,30,2,0,0,2,6,30,3,4,0,7,0,30,6,1,0,7,2,30,3,0,0,3,0,-27,3,0
2,2,13,3,30,6,1,0,7,0,30,4,0,0,4,1,30,6,1,0,7,6,30,7,0,0,7,3,30,4,0,0,4,1,-15,3,1
2,4,23,2,30,5,8,0,13,3,30,6,0,0,6,4,30,13,0,0,13,0,30,6,7,0,13,3,30,5,1,0,6,1,-15,3,1
2,2,25,2,30,7,7,0,14,4,30,6,0,0,6,0,30,6,8,0,14,1,30,7,7,0,14,4,30,6,0,0,6,1,-15,3,1
2,2,27,1,30,5,10,0,15,5,30,2,0,0,2,0,30,4,11,0,15,0,30,5,10,0,15,3,30,6,0,0,6,1,-15,3,1
2,3,31,0,30,5,7,0,12,4,30,8,0,0,8,6,30,9,3,0,12,0,30,3,9,0,12,0,30,4,2,0,6,1,-15,3,1
2,4,31,0,30,5,7,0,12,4,30,8,0,0,8,6,30,9,3,0,12,0,30,3,9,0,12,0,30,4,2,0,6,1,-15,3,1
2,1,4,3,30,6,2,0,8,4,30,2,2,0,4,0,30,2,6,0,8,0,30,6,2,0,8,4,30,4,0,0,4,0,-27,3,0
2,3,4,3,30,6,2,0,8,4,30,2,2,0,4,0,30,2,6,0,8,0,30,6,2,0,8,4,30,4,0,0,4,0,-27,3,0
2,3,8,0,30,7,0,0,7,3,30,2,0,0,2,0,30,4,3,0,7,3,30,6,1,0,7,4,30,3,0,0,3,0,-27,3,0
2,4,13,4,30,6,1,0,7,0,30,4,0,0,4,2,30,6,1,0,7,6,30,5,2,0,7,0,30,4,0,0,4,1,-15,3,1
2,1,17,3,30,9,5,0,14,4,30,6,0,0,6,0,30,2,12,0,14,4,30,5,9,0,14,6,30,4,0,0,4,1,-15,3,1
2,2,17,3,30,9,5,0,14,4,30,6,0,0,6,0,30,2,12,0,14,4,30,5,9,0,14,6,30,4,0,0,4,1,-15,3,1
2,4,23,1,30,4,9,0,13,3,30,6,0,0,6,6,30,12,1,0,13,0,30,5,8,0,13,5,30,6,0,0,6,1,-15,3,1
2,2,29,0,30,6,8,0,14,6,30,10,2,0,12,0,30,3,11,0,14,0,30,1,13,0,14,1,30,9,0,0,9,1,-15,3,1
2,3,29,0,30,6,8,0,14,6,30,10,2,0,12,0,30,3,11,0,14,0,30,1,13,0,14,1,30,9,0,0,9,1,-15,3,1
2,4,29,0,30,6,8,0,14,6,30,10,2,0,12,0,30,3,11,0,14,0,30,1,13,0,14,1,30,9,0,0,9,1,-15,3,1
2,1,31,3,30,8,4,0,12,5,30,8,0,0,8,3,30,8,4,0,12,0,30,4,8,0,12,1,30,4,2,0,6,1,-15,3,1
2,0,4,2,30,6,2,0,8,5,30,4,0,0,4,0,30,2,6,0,8,0,30,6,2,0,8,4,30,4,0,0,4,0,-27,3,0
2,3,4,0,30,6,2,0,8,5,30,4,0,0,4,0,30,2,6,0,8,0,30,6,2,0,8,4,30,4,0,0,4,0,-27,3,0
2,1,13,3,30,7,0,0,7,0,30,4,0,0,4,2,30,6,1,0,7,5,30,6,1,0,7,3,30,4,0,0,4,1,-15,3,1
2,2,13,3,30,7,0,0,7,0,30,4,0,0,4,2,30,6,1,0,7,5,30,6,1,0,7,3,30,4,0,0,4,1,-15,3,1
2,4,17,1,30,7,7,0,14,0,30,6,0,0,6,0,30,9,5,0,14,7,30,6,8,0,14,4,30,4,0,0,4,1,-15,3,1
2,3,21,3,30,8,2,0,10,3,30,6,0,0,6,0,30,4,6,0,10,2,30,3,7,0,10,0,30,4,0,0,4,1,-15,3,1
2,3,23,2,30,5,8,0,13,4,30,6,0,0,6,6,30,9,4,0,13,0,30,4,9,0,13,1,30,6,0,0,6,1,-15,3,1
2,4,23,2,30,5,8,0,13,4,30,6,0,0,6,6,30,9,4,0,13,0,30,4,9,0,13,1,30,6,0,0,6,1,-15,3,1
2,4,25,1,30,6,8,0,14,4,30,6,0,0,6,0,30,9,5,0,14,2,30,6,8,0,14,0,30,5,1,0,6,1,-15,3,1
2,1,27,1,30,5,10,0,15,0,30,1,1,0,2,0,30,10,5,0,15,0,30,4,11,0,15,2,30,6,0,0,6,1,-15,3,1
2,1,29,0,30,4,10,0,14,4,30,10,2,0,12,0,30,4,10,0,14,0,30,4,10,0,14,3,30,9,0,0,9,1,-15,3,1
2,3,29,0,30,4,10,0,14,4,30,10,2,0,12,0,30,4,10,0,14,0,30,4,10,0,14,3,30,9,0,0,9,1,-15,3,1
2,2,4,4,30,8,0,0,8,4,30,4,0,0,4,0,30,6,2,0,8,0,30,4,4,0,8,0,30,4,0,0,4,0,-27,3,0
2,3,4,4,30,8,0,0,8,4,30,4,0,0,4,0,30,6,2,0,8,0,30,4,4,0,8,0,30,4,0,0,4,0,-27,3,0
2,0,5,1,30,2,3,0,5,3,30,3,1,0,4,0,30,0,5,0,5,0,30,1,4,0,5,0,30,0,2,0,2,0,-27,3,0
2,3,8,2,30,7,0,0,7,4,30,2,0,0,2,3,30,3,4,0,7,2,30,5,2,0,7,3,30,3,0,0,3,0,-27,3,0
2,2,13,1,30,7,0,0,7,0,30,4,0,0,4,1,30,6,1,0,7,10,30,7,0,0,7,6,30,4,0,0,4,1,-15,3,1
2,4,13,1,30,7,0,0,7,0,30,4,0,0,4,1,30,6,1,0,7,10,30,7,0,0,7,6,30,4,0,0,4,1,-15,3,1
2,4,15,0,30,5,8,0,13,0,30,6,0,0,6,1,30,5,8,0,13,1,30,2,11,0,13,1,30,8,1,0,9,1,-15,3,1
2,3,17,0,30,10,4,0,14,3,30,6,0,0,6,0,30,4,10,0,14,2,30,6,8,0,14,5,30,4,0,0,4,1,-15,3,1
2,4,25,1,30,4,10,0,14,5,30,6,0,0,6,0,30,8,6,0,14,0,30,6,8,0,14,4,30,5,1,0,6,1,-15,3,1
2,1,26,1,30,9,0,0,9,4,30,4,0,0,4,1,30,0,9,0,9,0,30,1,8,0,9,6,30,3,0,0,3,1,-15,3,1
2,2,26,1,30,9,0,0,9,4,30,4,0,0,4,1,30,0,9,0,9,0,30,1,8,0,9,6,30,3,0,0,3,1,-15,3,1
2,3,26,1,30,9,0,0,9,4,30,4,0,0,4,1,30,0,9,0,9,0,30,1,8,0,9,6,30,3,0,0,3,1,-15,3,1
2,4,26,1,30,9,0,0,9,4,30,4,0,0,4,1,30,0,9,0,9,0,30,1,8,0,9,6,30,3,0,0,3,1,-15,3,1
2,0,27,1,30,4,11,0,15,4,30,1,1,0,2,0,30,5,10,0,15,3,30,5,10,0,15,2,30,6,0,0,6,1,-15,3,1
2,2,27,1,30,4,11,0,15,4,30,1,1,0,2,0,30,5,10,0,15,3,30,5,10,0,15,2,30,6,0,0,6,1,-15,3,1
2,4,27,1,30,4,11,0,15,4,30,1,1,0,2,0,30,5,10,0,15,3,30,5,10,0,15,2,30,6,0,0,6,1,-15,3,1
2,2,1,0,30,7,3,0,10,4,30,2,0,0,2,1,30,3,7,0,10,1,30,5,5,0,10,5,30,6,0,0,6,0,-27,3,0
2,3,2,3,30,6,4,0,10,3,30,3,1,0,4,0,30,3,7,0,10,0,30,4,6,0,10,1,30,7,1,0,8,0,-27,3,0
2,4,2,3,30,6,4,0,10,3,30,3,1,0,4,0,30,3,7,0,10,0,30,4,6,0,10,1,30,7,1,0,8,0,-27,3,0
2,1,5,0,30,2,3,0,5,3,30,1,3,0,4,0,30,1,4,0,5,0,30,1,4,0,5,1,30,0,2,0,2,0,-27,3,0
2,1,7,0,30,3,1,0,4,2,30,2,0,0,2,0,30,1,3,0,4,0,30,1,3,0,4,2,30,2,0,0,2,0,-27,3,0
2,2,13,4,30,5,2,0,7,1,30,4,0,0,4,2,30,5,2,0,7,15,30,6,1,0,7,0,30,4,0,0,4,1,-15,3,1
2,3,15,0,30,5,8,0,13,1,30,6,0,0,6,0,30,4,9,0,13,1,30,8,5,0,13,2,30,2,7,0,9,1,-15,3,1
2,3,17,4,30,10,4,0,14,2,30,6,0,0,6,1,30,8,6,0,14,4,30,5,9,0,14,2,30,4,0,0,4,1,-15,3,1
2,4,23,2,30,6,7,0,13,4,30,6,0,0,6,8,30,11,2,0,13,0,30,3,10,0,13,2,30,6,0,0,6,1,-15,3,1
2,0,27,1,30,5,10,0,15,2,30,2,0,0,2,0,30,9,6,0,15,0,30,3,12,0,15,1,30,6,0,0,6,1,-15,3,1
2,1,27,1,30,5,10,0,15,2,30,2,0,0,2,0,30,9,6,0,15,0,30,3,12,0,15,1,30,6,0,0,6,1,-15,3,1
2,4,27,1,30,5,10,0,15,2,30,2,0,0,2,0,30,9,6,0,15,0,30,3,12,0,15,1,30,6,0,0,6,1,-15,3,1
2,2,29,0,30,3,11,0,14,5,30,12,0,0,12,0,30,2,12,0,14,0,30,1,13,0,14,5,30,7,2,0,9,1,-15,3,1
2,3,29,0,30,3,11,0,14,5,30,12,0,0,12,0,30,2,12,0,14,0,30,1,13,0,14,5,30,7,2,0,9,1,-15,3,1
2,4,29,0,30,3,11,0,14,5,30,12,0,0,12,0,30,2,12,0,14,0,30,1,13,0,14,5,30,7,2,0,9,1,-15,3,1
2,0,31,5,30,5,7,0,12,6,30,8,0,0,8,3,30,8,4,0,12,0,30,7,5,0,12,0,30,6,0,0,6,1,-15,3,1
2,4,39,0,30,4,7,0,11,7,30,6,0,0,6,0,30,5,6,0,11,2,30,4,7,0,11,0,30,5,0,0,5,1,-15,3,1
2,1,4,4,30,8,0,0,8,4,30,4,0,0,4,0,30,5,3,0,8,0,30,4,4,0,8,1,30,4,0,0,4,0,-27,3,0
2,2,4,4,30,8,0,0,8,4,30,4,0,0,4,0,30,5,3,0,8,0,30,4,4,0,8,1,30,4,0,0,4,0,-27,3,0
2,4,4,4,30,8,0,0,8,4,30,4,0,0,4,0,30,5,3,0,8,0,30,4,4,0,8,1,30,4,0,0,4,0,-27,3,0
2,0,6,0,30,6,3,0,9,4,30,2,0,0,2,0,30,2,7,0,9,0,30,4,5,0,9,1,30,4,1,0,5,0,-27,3,0
2,4,8,1,30,7,0,0,7,4,30,2,0,0,2,3,30,2,5,0,7,2,30,7,0,0,7,2,30,3,0,0,3,0,-27,3,0
2,2,17,4,30,11,3,0,14,3,30,6,0,0,6,0,30,7,7,0,14,2,30,8,6,0,14,3,30,4,0,0,4,1,-15,3,1
2,3,17,4,30,11,3,0,14,3,30,6,0,0,6,0,30,7,7,0,14,2,30,8,6,0,14,3,30,4,0,0,4,1,-15,3,1
2,3,23,1,30,6,7,0,13,1,30,6,0,0,6,3,30,12,1,0,13,2,30,6,7,0,13,3,30,6,0,0,6,1,-15,3,1
2,4,23,1,30,6,7,0,13,1,30,6,0,0,6,3,30,12,1,0,13,2,30,6,7,0,13,3,30,6,0,0,6,1,-15,3,1
2,2,25,3,30,6,8,0,14,4,30,6,0,0,6,0,30,10,4,0,14,1,30,5,9,0,14,6,30,5,1,0,6,1,-15,3,1
2,4,25,3,30,6,8,0,14,4,30,6,0,0,6,0,30,10,4,0,14,1,30,5,9,0,14,6,30,5,1,0,6,1,-15,3,1
2,0,27,1,30,3,12,0,15,4,30,1,1,0,2,0,30,9,6,0,15,0,30,6,9,0,15,4,30,6,0,0,6,1,-15,3,1
2,3,27,1,30,3,12,0,15,4,30,1,1,0,2,0,30,9,6,0,15,0,30,6,9,0,15,0,30,6,0,0,6,1,-15,3,1
2,4,27,1,30,3,12,0,15,4,30,1,1,0,2,0,30,9,6,0,15,0,30,6,9,0,15,0,30,6,0,0,6,1,-15,3,1
2,2,31,8,30,6,6,0,12,5,30,7,1,0,8,5,30,10,2,0,12,0,30,4,8,0,12,0,30,5,1,0,6,1,-15,3,1
2,4,31,8,30,6,6,0,12,5,30,7,1,0,8,5,30,10,2,0,12,0,30,4,8,0,12,0,30,5,1,0,6,1,-15,3,1
2,3,4,2,30,7,1,0,8,5,30,4,0,0,4,1,30,1,7,0,8,0,30,3,5,0,8,1,30,3,1,0,4,0,-27,3,0
2,3,8,2,30,7,0,0,7,4,30,2,0,0,2,0,30,5,2,0,7,0,30,5,2,0,7,2,30,3,0,0,3,0,-27,3,0
2,1,13,3,30,6,1,0,7,0,30,4,0,0,4,2,30,6,1,0,7,7,30,4,3,0,7,0,30,4,0,0,4,1,-15,3,1
2,2,13,3,30,6,1,0,7,0,30,4,0,0,4,2,30,6,1,0,7,7,30,4,3,0,7,0,30,4,0,0,4,1,-15,3,1
2,4,13,3,30,6,1,0,7,0,30,4,0,0,4,2,30,6,1,0,7,7,30,4,3,0,7,0,30,4,0,0,4,1,-15,3,1
2,1,17,4,30,9,5,0,14,2,30,6,0,0,6,0,30,7,7,0,14,1,30,6,8,0,14,4,30,4,0,0,4,1,-15,3,1
2,4,17,4,30,9,5,0,14,2,30,6,0,0,6,0,30,7,7,0,14,0,30,6,8,0,14,4,30,4,0,0,4,1,-15,3,1
2,3,19,0,30,6,7,0,13,1,30,4,4,0,8,0,30,4,9,0,13,0,30,3,10,0,13,1,30,9,0,0,9,1,-15,3,1
2,4,19,0,30,6,7,0,13,1,30,4,4,0,8,0,30,4,9,0,13,0,30,3,10,0,13,1,30,9,0,0,9,1,-15,3,1
2,1,25,1,30,10,4,0,14,3,30,6,0,0,6,0,30,5,9,0,14,1,30,6,8,0,14,4,30,6,0,0,6,1,-15,3,1
2,3,27,0,30,5,10,0,15,4,30,2,0,0,2,0,30,6,9,0,15,1,30,6,9,0,15,3,30,6,0,0,6,1,-15,3,1
2,4,27,0,30,5,10,0,15,4,30,2,0,0,2,0,30,6,9,0,15,1,30,6,9,0,15,3,30,6,0,0,6,1,-15,3,1
2,1,29,0,30,4,10,0,14,4,30,12,0,0,12,0,30,6,8,0,14,0,30,1,13,0,14,0,30,7,2,0,9,1,-15,3,1
2,2,29,0,30,4,10,0,14,4,30,12,0,0,12,0,30,6,8,0,14,0,30,1,13,0,14,0,30,7,2,0,9,1,-15,3,1
2,4,29,0,30,4,10,0,14,4,30,12,0,0,12,0,30,6,8,0,14,0,30,1,13,0,14,0,30,7,2,0,9,1,-15,3,1
2,3,31,4,30,8,4,0,12,4,30,8,0,0,8,0,30,10,2,0,12,0,30,3,9,0,12,0,30,4,2,0,6,1,-15,3,1
2,4,31,4,30,8,4,0,12,4,30,8,0,0,8,0,30,10,2,0,12,0,30,3,9,0,12,0,30,4,2,0,6,1,-15,3,1
2,3,35,0,30,7,6,0,13,6,30,2,0,0,2,4,30,6,7,0,13,0,30,7,6,0,13,3,30,8,0,0,8,1,-15,3,1
2,3,7,1,30,4,5,0,9,2,30,4,0,0,4,0,30,6,3,0,9,5,30,3,6,0,9,1,30,5,1,0,6,0,-27,3,0
2,4,8,3,30,7,0,0,7,4,30,2,0,0,2,3,30,5,2,0,7,0,30,6,1,0,7,0,30,2,1,0,3,0,-27,3,0
2,0,13,3,30,7,0,0,7,1,30,4,0,0,4,2,30,6,1,0,7,5,30,7,0,0,7,7,30,4,0,0,4,1,-15,3,1
2,2,13,3,30,7,0,0,7,1,30,4,0,0,4,2,30,6,1,0,7,5,30,7,0,0,7,7,30,4,0,0,4,1,-15,3,1
2,3,13,3,30,7,0,0,7,1,30,4,0,0,4,2,30,6,1,0,7,5,30,7,0,0,7,7,30,4,0,0,4,1,-15,3,1
2,4,19,0,30,2,11,0,13,1,30,6,2,0,8,0,30,11,2,0,13,1,30,6,7,0,13,0,30,8,1,0,9,1,-15,3,1
2,2,23,2,30,5,8,0,13,4,30,6,0,0,6,5,30,8,5,0,13,0,30,3,10,0,13,2,30,6,0,0,6,1,-15,3,1
2,4,23,2,30,5,8,0,13,4,30,6,0,0,6,5,30,8,5,0,13,0,30,3,10,0,13,2,30,6,0,0,6,1,-15,3,1
2,4,25,0,30,8,6,0,14,4,30,6,0,0,6,2,30,5,9,0,14,1,30,5,9,0,14,0,30,5,1,0,6,1,-15,3,1
2,3,39,2,30,3,8,0,11,6,30,6,0,0,6,0,30,7,4,0,11,0,30,2,9,0,11,1,30,5,0,0,5,1,-15,3,1
2,4,39,2,30,3,8,0,11,6,30,6,0,0,6,0,30,7,4,0,11,0,30,2,9,0,11,1,30,5,0,0,5,1,-15,3,1
2,0,41,0,30,6,6,0,12,7,30,8,0,0,8,0,30,3,9,0,12,0,30,3,9,0,12,6,30,7,0,0,7,1,-15,3,1
2,4,41,0,30,6,6,0,12,7,30,8,0,0,8,0,30,3,9,0,12,0,30,3,9,0,12,6,30,7,0,0,7,1,-15,3,1
2,4,2,6,30,8,2,0,10,3,30,2,2,0,4,0,30,3,7,0,10,0,30,1,9,0,10,1,30,8,0,0,8,0,-27,3,0
2,3,4,0,30,4,4,0,8,4,30,2,2,0,4,6,30,1,7,0,8,2,30,8,0,0,8,1,30,3,1,0,4,0,-27,3,0
2,2,5,0,30,2,3,0,5,2,30,4,0,0,4,0,30,2,3,0,5,0,30,1,4,0,5,1,30,0,2,0,2,0,-27,3,0
2,3,5,0,30,2,3,0,5,2,30,4,0,0,4,0,30,2,3,0,5,0,30,1,4,0,5,1,30,0,2,0,2,0,-27,3,0
2,3,8,3,30,7,0,0,7,5,30,2,0,0,2,0,30,2,5,0,7,0,30,6,1,0,7,5,30,3,0,0,3,0,-27,3,0
2,1,13,3,30,6,1,0,7,0,30,4,0,0,4,2,30,5,2,0,7,8,30,6,1,0,7,6,30,4,0,0,4,1,-15,3,1
2,2,13,3,30,6,1,0,7,0,30,4,0,0,4,2,30,5,2,0,7,8,30,6,1,0,7,6,30,4,0,0,4,1,-15,3,1
2,4,17,3,30,9,5,0,14,2,30,6,0,0,6,0,30,7,7,0,14,1,30,5,9,0,14,4,30,4,0,0,4,1,-15,3,1
2,2,19,0,30,3,10,0,13,2,30,8,0,0,8,0,30,4,9,0,13,0,30,4,9,0,13,1,30,9,0,0,9,1,-15,3,1
2,3,19,0,30,3,10,0,13,2,30,8,0,0,8,0,30,4,9,0,13,0,30,4,9,0,13,1,30,9,0,0,9,1,-15,3,1
2,2,25,1,30,7,7,0,14,3,30,6,0,0,6,0,30,5,9,0,14,1,30,5,9,0,14,5,30,6,0,0,6,1,-15,3,1
2,4,25,1,30,7,7,0,14,3,30,6,0,0,6,0,30,5,9,0,14,1,30,5,9,0,14,5,30,6,0,0,6,1,-15,3,1
2,0,27,3,30,4,11,0,15,4,30,1,1,0,2,4,30,5,10,0,15,0,30,8,7,0,15,1,30,4,2,0,6,1,-15,3,1
2,1,27,3,30,4,11,0,15,4,30,1,1,0,2,4,30,5,10,0,15,0,30,8,7,0,15,1,30,4,2,0,6,1,-15,3,1
2,4,29,1,30,8,6,0,14,6,30,10,2,0,12,0,30,5,9,0,14,0,30,0,14,0,14,1,30,9,0,0,9,1,-15,3,1
2,2,31,5,30,5,7,0,12,4,30,8,0,0,8,3,30,12,0,0,12,0,30,3,9,0,12,1,30,4,2,0,6,1,-15,3,1
2,4,31,5,30,5,7,0,12,4,30,8,0,0,8,3,30,12,0,0,12,0,30,3,9,0,12,1,30,4,2,0,6,1,-15,3,1
2,3,33,2,30,5,6,0,11,5,30,4,0,0,4,0,30,8,3,0,11,2,30,3,8,0,11,6,30,4,0,0,4,1,-15,3,1
2,2,35,5,30,7,6,0,13,4,30,2,0,0,2,5,30,8,5,0,13,0,30,1,12,0,13,2,30,8,0,0,8,1,-15,3,1
2,3,45,0,30,9,4,0,13,11,30,10,0,0,10,0,30,0,13,0,13,0,30,4,9,0,13,8,30,5,0,0,5,1,-15,3,1
2,0,4,2,30,6,2,0,8,5,30,4,0,0,4,0,30,1,7,0,8,0,30,6,2,0,8,2,30,4,0,0,4,0,-27,3,0
2,1,4,2,30,6,2,0,8,5,30,4,0,0,4,0,30,1,7,0,8,0,30,6,2,0,8,2,30,4,0,0,4,0,-27,3,0
2,2,11,0,30,2,2,0,4,0,30,0,0,0,0,0,30,2,2,0,4,3,30,4,0,0,4,2,30,1,0,0,1,1,-15,3,1
2,2,17,4,30,10,4,0,14,2,30,6,0,0,6,0,30,6,8,0,14,2,30,5,9,0,14,0,30,4,0,0,4,1,-15,3,1
2,3,17,4,30,10,4,0,14,2,30,6,0,0,6,0,30,6,8,0,14,2,30,5,9,0,14,0,30,4,0,0,4,1,-15,3,1
2,4,17,4,30,10,4,0,14,2,30,6,0,0,6,0,30,6,8,0,14,2,30,5,9,0,14,0,30,4,0,0,4,1,-15,3,1
2,2,19,0,30,5,8,0,13,2,30,8,0,0,8,0,30,6,7,0,13,4,30,7,6,0,13,0,30,6,3,0,9,1,-15,3,1
2,4,19,0,30,5,8,0,13,2,30,8,0,0,8,0,30,6,7,0,13,4,30,7,6,0,13,0,30,6,3,0,9,1,-15,3,1
2,4,23,1,30,6,7,0,13,1,30,6,0,0,6,7,30,12,1,0,13,0,30,6,7,0,13,2,30,6,0,0,6,1,-15,3,1
2,3,25,4,30,5,9,0,14,2,30,6,0,0,6,0,30,10,4,0,14,1,30,5,9,0,14,4,30,5,1,0,6,1,-15,3,1
2,4,25,4,30,5,9,0,14,2,30,6,0,0,6,0,30,10,4,0,14,1,30,5,9,0,14,4,30,5,1,0,6,1,-15,3,1
2,2,29,0,30,4,10,0,14,6,30,10,2,0,12,0,30,4,10,0,14,0,30,6,8,0,14,6,30,9,0,0,9,1,-15,3,1
2,3,31,3,30,4,8,0,12,5,30,8,0,0,8,3,30,8,4,0,12,0,30,7,5,0,12,0,30,6,0,0,6,1,-15,3,1
2,3,8,1,30,7,0,0,7,3,30,2,0,0,2,2,30,3,4,0,7,2,30,6,1,0,7,1,30,3,0,0,3,0,-27,3,0
2,4,8,1,30,7,0,0,7,3,30,2,0,0,2,2,30,3,4,0,7,2,30,6,1,0,7,1,30,3,0,0,3,0,-27,3,0
2,3,17,2,30,7,7,0,14,4,30,6,0,0,6,0,30,4,10,0,14,4,30,7,7,0,14,5,30,4,0,0,4,1,-15,3,1
2,4,23,1,30,8,5,0,13,2,30,6,0,0,6,0,30,12,1,0,13,0,30,4,9,0,13,5,30,6,0,0,6,1,-15,3,1
2,0,27,1,30,5,10,0,15,5,30,2,0,0,2,0,30,3,12,0,15,4,30,6,9,0,15,4,30,6,0,0,6,1,-15,3,1
2,4,27,1,30,5,10,0,15,5,30,2,0,0,2,0,30,3,12,0,15,4,30,6,9,0,15,3,30,6,0,0,6,1,-15,3,1
2,3,39,0,30,3,8,0,11,6,30,6,0,0,6,0,30,6,5,0,11,0,30,3,8,0,11,5,30,5,0,0,5,1,-15,3,1
2,4,39,0,30,3,8,0,11,6,30,6,0,0,6,0,30,6,5,0,11,0,30,3,8,0,11,5,30,5,0,0,5,1,-15,3,1
2,3,47,0,30,1,13,0,14,6,30,4,0,0,4,0,30,4,10,0,14,3,30,3,11,0,14,8,30,7,0,0,7,1,-15,3,1
2,2,19,7,30,4,9,0,13,3,30,3,5,0,8,0,30,9,4,0,13,0,30,4,9,0,13,2,30,9,0,0,9,1,-15,3,1
2,3,19,7,30,4,9,0,13,3,30,3,5,0,8,0,30,9,4,0,13,0,30,4,9,0,13,2,30,9,0,0,9,1,-15,3,1
2,4,21,0,30,4,6,0,10,3,30,6,0,0,6,1,30,5,5,0,10,0,30,3,7,0,10,2,30,4,0,0,4,1,-15,3,1
2,2,25,1,30,5,9,0,14,5,30,6,0,0,6,0,30,3,11,0,14,2,30,5,9,0,14,6,30,6,0,0,6,1,-15,3,1
2,3,25,1,30,5,9,0,14,5,30,6,0,0,6,0,30,3,11,0,14,2,30,5,9,0,14,6,30,6,0,0,6,1,-15,3,1
2,4,25,1,30,5,9,0,14,5,30,6,0,0,6,0,30,3,11,0,14,2,30,5,9,0,14,6,30,6,0,0,6,1,-15,3,1
2,1,27,2,30,8,7,0,15,4,30,1,1,0,2,0,30,5,10,0,15,0,30,5,10,0,15,2,30,6,0,0,6,1,-15,3,1
2,2,27,2,30,8,7,0,15,4,30,1,1,0,2,0,30,5,10,0,15,0,30,5,10,0,15,2,30,6,0,0,6,1,-15,3,1
2,3,27,2,30,8,7,0,15,4,30,1,1,0,2,0,30,5,10,0,15,0,30,5,10,0,15,2,30,6,0,0,6,1,-15,3,1
2,2,35,0,30,7,6,0,13,2,30,2,0,0,2,1,30,12,1,0,13,2,30,1,12,0,13,3,30,8,0,0,8,1,-15,3,1
2,3,47,0,30,0,14,0,14,5,30,4,0,0,4,0,30,3,11,0,14,0,30,2,12,0,14,3,30,7,0,0,7,1,-15,3,1
2,1,4,2,30,7,1,0,8,5,30,4,0,0,4,0,30,2,6,0,8,0,30,6,2,0,8,4,30,4,0,0,4,0,-27,3,0
2,0,5,1,30,2,3,0,5,3,30,3,1,0,4,0,30,0,5,0,5,0,30,1,4,0,5,0,30,2,0,0,2,0,-27,3,0
2,1,5,1,30,2,3,0,5,3,30,3,1,0,4,0,30,0,5,0,5,0,30,1,4,0,5,0,30,2,0,0,2,0,-27,3,0
2,3,5,1,30,2,3,0,5,3,30,3,1,0,4,0,30,0,5,0,5,0,30,1,4,0,5,0,30,2,0,0,2,0,-27,3,0
2,2,11,0,30,2,2,0,4,0,30,0,0,0,0,0,30,1,3,0,4,3,30,3,1,0,4,2,30,1,0,0,1,1,-15,3,1
2,1,11,0,30,6,6,0,12,1,30,4,0,0,4,0,30,6,6,0,12,7,30,5,7,0,12,4,30,4,0,0,4,1,-15,3,1
2,4,11,0,30,6,6,0,12,1,30,4,0,0,4,0,30,6,6,0,12,7,30,5,7,0,12,4,30,4,0,0,4,1,-15,3,1
2,2,17,5,30,8,6,0,14,3,30,6,0,0,6,0,30,6,8,0,14,1,30,6,8,0,14,1,30,2,2,0,4,1,-15,3,1
2,0,19,3,30,5,8,0,13,2,30,5,3,0,8,0,30,4,9,0,13,0,30,4,9,0,13,2,30,8,1,0,9,1,-15,3,1
2,2,19,3,30,5,8,0,13,2,30,5,3,0,8,0,30,4,9,0,13,0,30,4,9,0,13,2,30,8,1,0,9,1,-15,3,1
2,0,21,3,30,7,3,0,10,4,30,5,1,0,6,1,30,3,7,0,10,7,30,4,6,0,10,0,30,4,0,0,4,1,-15,3,1
2,1,21,3,30,7,3,0,10,4,30,5,1,0,6,1,30,3,7,0,10,7,30,4,6,0,10,0,30,4,0,0,4,1,-15,3,1
2,2,21,3,30,7,3,0,10,4,30,5,1,0,6,1,30,3,7,0,10,7,30,4,6,0,10,0,30,4,0,0,4,1,-15,3,1
2,0,26,2,30,7,2,0,9,5,30,4,0,0,4,5,30,3,6,0,9,0,30,6,3,0,9,5,30,3,0,0,3,1,-15,3,1
2,3,26,2,30,7,2,0,9,5,30,4,0,0,4,5,30,3,6,0,9,0,30,6,3,0,9,5,30,3,0,0,3,1,-15,3,1
2,3,27,1,30,3,12,0,15,4,30,2,0,0,2,0,30,5,10,0,15,3,30,4,11,0,15,0,30,6,0,0,6,1,-15,3,1
2,4,39,0,30,3,8,0,11,7,30,6,0,0,6,0,30,3,8,0,11,1,30,3,8,0,11,6,30,5,0,0,5,1,-15,3,1
2,2,6,0,30,9,0,0,9,3,30,2,0,0,2,0,30,5,4,0,9,0,30,3,6,0,9,2,30,3,2,0,5,0,-27,3,0
2,0,17,3,30,7,7,0,14,2,30,6,0,0,6,0,30,7,7,0,14,3,30,8,6,0,14,4,30,4,0,0,4,1,-15,3,1
2,1,17,3,30,7,7,0,14,2,30,6,0,0,6,0,30,7,7,0,14,3,30,8,6,0,14,4,30,4,0,0,4,1,-15,3,1
2,2,17,3,30,7,7,0,14,2,30,6,0,0,6,0,30,7,7,0,14,3,30,8,6,0,14,4,30,4,0,0,4,1,-15,3,1
2,3,17,3,30,7,7,0,14,2,30,6,0,0,6,0,30,7,7,0,14,3,30,8,6,0,14,4,30,4,0,0,4,1,-15,3,1
2,2,19,0,30,4,9,0,13,2,30,4,4,0,8,0,30,5,8,0,13,2,30,4,9,0,13,1,30,9,0,0,9,1,-15,3,1
2,3,19,0,30,4,9,0,13,2,30,4,4,0,8,0,30,5,8,0,13,2,30,4,9,0,13,1,30,9,0,0,9,1,-15,3,1
2,3,31,1,30,4,8,0,12,8,30,8,0,0,8,3,30,4,8,0,12,4,30,9,3,0,12,4,30,6,0,0,6,1,-15,3,1
2,4,11,1,30,4,8,0,12,1,30,4,0,0,4,1,30,5,7,0,12,7,30,4,8,0,12,3,30,4,0,0,4,1,-15,3,1
2,2,19,0,30,3,10,0,13,1,30,5,3,0,8,0,30,9,4,0,13,3,30,6,7,0,13,2,30,8,1,0,9,1,-15,3,1
2,3,19,0,30,3,10,0,13,1,30,5,3,0,8,0,30,9,4,0,13,3,30,6,7,0,13,2,30,8,1,0,9,1,-15,3,1
2,1,25,1,30,6,8,0,14,3,30,6,0,0,6,0,30,7,7,0,14,1,30,5,9,0,14,3,30,6,0,0,6,1,-15,3,1
2,2,25,1,30,6,8,0,14,3,30,6,0,0,6,0,30,7,7,0,14,1,30,5,9,0,14,3,30,6,0,0,6,1,-15,3,1
2,3,25,1,30,6,8,0,14,3,30,6,0,0,6,0,30,7,7,0,14,1,30,5,9,0,14,3,30,6,0,0,6,1,-15,3,1
2,0,27,1,30,5,10,0,15,3,30,1,1,0,2,0,30,6,9,0,15,1,30,7,8,0,15,3,30,6,0,0,6,1,-15,3,1
2,1,27,1,30,5,10,0,15,3,30,1,1,0,2,0,30,6,9,0,15,1,30,7,8,0,15,3,30,6,0,0,6,1,-15,3,1
2,0,29,0,30,4,10,0,14,6,30,9,3,0,12,0,30,4,10,0,14,5,30,6,8,0,14,0,30,7,2,0,9,1,-15,3,1
2,1,29,0,30,4,10,0,14,6,30,9,3,0,12,0,30,4,10,0,14,5,30,6,8,0,14,0,30,7,2,0,9,1,-15,3,1
2,0,31,5,30,9,3,0,12,3,30,8,0,0,8,4,30,12,0,0,12,0,30,4,8,0,12,0,30,1,5,0,6,1,-15,3,1
2,3,31,5,30,9,3,0,12,3,30,8,0,0,8,4,30,12,0,0,12,0,30,4,8,0,12,0,30,1,5,0,6,1,-15,3,1
2,3,1,0,30,7,3,0,10,4,30,2,0,0,2,1,30,4,6,0,10,0,30,6,4,0,10,1,30,6,0,0,6,0,-27,3,0
2,3,7,1,30,5,4,0,9,2,30,4,0,0,4,0,30,8,1,0,9,5,30,3,6,0,9,2,30,5,1,0,6,0,-27,3,0
2,3,13,6,30,7,0,0,7,1,30,4,0,0,4,2,30,5,2,0,7,5,30,1,6,0,7,4,30,4,0,0,4,1,-15,3,1
2,2,19,0,30,7,6,0,13,0,30,5,3,0,8,3,30,4,9,0,13,0,30,3,10,0,13,1,30,5,4,0,9,1,-15,3,1
2,3,19,0,30,7,6,0,13,0,30,5,3,0,8,3,30,4,9,0,13,0,30,3,10,0,13,1,30,5,4,0,9,1,-15,3,1
2,4,21,1,30,6,4,0,10,3,30,4,2,0,6,0,30,5,5,0,10,1,30,5,5,0,10,3,30,4,0,0,4,1,-15,3,1
2,1,26,0,30,9,0,0,9,4,30,4,0,0,4,6,30,2,7,0,9,0,30,1,8,0,9,5,30,3,0,0,3,1,-15,3,1
2,2,26,0,30,9,0,0,9,4,30,4,0,0,4,6,30,2,7,0,9,0,30,1,8,0,9,5,30,3,0,0,3,1,-15,3,1
2,3,27,2,30,6,9,0,15,0,30,1,1,0,2,0,30,7,8,0,15,2,30,5,10,0,15,2,30,6,0,0,6,1,-15,3,1
2,4,39,0,30,1,10,0,11,6,30,6,0,0,6,0,30,5,6,0,11,0,30,2,9,0,11,3,30,5,0,0,5,1,-15,3,1
2,2,17,2,30,8,6,0,14,3,30,6,0,0,6,0,30,3,11,0,14,1,30,4,10,0,14,3,30,4,0,0,4,1,-15,3,1
2,3,17,2,30,8,6,0,14,3,30,6,0,0,6,0,30,3,11,0,14,1,30,4,10,0,14,3,30,4,0,0,4,1,-15,3,1
2,4,17,2,30,8,6,0,14,3,30,6,0,0,6,0,30,3,11,0,14,1,30,4,10,0,14,3,30,4,0,0,4,1,-15,3,1
2,2,19,0,30,2,11,0,13,1,30,4,4,0,8,0,30,6,7,0,13,4,30,4,9,0,13,0,30,7,2,0,9,1,-15,3,1
2,3,19,0,30,2,11,0,13,1,30,4,4,0,8,0,30,6,7,0,13,4,30,4,9,0,13,0,30,7,2,0,9,1,-15,3,1
2,3,25,1,30,8,6,0,14,4,30,6,0,0,6,0,30,6,8,0,14,2,30,8,6,0,14,2,30,6,0,0,6,1,-15,3,1
2,4,25,1,30,8,6,0,14,4,30,6,0,0,6,0,30,6,8,0,14,2,30,8,6,0,14,2,30,6,0,0,6,1,-15,3,1
2,4,27,2,30,6,9,0,15,5,30,2,0,0,2,0,30,5,10,0,15,0,30,6,9,0,15,1,30,5,1,0,6,1,-15,3,1
2,2,29,0,30,5,9,0,14,5,30,12,0,0,12,0,30,5,9,0,14,0,30,1,13,0,14,1,30,9,0,0,9,1,-15,3,1
2,3,39,0,30,3,8,0,11,6,30,6,0,0,6,0,30,5,6,0,11,0,30,2,9,0,11,4,30,5,0,0,5,1,-15,3,1
2,0,5,0,30,2,3,0,5,3,30,1,3,0,4,0,30,1,4,0,5,0,30,1,4,0,5,2,30,0,2,0,2,0,-27,3,0
2,3,5,0,30,2,3,0,5,3,30,1,3,0,4,0,30,1,4,0,5,0,30,1,4,0,5,2,30,0,2,0,2,0,-27,3,0
2,3,8,2,30,7,0,0,7,4,30,2,0,0,2,3,30,3,4,0,7,1,30,7,0,0,7,3,30,3,0,0,3,0,-27,3,0
2,1,17,2,30,9,5,0,14,4,30,6,0,0,6,0,30,3,11,0,14,2,30,5,9,0,14,0,30,4,0,0,4,1,-15,3,1
2,2,17,2,30,9,5,0,14,4,30,6,0,0,6,0,30,3,11,0,14,2,30,5,9,0,14,0,30,4,0,0,4,1,-15,3,1
2,3,17,2,30,9,5,0,14,4,30,6,0,0,6,0,30,3,11,0,14,2,30,5,9,0,14,0,30,4,0,0,4,1,-15,3,1
2,4,17,2,30,9,5,0,14,4,30,6,0,0,6,0,30,3,11,0,14,2,30,5,9,0,14,0,30,4,0,0,4,1,-15,3,1
2,4,19,0,30,6,7,0,13,2,30,3,5,0,8,0,30,8,5,0,13,1,30,5,8,0,13,3,30,8,1,0,9,1,-15,3,1
2,3,23,1,30,4,9,0,13,0,30,6,0,0,6,4,30,13,0,0,13,0,30,6,7,0,13,3,30,6,0,0,6,1,-15,3,1
2,4,23,1,30,4,9,0,13,0,30,6,0,0,6,4,30,13,0,0,13,0,30,6,7,0,13,3,30,6,0,0,6,1,-15,3,1
2,1,25,4,30,8,6,0,14,6,30,6,0,0,6,0,30,3,11,0,14,1,30,4,10,0,14,6,30,6,0,0,6,1,-15,3,1
2,4,25,4,30,8,6,0,14,6,30,6,0,0,6,0,30,3,11,0,14,1,30,4,10,0,14,6,30,6,0,0,6,1,-15,3,1
2,0,27,3,30,4,11,0,15,5,30,2,0,0,2,3,30,4,11,0,15,0,30,7,8,0,15,1,30,4,2,0,6,1,-15,3,1
2,1,27,3,30,4,11,0,15,5,30,2,0,0,2,3,30,4,11,0,15,0,30,7,8,0,15,1,30,4,2,0,6,1,-15,3,1
2,3,29,1,30,8,6,0,14,5,30,11,1,0,12,0,30,5,9,0,14,0,30,2,12,0,14,0,30,8,1,0,9,1,-15,3,1
2,3,31,0,30,6,6,0,12,5,30,8,0,0,8,4,30,9,3,0,12,0,30,3,9,0,12,0,30,6,0,0,6,1,-15,3,1
2,4,31,0,30,6,6,0,12,5,30,8,0,0,8,4,30,9,3,0,12,0,30,3,9,0,12,0,30,6,0,0,6,1,-15,3,1
2,2,5,0,30,2,3,0,5,2,30,3,1,0,4,0,30,2,3,0,5,0,30,3,2,0,5,0,30,0,2,0,2,0,-27,3,0
2,4,5,0,30,2,3,0,5,2,30,3,1,0,4,0,30,2,3,0,5,0,30,3,2,0,5,0,30,0,2,0,2,0,-27,3,0
2,2,15,0,30,4,9,0,13,1,30,6,0,0,6,0,30,3,10,0,13,2,30,7,6,0,13,4,30,9,0,0,9,1,-15,3,1
2,3,17,4,30,9,5,0,14,2,30,6,0,0,6,0,30,7,7,0,14,0,30,6,8,0,14,0,30,4,0,0,4,1,-15,3,1
2,2,19,0,30,6,7,0,13,2,30,3,5,0,8,0,30,4,9,0,13,3,30,4,9,0,13,1,30,8,1,0,9,1,-15,3,1
2,3,19,0,30,6,7,0,13,2,30,3,5,0,8,0,30,4,9,0,13,3,30,4,9,0,13,1,30,8,1,0,9,1,-15,3,1
2,2,27,1,30,4,11,0,15,3,30,2,0,0,2,0,30,9,6,0,15,4,30,5,10,0,15,1,30,6,0,0,6,1,-15,3,1
2,1,29,0,30,8,6,0,14,6,30,12,0,0,12,0,30,3,11,0,14,0,30,1,13,0,14,1,30,9,0,0,9,1,-15,3,1
2,4,29,0,30,8,6,0,14,6,30,12,0,0,12,0,30,3,11,0,14,0,30,1,13,0,14,1,30,9,0,0,9,1,-15,3,1
2,3,23,1,30,5,8,0,13,1,30,6,0,0,6,4,30,13,0,0,13,0,30,7,6,0,13,2,30,5,1,0,6,1,-15,3,1
2,0,25,1,30,8,6,0,14,5,30,6,0,0,6,0,30,6,8,0,14,3,30,5,9,0,14,5,30,5,1,0,6,1,-15,3,1
2,4,25,1,30,8,6,0,14,5,30,6,0,0,6,0,30,6,8,0,14,3,30,5,9,0,14,5,30,5,1,0,6,1,-15,3,1
2,0,27,1,30,4,11,0,15,5,30,2,0,0,2,0,30,3,12,0,15,0,30,4,11,0,15,1,30,4,2,0,6,1,-15,3,1
2,4,27,1,30,4,11,0,15,5,30,2,0,0,2,0,30,3,12,0,15,0,30,4,11,0,15,0,30,4,2,0,6,1,-15,3,1
2,4,29,0,30,6,8,0,14,5,30,11,1,0,12,0,30,8,6,0,14,0,30,1,13,0,14,0,30,9,0,0,9,1,-15,3,1
2,3,8,0,30,7,0,0,7,4,30,2,0,0,2,4,30,2,5,0,7,0,30,6,1,0,7,4,30,3,0,0,3,0,-27,3,0
2,4,8,0,30,7,0,0,7,4,30,2,0,0,2,4,30,2,5,0,7,0,30,6,1,0,7,4,30,3,0,0,3,0,-27,3,0
2,1,11,3,30,9,3,0,12,1,30,4,0,0,4,0,30,5,7,0,12,4,30,4,8,0,12,4,30,4,0,0,4,1,-15,3,1
2,2,11,3,30,9,3,0,12,1,30,4,0,0,4,0,30,5,7,0,12,4,30,4,8,0,12,4,30,4,0,0,4,1,-15,3,1
2,3,11,3,30,9,3,0,12,1,30,4,0,0,4,0,30,5,7,0,12,4,30,4,8,0,12,4,30,4,0,0,4,1,-15,3,1
2,4,11,3,30,9,3,0,12,1,30,4,0,0,4,0,30,5,7,0,12,4,30,4,8,0,12,4,30,4,0,0,4,1,-15,3,1
2,0,17,2,30,9,5,0,14,3,30,6,0,0,6,0,30,3,11,0,14,1,30,7,7,0,14,4,30,4,0,0,4,1,-15,3,1
2,1,17,2,30,9,5,0,14,3,30,6,0,0,6,0,30,3,11,0,14,1,30,7,7,0,14,4,30,4,0,0,4,1,-15,3,1
2,4,25,1,30,5,9,0,14,3,30,6,0,0,6,0,30,10,4,0,14,2,30,7,7,0,14,2,30,5,1,0,6,1,-15,3,1
2,3,27,0,30,1,4,0,5,3,30,0,0,0,0,0,30,1,4,0,5,5,30,3,2,0,5,1,30,4,0,0,4,1,-15,3,1
2,1,27,1,30,5,10,0,15,3,30,2,0,0,2,2,30,4,11,0,15,0,30,10,5,0,15,1,30,5,1,0,6,1,-15,3,1
2,2,27,1,30,5,10,0,15,3,30,2,0,0,2,2,30,4,11,0,15,0,30,10,5,0,15,1,30,5,1,0,6,1,-15,3,1
2,3,29,1,30,9,5,0,14,4,30,11,1,0,12,0,30,3,11,0,14,0,30,1,13,0,14,0,30,8,1,0,9,1,-15,3,1
2,3,31,1,30,4,8,0,12,4,30,8,0,0,8,3,30,9,3,0,12,0,30,3,9,0,12,1,30,5,1,0,6,1,-15,3,1
2,4,31,1,30,4,8,0,12,4,30,8,0,0,8,3,30,9,3,0,12,0,30,3,9,0,12,1,30,5,1,0,6,1,-15,3,1
2,4,32,0,30,4,5,0,9,4,30,2,0,0,2,1,30,7,2,0,9,1,30,3,6,0,9,4,30,2,0,0,2,1,-15,3,1
2,1,33,1,30,2,9,0,11,5,30,4,0,0,4,3,30,9,2,0,11,2,30,3,8,0,11,2,30,4,0,0,4,1,-15,3,1
2,2,33,1,30,2,9,0,11,5,30,4,0,0,4,3,30,9,2,0,11,2,30,3,8,0,11,2,30,4,0,0,4,1,-15,3,1
2,3,35,0,30,13,0,0,13,6,30,2,0,0,2,5,30,2,11,0,13,0,30,1,12,0,13,5,30,8,0,0,8,1,-15,3,1
2,4,9,0,30,2,2,0,4,2,30,2,0,0,2,0,30,0,4,0,4,0,30,1,3,0,4,2,30,0,1,0,1,0,-27,3,0
2,2,11,0,30,1,3,0,4,0,30,0,0,0,0,0,30,2,2,0,4,4,30,2,2,0,4,2,30,1,0,0,1,1,-15,3,1
2,2,11,1,30,4,8,0,12,1,30,4,0,0,4,0,30,7,5,0,12,2,30,8,4,0,12,5,30,4,0,0,4,1,-15,3,1
2,4,11,1,30,4,8,0,12,1,30,4,0,0,4,0,30,7,5,0,12,2,30,8,4,0,12,5,30,4,0,0,4,1,-15,3,1
2,1,13,4,30,6,1,0,7,1,30,4,0,0,4,2,30,5,2,0,7,11,30,5,2,0,7,4,30,4,0,0,4,1,-15,3,1
2,1,17,3,30,9,5,0,14,3,30,6,0,0,6,0,30,6,8,0,14,1,30,7,7,0,14,2,30,4,0,0,4,1,-15,3,1
2,2,17,3,30,9,5,0,14,3,30,6,0,0,6,0,30,6,8,0,14,1,30,7,7,0,14,2,30,4,0,0,4,1,-15,3,1
2,4,17,3,30,9,5,0,14,3,30,6,0,0,6,0,30,6,8,0,14,1,30,7,7,0,14,2,30,4,0,0,4,1,-15,3,1
2,2,19,0,30,4,9,0,13,1,30,8,0,0,8,0,30,7,6,0,13,0,30,3,10,0,13,0,30,7,2,0,9,1,-15,3,1
2,4,21,2,30,6,4,0,10,3,30,4,2,0,6,6,30,6,4,0,10,1,30,5,5,0,10,3,30,4,0,0,4,1,-15,3,1
2,2,23,1,30,5,8,0,13,3,30,6,0,0,6,5,30,11,2,0,13,0,30,4,9,0,13,1,30,6,0,0,6,1,-15,3,1
2,3,23,1,30,5,8,0,13,3,30,6,0,0,6,5,30,11,2,0,13,0,30,4,9,0,13,1,30,6,0,0,6,1,-15,3,1
2,4,25,1,30,7,7,0,14,4,30,6,0,0,6,0,30,4,10,0,14,1,30,5,9,0,14,6,30,5,1,0,6,1,-15,3,1
2,2,27,1,30,4,11,0,15,3,30,2,0,0,2,0,30,6,9,0,15,0,30,9,6,0,15,4,30,4,2,0,6,1,-15,3,1
2,4,27,1,30,4,11,0,15,3,30,2,0,0,2,0,30,6,9,0,15,0,30,9,6,0,15,4,30,4,2,0,6,1,-15,3,1
2,3,29,1,30,7,7,0,14,6,30,9,3,0,12,0,30,2,12,0,14,0,30,1,13,0,14,1,30,9,0,0,9,1,-15,3,1
2,3,31,1,30,6,6,0,12,3,30,8,0,0,8,3,30,10,2,0,12,0,30,3,9,0,12,4,30,3,3,0,6,1,-15,3,1
2,1,37,1,30,7,4,0,11,6,30,8,0,0,8,0,30,4,7,0,11,4,30,5,6,0,11,9,30,6,0,0,6,1,-15,3,1
2,4,13,2,30,6,1,0,7,0,30,4,0,0,4,3,30,6,1,0,7,7,30,5,2,0,7,3,30,4,0,0,4,1,-15,3,1
2,2,17,3,30,8,6,0,14,3,30,6,0,0,6,0,30,4,10,0,14,2,30,5,9,0,14,6,30,4,0,0,4,1,-15,3,1
2,2,31,3,30,9,3,0,12,3,30,8,0,0,8,4,30,11,1,0,12,0,30,3,9,0,12,0,30,2,4,0,6,1,-15,3,1
2,0,4,3,30,7,1,0,8,4,30,4,0,0,4,0,30,2,6,0,8,0,30,4,4,0,8,2,30,3,1,0,4,0,-27,3,0
2,1,4,3,30,7,1,0,8,4,30,4,0,0,4,0,30,2,6,0,8,0,30,4,4,0,8,2,30,3,1,0,4,0,-27,3,0
2,2,4,3,30,7,1,0,8,4,30,4,0,0,4,0,30,2,6,0,8,0,30,4,4,0,8,2,30,3,1,0,4,0,-27,3,0
2,3,8,5,30,7,0,0,7,5,30,2,0,0,2,0,30,1,6,0,7,0,30,7,0,0,7,0,30,3,0,0,3,0,-27,3,0
2,4,13,0,30,5,2,0,7,0,30,4,0,0,4,2,30,7,0,0,7,8,30,7,0,0,7,6,30,4,0,0,4,1,-15,3,1
2,4,27,1,30,11,4,0,15,4,30,2,0,0,2,0,30,4,11,0,15,0,30,3,12,0,15,0,30,6,0,0,6,1,-15,3,1
2,1,4,2,30,8,0,0,8,4,30,4,0,0,4,1,30,5,3,0,8,0,30,4,4,0,8,2,30,3,1,0,4,0,-27,3,0
2,2,4,2,30,8,0,0,8,4,30,4,0,0,4,1,30,5,3,0,8,0,30,4,4,0,8,2,30,3,1,0,4,0,-27,3,0
2,1,13,1,30,5,2,0,7,0,30,4,0,0,4,2,30,7,0,0,7,6,30,5,2,0,7,3,30,4,0,0,4,1,-15,3,1
2,4,17,3,30,9,5,0,14,3,30,6,0,0,6,0,30,3,11,0,14,2,30,6,8,0,14,2,30,4,0,0,4,1,-15,3,1
2,4,25,2,30,6,8,0,14,2,30,6,0,0,6,0,30,11,3,0,14,1,30,5,9,0,14,1,30,5,1,0,6,1,-15,3,1
2,3,27,1,30,4,11,0,15,2,30,2,0,0,2,0,30,4,11,0,15,2,30,6,9,0,15,4,30,6,0,0,6,1,-15,3,1
2,4,8,1,30,7,0,0,7,4,30,2,0,0,2,0,30,5,2,0,7,1,30,7,0,0,7,1,30,3,0,0,3,0,-27,3,0
2,2,13,0,30,7,0,0,7,0,30,4,0,0,4,2,30,7,0,0,7,10,30,6,1,0,7,5,30,4,0,0,4,1,-15,3,1
2,1,17,2,30,9,5,0,14,2,30,6,0,0,6,0,30,6,8,0,14,4,30,6,8,0,14,3,30,4,0,0,4,1,-15,3,1
2,3,17,2,30,9,5,0,14,2,30,6,0,0,6,0,30,6,8,0,14,4,30,6,8,0,14,3,30,4,0,0,4,1,-15,3,1
2,2,19,0,30,4,9,0,13,1,30,8,0,0,8,0,30,6,7,0,13,4,30,4,9,0,13,0,30,7,2,0,9,1,-15,3,1
2,3,19,0,30,4,9,0,13,1,30,8,0,0,8,0,30,6,7,0,13,4,30,4,9,0,13,0,30,7,2,0,9,1,-15,3,1
2,4,19,0,30,4,9,0,13,1,30,8,0,0,8,0,30,6,7,0,13,4,30,4,9,0,13,0,30,7,2,0,9,1,-15,3,1
2,3,22,1,30,7,1,0,8,3,30,2,0,0,2,4,30,4,4,0,8,1,30,4,4,0,8,1,30,1,3,0,4,1,-15,3,1
2,1,25,0,30,5,9,0,14,3,30,6,0,0,6,0,30,3,11,0,14,1,30,9,5,0,14,7,30,5,1,0,6,1,-15,3,1
2,4,27,1,30,5,10,0,15,2,30,2,0,0,2,0,30,7,8,0,15,0,30,4,11,0,15,0,30,6,0,0,6,1,-15,3,1
2,2,29,0,30,7,7,0,14,5,30,10,2,0,12,0,30,4,10,0,14,0,30,1,13,0,14,1,30,9,0,0,9,1,-15,3,1
2,3,29,0,30,7,7,0,14,5,30,10,2,0,12,0,30,4,10,0,14,0,30,1,13,0,14,1,30,9,0,0,9,1,-15,3,1
2,2,31,2,30,7,5,0,12,4,30,8,0,0,8,3,30,10,2,0,12,0,30,3,9,0,12,0,30,5,1,0,6,1,-15,3,1
2,2,5,0,30,2,3,0,5,2,30,3,1,0,4,0,30,1,4,0,5,0,30,2,3,0,5,0,30,0,2,0,2,0,-27,3,0
2,2,13,4,30,7,0,0,7,0,30,4,0,0,4,2,30,5,2,0,7,8,30,6,1,0,7,4,30,4,0,0,4,1,-15,3,1
2,3,15,0,30,4,9,0,13,0,30,6,0,0,6,0,30,6,7,0,13,1,30,5,8,0,13,2,30,8,1,0,9,1,-15,3,1
2,4,15,0,30,4,9,0,13,0,30,6,0,0,6,0,30,6,7,0,13,1,30,5,8,0,13,2,30,8,1,0,9,1,-15,3,1
2,1,17,3,30,10,4,0,14,3,30,6,0,0,6,0,30,5,9,0,14,1,30,7,7,0,14,8,30,4,0,0,4,1,-15,3,1
2,3,17,3,30,10,4,0,14,3,30,6,0,0,6,0,30,5,9,0,14,1,30,7,7,0,14,8,30,4,0,0,4,1,-15,3,1
2,1,19,0,30,4,9,0,13,2,30,3,5,0,8,0,30,4,9,0,13,2,30,7,6,0,13,2,30,9,0,0,9,1,-15,3,1
2,2,19,0,30,4,9,0,13,2,30,3,5,0,8,0,30,4,9,0,13,2,30,7,6,0,13,2,30,9,0,0,9,1,-15,3,1
2,4,19,0,30,4,9,0,13,2,30,3,5,0,8,0,30,4,9,0,13,2,30,7,6,0,13,2,30,9,0,0,9,1,-15,3,1
2,3,21,4,30,8,2,0,10,4,30,5,1,0,6,1,30,3,7,0,10,2,30,4,6,0,10,1,30,4,0,0,4,1,-15,3,1
2,4,25,2,30,6,8,0,14,2,30,6,0,0,6,2,30,9,5,0,14,1,30,5,9,0,14,3,30,6,0,0,6,1,-15,3,1
2,0,27,1,30,4,11,0,15,3,30,1,1,0,2,0,30,7,8,0,15,0,30,4,11,0,15,4,30,6,0,0,6,1,-15,3,1
2,1,29,0,30,5,9,0,14,6,30,10,2,0,12,0,30,3,11,0,14,0,30,4,10,0,14,6,30,9,0,0,9,1,-15,3,1
2,2,33,5,30,6,5,0,11,4,30,4,0,0,4,0,30,10,1,0,11,0,30,3,8,0,11,5,30,4,0,0,4,1,-15,3,1
2,3,33,5,30,6,5,0,11,4,30,4,0,0,4,0,30,10,1,0,11,0,30,3,8,0,11,5,30,4,0,0,4,1,-15,3,1
2,4,33,5,30,6,5,0,11,4,30,4,0,0,4,0,30,10,1,0,11,0,30,3,8,0,11,5,30,4,0,0,4,1,-15,3,1
2,2,35,1,30,7,6,0,13,7,30,2,0,0,2,1,30,2,11,0,13,0,30,3,10,0,13,2,30,8,0,0,8,1,-15,3,1
2,4,35,1,30,7,6,0,13,7,30,2,0,0,2,1,30,2,11,0,13,0,30,3,10,0,13,2,30,8,0,0,8,1,-15,3,1
2,2,39,0,30,2,9,0,11,5,30,6,0,0,6,0,30,9,2,0,11,0,30,4,7,0,11,4,30,5,0,0,5,1,-15,3,1
2,4,1,0,30,7,3,0,10,4,30,2,0,0,2,0,30,4,6,0,10,10,30,8,2,0,10,6,30,6,0,0,6,0,-27,3,0
2,2,4,2,30,8,0,0,8,4,30,4,0,0,4,0,30,5,3,0,8,0,30,4,4,0,8,2,30,4,0,0,4,0,-27,3,0
2,3,4,2,30,8,0,0,8,4,30,4,0,0,4,0,30,5,3,0,8,0,30,4,4,0,8,2,30,4,0,0,4,0,-27,3,0
2,2,9,3,30,4,0,0,4,3,30,2,0,0,2,0,30,0,4,0,4,0,30,1,3,0,4,5,30,1,0,0,1,0,-27,3,0
2,3,19,0,30,4,9,0,13,2,30,4,4,0,8,0,30,7,6,0,13,5,30,5,8,0,13,4,30,9,0,0,9,1,-15,3,1
2,4,23,1,30,7,6,0,13,1,30,6,0,0,6,7,30,13,0,0,13,0,30,5,8,0,13,3,30,6,0,0,6,1,-15,3,1
2,0,25,1,30,4,10,0,14,3,30,6,0,0,6,0,30,10,4,0,14,1,30,6,8,0,14,4,30,6,0,0,6,1,-15,3,1
2,0,27,1,30,4,11,0,15,5,30,2,0,0,2,0,30,2,13,0,15,2,30,6,9,0,15,5,30,6,0,0,6,1,-15,3,1
2,4,27,0,30,4,11,0,15,5,30,2,0,0,2,0,30,2,13,0,15,2,30,6,9,0,15,5,30,6,0,0,6,1,-15,3,1
2,0,29,0,30,7,7,0,14,4,30,11,1,0,12,0,30,6,8,0,14,0,30,1,13,0,14,2,30,9,0,0,9,1,-15,3,1
2,1,29,0,30,7,7,0,14,4,30,11,1,0,12,0,30,6,8,0,14,0,30,1,13,0,14,2,30,9,0,0,9,1,-15,3,1
2,2,29,0,30,7,7,0,14,4,30,11,1,0,12,0,30,6,8,0,14,0,30,1,13,0,14,2,30,9,0,0,9,1,-15,3,1
2,3,45,0,30,5,8,0,13,9,30,10,0,0,10,0,30,0,13,0,13,0,30,4,9,0,13,8,30,5,0,0,5,1,-15,3,1
2,2,17,3,30,9,5,0,14,2,30,6,0,0,6,0,30,6,8,0,14,1,30,6,8,0,14,3,30,4,0,0,4,1,-15,3,1
2,1,21,2,30,10,0,0,10,2,30,4,2,0,6,2,30,8,2,0,10,2,30,4,6,0,10,1,30,4,0,0,4,1,-15,3,1
2,3,21,2,30,10,0,0,10,2,30,4,2,0,6,0,30,8,2,0,10,2,30,4,6,0,10,1,30,4,0,0,4,1,-15,3,1
2,3,23,1,30,5,8,0,13,3,30,6,0,0,6,6,30,9,4,0,13,0,30,5,8,0,13,0,30,6,0,0,6,1,-15,3,1
2,4,25,1,30,7,7,0,14,3,30,6,0,0,6,0,30,11,3,0,14,1,30,5,9,0,14,4,30,5,1,0,6,1,-15,3,1
2,2,27,1,30,3,12,0,15,0,30,1,1,0,2,0,30,6,9,0,15,5,30,4,11,0,15,4,30,6,0,0,6,1,-15,3,1
2,1,33,3,30,6,5,0,11,6,30,4,0,0,4,3,30,7,4,0,11,2,30,5,6,0,11,5,30,4,0,0,4,1,-15,3,1
2,2,4,4,30,8,0,0,8,5,30,4,0,0,4,1,30,1,7,0,8,0,30,7,1,0,8,1,30,3,1,0,4,0,-27,3,0
2,2,6,2,30,8,1,0,9,3,30,2,0,0,2,0,30,4,5,0,9,0,30,3,6,0,9,1,30,4,1,0,5,0,-27,3,0
2,3,6,2,30,8,1,0,9,3,30,2,0,0,2,0,30,4,5,0,9,0,30,3,6,0,9,1,30,4,1,0,5,0,-27,3,0
2,2,13,3,30,6,1,0,7,1,30,4,0,0,4,2,30,6,1,0,7,3,30,4,3,0,7,3,30,4,0,0,4,1,-15,3,1
2,4,13,3,30,6,1,0,7,1,30,4,0,0,4,2,30,6,1,0,7,3,30,4,3,0,7,3,30,4,0,0,4,1,-15,3,1
2,1,19,0,30,3,10,0,13,3,30,8,0,0,8,4,30,7,6,0,13,2,30,3,10,0,13,2,30,8,1,0,9,1,-15,3,1
2,2,19,0,30,3,10,0,13,3,30,8,0,0,8,4,30,7,6,0,13,2,30,3,10,0,13,2,30,8,1,0,9,1,-15,3,1
2,3,19,0,30,3,10,0,13,3,30,8,0,0,8,4,30,7,6,0,13,2,30,3,10,0,13,2,30,8,1,0,9,1,-15,3,1
2,0,21,2,30,5,5,0,10,4,30,5,1,0,6,1,30,3,7,0,10,4,30,5,5,0,10,3,30,4,0,0,4,1,-15,3,1
2,1,21,2,30,5,5,0,10,4,30,5,1,0,6,1,30,3,7,0,10,4,30,5,5,0,10,3,30,4,0,0,4,1,-15,3,1
2,2,25,1,30,3,11,0,14,4,30,6,0,0,6,0,30,10,4,0,14,1,30,6,8,0,14,4,30,6,0,0,6,1,-15,3,1
2,4,25,1,30,3,11,0,14,4,30,6,0,0,6,0,30,10,4,0,14,1,30,6,8,0,14,4,30,6,0,0,6,1,-15,3,1
2,3,33,4,30,5,6,0,11,4,30,4,0,0,4,1,30,11,0,0,11,0,30,3,8,0,11,4,30,4,0,0,4,1,-15,3,1
2,4,33,4,30,5,6,0,11,4,30,4,0,0,4,1,30,11,0,0,11,0,30,3,8,0,11,4,30,4,0,0,4,1,-15,3,1
2,0,35,1,30,7,6,0,13,5,30,1,1,0,2,8,30,4,9,0,13,0,30,5,8,0,13,5,30,8,0,0,8,1,-15,3,1
2,1,35,1,30,7,6,0,13,5,30,1,1,0,2,8,30,4,9,0,13,0,30,5,8,0,13,5,30,8,0,0,8,1,-15,3,1
2,3,39,1,30,6,5,0,11,7,30,6,0,0,6,0,30,6,5,0,11,2,30,3,8,0,11,1,30,5,0,0,5,1,-15,3,1
2,4,39,1,30,6,5,0,11,7,30,6,0,0,6,0,30,6,5,0,11,2,30,3,8,0,11,1,30,5,0,0,5,1,-15,3,1
2,3,4,2,30,7,1,0,8,5,30,4,0,0,4,0,30,1,7,0,8,0,30,7,1,0,8,2,30,3,1,0,4,0,-27,3,0
2,1,13,2,30,5,2,0,7,0,30,4,0,0,4,2,30,5,2,0,7,6,30,7,0,0,7,7,30,4,0,0,4,1,-15,3,1
2,3,13,2,30,5,2,0,7,0,30,4,0,0,4,2,30,5,2,0,7,6,30,7,0,0,7,7,30,4,0,0,4,1,-15,3,1
2,3,17,5,30,9,5,0,14,4,30,6,0,0,6,0,30,5,9,0,14,1,30,7,7,0,14,2,30,4,0,0,4,1,-15,3,1
2,4,19,0,30,4,9,0,13,1,30,8,0,0,8,0,30,7,6,0,13,4,30,4,9,0,13,1,30,7,2,0,9,1,-15,3,1
2,1,23,2,30,5,8,0,13,0,30,6,0,0,6,4,30,12,1,0,13,4,30,6,7,0,13,1,30,6,0,0,6,1,-15,3,1
2,4,23,2,30,5,8,0,13,0,30,6,0,0,6,4,30,12,1,0,13,4,30,6,7,0,13,1,30,6,0,0,6,1,-15,3,1
2,4,27,0,30,4,11,0,15,4,30,2,0,0,2,0,30,7,8,0,15,1,30,6,9,0,15,3,30,6,0,0,6,1,-15,3,1
2,2,4,2,30,7,1,0,8,5,30,4,0,0,4,0,30,1,7,0,8,0,30,7,1,0,8,3,30,4,0,0,4,0,-27,3,0
2,1,13,1,30,4,3,0,7,0,30,4,0,0,4,5,30,5,2,0,7,10,30,6,1,0,7,3,30,4,0,0,4,1,-15,3,1
2,2,13,1,30,4,3,0,7,0,30,4,0,0,4,5,30,5,2,0,7,10,30,6,1,0,7,3,30,4,0,0,4,1,-15,3,1
2,3,15,0,30,4,9,0,13,1,30,4,2,0,6,0,30,3,10,0,13,1,30,6,7,0,13,3,30,9,0,0,9,1,-15,3,1
2,1,17,4,30,9,5,0,14,3,30,6,0,0,6,0,30,4,10,0,14,0,30,5,9,0,14,7,30,4,0,0,4,1,-15,3,1
2,3,17,4,30,9,5,0,14,3,30,6,0,0,6,0,30,4,10,0,14,0,30,5,9,0,14,7,30,4,0,0,4,1,-15,3,1
2,4,19,0,30,2,11,0,13,3,30,7,1,0,8,0,30,5,8,0,13,5,30,7,6,0,13,1,30,9,0,0,9,1,-15,3,1
2,4,23,1,30,3,10,0,13,2,30,6,0,0,6,4,30,8,5,0,13,4,30,6,7,0,13,2,30,6,0,0,6,1,-15,3,1
2,2,25,0,30,10,4,0,14,1,30,6,0,0,6,0,30,10,4,0,14,1,30,5,9,0,14,5,30,4,2,0,6,1,-15,3,1
2,3,25,0,30,10,4,0,14,1,30,6,0,0,6,0,30,10,4,0,14,1,30,5,9,0,14,5,30,4,2,0,6,1,-15,3,1
2,2,27,1,30,6,9,0,15,3,30,1,1,0,2,0,30,5,10,0,15,0,30,4,11,0,15,5,30,6,0,0,6,1,-15,3,1
2,4,27,0,30,6,9,0,15,3,30,1,1,0,2,0,30,5,10,0,15,0,30,4,11,0,15,5,30,6,0,0,6,1,-15,3,1
2,1,29,0,30,4,10,0,14,5,30,10,2,0,12,0,30,4,10,0,14,0,30,1,13,0,14,0,30,7,2,0,9,1,-15,3,1
2,3,29,0,30,4,10,0,14,5,30,10,2,0,12,0,30,4,10,0,14,0,30,1,13,0,14,0,30,7,2,0,9,1,-15,3,1
2,4,29,0,30,4,10,0,14,5,30,10,2,0,12,0,30,4,10,0,14,0,30,1,13,0,14,0,30,7,2,0,9,1,-15,3,1
2,2,31,6,30,7,5,0,12,4,30,8,0,0,8,6,30,11,1,0,12,0,30,3,9,0,12,0,30,1,5,0,6,1,-15,3,1
2,3,32,0,30,8,1,0,9,4,30,2,0,0,2,0,30,8,1,0,9,1,30,2,7,0,9,3,30,2,0,0,2,1,-15,3,1
2,4,32,0,30,8,1,0,9,4,30,2,0,0,2,0,30,8,1,0,9,1,30,2,7,0,9,3,30,2,0,0,2,1,-15,3,1
2,3,39,0,30,5,6,0,11,6,30,6,0,0,6,0,30,7,4,0,11,1,30,2,9,0,11,5,30,5,0,0,5,1,-15,3,1
2,4,39,0,30,5,6,0,11,6,30,6,0,0,6,0,30,7,4,0,11,1,30,2,9,0,11,5,30,5,0,0,5,1,-15,3,1
2,4,4,2,30,6,2,0,8,5,30,4,0,0,4,0,30,1,7,0,8,1,30,6,2,0,8,1,30,3,1,0,4,0,-27,3,0
2,3,7,1,30,5,4,0,9,3,30,4,0,0,4,0,30,5,4,0,9,5,30,3,6,0,9,1,30,6,0,0,6,0,-27,3,0
2,4,7,1,30,5,4,0,9,3,30,4,0,0,4,0,30,5,4,0,9,5,30,3,6,0,9,1,30,6,0,0,6,0,-27,3,0
2,3,9,0,30,2,2,0,4,2,30,2,0,0,2,0,30,3,1,0,4,2,30,1,3,0,4,0,30,0,1,0,1,0,-27,3,0
2,4,9,0,30,6,5,0,11,2,30,6,0,0,6,0,30,10,1,0,11,5,30,5,6,0,11,1,30,1,3,0,4,0,-27,3,0
2,2,13,1,30,5,2,0,7,0,30,4,0,0,4,2,30,7,0,0,7,11,30,6,1,0,7,3,30,4,0,0,4,1,-15,3,1
2,4,13,1,30,5,2,0,7,0,30,4,0,0,4,2,30,7,0,0,7,11,30,6,1,0,7,3,30,4,0,0,4,1,-15,3,1
2,3,15,0,30,6,7,0,13,0,30,5,1,0,6,0,30,3,10,0,13,1,30,4,9,0,13,3,30,9,0,0,9,1,-15,3,1
2,2,19,0,30,3,10,0,13,1,30,5,3,0,8,0,30,8,5,0,13,2,30,6,7,0,13,1,30,8,1,0,9,1,-15,3,1
2,4,19,0,30,3,10,0,13,1,30,5,3,0,8,0,30,8,5,0,13,2,30,6,7,0,13,1,30,8,1,0,9,1,-15,3,1
2,4,23,1,30,5,8,0,13,2,30,6,0,0,6,7,30,11,2,0,13,0,30,4,9,0,13,2,30,6,0,0,6,1,-15,3,1
2,3,25,1,30,8,6,0,14,1,30,6,0,0,6,0,30,10,4,0,14,1,30,5,9,0,14,3,30,5,1,0,6,1,-15,3,1
2,2,27,1,30,5,10,0,15,4,30,2,0,0,2,0,30,6,9,0,15,0,30,7,8,0,15,4,30,6,0,0,6,1,-15,3,1
2,3,27,1,30,5,10,0,15,4,30,2,0,0,2,0,30,6,9,0,15,0,30,7,8,0,15,4,30,6,0,0,6,1,-15,3,1
2,2,29,0,30,7,7,0,14,5,30,11,1,0,12,0,30,4,10,0,14,0,30,1,13,0,14,6,30,9,0,0,9,1,-15,3,1
2,3,29,0,30,7,7,0,14,5,30,11,1,0,12,0,30,4,10,0,14,0,30,1,13,0,14,6,30,9,0,0,9,1,-15,3,1
2,4,29,0,30,7,7,0,14,5,30,11,1,0,12,0,30,4,10,0,14,0,30,1,13,0,14,6,30,9,0,0,9,1,-15,3,1
2,2,37,1,30,8,3,0,11,5,30,8,0,0,8,0,30,7,4,0,11,2,30,3,8,0,11,2,30,6,0,0,6,1,-15,3,1
2,3,37,1,30,8,3,0,11,5,30,8,0,0,8,0,30,7,4,0,11,2,30,3,8,0,11,2,30,6,0,0,6,1,-15,3,1
2,3,4,2,30,5,3,0,8,4,30,4,0,0,4,0,30,2,6,0,8,0,30,5,3,0,8,3,30,4,0,0,4,0,-27,3,0
2,2,11,0,30,3,9,0,12,1,30,4,0,0,4,0,30,3,9,0,12,4,30,3,9,0,12,4,30,4,0,0,4,1,-15,3,1
2,3,11,0,30,3,9,0,12,1,30,4,0,0,4,0,30,3,9,0,12,4,30,3,9,0,12,4,30,4,0,0,4,1,-15,3,1
2,1,27,0,30,2,3,0,5,2,30,0,0,0,0,0,30,4,1,0,5,5,30,4,1,0,5,0,30,4,0,0,4,1,-15,3,1
2,3,27,0,30,2,3,0,5,2,30,0,0,0,0,0,30,4,1,0,5,5,30,4,1,0,5,0,30,4,0,0,4,1,-15,3,1
2,0,27,1,30,4,11,0,15,4,30,2,0,0,2,0,30,5,10,0,15,0,30,11,4,0,15,2,30,4,2,0,6,1,-15,3,1
2,2,27,1,30,4,11,0,15,4,30,2,0,0,2,0,30,5,10,0,15,0,30,11,4,0,15,2,30,4,2,0,6,1,-15,3,1
2,0,5,1,30,1,4,0,5,3,30,0,4,0,4,0,30,0,5,0,5,0,30,1,4,0,5,2,30,2,0,0,2,0,-27,3,0
2,2,5,1,30,1,4,0,5,3,30,0,4,0,4,0,30,0,5,0,5,0,30,1,4,0,5,2,30,2,0,0,2,0,-27,3,0
2,4,5,1,30,1,4,0,5,3,30,0,4,0,4,0,30,0,5,0,5,0,30,1,4,0,5,2,30,2,0,0,2,0,-27,3,0
2,4,8,0,30,7,0,0,7,3,30,2,0,0,2,4,30,4,3,0,7,2,30,7,0,0,7,4,30,3,0,0,3,0,-27,3,0
2,3,11,0,30,1,3,0,4,0,30,0,0,0,0,0,30,3,1,0,4,3,30,2,2,0,4,0,30,1,0,0,1,1,-15,3,1
2,1,11,8,30,5,7,0,12,4,30,4,0,0,4,1,30,4,8,0,12,3,30,6,6,0,12,2,30,4,0,0,4,1,-15,3,1
2,2,11,8,30,5,7,0,12,4,30,4,0,0,4,1,30,4,8,0,12,3,30,6,6,0,12,2,30,4,0,0,4,1,-15,3,1
2,3,11,8,30,5,7,0,12,4,30,4,0,0,4,1,30,4,8,0,12,3,30,6,6,0,12,2,30,4,0,0,4,1,-15,3,1
2,4,11,8,30,5,7,0,12,4,30,4,0,0,4,1,30,4,8,0,12,3,30,6,6,0,12,2,30,4,0,0,4,1,-15,3,1
2,2,13,3,30,7,0,0,7,1,30,4,0,0,4,4,30,7,0,0,7,5,30,2,5,0,7,1,30,4,0,0,4,1,-15,3,1
2,3,13,3,30,7,0,0,7,1,30,4,0,0,4,4,30,7,0,0,7,5,30,2,5,0,7,1,30,4,0,0,4,1,-15,3,1
2,3,17,4,30,7,7,0,14,2,30,6,0,0,6,0,30,7,7,0,14,1,30,5,9,0,14,4,30,4,0,0,4,1,-15,3,1
2,4,17,4,30,7,7,0,14,2,30,6,0,0,6,0,30,7,7,0,14,1,30,5,9,0,14,4,30,4,0,0,4,1,-15,3,1
2,1,19,0,30,5,8,0,13,1,30,6,2,0,8,0,30,5,8,0,13,1,30,4,9,0,13,1,30,8,1,0,9,1,-15,3,1
2,2,19,0,30,5,8,0,13,1,30,6,2,0,8,0,30,5,8,0,13,1,30,4,9,0,13,1,30,8,1,0,9,1,-15,3,1
2,3,19,0,30,5,8,0,13,1,30,6,2,0,8,0,30,5,8,0,13,1,30,4,9,0,13,1,30,8,1,0,9,1,-15,3,1
2,4,19,0,30,5,8,0,13,1,30,6,2,0,8,0,30,5,8,0,13,1,30,4,9,0,13,1,30,8,1,0,9,1,-15,3,1
2,4,23,1,30,5,8,0,13,4,30,6,0,0,6,7,30,11,2,0,13,0,30,4,9,0,13,2,30,5,1,0,6,1,-15,3,1
2,1,25,0,30,3,11,0,14,5,30,6,0,0,6,0,30,8,6,0,14,1,30,7,7,0,14,5,30,6,0,0,6,1,-15,3,1
2,3,25,0,30,3,11,0,14,5,30,6,0,0,6,0,30,8,6,0,14,1,30,7,7,0,14,5,30,6,0,0,6,1,-15,3,1
2,2,27,1,30,4,11,0,15,4,30,2,0,0,2,0,30,3,12,0,15,2,30,7,8,0,15,4,30,6,0,0,6,1,-15,3,1
2,3,27,1,30,4,11,0,15,4,30,2,0,0,2,0,30,3,12,0,15,2,30,7,8,0,15,4,30,6,0,0,6,1,-15,3,1
2,2,29,0,30,9,5,0,14,5,30,12,0,0,12,0,30,3,11,0,14,0,30,1,13,0,14,0,30,6,3,0,9,1,-15,3,1
2,4,29,0,30,9,5,0,14,5,30,12,0,0,12,0,30,3,11,0,14,0,30,1,13,0,14,0,30,6,3,0,9,1,-15,3,1
2,2,6,2,30,9,0,0,9,4,30,2,0,0,2,0,30,2,7,0,9,0,30,4,5,0,9,1,30,2,3,0,5,0,-27,3,0
2,4,8,1,30,7,0,0,7,4,30,2,0,0,2,8,30,4,3,0,7,0,30,5,2,0,7,0,30,3,0,0,3,0,-27,3,0
2,1,13,2,30,5,2,0,7,1,30,4,0,0,4,2,30,5,2,0,7,8,30,5,2,0,7,6,30,4,0,0,4,1,-15,3,1
2,2,13,2,30,5,2,0,7,1,30,4,0,0,4,2,30,5,2,0,7,8,30,5,2,0,7,6,30,4,0,0,4,1,-15,3,1
2,4,13,2,30,5,2,0,7,1,30,4,0,0,4,2,30,5,2,0,7,8,30,5,2,0,7,6,30,4,0,0,4,1,-15,3,1
2,4,15,1,30,4,9,0,13,1,30,6,0,0,6,0,30,4,9,0,13,1,30,7,6,0,13,2,30,8,1,0,9,1,-15,3,1
2,1,17,4,30,10,4,0,14,3,30,6,0,0,6,0,30,6,8,0,14,2,30,6,8,0,14,3,30,4,0,0,4,1,-15,3,1
2,2,17,4,30,10,4,0,14,3,30,6,0,0,6,0,30,6,8,0,14,2,30,6,8,0,14,3,30,4,0,0,4,1,-15,3,1
2,3,19,0,30,3,10,0,13,2,30,8,0,0,8,0,30,4,9,0,13,0,30,2,11,0,13,2,30,8,1,0,9,1,-15,3,1
2,1,27,2,30,3,12,0,15,0,30,2,0,0,2,0,30,10,5,0,15,3,30,4,11,0,15,2,30,6,0,0,6,1,-15,3,1
2,1,33,8,30,8,3,0,11,5,30,4,0,0,4,0,30,10,1,0,11,0,30,3,8,0,11,3,30,4,0,0,4,1,-15,3,1
2,2,33,8,30,8,3,0,11,5,30,4,0,0,4,0,30,10,1,0,11,0,30,3,8,0,11,3,30,4,0,0,4,1,-15,3,1
2,3,33,8,30,8,3,0,11,5,30,4,0,0,4,0,30,10,1,0,11,0,30,3,8,0,11,3,30,4,0,0,4,1,-15,3,1
2,1,4,0,30,8,0,0,8,5,30,4,0,0,4,0,30,2,6,0,8,0,30,8,0,0,8,2,30,3,1,0,4,0,-27,3,0
2,2,4,0,30,8,0,0,8,5,30,4,0,0,4,0,30,2,6,0,8,0,30,8,0,0,8,2,30,3,1,0,4,0,-27,3,0
2,1,13,3,30,6,1,0,7,0,30,4,0,0,4,2,30,5,2,0,7,6,30,6,1,0,7,4,30,4,0,0,4,1,-15,3,1
2,2,17,3,30,9,5,0,14,2,30,6,0,0,6,0,30,6,8,0,14,1,30,6,8,0,14,4,30,4,0,0,4,1,-15,3,1
2,4,17,0,30,9,5,0,14,2,30,6,0,0,6,0,30,6,8,0,14,1,30,6,8,0,14,4,30,4,0,0,4,1,-15,3,1
2,2,19,1,30,3,10,0,13,3,30,7,1,0,8,1,30,4,9,0,13,1,30,6,7,0,13,3,30,9,0,0,9,1,-15,3,1
2,0,21,0,30,8,2,0,10,3,30,5,1,0,6,1,30,3,7,0,10,6,30,5,5,0,10,2,30,4,0,0,4,1,-15,3,1
2,3,25,1,30,6,8,0,14,2,30,6,0,0,6,0,30,6,8,0,14,1,30,6,8,0,14,4,30,5,1,0,6,1,-15,3,1
2,4,25,1,30,6,8,0,14,2,30,6,0,0,6,0,30,6,8,0,14,1,30,6,8,0,14,4,30,5,1,0,6,1,-15,3,1
2,0,27,5,30,6,9,0,15,4,30,1,1,0,2,0,30,5,10,0,15,0,30,4,11,0,15,2,30,6,0,0,6,1,-15,3,1
2,2,31,4,30,6,6,0,12,4,30,8,0,0,8,4,30,10,2,0,12,3,30,3,9,0,12,0,30,3,3,0,6,1,-15,3,1
2,3,31,4,30,6,6,0,12,4,30,8,0,0,8,4,30,10,2,0,12,3,30,3,9,0,12,0,30,3,3,0,6,1,-15,3,1
2,4,31,4,30,6,6,0,12,4,30,8,0,0,8,4,30,10,2,0,12,3,30,3,9,0,12,0,30,3,3,0,6,1,-15,3,1
2,4,39,0,30,5,6,0,11,8,30,6,0,0,6,0,30,3,8,0,11,2,30,4,7,0,11,5,30,5,0,0,5,1,-15,3,1
2,4,4,3,30,6,2,0,8,5,30,2,2,0,4,0,30,2,6,0,8,0,30,5,3,0,8,3,30,4,0,0,4,0,-27,3,0
2,2,8,1,30,7,0,0,7,5,30,2,0,0,2,3,30,2,5,0,7,1,30,7,0,0,7,2,30,3,0,0,3,0,-27,3,0
2,4,8,1,30,7,0,0,7,5,30,2,0,0,2,3,30,2,5,0,7,0,30,7,0,0,7,2,30,3,0,0,3,0,-27,3,0
2,2,13,1,30,4,3,0,7,0,30,4,0,0,4,3,30,7,0,0,7,5,30,5,2,0,7,5,30,4,0,0,4,1,-15,3,1
2,0,19,1,30,7,6,0,13,2,30,7,1,0,8,0,30,4,9,0,13,4,30,6,7,0,13,1,30,7,2,0,9,1,-15,3,1
2,1,19,1,30,7,6,0,13,2,30,7,1,0,8,0,30,4,9,0,13,4,30,6,7,0,13,1,30,7,2,0,9,1,-15,3,1
2,2,25,3,30,8,6,0,14,4,30,6,0,0,6,0,30,6,8,0,14,1,30,5,9,0,14,6,30,5,1,0,6,1,-15,3,1
2,2,27,1,30,3,12,0,15,3,30,2,0,0,2,0,30,3,12,0,15,1,30,4,11,0,15,5,30,6,0,0,6,1,-15,3,1
2,0,29,0,30,6,8,0,14,5,30,11,1,0,12,0,30,4,10,0,14,0,30,2,12,0,14,2,30,9,0,0,9,1,-15,3,1
2,4,47,0,30,1,13,0,14,9,30,4,0,0,4,0,30,3,11,0,14,0,30,9,5,0,14,5,30,7,0,0,7,1,-15,3,1
2,1,13,3,30,7,0,0,7,0,30,4,0,0,4,2,30,5,2,0,7,6,30,7,0,0,7,4,30,4,0,0,4,1,-15,3,1
2,1,19,0,30,3,10,0,13,2,30,2,6,0,8,0,30,5,8,0,13,6,30,9,4,0,13,2,30,9,0,0,9,1,-15,3,1
2,4,19,0,30,3,10,0,13,2,30,2,6,0,8,0,30,5,8,0,13,6,30,9,4,0,13,2,30,9,0,0,9,1,-15,3,1
2,2,21,3,30,7,3,0,10,4,30,6,0,0,6,1,30,2,8,0,10,3,30,4,6,0,10,0,30,4,0,0,4,1,-15,3,1
2,4,23,2,30,8,5,0,13,2,30,6,0,0,6,0,30,9,4,0,13,0,30,6,7,0,13,6,30,6,0,0,6,1,-15,3,1
2,2,27,3,30,5,10,0,15,4,30,1,1,0,2,0,30,6,9,0,15,0,30,6,9,0,15,1,30,4,2,0,6,1,-15,3,1
2,4,27,0,30,5,10,0,15,4,30,1,1,0,2,0,30,6,9,0,15,0,30,6,9,0,15,1,30,4,2,0,6,1,-15,3,1
2,0,29,2,30,6,8,0,14,6,30,12,0,0,12,0,30,7,7,0,14,0,30,0,14,0,14,1,30,9,0,0,9,1,-15,3,1
2,2,31,1,30,4,8,0,12,7,30,8,0,0,8,3,30,4,8,0,12,0,30,7,5,0,12,4,30,6,0,0,6,1,-15,3,1
2,3,4,2,30,5,3,0,8,5,30,4,0,0,4,0,30,1,7,0,8,0,30,4,4,0,8,2,30,4,0,0,4,0,-27,3,0
2,2,11,1,30,4,8,0,12,1,30,4,0,0,4,0,30,6,6,0,12,3,30,8,4,0,12,6,30,4,0,0,4,1,-15,3,1
2,3,11,1,30,4,8,0,12,1,30,4,0,0,4,0,30,6,6,0,12,3,30,8,4,0,12,6,30,4,0,0,4,1,-15,3,1
2,1,13,2,30,7,0,0,7,0,30,4,0,0,4,2,30,5,2,0,7,4,30,7,0,0,7,5,30,4,0,0,4,1,-15,3,1
2,4,13,2,30,7,0,0,7,0,30,4,0,0,4,2,30,5,2,0,7,4,30,7,0,0,7,5,30,4,0,0,4,1,-15,3,1
2,2,15,0,30,6,7,0,13,0,30,6,0,0,6,0,30,3,10,0,13,1,30,5,8,0,13,2,30,9,0,0,9,1,-15,3,1
2,3,15,0,30,6,7,0,13,0,30,6,0,0,6,0,30,3,10,0,13,1,30,5,8,0,13,2,30,9,0,0,9,1,-15,3,1
2,3,23,2,30,6,7,0,13,2,30,6,0,0,6,5,30,10,3,0,13,0,30,4,9,0,13,2,30,6,0,0,6,1,-15,3,1
2,4,23,2,30,6,7,0,13,2,30,6,0,0,6,5,30,10,3,0,13,0,30,4,9,0,13,2,30,6,0,0,6,1,-15,3,1
2,4,25,0,30,5,9,0,14,4,30,6,0,0,6,0,30,4,10,0,14,1,30,10,4,0,14,3,30,5,1,0,6,1,-15,3,1
2,2,27,1,30,6,9,0,15,5,30,2,0,0,2,0,30,5,10,0,15,1,30,5,10,0,15,1,30,6,0,0,6,1,-15,3,1
2,4,29,0,30,7,7,0,14,5,30,12,0,0,12,0,30,5,9,0,14,0,30,1,13,0,14,0,30,7,2,0,9,1,-15,3,1
2,3,32,0,30,4,5,0,9,4,30,2,0,0,2,1,30,8,1,0,9,1,30,3,6,0,9,3,30,2,0,0,2,1,-15,3,1
2,4,32,0,30,4,5,0,9,4,30,2,0,0,2,1,30,8,1,0,9,1,30,3,6,0,9,3,30,2,0,0,2,1,-15,3,1
2,1,13,6,30,7,0,0,7,0,30,4,0,0,4,1,30,5,2,0,7,6,30,6,1,0,7,5,30,4,0,0,4,1,-15,3,1
2,3,13,6,30,7,0,0,7,0,30,4,0,0,4,1,30,5,2,0,7,6,30,6,1,0,7,5,30,4,0,0,4,1,-15,3,1
2,3,17,3,30,11,3,0,14,3,30,6,0,0,6,0,30,5,9,0,14,1,30,6,8,0,14,1,30,2,2,0,4,1,-15,3,1
2,4,19,3,30,4,9,0,13,2,30,8,0,0,8,3,30,6,7,0,13,0,30,3,10,0,13,0,30,5,4,0,9,1,-15,3,1
2,3,23,1,30,5,8,0,13,4,30,6,0,0,6,7,30,12,1,0,13,0,30,5,8,0,13,3,30,6,0,0,6,1,-15,3,1
2,0,27,3,30,4,11,0,15,4,30,1,1,0,2,0,30,9,6,0,15,1,30,6,9,0,15,3,30,6,0,0,6,1,-15,3,1
2,3,28,0,30,4,4,0,8,5,30,4,0,0,4,0,30,1,7,0,8,0,30,1,7,0,8,4,30,4,0,0,4,1,-15,3,1
2,4,28,0,30,4,4,0,8,5,30,4,0,0,4,0,30,1,7,0,8,0,30,1,7,0,8,4,30,4,0,0,4,1,-15,3,1
2,3,35,0,30,9,4,0,13,4,30,2,0,0,2,1,30,6,7,0,13,4,30,1,12,0,13,5,30,8,0,0,8,1,-15,3,1
2,3,4,2,30,7,1,0,8,5,30,4,0,0,4,0,30,2,6,0,8,0,30,4,4,0,8,5,30,4,0,0,4,0,-27,3,0
2,0,5,0,30,3,2,0,5,3,30,3,1,0,4,0,30,0,5,0,5,0,30,1,4,0,5,1,30,2,0,0,2,0,-27,3,0
2,1,5,0,30,3,2,0,5,3,30,3,1,0,4,0,30,0,5,0,5,0,30,1,4,0,5,1,30,2,0,0,2,0,-27,3,0
2,3,8,3,30,7,0,0,7,4,30,2,0,0,2,3,30,4,3,0,7,1,30,7,0,0,7,1,30,3,0,0,3,0,-27,3,0
2,4,8,3,30,7,0,0,7,4,30,2,0,0,2,3,30,4,3,0,7,1,30,7,0,0,7,1,30,3,0,0,3,0,-27,3,0
2,3,13,3,30,7,0,0,7,0,30,4,0,0,4,1,30,6,1,0,7,5,30,6,1,0,7,3,30,4,0,0,4,1,-15,3,1
2,4,15,1,30,4,9,0,13,1,30,6,0,0,6,0,30,3,10,0,13,0,30,4,9,0,13,1,30,7,2,0,9,1,-15,3,1
2,4,19,0,30,2,11,0,13,1,30,8,0,0,8,0,30,8,5,0,13,0,30,4,9,0,13,1,30,6,3,0,9,1,-15,3,1
2,1,21,2,30,6,4,0,10,4,30,6,0,0,6,1,30,3,7,0,10,4,30,5,5,0,10,6,30,4,0,0,4,1,-15,3,1
2,2,21,2,30,6,4,0,10,4,30,6,0,0,6,1,30,3,7,0,10,4,30,5,5,0,10,6,30,4,0,0,4,1,-15,3,1
2,3,21,2,30,6,4,0,10,4,30,6,0,0,6,1,30,3,7,0,10,4,30,5,5,0,10,6,30,4,0,0,4,1,-15,3,1
2,1,25,0,30,5,9,0,14,5,30,6,0,0,6,0,30,4,10,0,14,1,30,9,5,0,14,7,30,6,0,0,6,1,-15,3,1
2,3,25,0,30,5,9,0,14,5,30,6,0,0,6,0,30,4,10,0,14,0,30,9,5,0,14,7,30,6,0,0,6,1,-15,3,1
2,1,27,1,30,5,10,0,15,4,30,2,0,0,2,0,30,3,12,0,15,0,30,4,11,0,15,7,30,6,0,0,6,1,-15,3,1
2,2,27,1,30,5,10,0,15,4,30,2,0,0,2,0,30,3,12,0,15,0,30,4,11,0,15,7,30,6,0,0,6,1,-15,3,1
2,1,29,0,30,7,7,0,14,6,30,9,3,0,12,0,30,3,11,0,14,0,30,7,7,0,14,2,30,9,0,0,9,1,-15,3,1
2,3,29,0,30,7,7,0,14,6,30,9,3,0,12,0,30,3,11,0,14,0,30,7,7,0,14,2,30,9,0,0,9,1,-15,3,1
2,4,1,0,30,4,6,0,10,4,30,2,0,0,2,1,30,4,6,0,10,3,30,10,0,0,10,6,30,6,0,0,6,0,-27,3,0
2,4,17,4,30,8,6,0,14,2,30,6,0,0,6,0,30,8,6,0,14,2,30,6,8,0,14,5,30,4,0,0,4,1,-15,3,1
2,3,23,1,30,3,10,0,13,3,30,6,0,0,6,3,30,12,1,0,13,1,30,6,7,0,13,2,30,5,1,0,6,1,-15,3,1
2,4,23,1,30,3,10,0,13,3,30,6,0,0,6,3,30,12,1,0,13,1,30,6,7,0,13,2,30,5,1,0,6,1,-15,3,1
2,3,25,0,30,10,4,0,14,0,30,6,0,0,6,0,30,7,7,0,14,1,30,5,9,0,14,4,30,5,1,0,6,1,-15,3,1
2,3,27,1,30,4,11,0,15,4,30,2,0,0,2,5,30,3,12,0,15,0,30,9,6,0,15,1,30,4,2,0,6,1,-15,3,1
2,4,27,1,30,4,11,0,15,4,30,2,0,0,2,5,30,3,12,0,15,0,30,9,6,0,15,1,30,4,2,0,6,1,-15,3,1
2,1,29,1,30,7,7,0,14,5,30,9,3,0,12,0,30,5,9,0,14,0,30,1,13,0,14,0,30,9,0,0,9,1,-15,3,1
2,4,31,1,30,6,6,0,12,5,30,8,0,0,8,3,30,8,4,0,12,0,30,3,9,0,12,1,30,6,0,0,6,1,-15,3,1
2,0,33,2,30,3,8,0,11,6,30,4,0,0,4,8,30,9,2,0,11,0,30,3,8,0,11,7,30,4,0,0,4,1,-15,3,1
2,1,33,2,30,3,8,0,11,6,30,4,0,0,4,8,30,9,2,0,11,0,30,3,8,0,11,7,30,4,0,0,4,1,-15,3,1
2,3,33,2,30,3,8,0,11,6,30,4,0,0,4,8,30,9,2,0,11,0,30,3,8,0,11,7,30,4,0,0,4,1,-15,3,1
2,2,19,1,30,6,7,0,13,1,30,5,3,0,8,0,30,8,5,0,13,0,30,5,8,0,13,2,30,8,1,0,9,1,-15,3,1
2,3,19,1,30,6,7,0,13,1,30,5,3,0,8,0,30,8,5,0,13,0,30,5,8,0,13,2,30,8,1,0,9,1,-15,3,1
2,2,25,3,30,4,10,0,14,4,30,6,0,0,6,0,30,10,4,0,14,1,30,7,7,0,14,3,30,5,1,0,6,1,-15,3,1
2,0,33,4,30,6,5,0,11,5,30,4,0,0,4,5,30,9,2,0,11,1,30,4,7,0,11,7,30,4,0,0,4,1,-15,3,1
2,1,33,4,30,6,5,0,11,5,30,4,0,0,4,5,30,9,2,0,11,1,30,4,7,0,11,7,30,4,0,0,4,1,-15,3,1
2,2,33,4,30,6,5,0,11,5,30,4,0,0,4,5,30,9,2,0,11,1,30,4,7,0,11,7,30,4,0,0,4,1,-15,3,1
2,2,35,0,30,9,4,0,13,3,30,2,0,0,2,1,30,2,11,0,13,5,30,2,11,0,13,8,30,8,0,0,8,1,-15,3,1
2,3,35,0,30,9,4,0,13,3,30,2,0,0,2,1,30,2,11,0,13,5,30,2,11,0,13,8,30,8,0,0,8,1,-15,3,1
2,1,9,8,30,2,2,0,4,4,30,2,0,0,2,0,30,1,3,0,4,0,30,0,4,0,4,2,30,1,0,0,1,0,-27,3,0
2,2,9,8,30,2,2,0,4,4,30,2,0,0,2,0,30,1,3,0,4,0,30,0,4,0,4,2,30,1,0,0,1,0,-27,3,0
2,4,13,1,30,5,2,0,7,0,30,4,0,0,4,2,30,6,1,0,7,9,30,6,1,0,7,4,30,4,0,0,4,1,-15,3,1
2,2,17,4,30,11,3,0,14,2,30,6,0,0,6,0,30,8,6,0,14,1,30,4,10,0,14,2,30,4,0,0,4,1,-15,3,1
2,0,19,0,30,4,9,0,13,2,30,3,5,0,8,4,30,4,9,0,13,0,30,3,10,0,13,1,30,7,2,0,9,1,-15,3,1
2,1,19,0,30,4,9,0,13,2,30,3,5,0,8,4,30,4,9,0,13,0,30,3,10,0,13,1,30,7,2,0,9,1,-15,3,1
2,0,25,1,30,5,9,0,14,6,30,6,0,0,6,0,30,3,11,0,14,8,30,9,5,0,14,4,30,6,0,0,6,1,-15,3,1
2,2,25,1,30,5,9,0,14,6,30,6,0,0,6,0,30,3,11,0,14,8,30,9,5,0,14,0,30,6,0,0,6,1,-15,3,1
2,2,29,0,30,8,6,0,14,5,30,12,0,0,12,0,30,4,10,0,14,0,30,1,13,0,14,0,30,9,0,0,9,1,-15,3,1
2,4,31,3,30,6,6,0,12,4,30,8,0,0,8,4,30,10,2,0,12,0,30,3,9,0,12,1,30,4,2,0,6,1,-15,3,1
2,1,4,3,30,8,0,0,8,5,30,4,0,0,4,0,30,1,7,0,8,0,30,6,2,0,8,1,30,3,1,0,4,0,-27,3,0
2,2,4,3,30,8,0,0,8,5,30,4,0,0,4,0,30,1,7,0,8,0,30,6,2,0,8,1,30,3,1,0,4,0,-27,3,0
2,3,4,3,30,8,0,0,8,5,30,4,0,0,4,0,30,1,7,0,8,0,30,6,2,0,8,1,30,3,1,0,4,0,-27,3,0
2,4,4,3,30,8,0,0,8,5,30,4,0,0,4,0,30,1,7,0,8,0,30,6,2,0,8,1,30,3,1,0,4,0,-27,3,0
2,1,5,0,30,2,3,0,5,2,30,4,0,0,4,0,30,0,5,0,5,0,30,1,4,0,5,0,30,2,0,0,2,0,-27,3,0
2,2,13,4,30,5,2,0,7,0,30,4,0,0,4,2,30,6,1,0,7,6,30,6,1,0,7,6,30,4,0,0,4,1,-15,3,1
2,4,13,4,30,5,2,0,7,0,30,4,0,0,4,2,30,6,1,0,7,6,30,6,1,0,7,6,30,4,0,0,4,1,-15,3,1
2,3,19,0,30,6,7,0,13,0,30,3,5,0,8,0,30,4,9,0,13,5,30,4,9,0,13,4,30,8,1,0,9,1,-15,3,1
2,3,23,1,30,7,6,0,13,0,30,6,0,0,6,2,30,12,1,0,13,0,30,4,9,0,13,1,30,6,0,0,6,1,-15,3,1
2,4,27,1,30,4,11,0,15,1,30,2,0,0,2,0,30,12,3,0,15,0,30,8,7,0,15,3,30,6,0,0,6,1,-15,3,1
2,2,29,0,30,10,4,0,14,5,30,8,4,0,12,0,30,3,11,0,14,0,30,6,8,0,14,3,30,9,0,0,9,1,-15,3,1
2,4,29,0,30,10,4,0,14,5,30,8,4,0,12,0,30,3,11,0,14,0,30,6,8,0,14,3,30,9,0,0,9,1,-15,3,1
2,3,31,3,30,6,6,0,12,4,30,8,0,0,8,4,30,9,3,0,12,0,30,3,9,0,12,0,30,4,2,0,6,1,-15,3,1
2,0,38,0,30,8,2,0,10,8,30,6,0,0,6,0,30,1,9,0,10,0,30,4,6,0,10,7,30,6,0,0,6,1,-15,3,1
2,3,38,0,30,8,2,0,10,8,30,6,0,0,6,0,30,1,9,0,10,0,30,4,6,0,10,7,30,6,0,0,6,1,-15,3,1
2,4,39,0,30,4,7,0,11,7,30,6,0,0,6,0,30,3,8,0,11,0,30,2,9,0,11,3,30,5,0,0,5,1,-15,3,1
2,2,41,1,30,11,1,0,12,8,30,8,0,0,8,0,30,2,10,0,12,0,30,2,10,0,12,1,30,5,2,0,7,1,-15,3,1
2,3,41,1,30,11,1,0,12,8,30,8,0,0,8,0,30,2,10,0,12,0,30,2,10,0,12,1,30,5,2,0,7,1,-15,3,1
2,4,4,0,30,8,0,0,8,4,30,4,0,0,4,0,30,5,3,0,8,0,30,4,4,0,8,3,30,4,0,0,4,0,-27,3,0
2,4,13,1,30,7,0,0,7,1,30,4,0,0,4,2,30,6,1,0,7,3,30,6,1,0,7,2,30,4,0,0,4,1,-15,3,1
2,2,17,3,30,9,5,0,14,4,30,6,0,0,6,0,30,2,12,0,14,1,30,7,7,0,14,4,30,4,0,0,4,1,-15,3,1
2,3,17,3,30,9,5,0,14,4,30,6,0,0,6,0,30,2,12,0,14,1,30,7,7,0,14,4,30,4,0,0,4,1,-15,3,1
2,4,17,3,30,9,5,0,14,4,30,6,0,0,6,0,30,2,12,0,14,1,30,7,7,0,14,4,30,4,0,0,4,1,-15,3,1
2,4,19,0,30,5,8,0,13,1,30,8,0,0,8,0,30,4,9,0,13,0,30,5,8,0,13,0,30,7,2,0,9,1,-15,3,1
2,2,25,1,30,5,9,0,14,5,30,6,0,0,6,0,30,5,9,0,14,2,30,6,8,0,14,6,30,6,0,0,6,1,-15,3,1
2,3,25,1,30,5,9,0,14,5,30,6,0,0,6,0,30,5,9,0,14,2,30,6,8,0,14,6,30,6,0,0,6,1,-15,3,1
2,4,25,1,30,5,9,0,14,5,30,6,0,0,6,0,30,5,9,0,14,2,30,6,8,0,14,6,30,6,0,0,6,1,-15,3,1
2,3,27,1,30,5,10,0,15,5,30,2,0,0,2,0,30,4,11,0,15,2,30,5,10,0,15,6,30,6,0,0,6,1,-15,3,1
2,2,29,0,30,4,10,0,14,5,30,7,5,0,12,0,30,6,8,0,14,2,30,4,10,0,14,2,30,9,0,0,9,1,-15,3,1
2,4,31,1,30,6,6,0,12,4,30,8,0,0,8,0,30,10,2,0,12,0,30,3,9,0,12,1,30,4,2,0,6,1,-15,3,1
2,0,38,0,30,6,4,0,10,6,30,6,0,0,6,0,30,6,4,0,10,0,30,5,5,0,10,6,30,6,0,0,6,1,-15,3,1
2,1,38,0,30,6,4,0,10,6,30,6,0,0,6,0,30,6,4,0,10,0,30,5,5,0,10,6,30,6,0,0,6,1,-15,3,1
2,3,38,0,30,6,4,0,10,6,30,6,0,0,6,0,30,6,4,0,10,0,30,5,5,0,10,6,30,6,0,0,6,1,-15,3,1
2,4,38,0,30,6,4,0,10,6,30,6,0,0,6,0,30,6,4,0,10,0,30,5,5,0,10,6,30,6,0,0,6,1,-15,3,1
2,4,13,1,30,7,0,0,7,0,30,4,0,0,4,2,30,6,1,0,7,8,30,6,1,0,7,5,30,4,0,0,4,1,-15,3,1
2,4,15,0,30,4,9,0,13,0,30,5,1,0,6,0,30,4,9,0,13,1,30,2,11,0,13,0,30,9,0,0,9,1,-15,3,1
2,1,19,0,30,7,6,0,13,1,30,3,5,0,8,0,30,5,8,0,13,1,30,4,9,0,13,2,30,8,1,0,9,1,-15,3,1
2,2,19,0,30,7,6,0,13,1,30,3,5,0,8,0,30,5,8,0,13,1,30,4,9,0,13,2,30,8,1,0,9,1,-15,3,1
2,3,21,2,30,7,3,0,10,3,30,4,2,0,6,0,30,3,7,0,10,0,30,3,7,0,10,0,30,4,0,0,4,1,-15,3,1
2,4,21,2,30,7,3,0,10,3,30,4,2,0,6,0,30,3,7,0,10,0,30,3,7,0,10,0,30,4,0,0,4,1,-15,3,1
2,3,25,1,30,8,6,0,14,3,30,6,0,0,6,0,30,11,3,0,14,1,30,4,10,0,14,4,30,5,1,0,6,1,-15,3,1
2,2,27,1,30,4,11,0,15,3,30,1,1,0,2,0,30,4,11,0,15,0,30,8,7,0,15,4,30,6,0,0,6,1,-15,3,1
2,1,33,1,30,2,9,0,11,4,30,4,0,0,4,2,30,9,2,0,11,1,30,4,7,0,11,6,30,4,0,0,4,1,-15,3,1
2,3,33,1,30,2,9,0,11,4,30,4,0,0,4,2,30,9,2,0,11,1,30,4,7,0,11,6,30,4,0,0,4,1,-15,3,1
2,0,13,2,30,7,0,0,7,1,30,4,0,0,4,1,30,6,1,0,7,3,30,4,3,0,7,4,30,4,0,0,4,1,-15,3,1
2,2,13,2,30,7,0,0,7,1,30,4,0,0,4,1,30,6,1,0,7,3,30,4,3,0,7,4,30,4,0,0,4,1,-15,3,1
2,4,13,2,30,7,0,0,7,0,30,4,0,0,4,1,30,6,1,0,7,3,30,4,3,0,7,4,30,4,0,0,4,1,-15,3,1
2,2,17,4,30,9,5,0,14,3,30,6,0,0,6,0,30,5,9,0,14,1,30,6,8,0,14,0,30,4,0,0,4,1,-15,3,1
2,3,17,4,30,9,5,0,14,3,30,6,0,0,6,0,30,5,9,0,14,1,30,6,8,0,14,0,30,4,0,0,4,1,-15,3,1
2,2,19,0,30,5,8,0,13,1,30,6,2,0,8,0,30,7,6,0,13,5,30,4,9,0,13,1,30,8,1,0,9,1,-15,3,1
2,3,19,0,30,5,8,0,13,1,30,6,2,0,8,0,30,7,6,0,13,5,30,4,9,0,13,1,30,8,1,0,9,1,-15,3,1
2,4,19,0,30,5,8,0,13,1,30,6,2,0,8,0,30,7,6,0,13,5,30,4,9,0,13,1,30,8,1,0,9,1,-15,3,1
2,4,23,1,30,4,9,0,13,3,30,6,0,0,6,4,30,12,1,0,13,0,30,5,8,0,13,3,30,6,0,0,6,1,-15,3,1
2,1,25,1,30,9,5,0,14,2,30,6,0,0,6,0,30,7,7,0,14,1,30,6,8,0,14,3,30,5,1,0,6,1,-15,3,1
2,2,27,0,30,5,10,0,15,4,30,1,1,0,2,0,30,7,8,0,15,4,30,3,12,0,15,3,30,6,0,0,6,1,-15,3,1
2,4,27,0,30,5,10,0,15,4,30,1,1,0,2,0,30,7,8,0,15,4,30,3,12,0,15,3,30,6,0,0,6,1,-15,3,1
2,3,29,0,30,5,9,0,14,5,30,8,4,0,12,0,30,9,5,0,14,0,30,1,13,0,14,3,30,9,0,0,9,1,-15,3,1
2,2,33,1,30,2,9,0,11,5,30,4,0,0,4,2,30,10,1,0,11,3,30,3,8,0,11,5,30,4,0,0,4,1,-15,3,1
2,2,5,0,30,0,5,0,5,2,30,2,2,0,4,1,30,3,2,0,5,0,30,1,4,0,5,0,30,0,2,0,2,0,-27,3,0
2,0,21,1,30,8,2,0,10,2,30,6,0,0,6,1,30,7,3,0,10,3,30,5,5,0,10,1,30,4,0,0,4,1,-15,3,1
2,1,21,1,30,8,2,0,10,2,30,6,0,0,6,1,30,7,3,0,10,3,30,5,5,0,10,1,30,4,0,0,4,1,-15,3,1
2,4,22,2,30,7,1,0,8,3,30,2,0,0,2,0,30,4,4,0,8,0,30,2,6,0,8,3,30,4,0,0,4,1,-15,3,1
2,4,23,1,30,5,8,0,13,2,30,6,0,0,6,7,30,11,2,0,13,2,30,4,9,0,13,4,30,6,0,0,6,1,-15,3,1
2,4,25,0,30,7,7,0,14,4,30,6,0,0,6,0,30,10,4,0,14,1,30,8,6,0,14,3,30,5,1,0,6,1,-15,3,1
2,4,31,3,30,6,6,0,12,4,30,8,0,0,8,6,30,11,1,0,12,0,30,4,8,0,12,0,30,6,0,0,6,1,-15,3,1
2,1,33,1,30,3,8,0,11,5,30,4,0,0,4,2,30,8,3,0,11,3,30,4,7,0,11,6,30,4,0,0,4,1,-15,3,1
2,2,33,1,30,3,8,0,11,5,30,4,0,0,4,2,30,8,3,0,11,3,30,4,7,0,11,6,30,4,0,0,4,1,-15,3,1
2,3,33,1,30,3,8,0,11,5,30,4,0,0,4,2,30,8,3,0,11,3,30,4,7,0,11,6,30,4,0,0,4,1,-15,3,1
2,2,43,7,30,7,7,0,14,11,30,6,0,0,6,0,30,4,10,0,14,1,30,5,9,0,14,3,30,5,0,0,5,1,-15,3,1
2,3,43,7,30,7,7,0,14,11,30,6,0,0,6,0,30,4,10,0,14,1,30,5,9,0,14,3,30,5,0,0,5,1,-15,3,1
2,2,4,2,30,8,0,0,8,4,30,2,2,0,4,0,30,1,7,0,8,0,30,4,4,0,8,1,30,3,1,0,4,0,-27,3,0
2,0,5,0,30,4,1,0,5,3,30,3,1,0,4,0,30,1,4,0,5,0,30,1,4,0,5,1,30,0,2,0,2,0,-27,3,0
2,1,5,0,30,4,1,0,5,3,30,3,1,0,4,0,30,1,4,0,5,0,30,1,4,0,5,1,30,0,2,0,2,0,-27,3,0
2,2,5,0,30,4,1,0,5,3,30,3,1,0,4,0,30,1,4,0,5,0,30,1,4,0,5,1,30,0,2,0,2,0,-27,3,0
2,0,26,0,30,8,1,0,9,3,30,0,4,0,4,1,30,0,9,0,9,8,30,2,7,0,9,7,30,3,0,0,3,1,-15,3,1
2,1,26,0,30,8,1,0,9,3,30,0,4,0,4,1,30,0,9,0,9,8,30,2,7,0,9,7,30,3,0,0,3,1,-15,3,1
2,2,26,0,30,8,1,0,9,3,30,0,4,0,4,1,30,0,9,0,9,8,30,2,7,0,9,7,30,3,0,0,3,1,-15,3,1
2,1,31,1,30,5,7,0,12,5,30,8,0,0,8,9,30,10,2,0,12,0,30,4,8,0,12,1,30,6,0,0,6,1,-15,3,1
2,4,3,7,30,1,3,0,4,4,30,4,0,0,4,0,30,0,4,0,4,0,30,0,4,0,4,0,30,1,2,0,3,0,-27,3,0
2,2,5,0,30,1,4,0,5,2,30,3,1,0,4,0,30,3,2,0,5,0,30,1,4,0,5,1,30,0,2,0,2,0,-27,3,0
2,3,5,0,30,1,4,0,5,2,30,3,1,0,4,0,30,3,2,0,5,0,30,1,4,0,5,1,30,0,2,0,2,0,-27,3,0
2,3,11,1,30,3,9,0,12,1,30,4,0,0,4,0,30,5,7,0,12,5,30,5,7,0,12,5,30,4,0,0,4,1,-15,3,1
2,1,13,2,30,7,0,0,7,0,30,4,0,0,4,2,30,6,1,0,7,3,30,6,1,0,7,3,30,4,0,0,4,1,-15,3,1
2,3,13,2,30,7,0,0,7,0,30,4,0,0,4,2,30,6,1,0,7,3,30,6,1,0,7,3,30,4,0,0,4,1,-15,3,1
2,3,15,0,30,4,9,0,13,1,30,6,0,0,6,0,30,4,9,0,13,2,30,5,8,0,13,4,30,9,0,0,9,1,-15,3,1
2,4,17,0,30,8,6,0,14,2,30,6,0,0,6,0,30,7,7,0,14,5,30,5,9,0,14,2,30,4,0,0,4,1,-15,3,1
2,3,19,0,30,3,10,0,13,2,30,4,4,0,8,0,30,8,5,0,13,4,30,4,9,0,13,1,30,9,0,0,9,1,-15,3,1
2,0,25,1,30,3,11,0,14,4,30,6,0,0,6,0,30,7,7,0,14,1,30,10,4,0,14,3,30,6,0,0,6,1,-15,3,1
2,1,25,1,30,3,11,0,14,4,30,6,0,0,6,0,30,7,7,0,14,1,30,10,4,0,14,3,30,6,0,0,6,1,-15,3,1
2,2,25,1,30,3,11,0,14,4,30,6,0,0,6,0,30,7,7,0,14,1,30,10,4,0,14,3,30,6,0,0,6,1,-15,3,1
2,4,25,1,30,3,11,0,14,4,30,6,0,0,6,0,30,7,7,0,14,1,30,10,4,0,14,3,30,6,0,0,6,1,-15,3,1
2,2,29,0,30,10,4,0,14,6,30,12,0,0,12,0,30,4,10,0,14,0,30,1,13,0,14,1,30,9,0,0,9,1,-15,3,1
2,0,35,0,30,9,4,0,13,7,30,2,0,0,2,2,30,2,11,0,13,0,30,7,6,0,13,3,30,8,0,0,8,1,-15,3,1
2,4,35,0,30,9,4,0,13,7,30,2,0,0,2,2,30,2,11,0,13,0,30,7,6,0,13,3,30,8,0,0,8,1,-15,3,1
2,3,7,0,30,3,6,0,9,3,30,4,0,0,4,0,30,5,4,0,9,6,30,3,6,0,9,2,30,6,0,0,6,0,-27,3,0
2,2,17,4,30,10,4,0,14,3,30,6,0,0,6,0,30,5,9,0,14,1,30,6,8,0,14,3,30,4,0,0,4,1,-15,3,1
2,4,17,4,30,10,4,0,14,3,30,6,0,0,6,0,30,5,9,0,14,1,30,6,8,0,14,3,30,4,0,0,4,1,-15,3,1
2,1,19,0,30,4,9,0,13,3,30,7,1,0,8,0,30,5,8,0,13,10,30,6,7,0,13,0,30,7,2,0,9,1,-15,3,1
2,3,23,0,30,5,8,0,13,3,30,6,0,0,6,4,30,12,1,0,13,1,30,7,6,0,13,2,30,5,1,0,6,1,-15,3,1
2,3,25,1,30,9,5,0,14,5,30,6,0,0,6,0,30,5,9,0,14,1,30,5,9,0,14,5,30,5,1,0,6,1,-15,3,1
2,0,27,1,30,5,10,0,15,4,30,1,1,0,2,0,30,6,9,0,15,3,30,5,10,0,15,5,30,6,0,0,6,1,-15,3,1
2,0,29,0,30,5,9,0,14,5,30,12,0,0,12,0,30,6,8,0,14,0,30,0,14,0,14,3,30,9,0,0,9,1,-15,3,1
2,1,29,0,30,5,9,0,14,5,30,12,0,0,12,0,30,6,8,0,14,0,30,0,14,0,14,3,30,9,0,0,9,1,-15,3,1
2,3,29,0,30,5,9,0,14,5,30,12,0,0,12,0,30,6,8,0,14,0,30,0,14,0,14,3,30,9,0,0,9,1,-15,3,1
2,4,7,1,30,4,5,0,9,3,30,2,2,0,4,2,30,6,3,0,9,4,30,3,6,0,9,1,30,5,1,0,6,0,-27,3,0
2,1,13,3,30,6,1,0,7,0,30,4,0,0,4,2,30,6,1,0,7,8,30,5,2,0,7,3,30,4,0,0,4,1,-15,3,1
2,4,19,1,30,4,9,0,13,1,30,6,2,0,8,0,30,9,4,0,13,4,30,7,6,0,13,2,30,6,3,0,9,1,-15,3,1
2,1,25,1,30,6,8,0,14,4,30,6,0,0,6,0,30,6,8,0,14,1,30,5,9,0,14,4,30,5,1,0,6,1,-15,3,1
2,2,25,1,30,6,8,0,14,4,30,6,0,0,6,0,30,6,8,0,14,1,30,5,9,0,14,4,30,5,1,0,6,1,-15,3,1
2,3,25,1,30,6,8,0,14,4,30,6,0,0,6,0,30,6,8,0,14,1,30,5,9,0,14,4,30,5,1,0,6,1,-15,3,1
2,1,27,1,30,4,11,0,15,4,30,2,0,0,2,0,30,7,8,0,15,0,30,6,9,0,15,3,30,6,0,0,6,1,-15,3,1
2,2,27,1,30,4,11,0,15,4,30,2,0,0,2,0,30,7,8,0,15,0,30,6,9,0,15,3,30,6,0,0,6,1,-15,3,1
2,4,3,0,30,0,4,0,4,2,30,4,0,0,4,0,30,0,4,0,4,8,30,2,2,0,4,0,30,1,2,0,3,0,-27,3,0
2,4,7,0,30,1,3,0,4,2,30,2,0,0,2,2,30,2,2,0,4,0,30,1,3,0,4,0,30,1,1,0,2,0,-27,3,0
2,2,11,1,30,9,3,0,12,1,30,4,0,0,4,0,30,6,6,0,12,7,30,3,9,0,12,3,30,4,0,0,4,1,-15,3,1
2,4,11,1,30,9,3,0,12,1,30,4,0,0,4,0,30,6,6,0,12,7,30,3,9,0,12,3,30,4,0,0,4,1,-15,3,1
2,4,13,0,30,6,1,0,7,0,30,4,0,0,4,5,30,6,1,0,7,7,30,6,1,0,7,3,30,4,0,0,4,1,-15,3,1
2,0,19,0,30,3,10,0,13,1,30,7,1,0,8,3,30,9,4,0,13,0,30,7,6,0,13,0,30,5,4,0,9,1,-15,3,1
2,1,19,0,30,3,10,0,13,1,30,7,1,0,8,3,30,9,4,0,13,0,30,7,6,0,13,0,30,5,4,0,9,1,-15,3,1
2,3,19,0,30,3,10,0,13,1,30,7,1,0,8,3,30,9,4,0,13,0,30,7,6,0,13,0,30,5,4,0,9,1,-15,3,1
2,2,27,1,30,4,11,0,15,3,30,1,1,0,2,0,30,5,10,0,15,0,30,6,9,0,15,6,30,6,0,0,6,1,-15,3,1
2,3,27,1,30,4,11,0,15,3,30,1,1,0,2,0,30,5,10,0,15,0,30,6,9,0,15,6,30,6,0,0,6,1,-15,3,1
2,1,33,2,30,6,5,0,11,5,30,4,0,0,4,5,30,9,2,0,11,0,30,3,8,0,11,5,30,4,0,0,4,1,-15,3,1
2,2,35,1,30,7,6,0,13,4,30,2,0,0,2,1,30,2,11,0,13,2,30,3,10,0,13,5,30,8,0,0,8,1,-15,3,1
2,1,38,0,30,1,9,0,10,6,30,6,0,0,6,0,30,2,8,0,10,0,30,4,6,0,10,6,30,6,0,0,6,1,-15,3,1
2,2,13,1,30,5,2,0,7,0,30,4,0,0,4,2,30,7,0,0,7,8,30,6,1,0,7,5,30,4,0,0,4,1,-15,3,1
2,4,15,0,30,6,7,0,13,1,30,6,0,0,6,0,30,3,10,0,13,1,30,3,10,0,13,0,30,6,3,0,9,1,-15,3,1
2,4,19,1,30,5,8,0,13,2,30,6,2,0,8,0,30,6,7,0,13,3,30,8,5,0,13,1,30,9,0,0,9,1,-15,3,1
2,4,23,2,30,7,6,0,13,2,30,6,0,0,6,5,30,10,3,0,13,0,30,5,8,0,13,1,30,5,1,0,6,1,-15,3,1
2,1,25,1,30,9,5,0,14,1,30,6,0,0,6,0,30,9,5,0,14,1,30,5,9,0,14,3,30,5,1,0,6,1,-15,3,1
2,0,26,0,30,7,2,0,9,4,30,1,3,0,4,4,30,2,7,0,9,0,30,2,7,0,9,4,30,2,1,0,3,1,-15,3,1
2,3,26,0,30,7,2,0,9,4,30,1,3,0,4,4,30,2,7,0,9,0,30,2,7,0,9,4,30,2,1,0,3,1,-15,3,1
2,0,27,1,30,6,9,0,15,4,30,2,0,0,2,0,30,5,10,0,15,0,30,5,10,0,15,2,30,6,0,0,6,1,-15,3,1
2,2,27,1,30,6,9,0,15,0,30,2,0,0,2,0,30,5,10,0,15,0,30,5,10,0,15,2,30,6,0,0,6,1,-15,3,1
2,3,27,1,30,6,9,0,15,0,30,2,0,0,2,0,30,5,10,0,15,0,30,5,10,0,15,2,30,6,0,0,6,1,-15,3,1
2,4,27,1,30,6,9,0,15,0,30,2,0,0,2,0,30,5,10,0,15,0,30,5,10,0,15,2,30,6,0,0,6,1,-15,3,1
2,2,1,0,30,7,3,0,10,5,30,2,0,0,2,1,30,4,6,0,10,1,30,10,0,0,10,5,30,6,0,0,6,0,-27,3,0
2,3,1,0,30,7,3,0,10,5,30,2,0,0,2,1,30,4,6,0,10,1,30,10,0,0,10,5,30,6,0,0,6,0,-27,3,0
2,4,1,0,30,7,3,0,10,5,30,2,0,0,2,1,30,4,6,0,10,1,30,10,0,0,10,5,30,6,0,0,6,0,-27,3,0
2,1,21,2,30,8,2,0,10,1,30,5,1,0,6,1,30,10,0,0,10,2,30,3,7,0,10,0,30,4,0,0,4,1,-15,3,1
2,4,22,3,30,4,4,0,8,3,30,2,0,0,2,0,30,5,3,0,8,0,30,3,5,0,8,1,30,4,0,0,4,1,-15,3,1
2,0,29,0,30,4,10,0,14,5,30,11,1,0,12,0,30,4,10,0,14,0,30,1,13,0,14,1,30,9,0,0,9,1,-15,3,1
2,3,29,0,30,4,10,0,14,5,30,11,1,0,12,0,30,4,10,0,14,0,30,1,13,0,14,1,30,9,0,0,9,1,-15,3,1
2,4,29,0,30,4,10,0,14,5,30,11,1,0,12,0,30,4,10,0,14,0,30,1,13,0,14,1,30,9,0,0,9,1,-15,3,1
2,0,4,3,30,7,1,0,8,4,30,4,0,0,4,0,30,4,4,0,8,0,30,4,4,0,8,3,30,4,0,0,4,0,-27,3,0
2,3,4,3,30,7,1,0,8,4,30,4,0,0,4,0,30,4,4,0,8,0,30,4,4,0,8,3,30,4,0,0,4,0,-27,3,0
2,0,6,0,30,7,2,0,9,4,30,2,0,0,2,0,30,2,7,0,9,0,30,5,4,0,9,2,30,5,0,0,5,0,-27,3,0
2,4,11,0,30,8,4,0,12,1,30,4,0,0,4,1,30,5,7,0,12,1,30,6,6,0,12,5,30,4,0,0,4,1,-15,3,1
2,1,13,2,30,6,1,0,7,0,30,4,0,0,4,2,30,6,1,0,7,6,30,5,2,0,7,7,30,4,0,0,4,1,-15,3,1
2,3,17,4,30,10,4,0,14,1,30,6,0,0,6,0,30,11,3,0,14,2,30,4,10,0,14,4,30,4,0,0,4,1,-15,3,1
2,2,21,3,30,8,2,0,10,3,30,6,0,0,6,1,30,5,5,0,10,1,30,4,6,0,10,2,30,4,0,0,4,1,-15,3,1
2,1,25,2,30,7,7,0,14,2,30,6,0,0,6,1,30,10,4,0,14,1,30,5,9,0,14,4,30,5,1,0,6,1,-15,3,1
2,2,25,2,30,7,7,0,14,2,30,6,0,0,6,1,30,10,4,0,14,1,30,5,9,0,14,4,30,5,1,0,6,1,-15,3,1
2,3,31,3,30,5,7,0,12,6,30,8,0,0,8,3,30,8,4,0,12,2,30,6,6,0,12,2,30,6,0,0,6,1,-15,3,1
2,4,31,3,30,5,7,0,12,6,30,8,0,0,8,3,30,8,4,0,12,2,30,6,6,0,12,2,30,6,0,0,6,1,-15,3,1
2,4,8,3,30,7,0,0,7,3,30,2,0,0,2,0,30,4,3,0,7,0,30,5,2,0,7,0,30,2,1,0,3,0,-27,3,0
2,2,17,3,30,6,8,0,14,3,30,6,0,0,6,0,30,7,7,0,14,9,30,6,8,0,14,6,30,4,0,0,4,1,-15,3,1
2,2,19,0,30,3,10,0,13,2,30,2,6,0,8,0,30,6,7,0,13,0,30,6,7,0,13,0,30,8,1,0,9,1,-15,3,1
2,4,19,0,30,3,10,0,13,2,30,2,6,0,8,0,30,6,7,0,13,0,30,6,7,0,13,0,30,8,1,0,9,1,-15,3,1
2,1,25,1,30,6,8,0,14,2,30,6,0,0,6,1,30,14,0,0,14,1,30,4,10,0,14,2,30,6,0,0,6,1,-15,3,1
2,2,25,1,30,6,8,0,14,2,30,6,0,0,6,1,30,14,0,0,14,1,30,4,10,0,14,2,30,6,0,0,6,1,-15,3,1
2,4,25,1,30,6,8,0,14,2,30,6,0,0,6,1,30,14,0,0,14,1,30,4,10,0,14,2,30,6,0,0,6,1,-15,3,1
2,0,27,1,30,4,11,0,15,5,30,2,0,0,2,0,30,5,10,0,15,0,30,6,9,0,15,4,30,6,0,0,6,1,-15,3,1
2,1,27,1,30,4,11,0,15,5,30,2,0,0,2,0,30,5,10,0,15,0,30,6,9,0,15,4,30,6,0,0,6,1,-15,3,1
2,3,27,1,30,4,11,0,15,5,30,2,0,0,2,0,30,5,10,0,15,0,30,6,9,0,15,4,30,6,0,0,6,1,-15,3,1
2,4,27,1,30,4,11,0,15,5,30,2,0,0,2,0,30,5,10,0,15,0,30,6,9,0,15,4,30,6,0,0,6,1,-15,3,1
2,4,31,2,30,6,6,0,12,5,30,8,0,0,8,3,30,9,3,0,12,0,30,7,5,0,12,2,30,6,0,0,6,1,-15,3,1
2,0,17,6,30,11,3,0,14,4,30,6,0,0,6,0,30,4,10,0,14,1,30,5,9,0,14,2,30,4,0,0,4,1,-15,3,1
2,3,17,6,30,11,3,0,14,4,30,6,0,0,6,0,30,4,10,0,14,1,30,5,9,0,14,2,30,4,0,0,4,1,-15,3,1
2,3,19,0,30,5,8,0,13,0,30,8,0,0,8,4,30,10,3,0,13,0,30,5,8,0,13,1,30,6,3,0,9,1,-15,3,1
2,4,19,0,30,5,8,0,13,0,30,8,0,0,8,4,30,10,3,0,13,0,30,5,8,0,13,1,30,6,3,0,9,1,-15,3,1
2,2,23,1,30,4,9,0,13,2,30,6,0,0,6,5,30,12,1,0,13,0,30,6,7,0,13,3,30,6,0,0,6,1,-15,3,1
2,4,23,1,30,4,9,0,13,2,30,6,0,0,6,5,30,12,1,0,13,0,30,6,7,0,13,3,30,6,0,0,6,1,-15,3,1
2,0,27,1,30,3,12,0,15,3,30,1,1,0,2,0,30,3,12,0,15,3,30,4,11,0,15,3,30,6,0,0,6,1,-15,3,1
2,1,27,1,30,3,12,0,15,3,30,1,1,0,2,0,30,3,12,0,15,3,30,4,11,0,15,3,30,6,0,0,6,1,-15,3,1
2,2,27,1,30,3,12,0,15,3,30,1,1,0,2,0,30,3,12,0,15,3,30,4,11,0,15,3,30,6,0,0,6,1,-15,3,1
2,3,27,1,30,3,12,0,15,3,30,1,1,0,2,0,30,3,12,0,15,3,30,4,11,0,15,3,30,6,0,0,6,1,-15,3,1
2,1,29,0,30,4,10,0,14,5,30,10,2,0,12,0,30,6,8,0,14,0,30,0,14,0,14,1,30,9,0,0,9,1,-15,3,1
2,3,29,0,30,4,10,0,14,5,30,10,2,0,12,0,30,6,8,0,14,0,30,0,14,0,14,1,30,9,0,0,9,1,-15,3,1
2,2,31,2,30,10,2,0,12,6,30,8,0,0,8,3,30,4,8,0,12,0,30,3,9,0,12,2,30,3,3,0,6,1,-15,3,1
2,2,38,1,30,3,7,0,10,7,30,6,0,0,6,0,30,1,9,0,10,0,30,4,6,0,10,8,30,6,0,0,6,1,-15,3,1
2,3,38,1,30,3,7,0,10,7,30,6,0,0,6,0,30,1,9,0,10,0,30,4,6,0,10,8,30,6,0,0,6,1,-15,3,1
2,3,45,0,30,5,8,0,13,9,30,10,0,0,10,3,30,6,7,0,13,0,30,4,9,0,13,8,30,5,0,0,5,1,-15,3,1
2,3,11,3,30,5,7,0,12,2,30,4,0,0,4,0,30,5,7,0,12,3,30,6,6,0,12,3,30,4,0,0,4,1,-15,3,1
2,4,11,3,30,5,7,0,12,2,30,4,0,0,4,0,30,5,7,0,12,3,30,6,6,0,12,3,30,4,0,0,4,1,-15,3,1
2,0,17,3,30,6,8,0,14,4,30,6,0,0,6,0,30,4,10,0,14,5,30,6,8,0,14,3,30,4,0,0,4,1,-15,3,1
2,2,17,3,30,6,8,0,14,4,30,6,0,0,6,0,30,4,10,0,14,5,30,6,8,0,14,3,30,4,0,0,4,1,-15,3,1
2,2,19,0,30,5,8,0,13,0,30,4,4,0,8,0,30,7,6,0,13,2,30,6,7,0,13,0,30,9,0,0,9,1,-15,3,1
2,3,25,0,30,4,10,0,14,5,30,6,0,0,6,0,30,6,8,0,14,3,30,10,4,0,14,5,30,6,0,0,6,1,-15,3,1
2,4,27,1,30,5,10,0,15,5,30,2,0,0,2,0,30,2,13,0,15,1,30,6,9,0,15,4,30,6,0,0,6,1,-15,3,1
2,3,29,0,30,6,8,0,14,6,30,12,0,0,12,0,30,5,9,0,14,0,30,1,13,0,14,1,30,9,0,0,9,1,-15,3,1
2,2,39,0,30,4,7,0,11,5,30,6,0,0,6,0,30,5,6,0,11,2,30,2,9,0,11,6,30,5,0,0,5,1,-15,3,1
2,2,4,2,30,5,3,0,8,4,30,3,1,0,4,0,30,3,5,0,8,0,30,6,2,0,8,1,30,3,1,0,4,0,-27,3,0
2,3,8,0,30,6,1,0,7,3,30,2,0,0,2,5,30,5,2,0,7,1,30,7,0,0,7,0,30,3,0,0,3,0,-27,3,0
2,2,11,1,30,5,7,0,12,1,30,4,0,0,4,0,30,5,7,0,12,0,30,6,6,0,12,3,30,4,0,0,4,1,-15,3,1
2,3,11,1,30,5,7,0,12,1,30,4,0,0,4,0,30,5,7,0,12,0,30,6,6,0,12,3,30,4,0,0,4,1,-15,3,1
2,1,13,3,30,6,1,0,7,0,30,4,0,0,4,3,30,7,0,0,7,9,30,7,0,0,7,4,30,4,0,0,4,1,-15,3,1
2,2,13,3,30,6,1,0,7,0,30,4,0,0,4,3,30,7,0,0,7,9,30,7,0,0,7,4,30,4,0,0,4,1,-15,3,1
2,4,13,3,30,6,1,0,7,0,30,4,0,0,4,3,30,7,0,0,7,9,30,7,0,0,7,4,30,4,0,0,4,1,-15,3,1
2,1,17,3,30,9,5,0,14,3,30,6,0,0,6,0,30,5,9,0,14,2,30,7,7,0,14,4,30,4,0,0,4,1,-15,3,1
2,3,17,3,30,9,5,0,14,3,30,6,0,0,6,0,30,5,9,0,14,2,30,7,7,0,14,4,30,4,0,0,4,1,-15,3,1
2,2,19,1,30,3,10,0,13,2,30,4,4,0,8,2,30,6,7,0,13,5,30,9,4,0,13,0,30,6,3,0,9,1,-15,3,1
2,3,25,1,30,5,9,0,14,5,30,6,0,0,6,0,30,6,8,0,14,2,30,5,9,0,14,6,30,6,0,0,6,1,-15,3,1
2,0,4,3,30,6,2,0,8,4,30,2,2,0,4,1,30,5,3,0,8,0,30,4,4,0,8,1,30,3,1,0,4,0,-27,3,0
2,1,4,3,30,6,2,0,8,4,30,2,2,0,4,1,30,5,3,0,8,0,30,4,4,0,8,1,30,3,1,0,4,0,-27,3,0
2,3,4,3,30,6,2,0,8,4,30,2,2,0,4,1,30,5,3,0,8,0,30,4,4,0,8,1,30,3,1,0,4,0,-27,3,0
2,4,4,3,30,6,2,0,8,4,30,2,2,0,4,1,30,5,3,0,8,0,30,4,4,0,8,1,30,3,1,0,4,0,-27,3,0
2,3,17,3,30,9,5,0,14,2,30,6,0,0,6,0,30,6,8,0,14,4,30,4,10,0,14,1,30,4,0,0,4,1,-15,3,1
2,4,17,3,30,9,5,0,14,2,30,6,0,0,6,0,30,6,8,0,14,4,30,4,10,0,14,1,30,4,0,0,4,1,-15,3,1
2,2,19,0,30,3,10,0,13,2,30,5,3,0,8,0,30,6,7,0,13,2,30,4,9,0,13,2,30,8,1,0,9,1,-15,3,1
2,3,23,1,30,4,9,0,13,2,30,6,0,0,6,4,30,11,2,0,13,1,30,5,8,0,13,1,30,6,0,0,6,1,-15,3,1
2,4,23,1,30,4,9,0,13,2,30,6,0,0,6,4,30,11,2,0,13,1,30,5,8,0,13,1,30,6,0,0,6,1,-15,3,1
2,4,25,2,30,9,5,0,14,4,30,6,0,0,6,0,30,6,8,0,14,1,30,9,5,0,14,3,30,5,1,0,6,1,-15,3,1
2,3,31,4,30,7,5,0,12,6,30,8,0,0,8,3,30,7,5,0,12,0,30,3,9,0,12,1,30,5,1,0,6,1,-15,3,1
2,3,36,0,30,2,7,0,9,6,30,2,0,0,2,10,30,5,4,0,9,1,30,3,6,0,9,7,30,3,0,0,3,1,-15,3,1
2,2,39,0,30,3,8,0,11,6,30,6,0,0,6,1,30,7,4,0,11,0,30,2,9,0,11,3,30,5,0,0,5,1,-15,3,1
2,3,39,0,30,3,8,0,11,6,30,6,0,0,6,1,30,7,4,0,11,0,30,2,9,0,11,3,30,5,0,0,5,1,-15,3,1
2,4,39,0,30,3,8,0,11,6,30,6,0,0,6,1,30,7,4,0,11,0,30,2,9,0,11,3,30,5,0,0,5,1,-15,3,1
2,1,5,0,30,0,5,0,5,2,30,2,2,0,4,0,30,2,3,0,5,0,30,1,4,0,5,0,30,1,1,0,2,0,-27,3,0
2,2,19,0,30,10,3,0,13,0,30,5,3,0,8,0,30,9,4,0,13,0,30,3,10,0,13,1,30,7,2,0,9,1,-15,3,1
2,4,19,0,30,10,3,0,13,0,30,5,3,0,8,0,30,9,4,0,13,0,30,3,10,0,13,1,30,7,2,0,9,1,-15,3,1
2,2,27,0,30,8,7,0,15,2,30,2,0,0,2,2,30,3,12,0,15,0,30,3,12,0,15,1,30,5,1,0,6,1,-15,3,1
2,3,27,0,30,8,7,0,15,2,30,2,0,0,2,2,30,3,12,0,15,0,30,3,12,0,15,1,30,5,1,0,6,1,-15,3,1
2,4,27,0,30,8,7,0,15,2,30,2,0,0,2,2,30,3,12,0,15,0,30,3,12,0,15,1,30,5,1,0,6,1,-15,3,1
2,3,29,0,30,7,7,0,14,6,30,11,1,0,12,0,30,2,12,0,14,0,30,1,13,0,14,3,30,9,0,0,9,1,-15,3,1
2,2,33,1,30,4,7,0,11,3,30,4,0,0,4,0,30,11,0,0,11,2,30,3,8,0,11,0,30,4,0,0,4,1,-15,3,1
2,2,37,1,30,5,6,0,11,6,30,8,0,0,8,0,30,8,3,0,11,2,30,7,4,0,11,7,30,6,0,0,6,1,-15,3,1
2,3,39,0,30,5,6,0,11,7,30,6,0,0,6,0,30,4,7,0,11,3,30,3,8,0,11,3,30,5,0,0,5,1,-15,3,1
2,0,4,2,30,4,4,0,8,4,30,2,2,0,4,0,30,1,7,0,8,7,30,7,1,0,8,2,30,3,1,0,4,0,-27,3,0
2,1,4,2,30,4,4,0,8,4,30,2,2,0,4,0,30,1,7,0,8,7,30,7,1,0,8,2,30,3,1,0,4,0,-27,3,0
2,3,5,0,30,2,3,0,5,3,30,3,1,0,4,0,30,1,4,0,5,0,30,2,3,0,5,0,30,1,1,0,2,0,-27,3,0
2,2,11,0,30,5,7,0,12,1,30,4,0,0,4,0,30,8,4,0,12,5,30,9,3,0,12,5,30,4,0,0,4,1,-15,3,1
2,3,11,0,30,5,7,0,12,1,30,4,0,0,4,0,30,8,4,0,12,5,30,9,3,0,12,5,30,4,0,0,4,1,-15,3,1
2,1,13,3,30,5,2,0,7,0,30,4,0,0,4,2,30,6,1,0,7,11,30,4,3,0,7,1,30,4,0,0,4,1,-15,3,1
2,2,13,3,30,5,2,0,7,0,30,4,0,0,4,2,30,6,1,0,7,11,30,4,3,0,7,1,30,4,0,0,4,1,-15,3,1
2,4,17,4,30,11,3,0,14,2,30,6,0,0,6,0,30,5,9,0,14,1,30,3,11,0,14,4,30,4,0,0,4,1,-15,3,1
2,3,19,0,30,2,11,0,13,2,30,4,4,0,8,0,30,4,9,0,13,0,30,6,7,0,13,0,30,8,1,0,9,1,-15,3,1
2,4,22,2,30,8,0,0,8,2,30,2,0,0,2,0,30,5,3,0,8,0,30,3,5,0,8,1,30,2,2,0,4,1,-15,3,1
2,0,27,1,30,7,8,0,15,2,30,2,0,0,2,0,30,5,10,0,15,1,30,7,8,0,15,1,30,5,1,0,6,1,-15,3,1
2,4,31,4,30,7,5,0,12,4,30,8,0,0,8,6,30,9,3,0,12,0,30,3,9,0,12,0,30,2,4,0,6,1,-15,3,1
2,4,8,0,30,7,0,0,7,4,30,2,0,0,2,4,30,3,4,0,7,0,30,5,2,0,7,3,30,3,0,0,3,0,-27,3,0
2,2,13,3,30,7,0,0,7,0,30,4,0,0,4,2,30,6,1,0,7,5,30,1,6,0,7,5,30,4,0,0,4,1,-15,3,1
2,1,17,4,30,7,7,0,14,3,30,6,0,0,6,0,30,6,8,0,14,1,30,7,7,0,14,6,30,4,0,0,4,1,-15,3,1
2,4,17,4,30,7,7,0,14,3,30,6,0,0,6,0,30,6,8,0,14,1,30,7,7,0,14,3,30,4,0,0,4,1,-15,3,1
2,4,25,2,30,6,8,0,14,3,30,6,0,0,6,0,30,5,9,0,14,1,30,5,9,0,14,4,30,5,1,0,6,1,-15,3,1
2,3,27,1,30,4,11,0,15,3,30,2,0,0,2,0,30,4,11,0,15,3,30,5,10,0,15,3,30,6,0,0,6,1,-15,3,1
2,1,29,0,30,6,8,0,14,6,30,10,2,0,12,0,30,4,10,0,14,0,30,1,13,0,14,1,30,9,0,0,9,1,-15,3,1
2,4,29,0,30,6,8,0,14,6,30,10,2,0,12,0,30,4,10,0,14,0,30,1,13,0,14,1,30,9,0,0,9,1,-15,3,1
2,4,37,1,30,10,1,0,11,5,30,4,4,0,8,3,30,11,0,0,11,0,30,2,9,0,11,1,30,6,0,0,6,1,-15,3,1
2,4,17,3,30,11,3,0,14,4,30,6,0,0,6,0,30,3,11,0,14,1,30,6,8,0,14,1,30,4,0,0,4,1,-15,3,1
2,4,25,1,30,2,12,0,14,5,30,6,0,0,6,0,30,7,7,0,14,0,30,9,5,0,14,5,30,6,0,0,6,1,-15,3,1
2,4,27,2,30,5,10,0,15,5,30,2,0,0,2,0,30,2,13,0,15,0,30,4,11,0,15,1,30,4,2,0,6,1,-15,3,1
2,3,29,0,30,6,8,0,14,4,30,12,0,0,12,0,30,7,7,0,14,0,30,1,13,0,14,0,30,9,0,0,9,1,-15,3,1
2,4,29,0,30,6,8,0,14,4,30,12,0,0,12,0,30,7,7,0,14,0,30,1,13,0,14,0,30,9,0,0,9,1,-15,3,1
2,2,31,1,30,10,2,0,12,5,30,8,0,0,8,3,30,8,4,0,12,0,30,3,9,0,12,1,30,5,1,0,6,1,-15,3,1
2,1,5,0,30,2,3,0,5,3,30,0,4,0,4,0,30,0,5,0,5,0,30,2,3,0,5,0,30,1,1,0,2,0,-27,3,0
2,3,5,0,30,2,3,0,5,3,30,0,4,0,4,0,30,0,5,0,5,0,30,2,3,0,5,0,30,1,1,0,2,0,-27,3,0
2,3,8,1,30,7,0,0,7,4,30,2,0,0,2,5,30,4,3,0,7,2,30,6,1,0,7,3,30,3,0,0,3,0,-27,3,0
2,4,8,1,30,7,0,0,7,4,30,2,0,0,2,5,30,4,3,0,7,2,30,6,1,0,7,3,30,3,0,0,3,0,-27,3,0
2,4,15,0,30,6,7,0,13,0,30,6,0,0,6,1,30,3,10,0,13,1,30,3,10,0,13,2,30,5,4,0,9,1,-15,3,1
2,1,17,2,30,10,4,0,14,3,30,6,0,0,6,0,30,6,8,0,14,2,30,8,6,0,14,7,30,4,0,0,4,1,-15,3,1
2,2,17,2,30,10,4,0,14,3,30,6,0,0,6,0,30,6,8,0,14,2,30,8,6,0,14,7,30,4,0,0,4,1,-15,3,1
2,3,17,2,30,10,4,0,14,3,30,6,0,0,6,0,30,6,8,0,14,2,30,8,6,0,14,7,30,4,0,0,4,1,-15,3,1
2,3,19,0,30,4,9,0,13,2,30,8,0,0,8,0,30,7,6,0,13,0,30,7,6,0,13,1,30,8,1,0,9,1,-15,3,1
2,3,23,3,30,5,8,0,13,3,30,6,0,0,6,4,30,11,2,0,13,2,30,6,7,0,13,0,30,6,0,0,6,1,-15,3,1
2,1,25,2,30,9,5,0,14,3,30,6,0,0,6,0,30,5,9,0,14,1,30,5,9,0,14,5,30,5,1,0,6,1,-15,3,1
2,3,27,1,30,3,12,0,15,1,30,2,0,0,2,0,30,2,13,0,15,0,30,2,13,0,15,4,30,6,0,0,6,1,-15,3,1
2,4,29,0,30,3,11,0,14,6,30,12,0,0,12,0,30,6,8,0,14,0,30,1,13,0,14,0,30,9,0,0,9,1,-15,3,1
2,3,33,1,30,2,9,0,11,6,30,4,0,0,4,2,30,8,3,0,11,0,30,4,7,0,11,5,30,4,0,0,4,1,-15,3,1
2,2,19,0,30,4,9,0,13,2,30,5,3,0,8,0,30,5,8,0,13,7,30,5,8,0,13,2,30,9,0,0,9,1,-15,3,1
2,4,19,0,30,4,9,0,13,2,30,5,3,0,8,0,30,5,8,0,13,7,30,5,8,0,13,2,30,9,0,0,9,1,-15,3,1
2,2,23,2,30,7,6,0,13,2,30,6,0,0,6,3,30,13,0,0,13,0,30,9,4,0,13,2,30,5,1,0,6,1,-15,3,1
2,3,27,0,30,5,10,0,15,1,30,1,1,0,2,0,30,9,6,0,15,4,30,3,12,0,15,0,30,5,1,0,6,1,-15,3,1
2,4,27,0,30,5,10,0,15,1,30,1,1,0,2,0,30,9,6,0,15,4,30,3,12,0,15,0,30,5,1,0,6,1,-15,3,1
2,0,31,2,30,6,6,0,12,7,30,8,0,0,8,3,30,5,7,0,12,0,30,6,6,0,12,3,30,6,0,0,6,1,-15,3,1
2,2,31,2,30,6,6,0,12,7,30,8,0,0,8,3,30,5,7,0,12,0,30,6,6,0,12,3,30,6,0,0,6,1,-15,3,1
2,3,31,2,30,6,6,0,12,7,30,8,0,0,8,3,30,5,7,0,12,0,30,6,6,0,12,3,30,6,0,0,6,1,-15,3,1
2,1,37,1,30,6,5,0,11,4,30,8,0,0,8,3,30,11,0,0,11,2,30,3,8,0,11,2,30,2,4,0,6,1,-15,3,1
2,2,37,1,30,6,5,0,11,4,30,8,0,0,8,3,30,11,0,0,11,2,30,3,8,0,11,2,30,2,4,0,6,1,-15,3,1
2,3,37,1,30,6,5,0,11,4,30,8,0,0,8,3,30,11,0,0,11,2,30,3,8,0,11,2,30,2,4,0,6,1,-15,3,1
2,4,17,2,30,7,7,0,14,2,30,6,0,0,6,0,30,10,4,0,14,1,30,6,8,0,14,0,30,4,0,0,4,1,-15,3,1
2,4,19,0,30,9,4,0,13,1,30,3,5,0,8,0,30,5,8,0,13,0,30,4,9,0,13,2,30,8,1,0,9,1,-15,3,1
2,2,23,1,30,4,9,0,13,2,30,6,0,0,6,4,30,10,3,0,13,0,30,4,9,0,13,3,30,6,0,0,6,1,-15,3,1
2,3,23,1,30,4,9,0,13,2,30,6,0,0,6,4,30,10,3,0,13,0,30,4,9,0,13,3,30,6,0,0,6,1,-15,3,1
2,4,23,1,30,4,9,0,13,2,30,6,0,0,6,4,30,10,3,0,13,0,30,4,9,0,13,3,30,6,0,0,6,1,-15,3,1
2,2,26,4,30,7,2,0,9,5,30,4,0,0,4,2,30,1,8,0,9,0,30,2,7,0,9,4,30,1,2,0,3,1,-15,3,1
2,3,26,4,30,7,2,0,9,5,30,4,0,0,4,2,30,1,8,0,9,0,30,2,7,0,9,4,30,1,2,0,3,1,-15,3,1
2,3,27,1,30,5,10,0,15,2,30,2,0,0,2,0,30,7,8,0,15,1,30,5,10,0,15,0,30,6,0,0,6,1,-15,3,1
2,0,29,0,30,5,9,0,14,6,30,7,5,0,12,0,30,3,11,0,14,0,30,5,9,0,14,2,30,9,0,0,9,1,-15,3,1
2,3,29,0,30,5,9,0,14,6,30,7,5,0,12,0,30,3,11,0,14,0,30,5,9,0,14,2,30,9,0,0,9,1,-15,3,1
2,2,31,1,30,8,4,0,12,3,30,8,0,0,8,3,30,10,2,0,12,0,30,3,9,0,12,1,30,3,3,0,6,1,-15,3,1
2,3,31,1,30,8,4,0,12,3,30,8,0,0,8,3,30,10,2,0,12,0,30,3,9,0,12,1,30,3,3,0,6,1,-15,3,1
2,4,31,1,30,8,4,0,12,3,30,8,0,0,8,3,30,10,2,0,12,0,30,3,9,0,12,1,30,3,3,0,6,1,-15,3,1
2,3,6,0,30,5,4,0,9,4,30,2,0,0,2,0,30,2,7,0,9,0,30,5,4,0,9,2,30,5,0,0,5,0,-27,3,0
2,4,19,1,30,6,7,0,13,1,30,7,1,0,8,0,30,8,5,0,13,2,30,4,9,0,13,3,30,8,1,0,9,1,-15,3,1
2,3,23,2,30,8,5,0,13,2,30,6,0,0,6,4,30,11,2,0,13,0,30,4,9,0,13,2,30,6,0,0,6,1,-15,3,1
2,4,27,0,30,3,12,0,15,4,30,2,0,0,2,0,30,10,5,0,15,0,30,3,12,0,15,1,30,5,1,0,6,1,-15,3,1
2,0,29,0,30,6,8,0,14,6,30,10,2,0,12,0,30,3,11,0,14,0,30,1,13,0,14,2,30,9,0,0,9,1,-15,3,1
2,3,29,0,30,6,8,0,14,6,30,10,2,0,12,0,30,3,11,0,14,0,30,1,13,0,14,2,30,9,0,0,9,1,-15,3,1
2,4,31,0,30,4,8,0,12,7,30,8,0,0,8,3,30,4,8,0,12,0,30,9,3,0,12,3,30,6,0,0,6,1,-15,3,1
2,2,47,0,30,1,13,0,14,6,30,4,0,0,4,2,30,14,0,0,14,0,30,2,12,0,14,8,30,7,0,0,7,1,-15,3,1
2,3,17,3,30,9,5,0,14,3,30,6,0,0,6,0,30,4,10,0,14,1,30,7,7,0,14,5,30,4,0,0,4,1,-15,3,1
2,4,17,3,30,9,5,0,14,3,30,6,0,0,6,0,30,4,10,0,14,1,30,7,7,0,14,5,30,4,0,0,4,1,-15,3,1
2,1,19,0,30,6,7,0,13,1,30,7,1,0,8,0,30,7,6,0,13,0,30,2,11,0,13,1,30,8,1,0,9,1,-15,3,1
2,2,21,8,30,7,3,0,10,4,30,5,1,0,6,1,30,3,7,0,10,1,30,4,6,0,10,3,30,4,0,0,4,1,-15,3,1
2,3,21,8,30,7,3,0,10,4,30,5,1,0,6,1,30,3,7,0,10,1,30,4,6,0,10,3,30,4,0,0,4,1,-15,3,1
2,4,21,8,30,7,3,0,10,4,30,5,1,0,6,1,30,3,7,0,10,1,30,4,6,0,10,3,30,4,0,0,4,1,-15,3,1
2,4,22,3,30,8,0,0,8,2,30,2,0,0,2,0,30,4,4,0,8,1,30,1,7,0,8,3,30,4,0,0,4,1,-15,3,1
2,2,25,0,30,7,7,0,14,3,30,6,0,0,6,0,30,13,1,0,14,1,30,4,10,0,14,4,30,5,1,0,6,1,-15,3,1
2,3,25,0,30,7,7,0,14,3,30,6,0,0,6,0,30,13,1,0,14,1,30,4,10,0,14,4,30,5,1,0,6,1,-15,3,1
2,4,25,0,30,7,7,0,14,3,30,6,0,0,6,0,30,13,1,0,14,1,30,4,10,0,14,4,30,5,1,0,6,1,-15,3,1
2,1,29,0,30,4,10,0,14,5,30,9,3,0,12,0,30,8,6,0,14,0,30,2,12,0,14,3,30,9,0,0,9,1,-15,3,1
2,3,29,0,30,4,10,0,14,5,30,9,3,0,12,0,30,8,6,0,14,0,30,2,12,0,14,3,30,9,0,0,9,1,-15,3,1
2,2,31,2,30,7,5,0,12,4,30,8,0,0,8,3,30,10,2,0,12,0,30,3,9,0,12,0,30,4,2,0,6,1,-15,3,1
2,4,31,2,30,7,5,0,12,4,30,8,0,0,8,3,30,10,2,0,12,0,30,3,9,0,12,0,30,4,2,0,6,1,-15,3,1
2,2,47,0,30,3,11,0,14,5,30,4,0,0,4,0,30,7,7,0,14,1,30,3,11,0,14,7,30,7,0,0,7,1,-15,3,1
2,3,47,0,30,3,11,0,14,5,30,4,0,0,4,0,30,7,7,0,14,1,30,3,11,0,14,7,30,7,0,0,7,1,-15,3,1
2,2,17,2,30,9,5,0,14,2,30,6,0,0,6,0,30,6,8,0,14,1,30,7,7,0,14,3,30,4,0,0,4,1,-15,3,1
2,3,17,2,30,9,5,0,14,2,30,6,0,0,6,0,30,6,8,0,14,1,30,7,7,0,14,3,30,4,0,0,4,1,-15,3,1
2,4,17,2,30,9,5,0,14,2,30,6,0,0,6,0,30,6,8,0,14,1,30,7,7,0,14,3,30,4,0,0,4,1,-15,3,1
2,1,19,0,30,4,9,0,13,2,30,6,2,0,8,0,30,4,9,0,13,4,30,5,8,0,13,2,30,8,1,0,9,1,-15,3,1
2,1,21,3,30,7,3,0,10,4,30,6,0,0,6,1,30,3,7,0,10,6,30,4,6,0,10,2,30,4,0,0,4,1,-15,3,1
2,2,21,3,30,7,3,0,10,4,30,6,0,0,6,1,30,3,7,0,10,6,30,4,6,0,10,2,30,4,0,0,4,1,-15,3,1
2,3,25,1,30,11,3,0,14,2,30,6,0,0,6,0,30,6,8,0,14,1,30,4,10,0,14,5,30,5,1,0,6,1,-15,3,1
2,0,27,1,30,3,12,0,15,5,30,1,1,0,2,0,30,6,9,0,15,0,30,3,12,0,15,4,30,6,0,0,6,1,-15,3,1
2,1,27,1,30,3,12,0,15,5,30,1,1,0,2,0,30,6,9,0,15,0,30,3,12,0,15,4,30,6,0,0,6,1,-15,3,1
2,4,27,1,30,3,12,0,15,5,30,1,1,0,2,0,30,6,9,0,15,0,30,3,12,0,15,2,30,6,0,0,6,1,-15,3,1
2,3,35,0,30,6,7,0,13,3,30,2,0,0,2,1,30,6,7,0,13,5,30,2,11,0,13,7,30,8,0,0,8,1,-15,3,1
2,4,1,0,30,4,6,0,10,3,30,2,0,0,2,1,30,4,6,0,10,3,30,6,4,0,10,6,30,6,0,0,6,0,-27,3,0
2,1,17,3,30,10,4,0,14,2,30,6,0,0,6,0,30,7,7,0,14,1,30,6,8,0,14,2,30,4,0,0,4,1,-15,3,1
2,2,17,3,30,10,4,0,14,2,30,6,0,0,6,0,30,7,7,0,14,1,30,6,8,0,14,2,30,4,0,0,4,1,-15,3,1
2,2,19,0,30,4,9,0,13,2,30,4,4,0,8,0,30,9,4,0,13,3,30,4,9,0,13,3,30,8,1,0,9,1,-15,3,1
2,3,23,2,30,6,7,0,13,3,30,6,0,0,6,0,30,12,1,0,13,0,30,5,8,0,13,5,30,6,0,0,6,1,-15,3,1
2,3,25,1,30,3,11,0,14,5,30,6,0,0,6,0,30,4,10,0,14,4,30,9,5,0,14,4,30,6,0,0,6,1,-15,3,1
2,2,27,1,30,9,6,0,15,4,30,2,0,0,2,0,30,5,10,0,15,0,30,3,12,0,15,0,30,6,0,0,6,1,-15,3,1
2,3,27,1,30,9,6,0,15,4,30,2,0,0,2,0,30,5,10,0,15,0,30,3,12,0,15,0,30,6,0,0,6,1,-15,3,1
2,0,31,1,30,7,5,0,12,5,30,8,0,0,8,5,30,7,5,0,12,0,30,3,9,0,12,1,30,5,1,0,6,1,-15,3,1
2,2,31,1,30,7,5,0,12,5,30,8,0,0,8,5,30,7,5,0,12,0,30,3,9,0,12,1,30,5,1,0,6,1,-15,3,1
2,3,31,1,30,7,5,0,12,5,30,8,0,0,8,5,30,7,5,0,12,0,30,3,9,0,12,1,30,5,1,0,6,1,-15,3,1
2,4,31,1,30,7,5,0,12,5,30,8,0,0,8,5,30,7,5,0,12,0,30,3,9,0,12,1,30,5,1,0,6,1,-15,3,1
2,1,4,3,30,4,4,0,8,5,30,4,0,0,4,1,30,1,7,0,8,0,30,6,2,0,8,2,30,4,0,0,4,0,-27,3,0
2,4,17,3,30,8,6,0,14,2,30,6,0,0,6,0,30,7,7,0,14,0,30,6,8,0,14,6,30,4,0,0,4,1,-15,3,1
2,4,19,0,30,3,10,0,13,2,30,8,0,0,8,3,30,6,7,0,13,0,30,4,9,0,13,0,30,6,3,0,9,1,-15,3,1
2,1,23,2,30,5,8,0,13,2,30,6,0,0,6,8,30,11,2,0,13,0,30,5,8,0,13,4,30,6,0,0,6,1,-15,3,1
2,3,23,2,30,5,8,0,13,2,30,6,0,0,6,8,30,11,2,0,13,0,30,5,8,0,13,4,30,6,0,0,6,1,-15,3,1
2,4,23,2,30,5,8,0,13,2,30,6,0,0,6,8,30,11,2,0,13,0,30,5,8,0,13,4,30,6,0,0,6,1,-15,3,1
2,4,25,3,30,8,6,0,14,5,30,6,0,0,6,0,30,7,7,0,14,0,30,5,9,0,14,4,30,5,1,0,6,1,-15,3,1
2,3,29,0,30,6,8,0,14,6,30,12,0,0,12,0,30,7,7,0,14,0,30,1,13,0,14,0,30,9,0,0,9,1,-15,3,1
2,4,29,0,30,6,8,0,14,6,30,12,0,0,12,0,30,7,7,0,14,0,30,1,13,0,14,0,30,9,0,0,9,1,-15,3,1
2,2,31,3,30,8,4,0,12,3,30,8,0,0,8,3,30,10,2,0,12,0,30,3,9,0,12,2,30,4,2,0,6,1,-15,3,1
2,3,31,3,30,8,4,0,12,3,30,8,0,0,8,3,30,10,2,0,12,0,30,3,9,0,12,2,30,4,2,0,6,1,-15,3,1
2,0,5,0,30,2,3,0,5,3,30,0,4,0,4,0,30,1,4,0,5,0,30,3,2,0,5,0,30,1,1,0,2,0,-27,3,0
2,2,13,1,30,5,2,0,7,0,30,4,0,0,4,2,30,5,2,0,7,8,30,5,2,0,7,5,30,4,0,0,4,1,-15,3,1
2,2,17,3,30,10,4,0,14,3,30,6,0,0,6,0,30,4,10,0,14,2,30,6,8,0,14,5,30,4,0,0,4,1,-15,3,1
2,3,17,3,30,10,4,0,14,3,30,6,0,0,6,0,30,4,10,0,14,2,30,6,8,0,14,5,30,4,0,0,4,1,-15,3,1
2,2,19,0,30,4,9,0,13,2,30,5,3,0,8,0,30,5,8,0,13,1,30,5,8,0,13,2,30,9,0,0,9,1,-15,3,1
2,4,27,1,30,4,11,0,15,4,30,1,1,0,2,0,30,9,6,0,15,2,30,7,8,0,15,2,30,6,0,0,6,1,-15,3,1
2,0,29,0,30,10,4,0,14,6,30,12,0,0,12,0,30,2,12,0,14,0,30,0,14,0,14,4,30,9,0,0,9,1,-15,3,1
2,1,29,0,30,10,4,0,14,6,30,12,0,0,12,0,30,2,12,0,14,0,30,0,14,0,14,4,30,9,0,0,9,1,-15,3,1
2,2,29,0,30,10,4,0,14,6,30,12,0,0,12,0,30,2,12,0,14,0,30,0,14,0,14,4,30,9,0,0,9,1,-15,3,1
2,3,39,0,30,3,8,0,11,6,30,6,0,0,6,0,30,4,7,0,11,2,30,2,9,0,11,6,30,5,0,0,5,1,-15,3,1
2,4,13,0,30,6,1,0,7,0,30,4,0,0,4,2,30,6,1,0,7,13,30,6,1,0,7,5,30,4,0,0,4,1,-15,3,1
2,4,15,1,30,5,8,0,13,1,30,6,0,0,6,0,30,3,10,0,13,1,30,5,8,0,13,2,30,6,3,0,9,1,-15,3,1
2,1,17,4,30,8,6,0,14,3,30,6,0,0,6,2,30,5,9,0,14,2,30,5,9,0,14,0,30,4,0,0,4,1,-15,3,1
2,3,17,0,30,8,6,0,14,3,30,6,0,0,6,2,30,5,9,0,14,2,30,5,9,0,14,0,30,4,0,0,4,1,-15,3,1
2,1,19,0,30,4,9,0,13,2,30,6,2,0,8,0,30,9,4,0,13,0,30,5,8,0,13,2,30,8,1,0,9,1,-15,3,1
2,3,25,0,30,5,9,0,14,3,30,6,0,0,6,0,30,10,4,0,14,1,30,6,8,0,14,3,30,5,1,0,6,1,-15,3,1
2,3,27,1,30,5,10,0,15,1,30,1,1,0,2,0,30,6,9,0,15,4,30,3,12,0,15,4,30,6,0,0,6,1,-15,3,1
2,4,27,1,30,5,10,0,15,1,30,1,1,0,2,0,30,6,9,0,15,4,30,3,12,0,15,4,30,6,0,0,6,1,-15,3,1
2,0,31,0,30,3,9,0,12,6,30,8,0,0,8,3,30,5,7,0,12,2,30,8,4,0,12,5,30,6,0,0,6,1,-15,3,1
2,4,35,1,30,8,5,0,13,6,30,2,0,0,2,1,30,2,11,0,13,2,30,3,10,0,13,6,30,8,0,0,8,1,-15,3,1
2,0,39,0,30,5,6,0,11,6,30,6,0,0,6,0,30,7,4,0,11,5,30,4,7,0,11,0,30,3,2,0,5,1,-15,3,1
2,1,39,0,30,5,6,0,11,6,30,6,0,0,6,0,30,7,4,0,11,5,30,4,7,0,11,0,30,3,2,0,5,1,-15,3,1
2,4,39,0,30,5,6,0,11,6,30,6,0,0,6,0,30,7,4,0,11,5,30,4,7,0,11,0,30,3,2,0,5,1,-15,3,1
2,0,1,0,30,7,3,0,10,2,30,2,0,0,2,6,30,5,5,0,10,7,30,7,3,0,10,6,30,6,0,0,6,0,-27,3,0
2,2,1,0,30,7,3,0,10,2,30,2,0,0,2,6,30,5,5,0,10,7,30,7,3,0,10,6,30,6,0,0,6,0,-27,3,0
2,4,1,0,30,7,3,0,10,2,30,2,0,0,2,6,30,5,5,0,10,7,30,7,3,0,10,6,30,6,0,0,6,0,-27,3,0
2,4,7,1,30,4,5,0,9,3,30,4,0,0,4,2,30,6,3,0,9,4,30,3,6,0,9,1,30,4,2,0,6,0,-27,3,0
2,2,11,0,30,1,3,0,4,0,30,0,0,0,0,0,30,1,3,0,4,6,30,4,0,0,4,3,30,1,0,0,1,1,-15,3,1
2,4,22,1,30,6,2,0,8,3,30,2,0,0,2,0,30,3,5,0,8,2,30,2,6,0,8,1,30,4,0,0,4,1,-15,3,1
2,0,26,0,30,6,3,0,9,4,30,4,0,0,4,5,30,2,7,0,9,0,30,2,7,0,9,5,30,2,1,0,3,1,-15,3,1
2,1,27,3,30,5,10,0,15,1,30,2,0,0,2,0,30,12,3,0,15,0,30,4,11,0,15,4,30,3,3,0,6,1,-15,3,1
2,3,27,3,30,5,10,0,15,1,30,2,0,0,2,0,30,12,3,0,15,0,30,4,11,0,15,4,30,3,3,0,6,1,-15,3,1
2,4,27,3,30,5,10,0,15,1,30,2,0,0,2,0,30,12,3,0,15,0,30,4,11,0,15,4,30,3,3,0,6,1,-15,3,1
2,2,31,1,30,2,10,0,12,8,30,8,0,0,8,3,30,4,8,0,12,1,30,8,4,0,12,7,30,6,0,0,6,1,-15,3,1
2,3,31,1,30,2,10,0,12,8,30,8,0,0,8,3,30,4,8,0,12,1,30,8,4,0,12,7,30,6,0,0,6,1,-15,3,1
2,3,23,3,30,4,9,0,13,3,30,6,0,0,6,1,30,11,2,0,13,1,30,5,8,0,13,4,30,6,0,0,6,1,-15,3,1
2,1,25,1,30,6,8,0,14,5,30,6,0,0,6,0,30,8,6,0,14,1,30,6,8,0,14,4,30,5,1,0,6,1,-15,3,1
2,4,25,1,30,6,8,0,14,5,30,6,0,0,6,0,30,8,6,0,14,1,30,6,8,0,14,4,30,5,1,0,6,1,-15,3,1
2,3,27,1,30,5,10,0,15,2,30,2,0,0,2,0,30,8,7,0,15,2,30,6,9,0,15,0,30,6,0,0,6,1,-15,3,1
2,3,29,0,30,12,2,0,14,4,30,9,3,0,12,0,30,3,11,0,14,0,30,1,13,0,14,2,30,9,0,0,9,1,-15,3,1
2,3,39,0,30,4,7,0,11,5,30,6,0,0,6,0,30,8,3,0,11,1,30,3,8,0,11,4,30,5,0,0,5,1,-15,3,1
2,4,39,0,30,4,7,0,11,5,30,6,0,0,6,0,30,8,3,0,11,1,30,3,8,0,11,4,30,5,0,0,5,1,-15,3,1
2,4,8,0,30,7,0,0,7,3,30,2,0,0,2,0,30,5,2,0,7,0,30,4,3,0,7,3,30,3,0,0,3,0,-27,3,0
2,4,11,0,30,2,2,0,4,0,30,0,0,0,0,0,30,2,2,0,4,3,30,3,1,0,4,2,30,1,0,0,1,1,-15,3,1
2,2,13,2,30,3,0,0,3,0,30,2,0,0,2,0,30,3,0,0,3,6,30,2,1,0,3,2,30,2,0,0,2,1,-15,3,1
2,3,13,2,30,3,0,0,3,0,30,2,0,0,2,0,30,3,0,0,3,6,30,2,1,0,3,2,30,2,0,0,2,1,-15,3,1
2,1,21,0,30,5,5,0,10,3,30,4,2,0,6,0,30,4,6,0,10,2,30,4,6,0,10,4,30,4,0,0,4,1,-15,3,1
2,3,21,0,30,5,5,0,10,3,30,4,2,0,6,0,30,4,6,0,10,2,30,4,6,0,10,0,30,4,0,0,4,1,-15,3,1
2,2,25,1,30,7,7,0,14,4,30,6,0,0,6,0,30,5,9,0,14,1,30,7,7,0,14,4,30,5,1,0,6,1,-15,3,1
2,3,33,1,30,3,8,0,11,5,30,4,0,0,4,0,30,9,2,0,11,3,30,4,7,0,11,6,30,4,0,0,4,1,-15,3,1
2,4,2,0,30,6,4,0,10,2,30,3,1,0,4,3,30,7,3,0,10,4,30,8,2,0,10,1,30,2,6,0,8,0,-27,3,0
2,3,3,0,30,1,3,0,4,2,30,4,0,0,4,1,30,1,3,0,4,0,30,2,2,0,4,0,30,2,1,0,3,0,-27,3,0
2,4,3,0,30,1,3,0,4,2,30,4,0,0,4,1,30,1,3,0,4,0,30,2,2,0,4,0,30,2,1,0,3,0,-27,3,0
2,2,13,0,30,3,0,0,3,0,30,2,0,0,2,2,30,3,0,0,3,7,30,2,1,0,3,4,30,2,0,0,2,1,-15,3,1
2,2,17,2,30,5,9,0,14,3,30,6,0,0,6,0,30,3,11,0,14,1,30,5,9,0,14,6,30,4,0,0,4,1,-15,3,1
2,3,17,2,30,5,9,0,14,3,30,6,0,0,6,0,30,3,11,0,14,1,30,5,9,0,14,6,30,4,0,0,4,1,-15,3,1
2,4,19,0,30,2,11,0,13,3,30,7,1,0,8,4,30,4,9,0,13,2,30,6,7,0,13,0,30,7,2,0,9,1,-15,3,1
2,3,25,2,30,6,8,0,14,5,30,6,0,0,6,0,30,5,9,0,14,0,30,5,9,0,14,4,30,5,1,0,6,1,-15,3,1
2,4,25,2,30,6,8,0,14,5,30,6,0,0,6,0,30,5,9,0,14,0,30,5,9,0,14,4,30,5,1,0,6,1,-15,3,1
2,0,26,0,30,8,1,0,9,5,30,4,0,0,4,2,30,0,9,0,9,0,30,1,8,0,9,6,30,3,0,0,3,1,-15,3,1
2,1,27,1,30,4,11,0,15,5,30,2,0,0,2,0,30,6,9,0,15,1,30,5,10,0,15,2,30,6,0,0,6,1,-15,3,1
2,1,41,0,30,8,4,0,12,6,30,6,2,0,8,0,30,4,8,0,12,0,30,3,9,0,12,2,30,7,0,0,7,1,-15,3,1
2,2,41,0,30,8,4,0,12,6,30,6,2,0,8,0,30,4,8,0,12,0,30,3,9,0,12,2,30,7,0,0,7,1,-15,3,1
2,3,41,0,30,8,4,0,12,6,30,6,2,0,8,0,30,4,8,0,12,0,30,3,9,0,12,2,30,7,0,0,7,1,-15,3,1
2,3,5,0,30,0,5,0,5,2,30,1,3,0,4,0,30,1,4,0,5,0,30,1,4,0,5,0,30,2,0,0,2,0,-27,3,0
2,4,8,1,30,7,0,0,7,2,30,2,0,0,2,0,30,3,4,0,7,4,30,5,2,0,7,5,30,3,0,0,3,0,-27,3,0
2,3,13,2,30,6,1,0,7,1,30,4,0,0,4,5,30,7,0,0,7,5,30,5,2,0,7,4,30,4,0,0,4,1,-15,3,1
2,4,17,5,30,8,6,0,14,3,30,6,0,0,6,1,30,7,7,0,14,1,30,6,8,0,14,2,30,4,0,0,4,1,-15,3,1
2,4,19,0,30,4,9,0,13,2,30,4,4,0,8,0,30,9,4,0,13,0,30,6,7,0,13,0,30,8,1,0,9,1,-15,3,1
2,3,21,1,30,7,3,0,10,3,30,6,0,0,6,1,30,4,6,0,10,1,30,4,6,0,10,4,30,4,0,0,4,1,-15,3,1
2,3,23,0,30,4,9,0,13,4,30,6,0,0,6,6,30,9,4,0,13,0,30,8,5,0,13,5,30,6,0,0,6,1,-15,3,1
2,0,25,2,30,5,9,0,14,6,30,6,0,0,6,0,30,3,11,0,14,2,30,10,4,0,14,4,30,6,0,0,6,1,-15,3,1
2,3,31,0,30,9,3,0,12,3,30,8,0,0,8,3,30,10,2,0,12,0,30,3,9,0,12,0,30,3,3,0,6,1,-15,3,1
2,0,4,2,30,7,1,0,8,5,30,3,1,0,4,1,30,1,7,0,8,0,30,5,3,0,8,3,30,4,0,0,4,0,-27,3,0
2,4,8,0,30,7,0,0,7,4,30,2,0,0,2,0,30,3,4,0,7,2,30,7,0,0,7,3,30,3,0,0,3,0,-27,3,0
2,1,19,0,30,4,9,0,13,2,30,4,4,0,8,0,30,5,8,0,13,4,30,4,9,0,13,1,30,8,1,0,9,1,-15,3,1
2,4,21,2,30,8,2,0,10,3,30,6,0,0,6,1,30,4,6,0,10,0,30,3,7,0,10,1,30,4,0,0,4,1,-15,3,1
2,4,23,1,30,9,4,0,13,1,30,6,0,0,6,4,30,12,1,0,13,0,30,6,7,0,13,2,30,5,1,0,6,1,-15,3,1
2,2,30,2,30,3,2,0,5,3,30,2,0,0,2,2,30,2,3,0,5,9,30,1,4,0,5,3,30,3,0,0,3,1,-15,3,1
2,4,37,0,30,7,4,0,11,7,30,8,0,0,8,0,30,5,6,0,11,1,30,3,8,0,11,4,30,6,0,0,6,1,-15,3,1
2,3,2,0,30,9,1,0,10,3,30,4,0,0,4,0,30,4,6,0,10,4,30,6,4,0,10,1,30,3,5,0,8,0,-27,3,0
2,2,17,3,30,9,5,0,14,2,30,6,0,0,6,0,30,5,9,0,14,2,30,7,7,0,14,7,30,4,0,0,4,1,-15,3,1
2,3,17,3,30,9,5,0,14,2,30,6,0,0,6,0,30,5,9,0,14,2,30,7,7,0,14,7,30,4,0,0,4,1,-15,3,1
2,3,23,1,30,4,9,0,13,2,30,6,0,0,6,8,30,12,1,0,13,0,30,6,7,0,13,3,30,6,0,0,6,1,-15,3,1
2,4,23,1,30,4,9,0,13,2,30,6,0,0,6,8,30,12,1,0,13,0,30,6,7,0,13,3,30,6,0,0,6,1,-15,3,1
2,3,25,0,30,5,9,0,14,4,30,6,0,0,6,0,30,3,11,0,14,2,30,6,8,0,14,8,30,6,0,0,6,1,-15,3,1
2,2,43,0,30,6,8,0,14,6,30,6,0,0,6,0,30,4,10,0,14,1,30,1,13,0,14,6,30,5,0,0,5,1,-15,3,1
2,2,5,0,30,2,3,0,5,3,30,0,4,0,4,2,30,2,3,0,5,0,30,1,4,0,5,0,30,0,2,0,2,0,-27,3,0
2,4,8,1,30,7,0,0,7,3,30,2,0,0,2,2,30,5,2,0,7,0,30,6,1,0,7,1,30,3,0,0,3,0,-27,3,0
2,1,17,5,30,10,4,0,14,4,30,6,0,0,6,0,30,5,9,0,14,4,30,7,7,0,14,4,30,4,0,0,4,1,-15,3,1
2,2,17,5,30,10,4,0,14,4,30,6,0,0,6,0,30,5,9,0,14,4,30,7,7,0,14,4,30,4,0,0,4,1,-15,3,1
2,3,17,5,30,10,4,0,14,4,30,6,0,0,6,0,30,5,9,0,14,4,30,7,7,0,14,4,30,4,0,0,4,1,-15,3,1
2,4,17,5,30,10,4,0,14,4,30,6,0,0,6,0,30,5,9,0,14,4,30,7,7,0,14,4,30,4,0,0,4,1,-15,3,1
2,0,25,1,30,5,9,0,14,5,30,6,0,0,6,0,30,8,6,0,14,1,30,6,8,0,14,5,30,5,1,0,6,1,-15,3,1
2,2,25,1,30,5,9,0,14,5,30,6,0,0,6,0,30,8,6,0,14,1,30,6,8,0,14,5,30,5,1,0,6,1,-15,3,1
2,1,31,1,30,7,5,0,12,3,30,8,0,0,8,3,30,12,0,0,12,0,30,5,7,0,12,0,30,4,2,0,6,1,-15,3,1
2,3,31,1,30,7,5,0,12,3,30,8,0,0,8,3,30,12,0,0,12,0,30,5,7,0,12,0,30,4,2,0,6,1,-15,3,1
2,1,41,0,30,6,6,0,12,5,30,8,0,0,8,0,30,11,1,0,12,0,30,3,9,0,12,3,30,7,0,0,7,1,-15,3,1
2,2,41,0,30,6,6,0,12,5,30,8,0,0,8,0,30,11,1,0,12,0,30,3,9,0,12,3,30,7,0,0,7,1,-15,3,1
2,3,41,0,30,6,6,0,12,5,30,8,0,0,8,0,30,11,1,0,12,0,30,3,9,0,12,3,30,7,0,0,7,1,-15,3,1
2,4,41,0,30,6,6,0,12,5,30,8,0,0,8,0,30,11,1,0,12,0,30,3,9,0,12,3,30,7,0,0,7,1,-15,3,1
2,4,3,0,30,0,4,0,4,3,30,4,0,0,4,1,30,0,4,0,4,7,30,4,0,0,4,0,30,1,2,0,3,0,-27,3,0
2,4,5,0,30,0,5,0,5,2,30,0,4,0,4,0,30,1,4,0,5,0,30,1,4,0,5,1,30,2,0,0,2,0,-27,3,0
2,3,9,0,30,2,2,0,4,2,30,2,0,0,2,0,30,2,2,0,4,2,30,3,1,0,4,3,30,1,0,0,1,0,-27,3,0
2,4,9,0,30,2,2,0,4,2,30,2,0,0,2,0,30,2,2,0,4,2,30,3,1,0,4,3,30,1,0,0,1,0,-27,3,0
2,1,17,3,30,10,4,0,14,2,30,6,0,0,6,0,30,6,8,0,14,2,30,5,9,0,14,1,30,3,1,0,4,1,-15,3,1
2,2,17,3,30,10,4,0,14,2,30,6,0,0,6,0,30,6,8,0,14,2,30,5,9,0,14,1,30,3,1,0,4,1,-15,3,1
2,3,17,3,30,10,4,0,14,2,30,6,0,0,6,0,30,6,8,0,14,2,30,5,9,0,14,1,30,3,1,0,4,1,-15,3,1
2,4,23,2,30,4,9,0,13,3,30,6,0,0,6,4,30,13,0,0,13,0,30,5,8,0,13,0,30,6,0,0,6,1,-15,3,1
2,2,25,1,30,7,7,0,14,5,30,6,0,0,6,0,30,6,8,0,14,1,30,6,8,0,14,5,30,5,1,0,6,1,-15,3,1
2,3,25,1,30,7,7,0,14,5,30,6,0,0,6,0,30,6,8,0,14,1,30,6,8,0,14,5,30,5,1,0,6,1,-15,3,1
2,4,25,1,30,7,7,0,14,5,30,6,0,0,6,0,30,6,8,0,14,1,30,6,8,0,14,5,30,5,1,0,6,1,-15,3,1
2,0,27,1,30,4,11,0,15,3,30,1,1,0,2,0,30,3,12,0,15,6,30,5,10,0,15,3,30,6,0,0,6,1,-15,3,1
2,4,43,0,30,9,5,0,14,8,30,6,0,0,6,0,30,7,7,0,14,1,30,5,9,0,14,1,30,5,0,0,5,1,-15,3,1
2,4,11,0,30,5,7,0,12,0,30,4,0,0,4,4,30,6,6,0,12,3,30,5,7,0,12,3,30,4,0,0,4,1,-15,3,1
2,1,13,5,30,7,0,0,7,2,30,4,0,0,4,2,30,6,1,0,7,3,30,6,1,0,7,5,30,4,0,0,4,1,-15,3,1
2,2,13,5,30,7,0,0,7,2,30,4,0,0,4,2,30,6,1,0,7,3,30,6,1,0,7,5,30,4,0,0,4,1,-15,3,1
2,3,13,5,30,7,0,0,7,2,30,4,0,0,4,2,30,6,1,0,7,3,30,6,1,0,7,5,30,4,0,0,4,1,-15,3,1
2,4,13,5,30,7,0,0,7,2,30,4,0,0,4,2,30,6,1,0,7,3,30,6,1,0,7,5,30,4,0,0,4,1,-15,3,1
2,3,19,3,30,2,11,0,13,3,30,5,3,0,8,0,30,4,9,0,13,3,30,5,8,0,13,2,30,9,0,0,9,1,-15,3,1
2,4,19,3,30,2,11,0,13,3,30,5,3,0,8,0,30,4,9,0,13,3,30,5,8,0,13,2,30,9,0,0,9,1,-15,3,1
2,2,23,2,30,5,8,0,13,2,30,6,0,0,6,5,30,11,2,0,13,0,30,6,7,0,13,2,30,6,0,0,6,1,-15,3,1
2,1,27,1,30,4,11,0,15,1,30,2,0,0,2,0,30,12,3,0,15,0,30,5,10,0,15,1,30,6,0,0,6,1,-15,3,1
2,2,27,1,30,4,11,0,15,1,30,2,0,0,2,0,30,12,3,0,15,0,30,5,10,0,15,1,30,6,0,0,6,1,-15,3,1
2,3,27,1,30,4,11,0,15,1,30,2,0,0,2,0,30,12,3,0,15,0,30,5,10,0,15,1,30,6,0,0,6,1,-15,3,1
2,4,27,1,30,4,11,0,15,1,30,2,0,0,2,0,30,12,3,0,15,0,30,5,10,0,15,1,30,6,0,0,6,1,-15,3,1
2,2,31,4,30,6,6,0,12,6,30,8,0,0,8,3,30,8,4,0,12,0,30,8,4,0,12,1,30,6,0,0,6,1,-15,3,1
2,2,35,0,30,7,6,0,13,4,30,2,0,0,2,1,30,2,11,0,13,2,30,3,10,0,13,7,30,8,0,0,8,1,-15,3,1
2,3,35,0,30,7,6,0,13,4,30,2,0,0,2,1,30,2,11,0,13,2,30,3,10,0,13,7,30,8,0,0,8,1,-15,3,1
2,2,37,1,30,7,4,0,11,8,30,8,0,0,8,0,30,2,9,0,11,2,30,3,8,0,11,7,30,6,0,0,6,1,-15,3,1
2,4,7,1,30,4,5,0,9,2,30,4,0,0,4,0,30,8,1,0,9,4,30,3,6,0,9,1,30,3,3,0,6,0,-27,3,0
2,4,19,0,30,4,9,0,13,2,30,4,4,0,8,0,30,7,6,0,13,4,30,6,7,0,13,4,30,9,0,0,9,1,-15,3,1
2,3,23,2,30,7,6,0,13,3,30,6,0,0,6,6,30,9,4,0,13,0,30,6,7,0,13,0,30,6,0,0,6,1,-15,3,1
2,4,23,2,30,7,6,0,13,3,30,6,0,0,6,6,30,9,4,0,13,0,30,6,7,0,13,0,30,6,0,0,6,1,-15,3,1
2,2,27,1,30,3,12,0,15,2,30,2,0,0,2,0,30,7,8,0,15,2,30,6,9,0,15,4,30,6,0,0,6,1,-15,3,1
2,1,29,1,30,6,8,0,14,5,30,11,1,0,12,0,30,4,10,0,14,0,30,1,13,0,14,4,30,9,0,0,9,1,-15,3,1
2,1,4,2,30,6,2,0,8,4,30,4,0,0,4,1,30,5,3,0,8,0,30,6,2,0,8,1,30,4,0,0,4,0,-27,3,0
2,4,8,2,30,7,0,0,7,3,30,2,0,0,2,3,30,4,3,0,7,0,30,5,2,0,7,0,30,3,0,0,3,0,-27,3,0
2,3,11,1,30,5,7,0,12,1,30,4,0,0,4,0,30,7,5,0,12,2,30,5,7,0,12,0,30,4,0,0,4,1,-15,3,1
2,4,11,1,30,5,7,0,12,1,30,4,0,0,4,0,30,7,5,0,12,2,30,5,7,0,12,0,30,4,0,0,4,1,-15,3,1
2,0,13,4,30,6,1,0,7,2,30,4,0,0,4,5,30,7,0,0,7,4,30,7,0,0,7,3,30,4,0,0,4,1,-15,3,1
2,1,13,4,30,6,1,0,7,2,30,4,0,0,4,5,30,7,0,0,7,4,30,7,0,0,7,3,30,4,0,0,4,1,-15,3,1
2,2,13,4,30,6,1,0,7,2,30,4,0,0,4,5,30,7,0,0,7,4,30,7,0,0,7,3,30,4,0,0,4,1,-15,3,1
2,4,13,4,30,6,1,0,7,2,30,4,0,0,4,5,30,7,0,0,7,4,30,7,0,0,7,3,30,4,0,0,4,1,-15,3,1
2,4,15,0,30,4,9,0,13,1,30,6,0,0,6,0,30,4,9,0,13,1,30,3,10,0,13,2,30,9,0,0,9,1,-15,3,1
2,2,17,3,30,8,6,0,14,2,30,6,0,0,6,0,30,8,6,0,14,4,30,7,7,0,14,6,30,4,0,0,4,1,-15,3,1
2,3,19,0,30,4,9,0,13,1,30,8,0,0,8,0,30,6,7,0,13,4,30,4,9,0,13,0,30,6,3,0,9,1,-15,3,1
2,3,23,3,30,7,6,0,13,1,30,6,0,0,6,6,30,12,1,0,13,0,30,5,8,0,13,1,30,5,1,0,6,1,-15,3,1
2,4,25,0,30,6,8,0,14,2,30,6,0,0,6,0,30,9,5,0,14,1,30,5,9,0,14,4,30,5,1,0,6,1,-15,3,1
2,1,27,4,30,11,4,0,15,2,30,2,0,0,2,0,30,6,9,0,15,2,30,3,12,0,15,2,30,3,3,0,6,1,-15,3,1
2,2,27,4,30,11,4,0,15,2,30,2,0,0,2,0,30,6,9,0,15,2,30,3,12,0,15,2,30,3,3,0,6,1,-15,3,1
2,1,37,1,30,5,6,0,11,6,30,8,0,0,8,0,30,5,6,0,11,4,30,3,8,0,11,5,30,6,0,0,6,1,-15,3,1
2,3,37,1,30,5,6,0,11,6,30,8,0,0,8,0,30,5,6,0,11,4,30,3,8,0,11,5,30,6,0,0,6,1,-15,3,1
2,4,39,0,30,1,10,0,11,6,30,6,0,0,6,0,30,9,2,0,11,1,30,5,6,0,11,0,30,5,0,0,5,1,-15,3,1
2,0,5,0,30,2,3,0,5,3,30,0,4,0,4,5,30,1,4,0,5,0,30,1,4,0,5,0,30,0,2,0,2,0,-27,3,0
2,1,6,3,30,7,2,0,9,2,30,2,0,0,2,0,30,6,3,0,9,0,30,3,6,0,9,1,30,3,2,0,5,0,-27,3,0
2,4,6,2,30,7,2,0,9,2,30,2,0,0,2,0,30,6,3,0,9,0,30,3,6,0,9,1,30,3,2,0,5,0,-27,3,0
2,1,13,4,30,6,1,0,7,0,30,4,0,0,4,2,30,6,1,0,7,6,30,5,2,0,7,4,30,4,0,0,4,1,-15,3,1
2,4,13,4,30,6,1,0,7,0,30,4,0,0,4,2,30,6,1,0,7,6,30,5,2,0,7,4,30,4,0,0,4,1,-15,3,1
2,3,17,4,30,10,4,0,14,4,30,6,0,0,6,2,30,4,10,0,14,1,30,6,8,0,14,1,30,3,1,0,4,1,-15,3,1
2,3,19,0,30,5,8,0,13,1,30,5,3,0,8,0,30,7,6,0,13,3,30,4,9,0,13,2,30,8,1,0,9,1,-15,3,1
2,2,21,2,30,6,4,0,10,4,30,6,0,0,6,1,30,3,7,0,10,4,30,5,5,0,10,3,30,4,0,0,4,1,-15,3,1
2,3,25,1,30,4,10,0,14,4,30,6,0,0,6,0,30,6,8,0,14,1,30,7,7,0,14,3,30,6,0,0,6,1,-15,3,1
2,4,25,1,30,4,10,0,14,4,30,6,0,0,6,0,30,6,8,0,14,1,30,7,7,0,14,3,30,6,0,0,6,1,-15,3,1
2,1,27,1,30,5,10,0,15,4,30,2,0,0,2,0,30,3,12,0,15,1,30,4,11,0,15,5,30,6,0,0,6,1,-15,3,1
2,2,27,1,30,5,10,0,15,4,30,2,0,0,2,0,30,3,12,0,15,1,30,4,11,0,15,5,30,6,0,0,6,1,-15,3,1
2,3,27,1,30,5,10,0,15,4,30,2,0,0,2,0,30,3,12,0,15,1,30,4,11,0,15,5,30,6,0,0,6,1,-15,3,1
2,4,27,1,30,5,10,0,15,4,30,2,0,0,2,0,30,3,12,0,15,1,30,4,11,0,15,5,30,6,0,0,6,1,-15,3,1
2,1,31,1,30,6,6,0,12,4,30,8,0,0,8,5,30,10,2,0,12,0,30,5,7,0,12,0,30,4,2,0,6,1,-15,3,1
2,2,31,1,30,6,6,0,12,4,30,8,0,0,8,5,30,10,2,0,12,0,30,5,7,0,12,0,30,4,2,0,6,1,-15,3,1
2,3,31,1,30,6,6,0,12,4,30,8,0,0,8,5,30,10,2,0,12,0,30,5,7,0,12,0,30,4,2,0,6,1,-15,3,1
2,1,37,1,30,5,6,0,11,4,30,5,3,0,8,2,30,10,1,0,11,5,30,3,8,0,11,1,30,6,0,0,6,1,-15,3,1
2,2,37,1,30,5,6,0,11,4,30,5,3,0,8,2,30,10,1,0,11,5,30,3,8,0,11,1,30,6,0,0,6,1,-15,3,1
2,3,5,0,30,2,3,0,5,3,30,0,4,0,4,0,30,3,2,0,5,0,30,1,4,0,5,0,30,0,2,0,2,0,-27,3,0
2,4,5,0,30,2,3,0,5,3,30,0,4,0,4,0,30,3,2,0,5,0,30,1,4,0,5,0,30,0,2,0,2,0,-27,3,0
2,3,19,0,30,5,8,0,13,2,30,3,5,0,8,0,30,6,7,0,13,3,30,5,8,0,13,0,30,8,1,0,9,1,-15,3,1
2,4,25,1,30,10,4,0,14,1,30,6,0,0,6,0,30,8,6,0,14,1,30,5,9,0,14,0,30,5,1,0,6,1,-15,3,1
2,3,27,1,30,4,11,0,15,2,30,2,0,0,2,0,30,5,10,0,15,5,30,4,11,0,15,5,30,6,0,0,6,1,-15,3,1
2,0,33,4,30,6,5,0,11,5,30,4,0,0,4,5,30,9,2,0,11,0,30,3,8,0,11,5,30,4,0,0,4,1,-15,3,1
2,1,33,4,30,6,5,0,11,5,30,4,0,0,4,5,30,9,2,0,11,0,30,3,8,0,11,5,30,4,0,0,4,1,-15,3,1
2,4,33,4,30,6,5,0,11,5,30,4,0,0,4,5,30,9,2,0,11,0,30,3,8,0,11,5,30,4,0,0,4,1,-15,3,1
2,2,35,1,30,6,7,0,13,5,30,2,0,0,2,2,30,5,8,0,13,0,30,3,10,0,13,4,30,8,0,0,8,1,-15,3,1
2,3,35,1,30,6,7,0,13,5,30,2,0,0,2,2,30,5,8,0,13,0,30,3,10,0,13,4,30,8,0,0,8,1,-15,3,1
2,4,35,1,30,6,7,0,13,5,30,2,0,0,2,2,30,5,8,0,13,0,30,3,10,0,13,4,30,8,0,0,8,1,-15,3,1
2,4,8,0,30,7,0,0,7,4,30,2,0,0,2,0,30,1,6,0,7,0,30,5,2,0,7,2,30,3,0,0,3,0,-27,3,0
2,2,13,1,30,7,0,0,7,0,30,4,0,0,4,2,30,5,2,0,7,8,30,7,0,0,7,3,30,4,0,0,4,1,-15,3,1
2,4,17,4,30,9,5,0,14,2,30,6,0,0,6,0,30,7,7,0,14,1,30,6,8,0,14,1,30,3,1,0,4,1,-15,3,1
2,4,19,1,30,3,10,0,13,1,30,4,4,0,8,0,30,7,6,0,13,3,30,4,9,0,13,1,30,8,1,0,9,1,-15,3,1
2,2,4,2,30,8,0,0,8,4,30,4,0,0,4,0,30,2,6,0,8,0,30,4,4,0,8,3,30,3,1,0,4,0,-27,3,0
2,1,19,0,30,3,10,0,13,2,30,6,2,0,8,0,30,4,9,0,13,7,30,4,9,0,13,3,30,9,0,0,9,1,-15,3,1
2,2,19,0,30,3,10,0,13,2,30,6,2,0,8,0,30,4,9,0,13,7,30,4,9,0,13,3,30,9,0,0,9,1,-15,3,1
2,4,19,0,30,3,10,0,13,2,30,6,2,0,8,0,30,4,9,0,13,7,30,4,9,0,13,3,30,9,0,0,9,1,-15,3,1
2,4,23,2,30,4,9,0,13,3,30,6,0,0,6,7,30,11,2,0,13,0,30,7,6,0,13,1,30,5,1,0,6,1,-15,3,1
2,3,25,1,30,8,6,0,14,2,30,6,0,0,6,0,30,6,8,0,14,2,30,7,7,0,14,4,30,5,1,0,6,1,-15,3,1
2,4,27,1,30,5,10,0,15,4,30,2,0,0,2,0,30,7,8,0,15,2,30,4,11,0,15,1,30,6,0,0,6,1,-15,3,1
2,4,29,0,30,9,5,0,14,6,30,10,2,0,12,0,30,4,10,0,14,0,30,1,13,0,14,1,30,9,0,0,9,1,-15,3,1
2,2,32,2,30,8,1,0,9,4,30,2,0,0,2,0,30,7,2,0,9,1,30,2,7,0,9,3,30,2,0,0,2,1,-15,3,1
2,4,39,0,30,3,8,0,11,6,30,6,0,0,6,0,30,4,7,0,11,2,30,2,9,0,11,3,30,5,0,0,5,1,-15,3,1
2,3,5,0,30,1,4,0,5,2,30,4,0,0,4,0,30,1,4,0,5,0,30,3,2,0,5,1,30,2,0,0,2,0,-27,3,0
2,4,5,0,30,1,4,0,5,2,30,4,0,0,4,0,30,1,4,0,5,0,30,3,2,0,5,1,30,2,0,0,2,0,-27,3,0
2,1,17,9,30,10,4,0,14,2,30,6,0,0,6,0,30,5,9,0,14,5,30,4,10,0,14,0,30,2,2,0,4,1,-15,3,1
2,1,23,1,30,4,9,0,13,5,30,6,0,0,6,7,30,7,6,0,13,2,30,11,2,0,13,2,30,6,0,0,6,1,-15,3,1
2,3,23,1,30,4,9,0,13,5,30,6,0,0,6,7,30,7,6,0,13,2,30,11,2,0,13,2,30,6,0,0,6,1,-15,3,1
2,3,25,1,30,9,5,0,14,4,30,6,0,0,6,0,30,8,6,0,14,1,30,5,9,0,14,3,30,5,1,0,6,1,-15,3,1
2,4,25,1,30,9,5,0,14,4,30,6,0,0,6,0,30,8,6,0,14,1,30,5,9,0,14,3,30,5,1,0,6,1,-15,3,1
2,0,31,1,30,5,7,0,12,7,30,8,0,0,8,2,30,4,8,0,12,0,30,8,4,0,12,2,30,6,0,0,6,1,-15,3,1
2,2,31,1,30,5,7,0,12,7,30,8,0,0,8,2,30,4,8,0,12,0,30,8,4,0,12,2,30,6,0,0,6,1,-15,3,1
2,3,35,1,30,13,0,0,13,3,30,2,0,0,2,5,30,6,7,0,13,0,30,1,12,0,13,0,30,6,2,0,8,1,-15,3,1
2,0,37,2,30,8,3,0,11,6,30,8,0,0,8,0,30,5,6,0,11,5,30,4,7,0,11,6,30,6,0,0,6,1,-15,3,1
2,1,37,2,30,8,3,0,11,6,30,8,0,0,8,0,30,5,6,0,11,5,30,4,7,0,11,6,30,6,0,0,6,1,-15,3,1
2,3,41,0,30,5,7,0,12,5,30,8,0,0,8,0,30,12,0,0,12,0,30,5,7,0,12,2,30,3,4,0,7,1,-15,3,1
2,0,4,4,30,8,0,0,8,5,30,4,0,0,4,0,30,1,7,0,8,1,30,8,0,0,8,2,30,2,2,0,4,0,-27,3,0
2,3,8,2,30,7,0,0,7,3,30,2,0,0,2,3,30,5,2,0,7,0,30,7,0,0,7,0,30,3,0,0,3,0,-27,3,0
2,4,13,2,30,7,0,0,7,0,30,4,0,0,4,2,30,7,0,0,7,4,30,5,2,0,7,0,30,4,0,0,4,1,-15,3,1
2,2,17,3,30,9,5,0,14,2,30,6,0,0,6,0,30,8,6,0,14,1,30,5,9,0,14,7,30,4,0,0,4,1,-15,3,1
2,1,19,0,30,3,10,0,13,2,30,6,2,0,8,0,30,4,9,0,13,5,30,8,5,0,13,0,30,9,0,0,9,1,-15,3,1
2,4,19,0,30,3,10,0,13,2,30,6,2,0,8,0,30,4,9,0,13,5,30,8,5,0,13,0,30,9,0,0,9,1,-15,3,1
2,3,23,1,30,5,8,0,13,1,30,6,0,0,6,2,30,13,0,0,13,4,30,6,7,0,13,3,30,5,1,0,6,1,-15,3,1
2,3,29,0,30,8,6,0,14,6,30,12,0,0,12,0,30,6,8,0,14,0,30,1,13,0,14,2,30,9,0,0,9,1,-15,3,1
2,4,31,1,30,6,6,0,12,4,30,8,0,0,8,5,30,10,2,0,12,0,30,5,7,0,12,0,30,3,3,0,6,1,-15,3,1
2,4,39,0,30,4,7,0,11,5,30,6,0,0,6,0,30,11,0,0,11,2,30,2,9,0,11,5,30,5,0,0,5,1,-15,3,1
2,0,45,0,30,9,4,0,13,10,30,10,0,0,10,0,30,0,13,0,13,0,30,5,8,0,13,9,30,5,0,0,5,1,-15,3,1
2,4,22,3,30,8,0,0,8,3,30,2,0,0,2,0,30,3,5,0,8,1,30,4,4,0,8,0,30,3,1,0,4,1,-15,3,1
2,0,25,1,30,4,10,0,14,5,30,6,0,0,6,2,30,10,4,0,14,1,30,6,8,0,14,4,30,5,1,0,6,1,-15,3,1
2,2,25,1,30,4,10,0,14,5,30,6,0,0,6,0,30,10,4,0,14,1,30,6,8,0,14,4,30,5,1,0,6,1,-15,3,1
2,4,25,1,30,4,10,0,14,5,30,6,0,0,6,0,30,10,4,0,14,1,30,6,8,0,14,4,30,5,1,0,6,1,-15,3,1
2,0,27,1,30,5,10,0,15,3,30,2,0,0,2,0,30,3,12,0,15,3,30,5,10,0,15,5,30,6,0,0,6,1,-15,3,1
2,2,2,0,30,6,4,0,10,4,30,4,0,0,4,0,30,3,7,0,10,6,30,7,3,0,10,6,30,3,5,0,8,0,-27,3,0
2,3,2,0,30,6,4,0,10,4,30,4,0,0,4,0,30,3,7,0,10,6,30,7,3,0,10,6,30,3,5,0,8,0,-27,3,0
2,4,3,0,30,1,3,0,4,3,30,4,0,0,4,3,30,0,4,0,4,0,30,1,3,0,4,1,30,3,0,0,3,0,-27,3,0
2,3,8,2,30,7,0,0,7,3,30,2,0,0,2,4,30,6,1,0,7,1,30,7,0,0,7,0,30,3,0,0,3,0,-27,3,0
2,1,11,1,30,3,9,0,12,0,30,4,0,0,4,0,30,8,4,0,12,8,30,4,8,0,12,5,30,4,0,0,4,1,-15,3,1
2,2,11,1,30,3,9,0,12,0,30,4,0,0,4,0,30,8,4,0,12,8,30,4,8,0,12,5,30,4,0,0,4,1,-15,3,1
2,4,11,1,30,3,9,0,12,0,30,4,0,0,4,0,30,8,4,0,12,8,30,4,8,0,12,5,30,4,0,0,4,1,-15,3,1
2,3,17,0,30,10,4,0,14,4,30,6,0,0,6,0,30,3,11,0,14,2,30,6,8,0,14,0,30,4,0,0,4,1,-15,3,1
2,4,17,0,30,10,4,0,14,4,30,6,0,0,6,0,30,3,11,0,14,2,30,6,8,0,14,0,30,4,0,0,4,1,-15,3,1
2,3,19,3,30,4,9,0,13,3,30,8,0,0,8,0,30,7,6,0,13,3,30,4,9,0,13,3,30,9,0,0,9,1,-15,3,1
2,3,23,1,30,6,7,0,13,2,30,6,0,0,6,4,30,13,0,0,13,3,30,8,5,0,13,1,30,6,0,0,6,1,-15,3,1
2,4,23,1,30,6,7,0,13,2,30,6,0,0,6,4,30,13,0,0,13,3,30,8,5,0,13,1,30,6,0,0,6,1,-15,3,1
2,1,25,1,30,11,3,0,14,3,30,6,0,0,6,0,30,4,10,0,14,2,30,5,9,0,14,5,30,6,0,0,6,1,-15,3,1
2,3,25,1,30,11,3,0,14,3,30,6,0,0,6,0,30,4,10,0,14,2,30,5,9,0,14,5,30,6,0,0,6,1,-15,3,1
2,1,27,1,30,4,11,0,15,5,30,2,0,0,2,0,30,6,9,0,15,1,30,7,8,0,15,3,30,6,0,0,6,1,-15,3,1
2,2,29,0,30,6,8,0,14,5,30,11,1,0,12,0,30,7,7,0,14,0,30,1,13,0,14,1,30,9,0,0,9,1,-15,3,1
2,4,8,4,30,7,0,0,7,3,30,2,0,0,2,0,30,4,3,0,7,0,30,5,2,0,7,3,30,3,0,0,3,0,-27,3,0
2,4,17,0,30,11,3,0,14,0,30,6,0,0,6,0,30,6,8,0,14,1,30,5,9,0,14,2,30,4,0,0,4,1,-15,3,1
2,1,21,4,30,6,4,0,10,2,30,4,2,0,6,0,30,7,3,0,10,1,30,4,6,0,10,4,30,4,0,0,4,1,-15,3,1
2,3,21,4,30,6,4,0,10,2,30,4,2,0,6,0,30,7,3,0,10,1,30,4,6,0,10,4,30,4,0,0,4,1,-15,3,1
2,3,22,1,30,7,1,0,8,3,30,2,0,0,2,1,30,4,4,0,8,1,30,3,5,0,8,5,30,4,0,0,4,1,-15,3,1
2,3,27,7,30,4,1,0,5,3,30,0,0,0,0,0,30,3,2,0,5,4,30,3,2,0,5,0,30,1,3,0,4,1,-15,3,1
2,4,27,1,30,7,8,0,15,5,30,2,0,0,2,9,30,6,9,0,15,0,30,9,6,0,15,0,30,1,5,0,6,1,-15,3,1
2,3,33,0,30,2,9,0,11,5,30,4,0,0,4,3,30,9,2,0,11,1,30,6,5,0,11,8,30,4,0,0,4,1,-15,3,1
2,2,39,1,30,6,5,0,11,7,30,6,0,0,6,0,30,6,5,0,11,1,30,3,8,0,11,3,30,5,0,0,5,1,-15,3,1
2,0,47,6,30,0,14,0,14,8,30,4,0,0,4,0,30,4,10,0,14,0,30,2,12,0,14,6,30,7,0,0,7,1,-15,3,1
2,2,47,6,30,0,14,0,14,8,30,4,0,0,4,0,30,4,10,0,14,0,30,2,12,0,14,6,30,7,0,0,7,1,-15,3,1
2,4,47,6,30,0,14,0,14,8,30,4,0,0,4,0,30,4,10,0,14,0,30,2,12,0,14,6,30,7,0,0,7,1,-15,3,1
2,0,4,3,30,6,2,0,8,5,30,4,0,0,4,0,30,2,6,0,8,2,30,6,2,0,8,2,30,3,1,0,4,0,-27,3,0
2,2,4,3,30,6,2,0,8,5,30,4,0,0,4,0,30,2,6,0,8,2,30,6,2,0,8,2,30,3,1,0,4,0,-27,3,0
2,3,4,3,30,6,2,0,8,5,30,4,0,0,4,0,30,2,6,0,8,2,30,6,2,0,8,2,30,3,1,0,4,0,-27,3,0
2,2,6,0,30,6,3,0,9,4,30,2,0,0,2,0,30,2,7,0,9,0,30,4,5,0,9,0,30,5,0,0,5,0,-27,3,0
2,3,8,2,30,7,0,0,7,4,30,2,0,0,2,3,30,3,4,0,7,0,30,7,0,0,7,1,30,3,0,0,3,0,-27,3,0
2,4,8,2,30,7,0,0,7,4,30,2,0,0,2,3,30,3,4,0,7,0,30,7,0,0,7,1,30,3,0,0,3,0,-27,3,0
2,4,13,2,30,6,1,0,7,0,30,4,0,0,4,2,30,7,0,0,7,12,30,5,2,0,7,3,30,4,0,0,4,1,-15,3,1
2,3,19,0,30,3,10,0,13,2,30,3,5,0,8,0,30,6,7,0,13,5,30,9,4,0,13,3,30,9,0,0,9,1,-15,3,1
2,4,19,0,30,3,10,0,13,2,30,3,5,0,8,0,30,6,7,0,13,5,30,9,4,0,13,3,30,9,0,0,9,1,-15,3,1
2,4,23,1,30,11,2,0,13,1,30,6,0,0,6,3,30,12,1,0,13,0,30,5,8,0,13,1,30,5,1,0,6,1,-15,3,1
2,0,25,2,30,3,11,0,14,4,30,6,0,0,6,0,30,13,1,0,14,1,30,5,9,0,14,4,30,6,0,0,6,1,-15,3,1
2,1,25,2,30,3,11,0,14,4,30,6,0,0,6,0,30,13,1,0,14,1,30,5,9,0,14,4,30,6,0,0,6,1,-15,3,1
2,2,25,2,30,3,11,0,14,4,30,6,0,0,6,0,30,13,1,0,14,1,30,5,9,0,14,4,30,6,0,0,6,1,-15,3,1
2,2,27,0,30,1,4,0,5,3,30,0,0,0,0,0,30,1,4,0,5,6,30,3,2,0,5,0,30,2,2,0,4,1,-15,3,1
2,1,27,1,30,4,11,0,15,4,30,2,0,0,2,4,30,2,13,0,15,0,30,5,10,0,15,8,30,3,3,0,6,1,-15,3,1
2,3,27,1,30,4,11,0,15,4,30,2,0,0,2,4,30,2,13,0,15,0,30,5,10,0,15,8,30,3,3,0,6,1,-15,3,1
2,1,13,3,30,7,0,0,7,2,30,4,0,0,4,5,30,6,1,0,7,3,30,6,1,0,7,4,30,4,0,0,4,1,-15,3,1
2,2,13,3,30,7,0,0,7,2,30,4,0,0,4,5,30,6,1,0,7,3,30,6,1,0,7,4,30,4,0,0,4,1,-15,3,1
2,4,13,3,30,7,0,0,7,2,30,4,0,0,4,5,30,6,1,0,7,3,30,6,1,0,7,4,30,4,0,0,4,1,-15,3,1
2,2,19,0,30,3,10,0,13,0,30,4,4,0,8,0,30,4,9,0,13,0,30,7,6,0,13,1,30,9,0,0,9,1,-15,3,1
2,3,19,0,30,3,10,0,13,0,30,4,4,0,8,0,30,4,9,0,13,0,30,7,6,0,13,1,30,9,0,0,9,1,-15,3,1
2,4,39,0,30,2,9,0,11,7,30,6,0,0,6,0,30,4,7,0,11,2,30,4,7,0,11,6,30,5,0,0,5,1,-15,3,1
2,0,4,2,30,4,4,0,8,4,30,4,0,0,4,1,30,2,6,0,8,2,30,8,0,0,8,4,30,4,0,0,4,0,-27,3,0
2,1,4,2,30,4,4,0,8,4,30,4,0,0,4,1,30,2,6,0,8,2,30,8,0,0,8,4,30,4,0,0,4,0,-27,3,0
2,2,4,2,30,4,4,0,8,4,30,4,0,0,4,1,30,2,6,0,8,2,30,8,0,0,8,4,30,4,0,0,4,0,-27,3,0
2,3,4,2,30,4,4,0,8,4,30,4,0,0,4,1,30,2,6,0,8,2,30,8,0,0,8,4,30,4,0,0,4,0,-27,3,0
2,4,11,1,30,6,6,0,12,1,30,4,0,0,4,0,30,6,6,0,12,0,30,7,5,0,12,4,30,4,0,0,4,1,-15,3,1
2,2,13,1,30,5,2,0,7,0,30,4,0,0,4,2,30,5,2,0,7,5,30,7,0,0,7,6,30,4,0,0,4,1,-15,3,1
2,3,13,1,30,5,2,0,7,0,30,4,0,0,4,2,30,5,2,0,7,5,30,7,0,0,7,6,30,4,0,0,4,1,-15,3,1
2,4,13,1,30,5,2,0,7,0,30,4,0,0,4,2,30,5,2,0,7,5,30,7,0,0,7,6,30,4,0,0,4,1,-15,3,1
2,3,19,0,30,3,10,0,13,1,30,7,1,0,8,0,30,7,6,0,13,4,30,5,8,0,13,1,30,8,1,0,9,1,-15,3,1
2,3,25,0,30,9,5,0,14,4,30,6,0,0,6,0,30,8,6,0,14,1,30,5,9,0,14,4,30,5,1,0,6,1,-15,3,1
2,4,25,0,30,9,5,0,14,4,30,6,0,0,6,0,30,8,6,0,14,1,30,5,9,0,14,4,30,5,1,0,6,1,-15,3,1
2,0,27,1,30,4,11,0,15,2,30,1,1,0,2,0,30,7,8,0,15,3,30,6,9,0,15,5,30,6,0,0,6,1,-15,3,1
2,2,27,1,30,4,11,0,15,2,30,1,1,0,2,0,30,7,8,0,15,3,30,6,9,0,15,5,30,6,0,0,6,1,-15,3,1
2,3,27,1,30,4,11,0,15,2,30,1,1,0,2,0,30,7,8,0,15,3,30,6,9,0,15,5,30,6,0,0,6,1,-15,3,1
2,3,31,2,30,4,8,0,12,7,30,8,0,0,8,3,30,4,8,0,12,6,30,8,4,0,12,1,30,6,0,0,6,1,-15,3,1
2,4,31,2,30,4,8,0,12,7,30,8,0,0,8,3,30,4,8,0,12,6,30,8,4,0,12,1,30,6,0,0,6,1,-15,3,1
2,3,8,1,30,7,0,0,7,5,30,2,0,0,2,0,30,1,6,0,7,0,30,6,1,0,7,7,30,3,0,0,3,0,-27,3,0
2,3,11,2,30,4,8,0,12,1,30,4,0,0,4,0,30,5,7,0,12,3,30,4,8,0,12,4,30,4,0,0,4,1,-15,3,1
2,1,13,3,30,7,0,0,7,0,30,4,0,0,4,2,30,6,1,0,7,15,30,6,1,0,7,1,30,4,0,0,4,1,-15,3,1
2,4,13,3,30,7,0,0,7,0,30,4,0,0,4,2,30,6,1,0,7,15,30,6,1,0,7,1,30,4,0,0,4,1,-15,3,1
2,4,17,2,30,8,6,0,14,3,30,6,0,0,6,0,30,6,8,0,14,6,30,6,8,0,14,6,30,4,0,0,4,1,-15,3,1
2,1,19,0,30,4,9,0,13,2,30,4,4,0,8,0,30,4,9,0,13,3,30,8,5,0,13,2,30,8,1,0,9,1,-15,3,1
2,2,19,0,30,4,9,0,13,2,30,4,4,0,8,0,30,4,9,0,13,3,30,8,5,0,13,2,30,8,1,0,9,1,-15,3,1
2,1,25,2,30,5,9,0,14,2,30,6,0,0,6,0,30,14,0,0,14,1,30,5,9,0,14,3,30,5,1,0,6,1,-15,3,1
2,2,25,2,30,5,9,0,14,2,30,6,0,0,6,0,30,14,0,0,14,1,30,5,9,0,14,3,30,5,1,0,6,1,-15,3,1
2,4,25,2,30,5,9,0,14,2,30,6,0,0,6,0,30,14,0,0,14,1,30,5,9,0,14,3,30,5,1,0,6,1,-15,3,1
2,2,31,1,30,6,6,0,12,6,30,8,0,0,8,3,30,5,7,0,12,0,30,3,9,0,12,0,30,6,0,0,6,1,-15,3,1
2,3,31,1,30,6,6,0,12,6,30,8,0,0,8,3,30,5,7,0,12,0,30,3,9,0,12,0,30,6,0,0,6,1,-15,3,1
2,4,31,1,30,6,6,0,12,6,30,8,0,0,8,3,30,5,7,0,12,0,30,3,9,0,12,0,30,6,0,0,6,1,-15,3,1
2,2,4,2,30,8,0,0,8,4,30,4,0,0,4,0,30,2,6,0,8,0,30,3,5,0,8,1,30,3,1,0,4,0,-27,3,0
2,3,4,2,30,8,0,0,8,4,30,4,0,0,4,0,30,2,6,0,8,0,30,3,5,0,8,1,30,3,1,0,4,0,-27,3,0
2,1,5,0,30,1,4,0,5,2,30,3,1,0,4,0,30,1,4,0,5,0,30,1,4,0,5,0,30,0,2,0,2,0,-27,3,0
2,4,13,0,30,3,0,0,3,0,30,2,0,0,2,0,30,3,0,0,3,6,30,3,0,0,3,3,30,2,0,0,2,1,-15,3,1
2,1,13,2,30,5,2,0,7,1,30,4,0,0,4,2,30,6,1,0,7,11,30,7,0,0,7,0,30,4,0,0,4,1,-15,3,1
2,4,17,2,30,8,6,0,14,3,30,6,0,0,6,0,30,6,8,0,14,5,30,3,11,0,14,5,30,4,0,0,4,1,-15,3,1
2,3,23,2,30,5,8,0,13,4,30,6,0,0,6,8,30,10,3,0,13,0,30,3,10,0,13,3,30,6,0,0,6,1,-15,3,1
2,3,25,0,30,4,10,0,14,3,30,6,0,0,6,0,30,9,5,0,14,1,30,5,9,0,14,5,30,4,2,0,6,1,-15,3,1
2,2,35,1,30,9,4,0,13,6,30,1,1,0,2,1,30,2,11,0,13,7,30,2,11,0,13,8,30,8,0,0,8,1,-15,3,1
2,1,13,2,30,5,2,0,7,0,30,4,0,0,4,2,30,7,0,0,7,8,30,7,0,0,7,5,30,4,0,0,4,1,-15,3,1
2,3,17,3,30,9,5,0,14,3,30,6,0,0,6,0,30,5,9,0,14,2,30,6,8,0,14,2,30,4,0,0,4,1,-15,3,1
2,4,25,1,30,5,9,0,14,4,30,6,0,0,6,0,30,7,7,0,14,1,30,8,6,0,14,3,30,5,1,0,6,1,-15,3,1
2,3,27,1,30,4,11,0,15,5,30,1,1,0,2,0,30,6,9,0,15,1,30,5,10,0,15,3,30,6,0,0,6,1,-15,3,1
2,0,31,3,30,7,5,0,12,4,30,8,0,0,8,3,30,11,1,0,12,0,30,3,9,0,12,0,30,4,2,0,6,1,-15,3,1
2,1,31,3,30,7,5,0,12,4,30,8,0,0,8,3,30,11,1,0,12,0,30,3,9,0,12,0,30,4,2,0,6,1,-15,3,1
2,3,31,3,30,7,5,0,12,4,30,8,0,0,8,3,30,11,1,0,12,0,30,3,9,0,12,0,30,4,2,0,6,1,-15,3,1
2,0,5,0,30,2,3,0,5,3,30,2,2,0,4,0,30,0,5,0,5,2,30,1,4,0,5,0,30,0,2,0,2,0,-27,3,0
2,3,13,6,30,7,0,0,7,3,30,4,0,0,4,9,30,7,0,0,7,1,30,5,2,0,7,2,30,4,0,0,4,1,-15,3,1
2,0,25,0,30,11,3,0,14,3,30,6,0,0,6,0,30,10,4,0,14,1,30,6,8,0,14,2,30,6,0,0,6,1,-15,3,1
2,2,25,0,30,11,3,0,14,3,30,6,0,0,6,0,30,10,4,0,14,1,30,6,8,0,14,2,30,6,0,0,6,1,-15,3,1
2,0,27,1,30,8,7,0,15,4,30,1,1,0,2,0,30,3,12,0,15,4,30,4,11,0,15,5,30,6,0,0,6,1,-15,3,1
2,2,27,1,30,8,7,0,15,4,30,1,1,0,2,0,30,3,12,0,15,4,30,4,11,0,15,5,30,6,0,0,6,1,-15,3,1
2,4,27,1,30,8,7,0,15,4,30,1,1,0,2,0,30,3,12,0,15,4,30,4,11,0,15,5,30,6,0,0,6,1,-15,3,1
2,1,29,0,30,6,8,0,14,5,30,11,1,0,12,0,30,5,9,0,14,0,30,0,14,0,14,1,30,9,0,0,9,1,-15,3,1
2,4,41,0,30,9,3,0,12,7,30,8,0,0,8,0,30,3,9,0,12,0,30,3,9,0,12,2,30,2,5,0,7,1,-15,3,1
2,3,4,2,30,6,2,0,8,4,30,4,0,0,4,0,30,1,7,0,8,0,30,1,7,0,8,3,30,4,0,0,4,0,-27,3,0
2,4,4,2,30,6,2,0,8,4,30,4,0,0,4,0,30,1,7,0,8,0,30,1,7,0,8,3,30,4,0,0,4,0,-27,3,0
2,1,5,0,30,0,5,0,5,2,30,4,0,0,4,0,30,0,5,0,5,0,30,2,3,0,5,0,30,1,1,0,2,0,-27,3,0
2,2,5,0,30,0,5,0,5,2,30,4,0,0,4,0,30,0,5,0,5,0,30,2,3,0,5,0,30,1,1,0,2,0,-27,3,0
2,1,11,0,30,1,3,0,4,0,30,0,0,0,0,0,30,2,2,0,4,8,30,4,0,0,4,3,30,1,0,0,1,1,-15,3,1
2,2,11,0,30,1,3,0,4,0,30,0,0,0,0,0,30,2,2,0,4,8,30,4,0,0,4,3,30,1,0,0,1,1,-15,3,1
2,4,13,4,30,7,0,0,7,2,30,4,0,0,4,10,30,5,2,0,7,4,30,3,4,0,7,0,30,4,0,0,4,1,-15,3,1
2,3,17,3,30,8,6,0,14,0,30,6,0,0,6,0,30,10,4,0,14,5,30,6,8,0,14,8,30,4,0,0,4,1,-15,3,1
2,1,19,0,30,3,10,0,13,2,30,3,5,0,8,0,30,6,7,0,13,8,30,4,9,0,13,1,30,9,0,0,9,1,-15,3,1
2,3,23,1,30,4,9,0,13,3,30,6,0,0,6,4,30,12,1,0,13,0,30,5,8,0,13,0,30,6,0,0,6,1,-15,3,1
2,3,25,1,30,12,2,0,14,2,30,6,0,0,6,0,30,8,6,0,14,1,30,6,8,0,14,5,30,5,1,0,6,1,-15,3,1
2,1,27,1,30,3,12,0,15,3,30,2,0,0,2,0,30,4,11,0,15,1,30,5,10,0,15,4,30,6,0,0,6,1,-15,3,1
2,3,27,0,30,3,12,0,15,3,30,2,0,0,2,0,30,4,11,0,15,1,30,5,10,0,15,4,30,6,0,0,6,1,-15,3,1
2,1,29,0,30,4,10,0,14,5,30,11,1,0,12,0,30,7,7,0,14,0,30,1,13,0,14,2,30,9,0,0,9,1,-15,3,1
2,2,29,0,30,4,10,0,14,5,30,11,1,0,12,0,30,7,7,0,14,0,30,1,13,0,14,2,30,9,0,0,9,1,-15,3,1
2,1,33,2,30,5,6,0,11,5,30,4,0,0,4,5,30,9,2,0,11,0,30,3,8,0,11,5,30,4,0,0,4,1,-15,3,1
2,1,4,3,30,8,0,0,8,5,30,4,0,0,4,3,30,1,7,0,8,0,30,6,2,0,8,2,30,3,1,0,4,0,-27,3,0
2,2,4,3,30,8,0,0,8,5,30,4,0,0,4,3,30,1,7,0,8,0,30,6,2,0,8,2,30,3,1,0,4,0,-27,3,0
2,3,4,3,30,8,0,0,8,5,30,4,0,0,4,3,30,1,7,0,8,0,30,6,2,0,8,2,30,3,1,0,4,0,-27,3,0
2,3,8,1,30,7,0,0,7,3,30,2,0,0,2,2,30,6,1,0,7,0,30,6,1,0,7,0,30,3,0,0,3,0,-27,3,0
2,2,19,0,30,5,8,0,13,2,30,6,2,0,8,0,30,5,8,0,13,1,30,5,8,0,13,1,30,9,0,0,9,1,-15,3,1
2,3,19,0,30,5,8,0,13,2,30,6,2,0,8,0,30,5,8,0,13,1,30,5,8,0,13,1,30,9,0,0,9,1,-15,3,1
2,0,25,1,30,8,6,0,14,3,30,6,0,0,6,0,30,9,5,0,14,1,30,5,9,0,14,4,30,5,1,0,6,1,-15,3,1
2,1,25,1,30,8,6,0,14,3,30,6,0,0,6,0,30,9,5,0,14,1,30,5,9,0,14,4,30,5,1,0,6,1,-15,3,1
2,0,27,1,30,4,11,0,15,3,30,1,1,0,2,0,30,3,12,0,15,2,30,6,9,0,15,5,30,6,0,0,6,1,-15,3,1
2,3,27,0,30,4,11,0,15,3,30,1,1,0,2,0,30,3,12,0,15,2,30,6,9,0,15,5,30,6,0,0,6,1,-15,3,1
2,4,29,0,30,7,7,0,14,5,30,12,0,0,12,0,30,4,10,0,14,0,30,0,14,0,14,0,30,7,2,0,9,1,-15,3,1
2,1,11,3,30,4,8,0,12,3,30,4,0,0,4,3,30,2,10,0,12,7,30,3,9,0,12,3,30,4,0,0,4,1,-15,3,1
2,2,11,3,30,4,8,0,12,3,30,4,0,0,4,3,30,2,10,0,12,7,30,3,9,0,12,3,30,4,0,0,4,1,-15,3,1
2,4,11,3,30,4,8,0,12,3,30,4,0,0,4,3,30,2,10,0,12,7,30,3,9,0,12,3,30,4,0,0,4,1,-15,3,1
2,2,13,1,30,3,0,0,3,1,30,2,0,0,2,0,30,2,1,0,3,5,30,2,1,0,3,3,30,2,0,0,2,1,-15,3,1
2,3,13,1,30,3,0,0,3,1,30,2,0,0,2,0,30,2,1,0,3,5,30,2,1,0,3,3,30,2,0,0,2,1,-15,3,1
2,1,17,4,30,12,2,0,14,3,30,6,0,0,6,0,30,4,10,0,14,1,30,6,8,0,14,5,30,4,0,0,4,1,-15,3,1
2,2,17,4,30,12,2,0,14,3,30,6,0,0,6,0,30,4,10,0,14,1,30,6,8,0,14,5,30,4,0,0,4,1,-15,3,1
2,4,17,4,30,12,2,0,14,3,30,6,0,0,6,0,30,4,10,0,14,1,30,6,8,0,14,5,30,4,0,0,4,1,-15,3,1
2,3,19,0,30,3,10,0,13,3,30,3,5,0,8,6,30,4,9,0,13,3,30,7,6,0,13,1,30,9,0,0,9,1,-15,3,1
2,4,19,0,30,3,10,0,13,3,30,3,5,0,8,6,30,4,9,0,13,3,30,7,6,0,13,1,30,9,0,0,9,1,-15,3,1
2,0,27,2,30,4,11,0,15,3,30,2,0,0,2,0,30,7,8,0,15,5,30,7,8,0,15,2,30,5,1,0,6,1,-15,3,1
2,2,27,2,30,4,11,0,15,3,30,2,0,0,2,0,30,7,8,0,15,5,30,7,8,0,15,2,30,5,1,0,6,1,-15,3,1
2,3,27,2,30,4,11,0,15,3,30,2,0,0,2,0,30,7,8,0,15,5,30,7,8,0,15,2,30,5,1,0,6,1,-15,3,1
2,4,27,2,30,4,11,0,15,3,30,2,0,0,2,0,30,7,8,0,15,5,30,7,8,0,15,2,30,5,1,0,6,1,-15,3,1
2,0,29,0,30,6,8,0,14,6,30,11,1,0,12,0,30,2,12,0,14,0,30,1,13,0,14,3,30,9,0,0,9,1,-15,3,1
2,1,29,0,30,6,8,0,14,6,30,11,1,0,12,0,30,2,12,0,14,0,30,1,13,0,14,3,30,9,0,0,9,1,-15,3,1
2,4,29,0,30,6,8,0,14,6,30,11,1,0,12,0,30,2,12,0,14,0,30,1,13,0,14,0,30,9,0,0,9,1,-15,3,1
2,3,32,1,30,9,0,0,9,4,30,2,0,0,2,3,30,8,1,0,9,1,30,2,7,0,9,2,30,2,0,0,2,1,-15,3,1
2,4,1,0,30,7,3,0,10,4,30,2,0,0,2,1,30,4,6,0,10,8,30,4,6,0,10,6,30,6,0,0,6,0,-27,3,0
2,4,23,1,30,6,7,0,13,3,30,6,0,0,6,3,30,7,6,0,13,1,30,6,7,0,13,1,30,6,0,0,6,1,-15,3,1
2,3,25,1,30,10,4,0,14,4,30,6,0,0,6,0,30,6,8,0,14,1,30,5,9,0,14,4,30,4,2,0,6,1,-15,3,1
2,4,27,1,30,4,11,0,15,3,30,1,1,0,2,0,30,4,11,0,15,4,30,6,9,0,15,5,30,6,0,0,6,1,-15,3,1
2,2,31,3,30,5,7,0,12,4,30,8,0,0,8,2,30,12,0,0,12,0,30,3,9,0,12,1,30,5,1,0,6,1,-15,3,1
2,3,35,0,30,6,7,0,13,2,30,2,0,0,2,1,30,9,4,0,13,6,30,4,9,0,13,3,30,8,0,0,8,1,-15,3,1
2,4,35,0,30,6,7,0,13,2,30,2,0,0,2,1,30,9,4,0,13,6,30,4,9,0,13,3,30,8,0,0,8,1,-15,3,1
2,1,4,2,30,8,0,0,8,5,30,4,0,0,4,0,30,2,6,0,8,0,30,7,1,0,8,2,30,4,0,0,4,0,-27,3,0
2,2,4,2,30,8,0,0,8,5,30,4,0,0,4,0,30,2,6,0,8,0,30,7,1,0,8,2,30,4,0,0,4,0,-27,3,0
2,3,4,2,30,8,0,0,8,5,30,4,0,0,4,0,30,2,6,0,8,0,30,7,1,0,8,2,30,4,0,0,4,0,-27,3,0
2,3,11,1,30,4,8,0,12,1,30,4,0,0,4,0,30,6,6,0,12,2,30,7,5,0,12,5,30,4,0,0,4,1,-15,3,1
2,1,13,2,30,7,0,0,7,0,30,4,0,0,4,2,30,6,1,0,7,9,30,5,2,0,7,4,30,4,0,0,4,1,-15,3,1
2,2,13,2,30,7,0,0,7,0,30,4,0,0,4,2,30,6,1,0,7,9,30,5,2,0,7,4,30,4,0,0,4,1,-15,3,1
2,4,13,2,30,7,0,0,7,0,30,4,0,0,4,2,30,6,1,0,7,9,30,5,2,0,7,4,30,4,0,0,4,1,-15,3,1
2,3,17,3,30,9,5,0,14,3,30,6,0,0,6,0,30,6,8,0,14,0,30,6,8,0,14,1,30,4,0,0,4,1,-15,3,1
2,1,19,0,30,3,10,0,13,2,30,5,3,0,8,6,30,8,5,0,13,4,30,4,9,0,13,1,30,7,2,0,9,1,-15,3,1
2,4,19,0,30,3,10,0,13,2,30,5,3,0,8,6,30,8,5,0,13,4,30,4,9,0,13,1,30,7,2,0,9,1,-15,3,1
2,3,25,1,30,4,10,0,14,1,30,6,0,0,6,0,30,12,2,0,14,1,30,5,9,0,14,3,30,6,0,0,6,1,-15,3,1
2,2,27,1,30,4,11,0,15,3,30,1,1,0,2,0,30,6,9,0,15,1,30,9,6,0,15,4,30,6,0,0,6,1,-15,3,1
2,4,27,1,30,4,11,0,15,3,30,1,1,0,2,0,30,6,9,0,15,1,30,9,6,0,15,4,30,6,0,0,6,1,-15,3,1
2,4,35,0,30,7,6,0,13,3,30,2,0,0,2,2,30,7,6,0,13,0,30,1,12,0,13,3,30,8,0,0,8,1,-15,3,1
2,1,5,0,30,3,2,0,5,3,30,2,2,0,4,1,30,2,3,0,5,0,30,1,4,0,5,0,30,0,2,0,2,0,-27,3,0
2,3,5,0,30,3,2,0,5,3,30,2,2,0,4,0,30,2,3,0,5,0,30,1,4,0,5,0,30,0,2,0,2,0,-27,3,0
2,0,6,0,30,9,0,0,9,4,30,2,0,0,2,0,30,2,7,0,9,0,30,5,4,0,9,0,30,2,3,0,5,0,-27,3,0
2,4,7,0,30,4,5,0,9,3,30,3,1,0,4,0,30,5,4,0,9,4,30,3,6,0,9,1,30,4,2,0,6,0,-27,3,0
2,4,8,2,30,7,0,0,7,5,30,2,0,0,2,0,30,2,5,0,7,1,30,7,0,0,7,1,30,3,0,0,3,0,-27,3,0
2,2,17,3,30,8,6,0,14,3,30,6,0,0,6,0,30,6,8,0,14,3,30,8,6,0,14,5,30,4,0,0,4,1,-15,3,1
2,4,19,0,30,4,9,0,13,2,30,8,0,0,8,0,30,5,8,0,13,0,30,5,8,0,13,2,30,9,0,0,9,1,-15,3,1
2,4,22,6,30,6,2,0,8,2,30,2,0,0,2,0,30,5,3,0,8,1,30,4,4,0,8,3,30,3,1,0,4,1,-15,3,1
2,1,37,1,30,5,6,0,11,5,30,2,6,0,8,4,30,11,0,0,11,4,30,2,9,0,11,4,30,6,0,0,6,1,-15,3,1
2,3,37,1,30,5,6,0,11,5,30,2,6,0,8,4,30,11,0,0,11,4,30,2,9,0,11,4,30,6,0,0,6,1,-15,3,1
2,1,11,2,30,3,9,0,12,2,30,4,0,0,4,0,30,5,7,0,12,8,30,7,5,0,12,4,30,4,0,0,4,1,-15,3,1
2,1,13,4,30,6,1,0,7,0,30,4,0,0,4,3,30,6,1,0,7,5,30,6,1,0,7,5,30,4,0,0,4,1,-15,3,1
2,1,17,3,30,10,4,0,14,2,30,6,0,0,6,0,30,5,9,0,14,1,30,6,8,0,14,0,30,3,1,0,4,1,-15,3,1
2,4,17,3,30,10,4,0,14,2,30,6,0,0,6,0,30,5,9,0,14,1,30,6,8,0,14,0,30,3,1,0,4,1,-15,3,1
2,3,19,0,30,3,10,0,13,2,30,7,1,0,8,1,30,7,6,0,13,0,30,3,10,0,13,2,30,8,1,0,9,1,-15,3,1
2,4,27,1,30,6,9,0,15,2,30,1,1,0,2,0,30,7,8,0,15,0,30,3,12,0,15,0,30,6,0,0,6,1,-15,3,1
2,4,8,1,30,7,0,0,7,3,30,2,0,0,2,0,30,2,5,0,7,0,30,5,2,0,7,3,30,3,0,0,3,0,-27,3,0
2,2,13,9,30,7,0,0,7,1,30,4,0,0,4,2,30,5,2,0,7,5,30,5,2,0,7,1,30,4,0,0,4,1,-15,3,1
2,4,13,9,30,7,0,0,7,1,30,4,0,0,4,2,30,5,2,0,7,5,30,5,2,0,7,1,30,4,0,0,4,1,-15,3,1
2,1,19,0,30,3,10,0,13,1,30,6,2,0,8,3,30,11,2,0,13,1,30,4,9,0,13,1,30,7,2,0,9,1,-15,3,1
2,2,19,0,30,3,10,0,13,1,30,6,2,0,8,3,30,11,2,0,13,1,30,4,9,0,13,1,30,7,2,0,9,1,-15,3,1
2,1,25,0,30,2,12,0,14,4,30,6,0,0,6,0,30,8,6,0,14,1,30,7,7,0,14,5,30,6,0,0,6,1,-15,3,1
2,2,29,0,30,5,9,0,14,4,30,10,2,0,12,0,30,3,11,0,14,0,30,1,13,0,14,0,30,7,2,0,9,1,-15,3,1
2,3,29,0,30,5,9,0,14,4,30,10,2,0,12,0,30,3,11,0,14,0,30,1,13,0,14,0,30,7,2,0,9,1,-15,3,1
2,3,5,0,30,1,4,0,5,3,30,0,4,0,4,0,30,0,5,0,5,0,30,3,2,0,5,2,30,2,0,0,2,0,-27,3,0
2,3,11,1,30,4,8,0,12,0,30,4,0,0,4,0,30,10,2,0,12,4,30,7,5,0,12,5,30,4,0,0,4,1,-15,3,1
2,4,11,1,30,4,8,0,12,0,30,4,0,0,4,0,30,10,2,0,12,4,30,7,5,0,12,5,30,4,0,0,4,1,-15,3,1
2,4,19,0,30,4,9,0,13,2,30,6,2,0,8,0,30,5,8,0,13,5,30,5,8,0,13,2,30,9,0,0,9,1,-15,3,1
2,1,27,1,30,4,11,0,15,3,30,1,1,0,2,0,30,6,9,0,15,5,30,4,11,0,15,6,30,6,0,0,6,1,-15,3,1
2,2,27,1,30,4,11,0,15,3,30,1,1,0,2,0,30,6,9,0,15,5,30,4,11,0,15,6,30,6,0,0,6,1,-15,3,1
2,4,33,8,30,7,4,0,11,6,30,4,0,0,4,0,30,6,5,0,11,0,30,4,7,0,11,3,30,4,0,0,4,1,-15,3,1
2,1,38,0,30,1,9,0,10,6,30,6,0,0,6,0,30,2,8,0,10,4,30,2,8,0,10,7,30,6,0,0,6,1,-15,3,1
2,3,38,0,30,1,9,0,10,6,30,6,0,0,6,0,30,2,8,0,10,4,30,2,8,0,10,7,30,6,0,0,6,1,-15,3,1
2,2,13,1,30,6,1,0,7,0,30,4,0,0,4,2,30,6,1,0,7,14,30,5,2,0,7,2,30,4,0,0,4,1,-15,3,1
2,4,13,1,30,6,1,0,7,0,30,4,0,0,4,2,30,6,1,0,7,14,30,5,2,0,7,2,30,4,0,0,4,1,-15,3,1
2,1,17,4,30,10,4,0,14,4,30,6,0,0,6,0,30,3,11,0,14,0,30,7,7,0,14,2,30,4,0,0,4,1,-15,3,1
2,1,21,1,30,7,3,0,10,2,30,5,1,0,6,1,30,6,4,0,10,3,30,4,6,0,10,3,30,4,0,0,4,1,-15,3,1
2,3,29,0,30,5,9,0,14,6,30,11,1,0,12,0,30,2,12,0,14,0,30,8,6,0,14,1,30,9,0,0,9,1,-15,3,1
2,2,31,3,30,8,4,0,12,4,30,8,0,0,8,6,30,9,3,0,12,0,30,3,9,0,12,0,30,1,5,0,6,1,-15,3,1
2,4,31,3,30,8,4,0,12,4,30,8,0,0,8,6,30,9,3,0,12,0,30,3,9,0,12,0,30,1,5,0,6,1,-15,3,1
2,1,5,2,30,3,2,0,5,3,30,2,2,0,4,0,30,0,5,0,5,0,30,2,3,0,5,0,30,1,1,0,2,0,-27,3,0
2,2,5,2,30,3,2,0,5,3,30,2,2,0,4,0,30,0,5,0,5,0,30,2,3,0,5,0,30,1,1,0,2,0,-27,3,0
2,3,5,2,30,3,2,0,5,3,30,2,2,0,4,0,30,0,5,0,5,0,30,2,3,0,5,0,30,1,1,0,2,0,-27,3,0
2,4,5,2,30,3,2,0,5,3,30,2,2,0,4,0,30,0,5,0,5,0,30,2,3,0,5,0,30,1,1,0,2,0,-27,3,0
2,4,15,0,30,11,2,0,13,1,30,5,1,0,6,0,30,5,8,0,13,2,30,5,8,0,13,2,30,5,4,0,9,1,-15,3,1
2,2,17,4,30,10,4,0,14,2,30,6,0,0,6,0,30,9,5,0,14,5,30,4,10,0,14,4,30,4,0,0,4,1,-15,3,1
2,3,17,4,30,10,4,0,14,2,30,6,0,0,6,0,30,9,5,0,14,5,30,4,10,0,14,4,30,4,0,0,4,1,-15,3,1
2,4,17,4,30,10,4,0,14,2,30,6,0,0,6,0,30,9,5,0,14,5,30,4,10,0,14,4,30,4,0,0,4,1,-15,3,1
2,4,19,0,30,3,10,0,13,0,30,8,0,0,8,3,30,8,5,0,13,3,30,4,9,0,13,0,30,6,3,0,9,1,-15,3,1
2,1,27,1,30,6,9,0,15,3,30,1,1,0,2,0,30,7,8,0,15,2,30,4,11,0,15,1,30,6,0,0,6,1,-15,3,1
2,1,41,0,30,7,5,0,12,4,30,8,0,0,8,0,30,12,0,0,12,0,30,2,10,0,12,1,30,6,1,0,7,1,-15,3,1
2,2,41,0,30,7,5,0,12,4,30,8,0,0,8,0,30,12,0,0,12,0,30,2,10,0,12,1,30,6,1,0,7,1,-15,3,1
2,3,7,0,30,1,3,0,4,2,30,2,0,0,2,0,30,1,3,0,4,2,30,3,1,0,4,2,30,2,0,0,2,0,-27,3,0
2,4,7,1,30,3,6,0,9,3,30,4,0,0,4,0,30,4,5,0,9,8,30,6,3,0,9,1,30,6,0,0,6,0,-27,3,0
2,4,8,3,30,7,0,0,7,5,30,2,0,0,2,5,30,3,4,0,7,0,30,7,0,0,7,0,30,3,0,0,3,0,-27,3,0
2,4,13,3,30,6,1,0,7,0,30,4,0,0,4,2,30,6,1,0,7,3,30,6,1,0,7,5,30,4,0,0,4,1,-15,3,1
2,4,23,3,30,6,7,0,13,3,30,6,0,0,6,4,30,11,2,0,13,0,30,5,8,0,13,1,30,5,1,0,6,1,-15,3,1
2,2,13,4,30,6,1,0,7,0,30,4,0,0,4,2,30,6,1,0,7,4,30,7,0,0,7,5,30,4,0,0,4,1,-15,3,1
2,3,13,4,30,6,1,0,7,0,30,4,0,0,4,2,30,6,1,0,7,4,30,7,0,0,7,5,30,4,0,0,4,1,-15,3,1
2,4,17,3,30,8,6,0,14,2,30,6,0,0,6,0,30,8,6,0,14,0,30,5,9,0,14,4,30,4,0,0,4,1,-15,3,1
2,2,19,1,30,2,11,0,13,2,30,7,1,0,8,0,30,7,6,0,13,7,30,4,9,0,13,0,30,8,1,0,9,1,-15,3,1
2,4,22,1,30,6,2,0,8,3,30,2,0,0,2,4,30,5,3,0,8,0,30,4,4,0,8,3,30,3,1,0,4,1,-15,3,1
2,3,23,2,30,5,8,0,13,1,30,6,0,0,6,2,30,12,1,0,13,2,30,4,9,0,13,1,30,6,0,0,6,1,-15,3,1
2,2,27,1,30,4,11,0,15,4,30,2,0,0,2,0,30,3,12,0,15,1,30,5,10,0,15,0,30,4,2,0,6,1,-15,3,1
2,4,31,3,30,8,4,0,12,4,30,8,0,0,8,5,30,9,3,0,12,0,30,4,8,0,12,1,30,2,4,0,6,1,-15,3,1
2,3,39,0,30,5,6,0,11,6,30,6,0,0,6,0,30,5,6,0,11,0,30,2,9,0,11,2,30,5,0,0,5,1,-15,3,1
2,2,25,1,30,4,10,0,14,3,30,6,0,0,6,0,30,8,6,0,14,4,30,6,8,0,14,5,30,5,1,0,6,1,-15,3,1
2,3,25,1,30,4,10,0,14,3,30,6,0,0,6,0,30,8,6,0,14,4,30,6,8,0,14,5,30,5,1,0,6,1,-15,3,1
2,2,27,1,30,4,11,0,15,3,30,1,1,0,2,0,30,6,9,0,15,3,30,4,11,0,15,4,30,6,0,0,6,1,-15,3,1
2,2,31,4,30,7,5,0,12,4,30,8,0,0,8,3,30,9,3,0,12,0,30,3,9,0,12,0,30,2,4,0,6,1,-15,3,1
2,3,33,1,30,3,8,0,11,5,30,4,0,0,4,1,30,9,2,0,11,3,30,4,7,0,11,6,30,4,0,0,4,1,-15,3,1
2,2,37,1,30,6,5,0,11,6,30,8,0,0,8,0,30,4,7,0,11,2,30,3,8,0,11,2,30,6,0,0,6,1,-15,3,1
2,2,4,2,30,7,1,0,8,5,30,4,0,0,4,0,30,2,6,0,8,0,30,6,2,0,8,2,30,4,0,0,4,0,-27,3,0
2,3,4,2,30,7,1,0,8,5,30,4,0,0,4,0,30,2,6,0,8,0,30,6,2,0,8,2,30,4,0,0,4,0,-27,3,0
2,3,8,2,30,7,0,0,7,3,30,2,0,0,2,2,30,4,3,0,7,0,30,6,1,0,7,0,30,3,0,0,3,0,-27,3,0
2,4,8,2,30,7,0,0,7,3,30,2,0,0,2,2,30,4,3,0,7,0,30,6,1,0,7,0,30,3,0,0,3,0,-27,3,0
2,1,13,1,30,4,3,0,7,0,30,4,0,0,4,3,30,7,0,0,7,9,30,5,2,0,7,2,30,4,0,0,4,1,-15,3,1
2,2,13,1,30,4,3,0,7,0,30,4,0,0,4,3,30,7,0,0,7,9,30,5,2,0,7,2,30,4,0,0,4,1,-15,3,1
2,1,23,1,30,4,9,0,13,2,30,6,0,0,6,8,30,12,1,0,13,2,30,5,8,0,13,1,30,6,0,0,6,1,-15,3,1
2,3,23,1,30,4,9,0,13,2,30,6,0,0,6,8,30,12,1,0,13,2,30,5,8,0,13,1,30,6,0,0,6,1,-15,3,1
2,0,29,0,30,6,8,0,14,6,30,10,2,0,12,0,30,6,8,0,14,0,30,0,14,0,14,4,30,9,0,0,9,1,-15,3,1
2,2,47,0,30,0,14,0,14,6,30,4,0,0,4,0,30,3,11,0,14,1,30,3,11,0,14,10,30,7,0,0,7,1,-15,3,1
2,4,23,1,30,10,3,0,13,0,30,6,0,0,6,0,30,13,0,0,13,1,30,5,8,0,13,6,30,6,0,0,6,1,-15,3,1
2,1,25,1,30,3,11,0,14,2,30,6,0,0,6,0,30,10,4,0,14,2,30,6,8,0,14,4,30,6,0,0,6,1,-15,3,1
2,4,25,1,30,3,11,0,14,2,30,6,0,0,6,0,30,10,4,0,14,2,30,6,8,0,14,4,30,6,0,0,6,1,-15,3,1
2,4,29,0,30,5,9,0,14,6,30,11,1,0,12,0,30,5,9,0,14,0,30,0,14,0,14,4,30,9,0,0,9,1,-15,3,1
2,3,31,1,30,2,10,0,12,5,30,8,0,0,8,3,30,4,8,0,12,0,30,8,4,0,12,5,30,6,0,0,6,1,-15,3,1
2,4,6,0,30,4,5,0,9,3,30,2,0,0,2,0,30,2,7,0,9,0,30,3,6,0,9,3,30,5,0,0,5,0,-27,3,0
2,2,11,1,30,4,8,0,12,0,30,4,0,0,4,0,30,8,4,0,12,4,30,5,7,0,12,4,30,4,0,0,4,1,-15,3,1
2,4,11,1,30,4,8,0,12,0,30,4,0,0,4,0,30,8,4,0,12,4,30,5,7,0,12,4,30,4,0,0,4,1,-15,3,1
2,4,13,1,30,6,1,0,7,0,30,4,0,0,4,2,30,7,0,0,7,13,30,5,2,0,7,2,30,4,0,0,4,1,-15,3,1
2,4,22,1,30,6,2,0,8,3,30,2,0,0,2,1,30,5,3,0,8,1,30,4,4,0,8,2,30,4,0,0,4,1,-15,3,1
2,3,23,1,30,3,10,0,13,3,30,6,0,0,6,4,30,11,2,0,13,0,30,5,8,0,13,2,30,6,0,0,6,1,-15,3,1
2,4,23,1,30,3,10,0,13,3,30,6,0,0,6,4,30,11,2,0,13,0,30,5,8,0,13,2,30,6,0,0,6,1,-15,3,1
2,1,27,1,30,12,3,0,15,3,30,2,0,0,2,0,30,2,13,0,15,2,30,3,12,0,15,2,30,6,0,0,6,1,-15,3,1
2,4,27,1,30,12,3,0,15,3,30,2,0,0,2,0,30,2,13,0,15,0,30,3,12,0,15,0,30,6,0,0,6,1,-15,3,1
2,4,31,0,30,7,5,0,12,3,30,8,0,0,8,3,30,10,2,0,12,0,30,3,9,0,12,0,30,2,4,0,6,1,-15,3,1
2,0,5,0,30,5,0,0,5,3,30,1,3,0,4,3,30,0,5,0,5,0,30,1,4,0,5,0,30,0,2,0,2,0,-27,3,0
2,1,6,0,30,6,3,0,9,3,30,2,0,0,2,0,30,4,5,0,9,0,30,4,5,0,9,1,30,3,2,0,5,0,-27,3,0
2,3,6,0,30,6,3,0,9,3,30,2,0,0,2,0,30,4,5,0,9,0,30,4,5,0,9,1,30,3,2,0,5,0,-27,3,0
2,3,11,1,30,5,7,0,12,1,30,4,0,0,4,0,30,8,4,0,12,2,30,6,6,0,12,0,30,4,0,0,4,1,-15,3,1
2,4,11,1,30,5,7,0,12,1,30,4,0,0,4,0,30,8,4,0,12,2,30,6,6,0,12,0,30,4,0,0,4,1,-15,3,1
2,2,13,3,30,7,0,0,7,0,30,4,0,0,4,0,30,5,2,0,7,9,30,6,1,0,7,3,30,4,0,0,4,1,-15,3,1
2,1,17,3,30,9,5,0,14,3,30,6,0,0,6,0,30,6,8,0,14,3,30,6,8,0,14,2,30,4,0,0,4,1,-15,3,1
2,2,17,3,30,9,5,0,14,3,30,6,0,0,6,0,30,6,8,0,14,3,30,6,8,0,14,2,30,4,0,0,4,1,-15,3,1
2,3,17,3,30,9,5,0,14,3,30,6,0,0,6,0,30,6,8,0,14,3,30,6,8,0,14,2,30,4,0,0,4,1,-15,3,1
2,0,19,0,30,4,9,0,13,2,30,7,1,0,8,0,30,4,9,0,13,3,30,7,6,0,13,0,30,6,3,0,9,1,-15,3,1
2,3,19,0,30,4,9,0,13,2,30,7,1,0,8,0,30,4,9,0,13,3,30,7,6,0,13,0,30,6,3,0,9,1,-15,3,1
2,4,19,0,30,4,9,0,13,2,30,7,1,0,8,0,30,4,9,0,13,3,30,7,6,0,13,0,30,6,3,0,9,1,-15,3,1
2,3,23,1,30,6,7,0,13,2,30,6,0,0,6,6,30,13,0,0,13,0,30,5,8,0,13,2,30,5,1,0,6,1,-15,3,1
2,4,13,1,30,6,1,0,7,0,30,4,0,0,4,2,30,5,2,0,7,6,30,5,2,0,7,3,30,4,0,0,4,1,-15,3,1
2,4,15,1,30,4,9,0,13,0,30,6,0,0,6,0,30,5,8,0,13,0,30,4,9,0,13,2,30,8,1,0,9,1,-15,3,1
2,2,17,5,30,11,3,0,14,3,30,6,0,0,6,0,30,5,9,0,14,2,30,3,11,0,14,1,30,4,0,0,4,1,-15,3,1
2,3,17,5,30,11,3,0,14,3,30,6,0,0,6,0,30,5,9,0,14,2,30,3,11,0,14,1,30,4,0,0,4,1,-15,3,1
2,1,19,0,30,1,12,0,13,2,30,6,2,0,8,0,30,6,7,0,13,5,30,3,10,0,13,0,30,8,1,0,9,1,-15,3,1
2,3,19,0,30,1,12,0,13,2,30,6,2,0,8,0,30,6,7,0,13,5,30,3,10,0,13,0,30,8,1,0,9,1,-15,3,1
2,4,19,0,30,1,12,0,13,2,30,6,2,0,8,0,30,6,7,0,13,5,30,3,10,0,13,0,30,8,1,0,9,1,-15,3,1
2,1,23,1,30,4,9,0,13,1,30,6,0,0,6,6,30,13,0,0,13,0,30,6,7,0,13,2,30,6,0,0,6,1,-15,3,1
2,2,23,1,30,4,9,0,13,1,30,6,0,0,6,6,30,13,0,0,13,0,30,6,7,0,13,2,30,6,0,0,6,1,-15,3,1
2,3,23,1,30,4,9,0,13,1,30,6,0,0,6,6,30,13,0,0,13,0,30,6,7,0,13,2,30,6,0,0,6,1,-15,3,1
2,4,27,1,30,3,12,0,15,3,30,1,1,0,2,0,30,7,8,0,15,0,30,6,9,0,15,1,30,6,0,0,6,1,-15,3,1
2,3,29,0,30,7,7,0,14,6,30,11,1,0,12,0,30,4,10,0,14,0,30,0,14,0,14,3,30,9,0,0,9,1,-15,3,1
2,4,29,0,30,7,7,0,14,6,30,11,1,0,12,0,30,4,10,0,14,0,30,0,14,0,14,3,30,9,0,0,9,1,-15,3,1
2,2,31,1,30,5,7,0,12,6,30,8,0,0,8,5,30,8,4,0,12,0,30,3,9,0,12,3,30,6,0,0,6,1,-15,3,1
2,3,31,1,30,5,7,0,12,6,30,8,0,0,8,5,30,8,4,0,12,0,30,3,9,0,12,3,30,6,0,0,6,1,-15,3,1
2,4,32,0,30,6,3,0,9,3,30,2,0,0,2,0,30,9,0,0,9,1,30,3,6,0,9,6,30,2,0,0,2,1,-15,3,1
2,3,3,5,30,1,3,0,4,4,30,4,0,0,4,0,30,0,4,0,4,0,30,2,2,0,4,0,30,1,2,0,3,0,-27,3,0
2,4,13,2,30,6,1,0,7,0,30,4,0,0,4,2,30,5,2,0,7,7,30,5,2,0,7,1,30,4,0,0,4,1,-15,3,1
2,1,17,5,30,8,6,0,14,3,30,6,0,0,6,0,30,5,9,0,14,4,30,7,7,0,14,2,30,4,0,0,4,1,-15,3,1
2,4,17,5,30,8,6,0,14,3,30,6,0,0,6,0,30,5,9,0,14,4,30,7,7,0,14,2,30,4,0,0,4,1,-15,3,1
2,1,19,1,30,3,10,0,13,2,30,4,4,0,8,0,30,7,6,0,13,9,30,4,9,0,13,3,30,8,1,0,9,1,-15,3,1
2,0,27,1,30,8,7,0,15,5,30,2,0,0,2,0,30,2,13,0,15,1,30,5,10,0,15,3,30,6,0,0,6,1,-15,3,1
2,3,35,0,30,5,8,0,13,3,30,2,0,0,2,1,30,8,5,0,13,2,30,3,10,0,13,0,30,8,0,0,8,1,-15,3,1
2,2,39,0,30,3,8,0,11,6,30,6,0,0,6,0,30,4,7,0,11,0,30,4,7,0,11,7,30,5,0,0,5,1,-15,3,1
2,3,39,0,30,3,8,0,11,6,30,6,0,0,6,0,30,4,7,0,11,0,30,4,7,0,11,7,30,5,0,0,5,1,-15,3,1
2,3,1,0,30,9,1,0,10,4,30,2,0,0,2,1,30,4,6,0,10,1,30,7,3,0,10,6,30,6,0,0,6,0,-27,3,0
2,2,13,3,30,7,0,0,7,0,30,4,0,0,4,2,30,7,0,0,7,10,30,7,0,0,7,5,30,4,0,0,4,1,-15,3,1
2,4,13,3,30,7,0,0,7,0,30,4,0,0,4,2,30,7,0,0,7,10,30,7,0,0,7,5,30,4,0,0,4,1,-15,3,1
2,2,17,3,30,9,5,0,14,2,30,6,0,0,6,0,30,7,7,0,14,3,30,7,7,0,14,3,30,4,0,0,4,1,-15,3,1
2,3,17,3,30,9,5,0,14,2,30,6,0,0,6,0,30,7,7,0,14,3,30,7,7,0,14,3,30,4,0,0,4,1,-15,3,1
2,0,21,1,30,7,3,0,10,3,30,5,1,0,6,1,30,3,7,0,10,3,30,4,6,0,10,4,30,4,0,0,4,1,-15,3,1
2,4,25,1,30,6,8,0,14,3,30,6,0,0,6,0,30,11,3,0,14,1,30,4,10,0,14,4,30,5,1,0,6,1,-15,3,1
2,4,11,0,30,5,7,0,12,1,30,4,0,0,4,0,30,5,7,0,12,0,30,7,5,0,12,4,30,4,0,0,4,1,-15,3,1
2,0,14,0,30,7,2,0,9,2,30,6,0,0,6,4,30,3,6,0,9,9,30,1,8,0,9,2,30,4,0,0,4,1,-15,3,1
2,1,14,0,30,7,2,0,9,2,30,6,0,0,6,4,30,3,6,0,9,9,30,1,8,0,9,2,30,4,0,0,4,1,-15,3,1
2,4,14,0,30,7,2,0,9,2,30,6,0,0,6,4,30,3,6,0,9,9,30,1,8,0,9,2,30,4,0,0,4,1,-15,3,1
2,3,23,1,30,7,6,0,13,1,30,6,0,0,6,4,30,12,1,0,13,0,30,5,8,0,13,3,30,6,0,0,6,1,-15,3,1
2,0,27,1,30,5,10,0,15,4,30,1,1,0,2,0,30,5,10,0,15,2,30,5,10,0,15,5,30,6,0,0,6,1,-15,3,1
2,1,27,1,30,5,10,0,15,4,30,1,1,0,2,0,30,5,10,0,15,2,30,5,10,0,15,5,30,6,0,0,6,1,-15,3,1
2,3,31,2,30,7,5,0,12,3,30,8,0,0,8,3,30,12,0,0,12,0,30,3,9,0,12,0,30,4,2,0,6,1,-15,3,1
2,3,35,0,30,4,9,0,13,4,30,2,0,0,2,1,30,10,3,0,13,2,30,4,9,0,13,6,30,8,0,0,8,1,-15,3,1
2,3,13,1,30,5,2,0,7,0,30,4,0,0,4,1,30,6,1,0,7,5,30,6,1,0,7,5,30,4,0,0,4,1,-15,3,1
2,4,13,1,30,5,2,0,7,0,30,4,0,0,4,1,30,6,1,0,7,5,30,6,1,0,7,5,30,4,0,0,4,1,-15,3,1
2,4,17,3,30,11,3,0,14,3,30,6,0,0,6,0,30,6,8,0,14,2,30,7,7,0,14,4,30,4,0,0,4,1,-15,3,1
2,3,19,0,30,3,10,0,13,2,30,8,0,0,8,0,30,5,8,0,13,0,30,4,9,0,13,1,30,8,1,0,9,1,-15,3,1
2,4,29,0,30,5,9,0,14,6,30,11,1,0,12,0,30,5,9,0,14,0,30,1,13,0,14,4,30,9,0,0,9,1,-15,3,1
2,3,31,0,30,4,8,0,12,4,30,8,0,0,8,3,30,11,1,0,12,0,30,5,7,0,12,2,30,6,0,0,6,1,-15,3,1
2,4,31,0,30,4,8,0,12,4,30,8,0,0,8,3,30,11,1,0,12,0,30,5,7,0,12,2,30,6,0,0,6,1,-15,3,1
2,3,1,0,30,7,3,0,10,4,30,2,0,0,2,0,30,4,6,0,10,3,30,7,3,0,10,2,30,6,0,0,6,0,-27,3,0
2,4,7,0,30,4,5,0,9,2,30,4,0,0,4,3,30,6,3,0,9,8,30,3,6,0,9,1,30,6,0,0,6,0,-27,3,0
2,2,13,2,30,5,2,0,7,0,30,4,0,0,4,2,30,5,2,0,7,8,30,5,2,0,7,6,30,4,0,0,4,1,-15,3,1
2,1,17,4,30,9,5,0,14,3,30,6,0,0,6,0,30,4,10,0,14,2,30,6,8,0,14,6,30,4,0,0,4,1,-15,3,1
2,4,19,0,30,3,10,0,13,2,30,7,1,0,8,0,30,6,7,0,13,7,30,4,9,0,13,3,30,9,0,0,9,1,-15,3,1
2,3,23,2,30,5,8,0,13,3,30,6,0,0,6,3,30,13,0,0,13,0,30,5,8,0,13,1,30,6,0,0,6,1,-15,3,1
2,4,27,1,30,4,11,0,15,5,30,2,0,0,2,0,30,4,11,0,15,5,30,5,10,0,15,4,30,6,0,0,6,1,-15,3,1
2,3,29,0,30,7,7,0,14,6,30,11,1,0,12,0,30,4,10,0,14,0,30,1,13,0,14,1,30,9,0,0,9,1,-15,3,1
2,4,31,5,30,6,6,0,12,5,30,8,0,0,8,6,30,9,3,0,12,0,30,3,9,0,12,1,30,1,5,0,6,1,-15,3,1
2,3,33,1,30,2,9,0,11,5,30,4,0,0,4,0,30,8,3,0,11,2,30,3,8,0,11,6,30,4,0,0,4,1,-15,3,1
2,3,5,0,30,2,3,0,5,3,30,1,3,0,4,0,30,0,5,0,5,0,30,1,4,0,5,2,30,2,0,0,2,0,-27,3,0
2,3,8,0,30,7,0,0,7,2,30,2,0,0,2,1,30,7,0,0,7,1,30,7,0,0,7,0,30,3,0,0,3,0,-27,3,0
2,4,8,0,30,7,0,0,7,2,30,2,0,0,2,1,30,7,0,0,7,1,30,7,0,0,7,0,30,3,0,0,3,0,-27,3,0
2,1,17,3,30,9,5,0,14,3,30,6,0,0,6,0,30,5,9,0,14,5,30,5,9,0,14,4,30,4,0,0,4,1,-15,3,1
2,4,17,3,30,9,5,0,14,3,30,6,0,0,6,0,30,5,9,0,14,5,30,5,9,0,14,0,30,4,0,0,4,1,-15,3,1
2,2,19,0,30,3,10,0,13,2,30,3,5,0,8,0,30,4,9,0,13,5,30,7,6,0,13,2,30,9,0,0,9,1,-15,3,1
2,4,19,0,30,3,10,0,13,2,30,3,5,0,8,0,30,4,9,0,13,5,30,7,6,0,13,2,30,9,0,0,9,1,-15,3,1
2,4,31,2,30,5,7,0,12,7,30,8,0,0,8,3,30,4,8,0,12,0,30,8,4,0,12,2,30,6,0,0,6,1,-15,3,1
2,2,13,1,30,5,2,0,7,0,30,4,0,0,4,2,30,6,1,0,7,4,30,5,2,0,7,2,30,4,0,0,4,1,-15,3,1
2,4,19,0,30,1,12,0,13,1,30,6,2,0,8,0,30,5,8,0,13,3,30,8,5,0,13,5,30,9,0,0,9,1,-15,3,1
2,3,23,3,30,7,6,0,13,0,30,6,0,0,6,2,30,11,2,0,13,0,30,3,10,0,13,1,30,6,0,0,6,1,-15,3,1
2,3,25,1,30,11,3,0,14,1,30,6,0,0,6,0,30,9,5,0,14,1,30,4,10,0,14,3,30,5,1,0,6,1,-15,3,1
2,4,33,2,30,6,5,0,11,6,30,4,0,0,4,0,30,6,5,0,11,0,30,6,5,0,11,5,30,4,0,0,4,1,-15,3,1
2,4,35,2,30,10,3,0,13,4,30,2,0,0,2,0,30,5,8,0,13,0,30,1,12,0,13,1,30,7,1,0,8,1,-15,3,1
2,3,47,0,30,0,14,0,14,5,30,4,0,0,4,0,30,6,8,0,14,0,30,5,9,0,14,6,30,7,0,0,7,1,-15,3,1
2,1,5,0,30,1,4,0,5,2,30,2,2,0,4,0,30,2,3,0,5,0,30,1,4,0,5,0,30,0,2,0,2,0,-27,3,0
2,2,13,3,30,7,0,0,7,1,30,4,0,0,4,2,30,6,1,0,7,2,30,6,1,0,7,2,30,4,0,0,4,1,-15,3,1
2,4,15,0,30,4,9,0,13,0,30,5,1,0,6,0,30,4,9,0,13,1,30,3,10,0,13,2,30,7,2,0,9,1,-15,3,1
2,3,17,6,30,10,4,0,14,2,30,6,0,0,6,0,30,9,5,0,14,0,30,6,8,0,14,4,30,4,0,0,4,1,-15,3,1
2,4,17,6,30,10,4,0,14,2,30,6,0,0,6,0,30,9,5,0,14,0,30,6,8,0,14,4,30,4,0,0,4,1,-15,3,1
2,4,23,1,30,3,10,0,13,4,30,6,0,0,6,4,30,10,3,0,13,2,30,5,8,0,13,1,30,6,0,0,6,1,-15,3,1
2,1,25,1,30,8,6,0,14,3,30,6,0,0,6,0,30,5,9,0,14,1,30,7,7,0,14,3,30,6,0,0,6,1,-15,3,1
2,2,25,1,30,8,6,0,14,3,30,6,0,0,6,0,30,5,9,0,14,1,30,7,7,0,14,3,30,6,0,0,6,1,-15,3,1
2,3,25,1,30,8,6,0,14,3,30,6,0,0,6,0,30,5,9,0,14,1,30,7,7,0,14,3,30,6,0,0,6,1,-15,3,1
2,3,27,1,30,5,10,0,15,3,30,1,1,0,2,0,30,2,13,0,15,0,30,4,11,0,15,3,30,6,0,0,6,1,-15,3,1
2,2,29,0,30,5,9,0,14,5,30,8,4,0,12,0,30,7,7,0,14,0,30,5,9,0,14,0,30,9,0,0,9,1,-15,3,1
2,3,29,0,30,5,9,0,14,5,30,8,4,0,12,0,30,7,7,0,14,0,30,5,9,0,14,0,30,9,0,0,9,1,-15,3,1
2,4,29,0,30,5,9,0,14,5,30,8,4,0,12,0,30,7,7,0,14,0,30,5,9,0,14,0,30,9,0,0,9,1,-15,3,1
2,4,4,0,30,4,4,0,8,5,30,4,0,0,4,1,30,1,7,0,8,0,30,8,0,0,8,1,30,4,0,0,4,0,-27,3,0
2,2,9,0,30,2,2,0,4,2,30,2,0,0,2,3,30,4,0,0,4,2,30,2,2,0,4,0,30,1,0,0,1,0,-27,3,0
2,3,9,0,30,2,2,0,4,2,30,2,0,0,2,3,30,4,0,0,4,2,30,2,2,0,4,0,30,1,0,0,1,0,-27,3,0
2,4,15,0,30,4,9,0,13,1,30,6,0,0,6,0,30,5,8,0,13,1,30,8,5,0,13,2,30,9,0,0,9,1,-15,3,1
2,4,17,2,30,9,5,0,14,4,30,6,0,0,6,0,30,3,11,0,14,2,30,8,6,0,14,0,30,4,0,0,4,1,-15,3,1
2,2,27,1,30,6,9,0,15,3,30,2,0,0,2,0,30,6,9,0,15,0,30,3,12,0,15,0,30,5,1,0,6,1,-15,3,1
2,3,27,1,30,6,9,0,15,3,30,2,0,0,2,0,30,6,9,0,15,0,30,3,12,0,15,0,30,5,1,0,6,1,-15,3,1
2,2,36,0,30,4,5,0,9,5,30,0,2,0,2,6,30,4,5,0,9,0,30,3,6,0,9,6,30,3,0,0,3,1,-15,3,1
2,3,36,0,30,4,5,0,9,5,30,0,2,0,2,6,30,4,5,0,9,0,30,3,6,0,9,6,30,3,0,0,3,1,-15,3,1
2,2,38,0,30,1,9,0,10,7,30,6,0,0,6,4,30,1,9,0,10,0,30,2,8,0,10,9,30,6,0,0,6,1,-15,3,1
2,3,38,0,30,1,9,0,10,7,30,6,0,0,6,4,30,1,9,0,10,0,30,2,8,0,10,9,30,6,0,0,6,1,-15,3,1
2,2,13,0,30,6,1,0,7,0,30,4,0,0,4,2,30,6,1,0,7,8,30,5,2,0,7,8,30,4,0,0,4,1,-15,3,1
2,2,19,0,30,4,9,0,13,2,30,5,3,0,8,0,30,4,9,0,13,4,30,5,8,0,13,1,30,9,0,0,9,1,-15,3,1
2,1,25,1,30,2,12,0,14,5,30,6,0,0,6,0,30,6,8,0,14,1,30,6,8,0,14,6,30,6,0,0,6,1,-15,3,1
2,2,25,1,30,2,12,0,14,5,30,6,0,0,6,0,30,6,8,0,14,1,30,6,8,0,14,6,30,6,0,0,6,1,-15,3,1
2,3,25,1,30,2,12,0,14,5,30,6,0,0,6,0,30,6,8,0,14,1,30,6,8,0,14,6,30,6,0,0,6,1,-15,3,1
2,3,43,0,30,5,9,0,14,8,30,6,0,0,6,0,30,8,6,0,14,1,30,7,7,0,14,1,30,5,0,0,5,1,-15,3,1
2,1,4,6,30,8,0,0,8,5,30,4,0,0,4,0,30,2,6,0,8,0,30,1,7,0,8,4,30,4,0,0,4,0,-27,3,0
2,3,4,6,30,8,0,0,8,5,30,4,0,0,4,0,30,2,6,0,8,0,30,1,7,0,8,0,30,4,0,0,4,0,-27,3,0
2,4,4,6,30,8,0,0,8,5,30,4,0,0,4,0,30,2,6,0,8,0,30,1,7,0,8,0,30,4,0,0,4,0,-27,3,0
2,3,13,1,30,7,0,0,7,1,30,4,0,0,4,2,30,7,0,0,7,6,30,6,1,0,7,0,30,4,0,0,4,1,-15,3,1
2,1,25,0,30,8,6,0,14,1,30,6,0,0,6,0,30,7,7,0,14,1,30,7,7,0,14,6,30,6,0,0,6,1,-15,3,1
2,1,27,1,30,3,12,0,15,4,30,2,0,0,2,0,30,5,10,0,15,2,30,4,11,0,15,5,30,6,0,0,6,1,-15,3,1
2,2,27,1,30,3,12,0,15,4,30,2,0,0,2,0,30,5,10,0,15,2,30,4,11,0,15,5,30,6,0,0,6,1,-15,3,1
2,4,27,1,30,3,12,0,15,4,30,2,0,0,2,0,30,5,10,0,15,2,30,4,11,0,15,5,30,6,0,0,6,1,-15,3,1
2,2,29,0,30,3,11,0,14,6,30,7,5,0,12,0,30,3,11,0,14,1,30,8,6,0,14,3,30,9,0,0,9,1,-15,3,1
2,4,29,0,30,3,11,0,14,6,30,7,5,0,12,0,30,3,11,0,14,1,30,8,6,0,14,3,30,9,0,0,9,1,-15,3,1
2,4,31,1,30,7,5,0,12,5,30,8,0,0,8,8,30,7,5,0,12,0,30,3,9,0,12,0,30,5,1,0,6,1,-15,3,1
2,1,33,1,30,4,7,0,11,5,30,4,0,0,4,3,30,10,1,0,11,3,30,5,6,0,11,6,30,4,0,0,4,1,-15,3,1
2,2,33,1,30,4,7,0,11,5,30,4,0,0,4,3,30,10,1,0,11,3,30,5,6,0,11,6,30,4,0,0,4,1,-15,3,1
2,3,35,0,30,7,6,0,13,4,30,2,0,0,2,1,30,5,8,0,13,0,30,3,10,0,13,3,30,8,0,0,8,1,-15,3,1
2,3,41,0,30,5,7,0,12,7,30,6,2,0,8,0,30,7,5,0,12,0,30,3,9,0,12,6,30,6,1,0,7,1,-15,3,1
2,1,4,3,30,6,2,0,8,4,30,3,1,0,4,0,30,2,6,0,8,0,30,5,3,0,8,3,30,4,0,0,4,0,-27,3,0
2,3,4,3,30,6,2,0,8,4,30,3,1,0,4,0,30,2,6,0,8,0,30,5,3,0,8,3,30,4,0,0,4,0,-27,3,0
2,4,8,1,30,7,0,0,7,4,30,2,0,0,2,3,30,3,4,0,7,0,30,1,6,0,7,0,30,3,0,0,3,0,-27,3,0
2,3,17,2,30,10,4,0,14,3,30,6,0,0,6,0,30,3,11,0,14,1,30,5,9,0,14,7,30,4,0,0,4,1,-15,3,1
2,0,19,0,30,3,10,0,13,2,30,3,5,0,8,0,30,5,8,0,13,7,30,8,5,0,13,3,30,9,0,0,9,1,-15,3,1
2,1,19,0,30,3,10,0,13,2,30,3,5,0,8,0,30,5,8,0,13,7,30,8,5,0,13,3,30,9,0,0,9,1,-15,3,1
2,4,26,2,30,9,0,0,9,5,30,4,0,0,4,4,30,1,8,0,9,0,30,2,7,0,9,0,30,3,0,0,3,1,-15,3,1
2,3,27,2,30,9,6,0,15,4,30,2,0,0,2,1,30,6,9,0,15,0,30,3,12,0,15,0,30,3,3,0,6,1,-15,3,1
2,4,27,2,30,9,6,0,15,4,30,2,0,0,2,1,30,6,9,0,15,0,30,3,12,0,15,0,30,3,3,0,6,1,-15,3,1
2,2,35,0,30,8,5,0,13,4,30,2,0,0,2,1,30,2,11,0,13,0,30,3,10,0,13,8,30,8,0,0,8,1,-15,3,1
2,3,35,0,30,8,5,0,13,4,30,2,0,0,2,1,30,2,11,0,13,0,30,3,10,0,13,8,30,8,0,0,8,1,-15,3,1
2,3,43,0,30,12,2,0,14,7,30,6,0,0,6,0,30,4,10,0,14,1,30,1,13,0,14,7,30,5,0,0,5,1,-15,3,1
2,4,1,0,30,7,3,0,10,4,30,2,0,0,2,1,30,4,6,0,10,9,30,8,2,0,10,6,30,6,0,0,6,0,-27,3,0
2,3,4,2,30,8,0,0,8,4,30,4,0,0,4,0,30,5,3,0,8,0,30,4,4,0,8,1,30,4,0,0,4,0,-27,3,0
2,4,4,2,30,8,0,0,8,4,30,4,0,0,4,0,30,5,3,0,8,0,30,4,4,0,8,1,30,4,0,0,4,0,-27,3,0
2,1,5,0,30,1,4,0,5,2,30,3,1,0,4,0,30,3,2,0,5,0,30,1,4,0,5,0,30,0,2,0,2,0,-27,3,0
2,2,5,0,30,1,4,0,5,2,30,3,1,0,4,0,30,3,2,0,5,0,30,1,4,0,5,0,30,0,2,0,2,0,-27,3,0
2,3,8,1,30,7,0,0,7,5,30,2,0,0,2,0,30,2,5,0,7,0,30,7,0,0,7,4,30,3,0,0,3,0,-27,3,0
2,3,17,3,30,7,7,0,14,4,30,6,0,0,6,0,30,4,10,0,14,1,30,8,6,0,14,3,30,4,0,0,4,1,-15,3,1
2,3,25,1,30,7,7,0,14,5,30,6,0,0,6,0,30,6,8,0,14,3,30,6,8,0,14,0,30,5,1,0,6,1,-15,3,1
2,4,25,1,30,7,7,0,14,5,30,6,0,0,6,0,30,6,8,0,14,3,30,6,8,0,14,0,30,5,1,0,6,1,-15,3,1
2,3,26,2,30,6,3,0,9,5,30,4,0,0,4,3,30,2,7,0,9,0,30,5,4,0,9,3,30,1,2,0,3,1,-15,3,1
2,3,27,3,30,5,10,0,15,5,30,2,0,0,2,0,30,7,8,0,15,0,30,8,7,0,15,0,30,4,2,0,6,1,-15,3,1
2,4,27,3,30,5,10,0,15,5,30,2,0,0,2,0,30,7,8,0,15,0,30,8,7,0,15,0,30,4,2,0,6,1,-15,3,1
2,2,35,0,30,7,6,0,13,5,30,0,2,0,2,1,30,2,11,0,13,0,30,1,12,0,13,7,30,8,0,0,8,1,-15,3,1
2,3,35,0,30,7,6,0,13,5,30,0,2,0,2,1,30,2,11,0,13,0,30,1,12,0,13,7,30,8,0,0,8,1,-15,3,1
2,4,13,5,30,7,0,0,7,0,30,4,0,0,4,1,30,6,1,0,7,7,30,7,0,0,7,4,30,4,0,0,4,1,-15,3,1
2,4,17,3,30,8,6,0,14,3,30,6,0,0,6,0,30,6,8,0,14,2,30,6,8,0,14,2,30,4,0,0,4,1,-15,3,1
2,4,19,0,30,4,9,0,13,2,30,4,4,0,8,0,30,9,4,0,13,0,30,5,8,0,13,2,30,8,1,0,9,1,-15,3,1
2,3,21,8,30,7,3,0,10,5,30,6,0,0,6,0,30,3,7,0,10,1,30,5,5,0,10,1,30,4,0,0,4,1,-15,3,1
2,4,21,8,30,7,3,0,10,5,30,6,0,0,6,0,30,3,7,0,10,1,30,5,5,0,10,1,30,4,0,0,4,1,-15,3,1
2,4,25,2,30,8,6,0,14,2,30,6,0,0,6,0,30,12,2,0,14,1,30,5,9,0,14,2,30,5,1,0,6,1,-15,3,1
2,3,27,2,30,5,10,0,15,2,30,2,0,0,2,0,30,6,9,0,15,0,30,4,11,0,15,2,30,3,3,0,6,1,-15,3,1
2,2,29,0,30,4,10,0,14,6,30,9,3,0,12,0,30,7,7,0,14,0,30,5,9,0,14,5,30,9,0,0,9,1,-15,3,1
2,3,29,0,30,4,10,0,14,6,30,9,3,0,12,0,30,7,7,0,14,0,30,5,9,0,14,5,30,9,0,0,9,1,-15,3,1
2,1,31,1,30,4,8,0,12,6,30,8,0,0,8,3,30,7,5,0,12,0,30,5,7,0,12,6,30,6,0,0,6,1,-15,3,1
2,2,31,1,30,4,8,0,12,6,30,8,0,0,8,3,30,7,5,0,12,0,30,5,7,0,12,6,30,6,0,0,6,1,-15,3,1
2,3,5,0,30,3,2,0,5,3,30,3,1,0,4,0,30,0,5,0,5,0,30,2,3,0,5,0,30,0,2,0,2,0,-27,3,0
2,3,8,5,30,7,0,0,7,3,30,2,0,0,2,0,30,4,3,0,7,0,30,0,7,0,7,0,30,3,0,0,3,0,-27,3,0
2,4,8,5,30,7,0,0,7,3,30,2,0,0,2,0,30,4,3,0,7,0,30,0,7,0,7,0,30,3,0,0,3,0,-27,3,0
2,3,23,1,30,6,7,0,13,3,30,6,0,0,6,5,30,12,1,0,13,0,30,6,7,0,13,1,30,6,0,0,6,1,-15,3,1
2,0,25,1,30,4,10,0,14,4,30,6,0,0,6,0,30,3,11,0,14,1,30,9,5,0,14,8,30,6,0,0,6,1,-15,3,1
2,3,25,1,30,4,10,0,14,4,30,6,0,0,6,0,30,3,11,0,14,1,30,9,5,0,14,8,30,6,0,0,6,1,-15,3,1
2,0,27,2,30,6,9,0,15,4,30,2,0,0,2,0,30,3,12,0,15,4,30,4,11,0,15,3,30,6,0,0,6,1,-15,3,1
2,3,27,2,30,6,9,0,15,4,30,2,0,0,2,0,30,3,12,0,15,4,30,4,11,0,15,3,30,6,0,0,6,1,-15,3,1
2,3,31,7,30,6,6,0,12,5,30,8,0,0,8,4,30,9,3,0,12,0,30,3,9,0,12,0,30,2,4,0,6,1,-15,3,1
2,4,31,7,30,6,6,0,12,5,30,8,0,0,8,4,30,9,3,0,12,0,30,3,9,0,12,0,30,2,4,0,6,1,-15,3,1
2,0,4,2,30,6,2,0,8,5,30,4,0,0,4,3,30,1,7,0,8,0,30,6,2,0,8,3,30,3,1,0,4,0,-27,3,0
2,1,4,2,30,6,2,0,8,5,30,4,0,0,4,3,30,1,7,0,8,0,30,6,2,0,8,3,30,3,1,0,4,0,-27,3,0
2,4,4,2,30,6,2,0,8,5,30,4,0,0,4,3,30,1,7,0,8,0,30,6,2,0,8,3,30,3,1,0,4,0,-27,3,0
2,1,23,1,30,5,8,0,13,2,30,6,0,0,6,6,30,13,0,0,13,0,30,5,8,0,13,3,30,6,0,0,6,1,-15,3,1
2,2,23,1,30,5,8,0,13,2,30,6,0,0,6,6,30,13,0,0,13,0,30,5,8,0,13,3,30,6,0,0,6,1,-15,3,1
2,3,25,1,30,6,8,0,14,3,30,6,0,0,6,0,30,5,9,0,14,1,30,6,8,0,14,5,30,6,0,0,6,1,-15,3,1
2,4,31,3,30,6,6,0,12,4,30,8,0,0,8,3,30,8,4,0,12,0,30,3,9,0,12,1,30,2,4,0,6,1,-15,3,1
2,2,17,4,30,10,4,0,14,2,30,6,0,0,6,0,30,7,7,0,14,1,30,7,7,0,14,5,30,4,0,0,4,1,-15,3,1
2,4,17,4,30,10,4,0,14,2,30,6,0,0,6,0,30,7,7,0,14,1,30,7,7,0,14,5,30,4,0,0,4,1,-15,3,1
2,3,19,0,30,4,9,0,13,1,30,8,0,0,8,0,30,8,5,0,13,1,30,6,7,0,13,1,30,5,4,0,9,1,-15,3,1
2,1,21,1,30,5,5,0,10,3,30,5,1,0,6,1,30,4,6,0,10,3,30,5,5,0,10,4,30,4,0,0,4,1,-15,3,1
2,3,21,1,30,5,5,0,10,3,30,5,1,0,6,1,30,4,6,0,10,3,30,5,5,0,10,4,30,4,0,0,4,1,-15,3,1
2,4,21,1,30,5,5,0,10,3,30,5,1,0,6,1,30,4,6,0,10,3,30,5,5,0,10,4,30,4,0,0,4,1,-15,3,1
2,3,23,2,30,6,7,0,13,0,30,6,0,0,6,5,30,13,0,0,13,0,30,4,9,0,13,4,30,6,0,0,6,1,-15,3,1
2,1,25,2,30,10,4,0,14,3,30,6,0,0,6,0,30,8,6,0,14,1,30,4,10,0,14,4,30,5,1,0,6,1,-15,3,1
2,3,27,0,30,4,11,0,15,1,30,2,0,0,2,0,30,6,9,0,15,2,30,7,8,0,15,4,30,6,0,0,6,1,-15,3,1
2,4,27,0,30,4,11,0,15,1,30,2,0,0,2,0,30,6,9,0,15,2,30,7,8,0,15,4,30,6,0,0,6,1,-15,3,1
2,4,29,0,30,5,9,0,14,6,30,11,1,0,12,0,30,5,9,0,14,0,30,1,13,0,14,3,30,9,0,0,9,1,-15,3,1
2,1,5,0,30,3,2,0,5,3,30,0,4,0,4,1,30,2,3,0,5,0,30,1,4,0,5,0,30,0,2,0,2,0,-27,3,0
2,2,5,0,30,3,2,0,5,3,30,0,4,0,4,1,30,2,3,0,5,0,30,1,4,0,5,0,30,0,2,0,2,0,-27,3,0
2,4,5,0,30,3,2,0,5,3,30,0,4,0,4,0,30,2,3,0,5,0,30,1,4,0,5,0,30,0,2,0,2,0,-27,3,0
2,1,13,4,30,7,0,0,7,0,30,4,0,0,4,3,30,7,0,0,7,4,30,6,1,0,7,3,30,4,0,0,4,1,-15,3,1
2,2,13,4,30,7,0,0,7,0,30,4,0,0,4,3,30,7,0,0,7,4,30,6,1,0,7,3,30,4,0,0,4,1,-15,3,1
2,3,15,1,30,5,8,0,13,0,30,5,1,0,6,0,30,3,10,0,13,0,30,3,10,0,13,2,30,8,1,0,9,1,-15,3,1
2,4,15,1,30,5,8,0,13,0,30,5,1,0,6,0,30,3,10,0,13,0,30,3,10,0,13,2,30,8,1,0,9,1,-15,3,1
2,2,17,2,30,9,5,0,14,3,30,6,0,0,6,0,30,7,7,0,14,5,30,6,8,0,14,5,30,4,0,0,4,1,-15,3,1
2,4,17,2,30,9,5,0,14,3,30,6,0,0,6,0,30,7,7,0,14,5,30,6,8,0,14,5,30,4,0,0,4,1,-15,3,1
2,2,19,0,30,2,11,0,13,2,30,7,1,0,8,0,30,4,9,0,13,0,30,6,7,0,13,0,30,8,1,0,9,1,-15,3,1
2,3,21,3,30,9,1,0,10,4,30,6,0,0,6,1,30,3,7,0,10,3,30,4,6,0,10,0,30,4,0,0,4,1,-15,3,1
2,4,23,1,30,11,2,0,13,0,30,6,0,0,6,6,30,13,0,0,13,0,30,4,9,0,13,1,30,6,0,0,6,1,-15,3,1
2,2,25,0,30,5,9,0,14,4,30,6,0,0,6,0,30,10,4,0,14,2,30,5,9,0,14,4,30,5,1,0,6,1,-15,3,1
2,1,27,0,30,5,10,0,15,3,30,1,1,0,2,0,30,5,10,0,15,0,30,6,9,0,15,5,30,6,0,0,6,1,-15,3,1
2,2,29,0,30,10,4,0,14,6,30,12,0,0,12,0,30,4,10,0,14,0,30,0,14,0,14,0,30,9,0,0,9,1,-15,3,1
2,3,29,0,30,10,4,0,14,6,30,12,0,0,12,0,30,4,10,0,14,0,30,0,14,0,14,0,30,9,0,0,9,1,-15,3,1
2,4,29,0,30,10,4,0,14,6,30,12,0,0,12,0,30,4,10,0,14,0,30,0,14,0,14,0,30,9,0,0,9,1,-15,3,1
2,1,31,6,30,8,4,0,12,4,30,8,0,0,8,6,30,9,3,0,12,0,30,3,9,0,12,0,30,1,5,0,6,1,-15,3,1
2,2,31,6,30,8,4,0,12,4,30,8,0,0,8,6,30,9,3,0,12,0,30,3,9,0,12,0,30,1,5,0,6,1,-15,3,1
2,4,35,5,30,6,7,0,13,3,30,2,0,0,2,1,30,9,4,0,13,1,30,2,11,0,13,0,30,8,0,0,8,1,-15,3,1
2,3,4,2,30,6,2,0,8,5,30,4,0,0,4,0,30,1,7,0,8,0,30,5,3,0,8,4,30,4,0,0,4,0,-27,3,0
2,4,12,0,30,2,5,0,7,1,30,4,2,0,6,2,30,3,4,0,7,7,30,7,0,0,7,6,30,3,0,0,3,1,-15,3,1
2,3,19,0,30,2,11,0,13,1,30,8,0,0,8,0,30,7,6,0,13,0,30,3,10,0,13,0,30,6,3,0,9,1,-15,3,1
2,4,25,5,30,6,8,0,14,4,30,6,0,0,6,0,30,9,5,0,14,0,30,5,9,0,14,4,30,5,1,0,6,1,-15,3,1
2,2,27,1,30,3,12,0,15,2,30,2,0,0,2,0,30,2,13,0,15,0,30,4,11,0,15,1,30,6,0,0,6,1,-15,3,1
2,3,27,1,30,3,12,0,15,2,30,2,0,0,2,0,30,2,13,0,15,0,30,4,11,0,15,1,30,6,0,0,6,1,-15,3,1
2,4,27,1,30,3,12,0,15,2,30,2,0,0,2,0,30,2,13,0,15,0,30,4,11,0,15,1,30,6,0,0,6,1,-15,3,1
2,3,33,1,30,2,9,0,11,5,30,4,0,0,4,0,30,10,1,0,11,1,30,4,7,0,11,6,30,4,0,0,4,1,-15,3,1
2,3,1,0,30,6,4,0,10,4,30,2,0,0,2,1,30,5,5,0,10,1,30,9,1,0,10,6,30,6,0,0,6,0,-27,3,0
2,3,5,1,30,5,0,0,5,3,30,2,2,0,4,0,30,0,5,0,5,0,30,1,4,0,5,0,30,2,0,0,2,0,-27,3,0
2,4,5,1,30,5,0,0,5,3,30,2,2,0,4,0,30,0,5,0,5,0,30,1,4,0,5,0,30,2,0,0,2,0,-27,3,0
2,3,17,3,30,9,5,0,14,4,30,6,0,0,6,0,30,3,11,0,14,1,30,7,7,0,14,2,30,4,0,0,4,1,-15,3,1
2,2,19,0,30,4,9,0,13,2,30,6,2,0,8,4,30,7,6,0,13,0,30,4,9,0,13,2,30,7,2,0,9,1,-15,3,1
2,4,19,0,30,4,9,0,13,0,30,6,2,0,8,4,30,7,6,0,13,0,30,4,9,0,13,2,30,7,2,0,9,1,-15,3,1
2,4,23,1,30,4,9,0,13,3,30,6,0,0,6,6,30,9,4,0,13,0,30,5,8,0,13,3,30,6,0,0,6,1,-15,3,1
2,2,25,1,30,7,7,0,14,3,30,6,0,0,6,0,30,6,8,0,14,1,30,7,7,0,14,0,30,5,1,0,6,1,-15,3,1
2,3,25,1,30,7,7,0,14,3,30,6,0,0,6,0,30,6,8,0,14,1,30,7,7,0,14,0,30,5,1,0,6,1,-15,3,1
2,4,31,3,30,7,5,0,12,4,30,8,0,0,8,3,30,12,0,0,12,0,30,3,9,0,12,1,30,3,3,0,6,1,-15,3,1
2,1,17,4,30,11,3,0,14,2,30,6,0,0,6,0,30,5,9,0,14,4,30,5,9,0,14,2,30,4,0,0,4,1,-15,3,1
2,2,17,4,30,11,3,0,14,2,30,6,0,0,6,0,30,5,9,0,14,4,30,5,9,0,14,2,30,4,0,0,4,1,-15,3,1
2,4,17,4,30,11,3,0,14,2,30,6,0,0,6,0,30,5,9,0,14,1,30,5,9,0,14,2,30,4,0,0,4,1,-15,3,1
2,3,23,3,30,4,9,0,13,2,30,6,0,0,6,5,30,13,0,0,13,0,30,5,8,0,13,3,30,6,0,0,6,1,-15,3,1
2,1,25,1,30,6,8,0,14,5,30,6,0,0,6,0,30,6,8,0,14,1,30,6,8,0,14,6,30,6,0,0,6,1,-15,3,1
2,3,25,1,30,6,8,0,14,5,30,6,0,0,6,0,30,6,8,0,14,1,30,6,8,0,14,6,30,6,0,0,6,1,-15,3,1
2,1,26,1,30,5,4,0,9,6,30,4,0,0,4,2,30,0,9,0,9,0,30,4,5,0,9,7,30,3,0,0,3,1,-15,3,1
2,1,27,1,30,4,11,0,15,3,30,1,1,0,2,0,30,2,13,0,15,0,30,9,6,0,15,3,30,6,0,0,6,1,-15,3,1
2,2,27,1,30,4,11,0,15,3,30,1,1,0,2,0,30,2,13,0,15,0,30,9,6,0,15,3,30,6,0,0,6,1,-15,3,1
2,4,29,1,30,7,7,0,14,5,30,12,0,0,12,0,30,3,11,0,14,0,30,0,14,0,14,0,30,6,3,0,9,1,-15,3,1
2,3,31,1,30,8,4,0,12,3,30,8,0,0,8,4,30,11,1,0,12,0,30,3,9,0,12,0,30,2,4,0,6,1,-15,3,1
2,2,43,0,30,7,7,0,14,7,30,6,0,0,6,3,30,5,9,0,14,1,30,4,10,0,14,7,30,5,0,0,5,1,-15,3,1
2,3,43,0,30,7,7,0,14,7,30,6,0,0,6,3,30,5,9,0,14,1,30,4,10,0,14,7,30,5,0,0,5,1,-15,3,1
2,4,11,0,30,1,3,0,4,0,30,0,0,0,0,0,30,1,3,0,4,3,30,3,1,0,4,2,30,1,0,0,1,1,-15,3,1
2,4,22,2,30,8,0,0,8,3,30,2,0,0,2,0,30,4,4,0,8,1,30,2,6,0,8,1,30,2,2,0,4,1,-15,3,1
2,4,23,2,30,2,11,0,13,1,30,6,0,0,6,6,30,13,0,0,13,0,30,5,8,0,13,3,30,6,0,0,6,1,-15,3,1
2,2,25,1,30,4,10,0,14,4,30,6,0,0,6,0,30,9,5,0,14,1,30,5,9,0,14,4,30,5,1,0,6,1,-15,3,1
2,0,27,1,30,4,11,0,15,3,30,2,0,0,2,0,30,4,11,0,15,4,30,4,11,0,15,6,30,6,0,0,6,1,-15,3,1
2,1,27,1,30,4,11,0,15,3,30,2,0,0,2,0,30,4,11,0,15,4,30,4,11,0,15,6,30,6,0,0,6,1,-15,3,1
2,4,27,1,30,4,11,0,15,3,30,2,0,0,2,0,30,4,11,0,15,4,30,4,11,0,15,6,30,6,0,0,6,1,-15,3,1
2,0,29,0,30,6,8,0,14,5,30,11,1,0,12,0,30,3,11,0,14,0,30,2,12,0,14,5,30,9,0,0,9,1,-15,3,1
2,3,36,0,30,1,8,0,9,6,30,1,1,0,2,9,30,7,2,0,9,0,30,7,2,0,9,4,30,3,0,0,3,1,-15,3,1
2,4,36,0,30,1,8,0,9,6,30,1,1,0,2,9,30,7,2,0,9,0,30,7,2,0,9,4,30,3,0,0,3,1,-15,3,1
2,2,5,0,30,2,3,0,5,3,30,0,4,0,4,0,30,0,5,0,5,1,30,4,1,0,5,0,30,0,2,0,2,0,-27,3,0
2,3,11,0,30,1,3,0,4,0,30,0,0,0,0,0,30,3,1,0,4,4,30,2,2,0,4,2,30,1,0,0,1,1,-15,3,1
2,2,19,0,30,6,7,0,13,0,30,7,1,0,8,2,30,13,0,0,13,0,30,3,10,0,13,0,30,7,2,0,9,1,-15,3,1
2,3,19,0,30,6,7,0,13,0,30,7,1,0,8,2,30,13,0,0,13,0,30,3,10,0,13,0,30,7,2,0,9,1,-15,3,1
2,3,23,1,30,5,8,0,13,1,30,6,0,0,6,6,30,11,2,0,13,0,30,5,8,0,13,2,30,6,0,0,6,1,-15,3,1
2,4,23,1,30,5,8,0,13,1,30,6,0,0,6,6,30,11,2,0,13,0,30,5,8,0,13,2,30,6,0,0,6,1,-15,3,1
2,3,25,1,30,6,8,0,14,4,30,6,0,0,6,0,30,9,5,0,14,0,30,6,8,0,14,4,30,6,0,0,6,1,-15,3,1
2,4,25,1,30,6,8,0,14,4,30,6,0,0,6,0,30,9,5,0,14,0,30,6,8,0,14,4,30,6,0,0,6,1,-15,3,1
2,0,29,0,30,8,6,0,14,6,30,12,0,0,12,0,30,3,11,0,14,0,30,1,13,0,14,2,30,9,0,0,9,1,-15,3,1
2,1,29,0,30,8,6,0,14,6,30,12,0,0,12,0,30,3,11,0,14,0,30,1,13,0,14,2,30,9,0,0,9,1,-15,3,1
2,1,4,2,30,6,2,0,8,5,30,4,0,0,4,1,30,1,7,0,8,0,30,7,1,0,8,1,30,4,0,0,4,0,-27,3,0
2,3,4,2,30,6,2,0,8,5,30,4,0,0,4,1,30,1,7,0,8,0,30,7,1,0,8,1,30,4,0,0,4,0,-27,3,0
2,0,17,2,30,8,6,0,14,4,30,6,0,0,6,0,30,4,10,0,14,5,30,7,7,0,14,7,30,4,0,0,4,1,-15,3,1
2,4,19,0,30,3,10,0,13,1,30,7,1,0,8,0,30,9,4,0,13,7,30,6,7,0,13,1,30,6,3,0,9,1,-15,3,1
2,4,22,1,30,8,0,0,8,3,30,2,0,0,2,0,30,3,5,0,8,1,30,4,4,0,8,3,30,4,0,0,4,1,-15,3,1
2,4,23,2,30,6,7,0,13,2,30,6,0,0,6,3,30,12,1,0,13,0,30,4,9,0,13,4,30,6,0,0,6,1,-15,3,1
2,4,27,2,30,5,10,0,15,4,30,2,0,0,2,0,30,9,6,0,15,0,30,6,9,0,15,1,30,4,2,0,6,1,-15,3,1
2,0,1,0,30,7,3,0,10,3,30,2,0,0,2,3,30,7,3,0,10,4,30,6,4,0,10,6,30,6,0,0,6,0,-27,3,0
2,3,1,0,30,7,3,0,10,3,30,2,0,0,2,3,30,7,3,0,10,4,30,6,4,0,10,6,30,6,0,0,6,0,-27,3,0
2,4,1,0,30,7,3,0,10,3,30,2,0,0,2,3,30,7,3,0,10,4,30,6,4,0,10,6,30,6,0,0,6,0,-27,3,0
2,0,4,2,30,5,3,0,8,5,30,4,0,0,4,2,30,1,7,0,8,0,30,7,1,0,8,2,30,4,0,0,4,0,-27,3,0
2,1,5,0,30,2,3,0,5,2,30,4,0,0,4,1,30,1,4,0,5,0,30,1,4,0,5,0,30,0,2,0,2,0,-27,3,0
2,4,13,3,30,5,2,0,7,0,30,4,0,0,4,2,30,7,0,0,7,9,30,5,2,0,7,0,30,4,0,0,4,1,-15,3,1
2,1,17,3,30,9,5,0,14,3,30,6,0,0,6,0,30,6,8,0,14,6,30,6,8,0,14,7,30,4,0,0,4,1,-15,3,1
2,3,17,3,30,9,5,0,14,3,30,6,0,0,6,0,30,6,8,0,14,5,30,6,8,0,14,7,30,4,0,0,4,1,-15,3,1
2,0,27,1,30,3,12,0,15,4,30,2,0,0,2,0,30,3,12,0,15,2,30,5,10,0,15,5,30,6,0,0,6,1,-15,3,1
2,1,27,1,30,3,12,0,15,4,30,2,0,0,2,0,30,3,12,0,15,2,30,5,10,0,15,5,30,6,0,0,6,1,-15,3,1
2,2,27,1,30,3,12,0,15,4,30,2,0,0,2,0,30,3,12,0,15,2,30,5,10,0,15,5,30,6,0,0,6,1,-15,3,1
2,4,29,0,30,8,6,0,14,5,30,8,4,0,12,1,30,3,11,0,14,0,30,2,12,0,14,3,30,9,0,0,9,1,-15,3,1
2,4,3,1,30,4,0,0,4,3,30,4,0,0,4,2,30,1,3,0,4,0,30,0,4,0,4,0,30,1,2,0,3,0,-27,3,0
2,0,4,3,30,4,4,0,8,4,30,4,0,0,4,4,30,2,6,0,8,0,30,8,0,0,8,1,30,2,2,0,4,0,-27,3,0
2,4,9,1,30,9,2,0,11,3,30,6,0,0,6,1,30,8,3,0,11,1,30,3,8,0,11,5,30,4,0,0,4,0,-27,3,0
2,3,19,0,30,2,11,0,13,2,30,6,2,0,8,0,30,7,6,0,13,0,30,7,6,0,13,1,30,7,2,0,9,1,-15,3,1
2,4,25,0,30,5,9,0,14,4,30,6,0,0,6,0,30,9,5,0,14,0,30,4,10,0,14,0,30,5,1,0,6,1,-15,3,1
2,1,27,1,30,3,12,0,15,5,30,1,1,0,2,0,30,4,11,0,15,1,30,4,11,0,15,2,30,6,0,0,6,1,-15,3,1
2,3,27,1,30,3,12,0,15,5,30,1,1,0,2,0,30,4,11,0,15,1,30,4,11,0,15,2,30,6,0,0,6,1,-15,3,1
2,4,27,1,30,3,12,0,15,5,30,1,1,0,2,0,30,4,11,0,15,1,30,4,11,0,15,2,30,6,0,0,6,1,-15,3,1
2,4,29,0,30,6,8,0,14,6,30,12,0,0,12,0,30,5,9,0,14,0,30,0,14,0,14,0,30,9,0,0,9,1,-15,3,1
2,1,5,0,30,1,4,0,5,3,30,1,3,0,4,0,30,0,5,0,5,0,30,3,2,0,5,0,30,1,1,0,2,0,-27,3,0
2,2,5,0,30,1,4,0,5,3,30,1,3,0,4,0,30,0,5,0,5,0,30,3,2,0,5,0,30,1,1,0,2,0,-27,3,0
2,4,5,0,30,1,4,0,5,3,30,1,3,0,4,0,30,0,5,0,5,0,30,3,2,0,5,0,30,1,1,0,2,0,-27,3,0
2,2,7,1,30,5,4,0,9,3,30,4,0,0,4,0,30,5,4,0,9,8,30,3,6,0,9,1,30,5,1,0,6,0,-27,3,0
2,4,7,1,30,5,4,0,9,3,30,4,0,0,4,0,30,5,4,0,9,8,30,3,6,0,9,1,30,5,1,0,6,0,-27,3,0
2,2,17,2,30,11,3,0,14,0,30,6,0,0,6,0,30,6,8,0,14,3,30,4,10,0,14,2,30,4,0,0,4,1,-15,3,1
2,3,17,2,30,11,3,0,14,0,30,6,0,0,6,0,30,6,8,0,14,3,30,4,10,0,14,2,30,4,0,0,4,1,-15,3,1
2,4,17,2,30,11,3,0,14,0,30,6,0,0,6,0,30,6,8,0,14,3,30,4,10,0,14,2,30,4,0,0,4,1,-15,3,1
2,1,23,1,30,5,8,0,13,2,30,6,0,0,6,8,30,11,2,0,13,0,30,5,8,0,13,1,30,5,1,0,6,1,-15,3,1
2,3,23,1,30,5,8,0,13,2,30,6,0,0,6,8,30,11,2,0,13,0,30,5,8,0,13,1,30,5,1,0,6,1,-15,3,1
2,4,23,1,30,5,8,0,13,2,30,6,0,0,6,8,30,11,2,0,13,0,30,5,8,0,13,1,30,5,1,0,6,1,-15,3,1
2,1,27,0,30,4,11,0,15,4,30,2,0,0,2,0,30,3,12,0,15,0,30,6,9,0,15,1,30,4,2,0,6,1,-15,3,1
2,2,27,0,30,4,11,0,15,4,30,2,0,0,2,0,30,3,12,0,15,0,30,6,9,0,15,1,30,4,2,0,6,1,-15,3,1
2,3,27,0,30,4,11,0,15,4,30,2,0,0,2,0,30,3,12,0,15,0,30,6,9,0,15,1,30,4,2,0,6,1,-15,3,1
2,4,27,0,30,4,11,0,15,4,30,2,0,0,2,0,30,3,12,0,15,0,30,6,9,0,15,1,30,4,2,0,6,1,-15,3,1
2,1,29,0,30,8,6,0,14,5,30,11,1,0,12,0,30,5,9,0,14,0,30,1,13,0,14,0,30,8,1,0,9,1,-15,3,1
2,3,29,0,30,8,6,0,14,5,30,11,1,0,12,0,30,5,9,0,14,0,30,1,13,0,14,0,30,8,1,0,9,1,-15,3,1
2,4,29,0,30,8,6,0,14,5,30,11,1,0,12,0,30,5,9,0,14,0,30,1,13,0,14,0,30,8,1,0,9,1,-15,3,1
2,3,31,3,30,10,2,0,12,4,30,8,0,0,8,3,30,8,4,0,12,0,30,4,8,0,12,0,30,1,5,0,6,1,-15,3,1
2,4,31,3,30,10,2,0,12,4,30,8,0,0,8,3,30,8,4,0,12,0,30,4,8,0,12,0,30,1,5,0,6,1,-15,3,1
2,4,35,1,30,8,5,0,13,1,30,2,0,0,2,1,30,10,3,0,13,4,30,3,10,0,13,0,30,8,0,0,8,1,-15,3,1
2,1,13,2,30,6,1,0,7,0,30,4,0,0,4,3,30,7,0,0,7,7,30,7,0,0,7,5,30,4,0,0,4,1,-15,3,1
2,2,13,2,30,6,1,0,7,0,30,4,0,0,4,3,30,7,0,0,7,7,30,7,0,0,7,5,30,4,0,0,4,1,-15,3,1
2,1,15,0,30,4,9,0,13,0,30,6,0,0,6,0,30,4,9,0,13,1,30,4,9,0,13,2,30,9,0,0,9,1,-15,3,1
2,2,15,0,30,4,9,0,13,0,30,6,0,0,6,0,30,4,9,0,13,1,30,4,9,0,13,2,30,9,0,0,9,1,-15,3,1
2,4,22,3,30,8,0,0,8,3,30,2,0,0,2,0,30,4,4,0,8,1,30,3,5,0,8,0,30,4,0,0,4,1,-15,3,1
2,3,23,1,30,7,6,0,13,1,30,6,0,0,6,2,30,13,0,0,13,1,30,4,9,0,13,3,30,6,0,0,6,1,-15,3,1
2,4,23,1,30,7,6,0,13,1,30,6,0,0,6,2,30,13,0,0,13,1,30,4,9,0,13,3,30,6,0,0,6,1,-15,3,1
2,2,27,1,30,4,11,0,15,4,30,1,1,0,2,0,30,9,6,0,15,0,30,6,9,0,15,0,30,5,1,0,6,1,-15,3,1
2,1,29,0,30,5,9,0,14,5,30,12,0,0,12,0,30,4,10,0,14,0,30,0,14,0,14,0,30,9,0,0,9,1,-15,3,1
2,3,31,3,30,3,9,0,12,5,30,8,0,0,8,5,30,10,2,0,12,0,30,3,9,0,12,0,30,5,1,0,6,1,-15,3,1
2,4,31,3,30,3,9,0,12,5,30,8,0,0,8,5,30,10,2,0,12,0,30,3,9,0,12,0,30,5,1,0,6,1,-15,3,1
2,2,4,2,30,7,1,0,8,5,30,4,0,0,4,0,30,1,7,0,8,0,30,5,3,0,8,1,30,4,0,0,4,0,-27,3,0
2,4,4,2,30,7,1,0,8,5,30,4,0,0,4,0,30,1,7,0,8,0,30,5,3,0,8,1,30,4,0,0,4,0,-27,3,0
2,4,8,2,30,7,0,0,7,4,30,2,0,0,2,0,30,3,4,0,7,0,30,6,1,0,7,2,30,3,0,0,3,0,-27,3,0
2,2,13,0,30,5,2,0,7,0,30,4,0,0,4,2,30,5,2,0,7,10,30,6,1,0,7,3,30,4,0,0,4,1,-15,3,1
2,3,17,4,30,11,3,0,14,4,30,6,0,0,6,0,30,3,11,0,14,2,30,4,10,0,14,0,30,4,0,0,4,1,-15,3,1
2,4,19,0,30,3,10,0,13,2,30,7,1,0,8,2,30,11,2,0,13,0,30,3,10,0,13,2,30,8,1,0,9,1,-15,3,1
2,2,25,3,30,4,10,0,14,4,30,6,0,0,6,0,30,8,6,0,14,1,30,7,7,0,14,5,30,5,1,0,6,1,-15,3,1
2,0,31,3,30,9,3,0,12,4,30,8,0,0,8,4,30,10,2,0,12,0,30,4,8,0,12,0,30,3,3,0,6,1,-15,3,1
2,1,31,3,30,9,3,0,12,4,30,8,0,0,8,4,30,10,2,0,12,0,30,4,8,0,12,0,30,3,3,0,6,1,-15,3,1
2,2,31,3,30,9,3,0,12,4,30,8,0,0,8,4,30,10,2,0,12,0,30,4,8,0,12,0,30,3,3,0,6,1,-15,3,1
2,1,41,0,30,8,4,0,12,5,30,8,0,0,8,0,30,10,2,0,12,0,30,3,9,0,12,1,30,3,4,0,7,1,-15,3,1
2,3,41,0,30,8,4,0,12,5,30,8,0,0,8,0,30,10,2,0,12,0,30,3,9,0,12,1,30,3,4,0,7,1,-15,3,1
2,4,11,1,30,4,8,0,12,0,30,4,0,0,4,0,30,5,7,0,12,3,30,5,7,0,12,4,30,4,0,0,4,1,-15,3,1
2,2,13,3,30,6,1,0,7,0,30,4,0,0,4,1,30,6,1,0,7,15,30,6,1,0,7,5,30,4,0,0,4,1,-15,3,1
2,1,17,4,30,10,4,0,14,3,30,6,0,0,6,2,30,5,9,0,14,2,30,5,9,0,14,1,30,3,1,0,4,1,-15,3,1
2,2,19,0,30,3,10,0,13,2,30,6,2,0,8,0,30,9,4,0,13,4,30,3,10,0,13,4,30,7,2,0,9,1,-15,3,1
2,4,19,0,30,3,10,0,13,2,30,6,2,0,8,0,30,9,4,0,13,4,30,3,10,0,13,4,30,7,2,0,9,1,-15,3,1
2,0,25,1,30,5,9,0,14,5,30,6,0,0,6,0,30,7,7,0,14,1,30,5,9,0,14,6,30,6,0,0,6,1,-15,3,1
2,1,25,1,30,5,9,0,14,5,30,6,0,0,6,0,30,7,7,0,14,1,30,5,9,0,14,6,30,6,0,0,6,1,-15,3,1
2,2,25,1,30,5,9,0,14,5,30,6,0,0,6,0,30,7,7,0,14,1,30,5,9,0,14,6,30,6,0,0,6,1,-15,3,1
2,3,25,1,30,5,9,0,14,5,30,6,0,0,6,0,30,7,7,0,14,1,30,5,9,0,14,6,30,6,0,0,6,1,-15,3,1
2,4,25,1,30,5,9,0,14,5,30,6,0,0,6,0,30,7,7,0,14,1,30,5,9,0,14,6,30,6,0,0,6,1,-15,3,1
2,2,27,1,30,4,11,0,15,2,30,2,0,0,2,0,30,2,13,0,15,4,30,4,11,0,15,8,30,6,0,0,6,1,-15,3,1
2,1,29,0,30,5,9,0,14,5,30,12,0,0,12,0,30,4,10,0,14,0,30,3,11,0,14,3,30,9,0,0,9,1,-15,3,1
2,3,31,4,30,5,7,0,12,6,30,8,0,0,8,6,30,8,4,0,12,0,30,3,9,0,12,0,30,5,1,0,6,1,-15,3,1
2,4,31,4,30,5,7,0,12,6,30,8,0,0,8,6,30,8,4,0,12,0,30,3,9,0,12,0,30,5,1,0,6,1,-15,3,1
2,0,43,1,30,11,3,0,14,7,30,6,0,0,6,0,30,4,10,0,14,1,30,4,10,0,14,5,30,5,0,0,5,1,-15,3,1
2,2,43,1,30,11,3,0,14,7,30,6,0,0,6,0,30,4,10,0,14,1,30,4,10,0,14,5,30,5,0,0,5,1,-15,3,1
2,3,43,1,30,11,3,0,14,7,30,6,0,0,6,0,30,4,10,0,14,1,30,4,10,0,14,5,30,5,0,0,5,1,-15,3,1
2,1,4,2,30,5,3,0,8,4,30,4,0,0,4,1,30,2,6,0,8,1,30,5,3,0,8,1,30,4,0,0,4,0,-27,3,0
2,1,5,0,30,1,4,0,5,1,30,2,2,0,4,0,30,0,5,0,5,0,30,1,4,0,5,0,30,0,2,0,2,0,-27,3,0
2,3,5,0,30,1,4,0,5,1,30,2,2,0,4,0,30,0,5,0,5,0,30,1,4,0,5,0,30,0,2,0,2,0,-27,3,0
2,4,8,4,30,7,0,0,7,4,30,2,0,0,2,4,30,4,3,0,7,0,30,4,3,0,7,1,30,3,0,0,3,0,-27,3,0
2,1,13,4,30,7,0,0,7,0,30,4,0,0,4,2,30,5,2,0,7,9,30,6,1,0,7,2,30,4,0,0,4,1,-15,3,1
2,2,13,4,30,7,0,0,7,0,30,4,0,0,4,2,30,5,2,0,7,9,30,6,1,0,7,2,30,4,0,0,4,1,-15,3,1
2,4,13,4,30,7,0,0,7,0,30,4,0,0,4,2,30,5,2,0,7,9,30,6,1,0,7,2,30,4,0,0,4,1,-15,3,1
2,1,17,2,30,9,5,0,14,2,30,6,0,0,6,0,30,7,7,0,14,5,30,5,9,0,14,5,30,4,0,0,4,1,-15,3,1
2,3,17,2,30,9,5,0,14,2,30,6,0,0,6,0,30,7,7,0,14,0,30,5,9,0,14,5,30,4,0,0,4,1,-15,3,1
2,1,19,5,30,2,11,0,13,2,30,6,2,0,8,0,30,6,7,0,13,2,30,6,7,0,13,0,30,8,1,0,9,1,-15,3,1
2,3,19,0,30,2,11,0,13,2,30,6,2,0,8,0,30,6,7,0,13,2,30,6,7,0,13,0,30,8,1,0,9,1,-15,3,1
2,3,22,1,30,6,2,0,8,2,30,2,0,0,2,0,30,4,4,0,8,1,30,2,6,0,8,4,30,4,0,0,4,1,-15,3,1
2,3,25,0,30,4,10,0,14,5,30,6,0,0,6,0,30,9,5,0,14,3,30,12,2,0,14,3,30,5,1,0,6,1,-15,3,1
2,4,25,0,30,4,10,0,14,5,30,6,0,0,6,0,30,9,5,0,14,3,30,12,2,0,14,3,30,5,1,0,6,1,-15,3,1
2,2,27,1,30,7,8,0,15,2,30,1,1,0,2,0,30,2,13,0,15,2,30,6,9,0,15,4,30,6,0,0,6,1,-15,3,1
2,4,27,1,30,7,8,0,15,2,30,1,1,0,2,0,30,2,13,0,15,2,30,6,9,0,15,4,30,6,0,0,6,1,-15,3,1
2,3,29,1,30,5,9,0,14,6,30,10,2,0,12,0,30,2,12,0,14,0,30,0,14,0,14,1,30,9,0,0,9,1,-15,3,1
2,4,17,3,30,9,5,0,14,0,30,6,0,0,6,0,30,6,8,0,14,0,30,5,9,0,14,4,30,4,0,0,4,1,-15,3,1
2,3,19,0,30,3,10,0,13,1,30,8,0,0,8,0,30,5,8,0,13,0,30,3,10,0,13,0,30,7,2,0,9,1,-15,3,1
2,4,19,0,30,3,10,0,13,1,30,8,0,0,8,0,30,5,8,0,13,0,30,3,10,0,13,0,30,7,2,0,9,1,-15,3,1
2,0,27,2,30,5,10,0,15,3,30,1,1,0,2,0,30,5,10,0,15,4,30,7,8,0,15,3,30,6,0,0,6,1,-15,3,1
2,4,31,1,30,8,4,0,12,5,30,8,0,0,8,3,30,8,4,0,12,0,30,7,5,0,12,0,30,6,0,0,6,1,-15,3,1
2,3,8,1,30,7,0,0,7,4,30,2,0,0,2,3,30,2,5,0,7,0,30,5,2,0,7,2,30,3,0,0,3,0,-27,3,0
2,4,8,1,30,7,0,0,7,4,30,2,0,0,2,3,30,2,5,0,7,0,30,5,2,0,7,2,30,3,0,0,3,0,-27,3,0
2,2,13,1,30,4,3,0,7,0,30,4,0,0,4,0,30,5,2,0,7,13,30,5,2,0,7,4,30,4,0,0,4,1,-15,3,1
2,2,17,6,30,12,2,0,14,3,30,6,0,0,6,0,30,4,10,0,14,1,30,4,10,0,14,3,30,4,0,0,4,1,-15,3,1
2,1,25,1,30,9,5,0,14,3,30,6,0,0,6,0,30,6,8,0,14,4,30,9,5,0,14,4,30,6,0,0,6,1,-15,3,1
2,2,25,1,30,9,5,0,14,3,30,6,0,0,6,0,30,6,8,0,14,4,30,9,5,0,14,4,30,6,0,0,6,1,-15,3,1
2,0,27,1,30,3,12,0,15,4,30,2,0,0,2,0,30,4,11,0,15,4,30,7,8,0,15,3,30,6,0,0,6,1,-15,3,1
2,2,27,1,30,3,12,0,15,3,30,2,0,0,2,0,30,4,11,0,15,4,30,7,8,0,15,3,30,6,0,0,6,1,-15,3,1
2,1,31,6,30,6,6,0,12,4,30,8,0,0,8,4,30,11,1,0,12,0,30,3,9,0,12,0,30,2,4,0,6,1,-15,3,1
2,4,31,6,30,6,6,0,12,4,30,8,0,0,8,0,30,11,1,0,12,0,30,3,9,0,12,0,30,2,4,0,6,1,-15,3,1
2,1,33,1,30,2,9,0,11,6,30,4,0,0,4,5,30,9,2,0,11,3,30,5,6,0,11,6,30,4,0,0,4,1,-15,3,1
2,2,33,1,30,2,9,0,11,6,30,4,0,0,4,5,30,9,2,0,11,3,30,5,6,0,11,6,30,4,0,0,4,1,-15,3,1
2,3,39,0,30,3,8,0,11,6,30,6,0,0,6,0,30,5,6,0,11,0,30,4,7,0,11,6,30,5,0,0,5,1,-15,3,1
2,2,9,0,30,1,3,0,4,2,30,2,0,0,2,0,30,0,4,0,4,0,30,1,3,0,4,0,30,1,0,0,1,0,-27,3,0
2,1,13,2,30,5,2,0,7,1,30,4,0,0,4,2,30,6,1,0,7,3,30,5,2,0,7,4,30,4,0,0,4,1,-15,3,1
2,2,25,1,30,6,8,0,14,3,30,6,0,0,6,0,30,6,8,0,14,1,30,7,7,0,14,0,30,6,0,0,6,1,-15,3,1
2,1,27,2,30,6,9,0,15,2,30,1,1,0,2,0,30,7,8,0,15,0,30,6,9,0,15,1,30,5,1,0,6,1,-15,3,1
2,3,27,2,30,6,9,0,15,2,30,1,1,0,2,0,30,7,8,0,15,0,30,6,9,0,15,1,30,5,1,0,6,1,-15,3,1
2,4,27,2,30,6,9,0,15,2,30,1,1,0,2,0,30,7,8,0,15,0,30,6,9,0,15,1,30,5,1,0,6,1,-15,3,1
2,0,31,5,30,4,8,0,12,5,30,8,0,0,8,6,30,9,3,0,12,0,30,3,9,0,12,0,30,6,0,0,6,1,-15,3,1
2,1,31,5,30,4,8,0,12,5,30,8,0,0,8,6,30,9,3,0,12,0,30,3,9,0,12,0,30,6,0,0,6,1,-15,3,1
2,2,31,5,30,4,8,0,12,5,30,8,0,0,8,6,30,9,3,0,12,0,30,3,9,0,12,0,30,6,0,0,6,1,-15,3,1
2,0,43,0,30,9,5,0,14,8,30,6,0,0,6,0,30,4,10,0,14,1,30,4,10,0,14,8,30,5,0,0,5,1,-15,3,1
2,3,43,0,30,9,5,0,14,8,30,6,0,0,6,0,30,4,10,0,14,1,30,4,10,0,14,8,30,5,0,0,5,1,-15,3,1
2,2,47,0,30,0,14,0,14,7,30,4,0,0,4,0,30,4,10,0,14,3,30,3,11,0,14,6,30,7,0,0,7,1,-15,3,1
2,3,47,0,30,0,14,0,14,7,30,4,0,0,4,0,30,4,10,0,14,3,30,3,11,0,14,6,30,7,0,0,7,1,-15,3,1
2,4,47,0,30,0,14,0,14,7,30,4,0,0,4,0,30,4,10,0,14,3,30,3,11,0,14,6,30,7,0,0,7,1,-15,3,1
2,0,4,3,30,8,0,0,8,5,30,4,0,0,4,0,30,2,6,0,8,0,30,6,2,0,8,2,30,4,0,0,4,0,-27,3,0
2,3,4,0,30,8,0,0,8,5,30,4,0,0,4,0,30,2,6,0,8,0,30,6,2,0,8,2,30,4,0,0,4,0,-27,3,0
2,2,6,0,30,7,2,0,9,3,30,2,0,0,2,0,30,4,5,0,9,0,30,4,5,0,9,3,30,5,0,0,5,0,-27,3,0
2,3,9,0,30,6,5,0,11,3,30,6,0,0,6,1,30,5,6,0,11,5,30,3,8,0,11,2,30,4,0,0,4,0,-27,3,0
2,4,9,0,30,6,5,0,11,3,30,6,0,0,6,1,30,5,6,0,11,5,30,3,8,0,11,2,30,4,0,0,4,0,-27,3,0
2,3,13,2,30,3,0,0,3,1,30,2,0,0,2,0,30,3,0,0,3,5,30,3,0,0,3,2,30,2,0,0,2,1,-15,3,1
2,4,13,2,30,3,0,0,3,1,30,2,0,0,2,0,30,3,0,0,3,5,30,3,0,0,3,2,30,2,0,0,2,1,-15,3,1
2,4,13,1,30,7,0,0,7,0,30,4,0,0,4,2,30,6,1,0,7,12,30,7,0,0,7,2,30,4,0,0,4,1,-15,3,1
2,3,17,3,30,8,6,0,14,3,30,6,0,0,6,0,30,6,8,0,14,1,30,7,7,0,14,0,30,4,0,0,4,1,-15,3,1
2,2,19,0,30,3,10,0,13,1,30,5,3,0,8,0,30,7,6,0,13,4,30,4,9,0,13,1,30,7,2,0,9,1,-15,3,1
2,0,21,2,30,6,4,0,10,4,30,5,1,0,6,1,30,3,7,0,10,3,30,5,5,0,10,5,30,4,0,0,4,1,-15,3,1
2,1,21,2,30,6,4,0,10,4,30,5,1,0,6,1,30,3,7,0,10,3,30,5,5,0,10,5,30,4,0,0,4,1,-15,3,1
2,0,27,3,30,5,10,0,15,3,30,2,0,0,2,0,30,9,6,0,15,0,30,5,10,0,15,1,30,6,0,0,6,1,-15,3,1
2,3,27,3,30,5,10,0,15,3,30,2,0,0,2,0,30,9,6,0,15,0,30,5,10,0,15,1,30,6,0,0,6,1,-15,3,1
2,4,27,3,30,5,10,0,15,3,30,2,0,0,2,0,30,9,6,0,15,0,30,5,10,0,15,1,30,6,0,0,6,1,-15,3,1
2,1,29,0,30,9,5,0,14,6,30,10,2,0,12,0,30,3,11,0,14,0,30,1,13,0,14,5,30,9,0,0,9,1,-15,3,1
2,2,29,0,30,9,5,0,14,6,30,10,2,0,12,0,30,3,11,0,14,0,30,1,13,0,14,5,30,9,0,0,9,1,-15,3,1
2,3,35,6,30,9,4,0,13,5,30,2,0,0,2,1,30,2,11,0,13,0,30,3,10,0,13,2,30,8,0,0,8,1,-15,3,1
2,0,6,0,30,9,0,0,9,4,30,2,0,0,2,0,30,2,7,0,9,0,30,5,4,0,9,1,30,3,2,0,5,0,-27,3,0
2,2,7,2,30,3,1,0,4,2,30,2,0,0,2,0,30,1,3,0,4,0,30,0,4,0,4,1,30,1,1,0,2,0,-27,3,0
2,4,7,2,30,3,1,0,4,2,30,2,0,0,2,0,30,1,3,0,4,0,30,0,4,0,4,1,30,1,1,0,2,0,-27,3,0
2,2,11,2,30,4,8,0,12,1,30,4,0,0,4,0,30,5,7,0,12,3,30,4,8,0,12,4,30,4,0,0,4,1,-15,3,1
2,4,11,2,30,4,8,0,12,1,30,4,0,0,4,0,30,5,7,0,12,3,30,4,8,0,12,4,30,4,0,0,4,1,-15,3,1
2,3,13,3,30,6,1,0,7,0,30,4,0,0,4,4,30,7,0,0,7,5,30,4,3,0,7,4,30,4,0,0,4,1,-15,3,1
2,4,13,3,30,6,1,0,7,0,30,4,0,0,4,4,30,7,0,0,7,5,30,4,3,0,7,4,30,4,0,0,4,1,-15,3,1
2,0,17,2,30,9,5,0,14,4,30,6,0,0,6,0,30,4,10,0,14,3,30,8,6,0,14,4,30,4,0,0,4,1,-15,3,1
2,1,17,2,30,9,5,0,14,4,30,6,0,0,6,0,30,4,10,0,14,3,30,8,6,0,14,4,30,4,0,0,4,1,-15,3,1
2,3,19,0,30,4,9,0,13,2,30,5,3,0,8,0,30,4,9,0,13,6,30,7,6,0,13,1,30,9,0,0,9,1,-15,3,1
2,4,9,0,30,2,2,0,4,1,30,2,0,0,2,0,30,0,4,0,4,4,30,2,2,0,4,2,30,1,0,0,1,0,-27,3,0
2,3,12,1,30,5,2,0,7,3,30,3,3,0,6,1,30,1,6,0,7,5,30,7,0,0,7,4,30,3,0,0,3,1,-15,3,1
2,4,12,1,30,5,2,0,7,3,30,3,3,0,6,1,30,1,6,0,7,5,30,7,0,0,7,4,30,3,0,0,3,1,-15,3,1
2,4,13,4,30,5,2,0,7,2,30,4,0,0,4,5,30,7,0,0,7,2,30,4,3,0,7,0,30,3,1,0,4,1,-15,3,1
2,1,18,0,30,5,3,0,8,3,30,4,0,0,4,3,30,1,7,0,8,8,30,8,0,0,8,2,30,5,0,0,5,1,-15,3,1
2,2,18,0,30,5,3,0,8,3,30,4,0,0,4,3,30,1,7,0,8,8,30,8,0,0,8,2,30,5,0,0,5,1,-15,3,1
2,3,23,2,30,7,6,0,13,3,30,6,0,0,6,5,30,12,1,0,13,0,30,5,8,0,13,1,30,6,0,0,6,1,-15,3,1
2,4,23,2,30,7,6,0,13,3,30,6,0,0,6,5,30,12,1,0,13,0,30,5,8,0,13,1,30,6,0,0,6,1,-15,3,1
2,3,25,1,30,5,9,0,14,4,30,6,0,0,6,0,30,11,3,0,14,0,30,5,9,0,14,4,30,5,1,0,6,1,-15,3,1
2,4,25,1,30,5,9,0,14,4,30,6,0,0,6,0,30,11,3,0,14,0,30,5,9,0,14,4,30,5,1,0,6,1,-15,3,1
2,3,29,0,30,10,4,0,14,5,30,7,5,0,12,0,30,7,7,0,14,0,30,1,13,0,14,0,30,9,0,0,9,1,-15,3,1
2,4,32,0,30,7,2,0,9,4,30,2,0,0,2,2,30,7,2,0,9,1,30,2,7,0,9,2,30,2,0,0,2,1,-15,3,1
2,2,1,0,30,7,3,0,10,4,30,2,0,0,2,1,30,4,6,0,10,6,30,8,2,0,10,4,30,6,0,0,6,0,-27,3,0
2,0,4,2,30,7,1,0,8,4,30,2,2,0,4,0,30,3,5,0,8,0,30,6,2,0,8,2,30,4,0,0,4,0,-27,3,0
2,2,4,2,30,7,1,0,8,4,30,2,2,0,4,0,30,3,5,0,8,0,30,6,2,0,8,2,30,4,0,0,4,0,-27,3,0
2,3,7,0,30,4,0,0,4,2,30,2,0,0,2,0,30,1,3,0,4,0,30,1,3,0,4,1,30,1,1,0,2,0,-27,3,0
2,4,9,1,30,9,2,0,11,3,30,6,0,0,6,1,30,6,5,0,11,0,30,3,8,0,11,0,30,3,1,0,4,0,-27,3,0
2,1,17,2,30,8,6,0,14,2,30,6,0,0,6,0,30,7,7,0,14,4,30,8,6,0,14,3,30,4,0,0,4,1,-15,3,1
2,4,17,2,30,8,6,0,14,2,30,6,0,0,6,0,30,7,7,0,14,4,30,8,6,0,14,3,30,4,0,0,4,1,-15,3,1
2,4,19,0,30,3,10,0,13,2,30,6,2,0,8,0,30,6,7,0,13,0,30,3,10,0,13,0,30,8,1,0,9,1,-15,3,1
2,3,21,2,30,9,1,0,10,3,30,5,1,0,6,0,30,4,6,0,10,3,30,4,6,0,10,2,30,4,0,0,4,1,-15,3,1
2,3,23,3,30,4,9,0,13,4,30,6,0,0,6,8,30,10,3,0,13,0,30,4,9,0,13,1,30,5,1,0,6,1,-15,3,1
2,4,25,0,30,11,3,0,14,2,30,6,0,0,6,0,30,7,7,0,14,1,30,5,9,0,14,3,30,5,1,0,6,1,-15,3,1
2,4,27,1,30,4,11,0,15,2,30,1,1,0,2,0,30,6,9,0,15,0,30,7,8,0,15,4,30,6,0,0,6,1,-15,3,1
2,2,35,0,30,9,4,0,13,2,30,2,0,0,2,1,30,8,5,0,13,2,30,3,10,0,13,4,30,8,0,0,8,1,-15,3,1
2,3,13,5,30,5,2,0,7,0,30,4,0,0,4,5,30,7,0,0,7,5,30,6,1,0,7,0,30,4,0,0,4,1,-15,3,1
2,4,13,5,30,5,2,0,7,0,30,4,0,0,4,5,30,7,0,0,7,5,30,6,1,0,7,0,30,4,0,0,4,1,-15,3,1
2,4,23,1,30,5,8,0,13,3,30,6,0,0,6,5,30,12,1,0,13,0,30,5,8,0,13,4,30,6,0,0,6,1,-15,3,1
2,2,25,1,30,7,7,0,14,5,30,6,0,0,6,0,30,5,9,0,14,1,30,7,7,0,14,5,30,5,1,0,6,1,-15,3,1
2,4,31,5,30,7,5,0,12,5,30,8,0,0,8,8,30,8,4,0,12,0,30,3,9,0,12,1,30,3,3,0,6,1,-15,3,1
2,3,32,0,30,6,3,0,9,4,30,2,0,0,2,3,30,9,0,0,9,1,30,3,6,0,9,3,30,2,0,0,2,1,-15,3,1
2,4,3,0,30,0,4,0,4,2,30,4,0,0,4,0,30,0,4,0,4,0,30,1,3,0,4,0,30,2,1,0,3,0,-27,3,0
2,4,17,2,30,9,5,0,14,3,30,6,0,0,6,0,30,5,9,0,14,1,30,8,6,0,14,6,30,4,0,0,4,1,-15,3,1
2,3,19,6,30,4,9,0,13,2,30,2,6,0,8,0,30,4,9,0,13,6,30,7,6,0,13,0,30,7,2,0,9,1,-15,3,1
2,4,19,6,30,4,9,0,13,2,30,2,6,0,8,0,30,4,9,0,13,6,30,7,6,0,13,0,30,7,2,0,9,1,-15,3,1
2,0,27,0,30,5,10,0,15,3,30,2,0,0,2,0,30,5,10,0,15,0,30,6,9,0,15,1,30,5,1,0,6,1,-15,3,1
2,3,27,0,30,5,10,0,15,3,30,2,0,0,2,0,30,5,10,0,15,0,30,6,9,0,15,1,30,5,1,0,6,1,-15,3,1
2,4,27,0,30,5,10,0,15,3,30,2,0,0,2,0,30,5,10,0,15,0,30,6,9,0,15,1,30,5,1,0,6,1,-15,3,1
2,3,33,1,30,2,9,0,11,4,30,4,0,0,4,0,30,8,3,0,11,0,30,3,8,0,11,5,30,4,0,0,4,1,-15,3,1
2,1,5,0,30,4,1,0,5,4,30,0,4,0,4,1,30,0,5,0,5,0,30,1,4,0,5,0,30,1,1,0,2,0,-27,3,0
2,3,5,0,30,4,1,0,5,4,30,0,4,0,4,1,30,0,5,0,5,0,30,1,4,0,5,0,30,1,1,0,2,0,-27,3,0
2,4,5,0,30,4,1,0,5,4,30,0,4,0,4,1,30,0,5,0,5,0,30,1,4,0,5,0,30,1,1,0,2,0,-27,3,0
2,1,13,1,30,7,0,0,7,0,30,4,0,0,4,3,30,7,0,0,7,4,30,7,0,0,7,4,30,4,0,0,4,1,-15,3,1
2,2,13,1,30,7,0,0,7,0,30,4,0,0,4,3,30,7,0,0,7,4,30,7,0,0,7,4,30,4,0,0,4,1,-15,3,1
2,4,17,3,30,10,4,0,14,2,30,6,0,0,6,0,30,6,8,0,14,1,30,4,10,0,14,1,30,4,0,0,4,1,-15,3,1
2,2,19,0,30,3,10,0,13,2,30,7,1,0,8,0,30,5,8,0,13,5,30,4,9,0,13,0,30,7,2,0,9,1,-15,3,1
2,3,19,0,30,3,10,0,13,2,30,7,1,0,8,0,30,5,8,0,13,5,30,4,9,0,13,0,30,7,2,0,9,1,-15,3,1
2,4,19,0,30,3,10,0,13,2,30,7,1,0,8,0,30,5,8,0,13,5,30,4,9,0,13,0,30,7,2,0,9,1,-15,3,1
2,2,25,1,30,9,5,0,14,4,30,6,0,0,6,0,30,9,5,0,14,1,30,4,10,0,14,4,30,5,1,0,6,1,-15,3,1
2,2,29,1,30,9,5,0,14,5,30,9,3,0,12,0,30,5,9,0,14,0,30,1,13,0,14,2,30,9,0,0,9,1,-15,3,1
2,4,38,0,30,3,7,0,10,7,30,6,0,0,6,3,30,2,8,0,10,0,30,2,8,0,10,6,30,6,0,0,6,1,-15,3,1
2,2,4,2,30,5,3,0,8,4,30,4,0,0,4,0,30,3,5,0,8,0,30,7,1,0,8,3,30,4,0,0,4,0,-27,3,0
2,1,11,1,30,7,5,0,12,0,30,4,0,0,4,0,30,9,3,0,12,7,30,4,8,0,12,6,30,4,0,0,4,1,-15,3,1
2,2,11,1,30,7,5,0,12,0,30,4,0,0,4,0,30,9,3,0,12,7,30,4,8,0,12,6,30,4,0,0,4,1,-15,3,1
2,1,17,2,30,9,5,0,14,2,30,6,0,0,6,0,30,6,8,0,14,2,30,7,7,0,14,5,30,4,0,0,4,1,-15,3,1
2,2,19,1,30,4,9,0,13,2,30,5,3,0,8,0,30,4,9,0,13,4,30,4,9,0,13,1,30,9,0,0,9,1,-15,3,1
2,3,19,1,30,4,9,0,13,2,30,5,3,0,8,0,30,4,9,0,13,4,30,4,9,0,13,1,30,9,0,0,9,1,-15,3,1
2,4,19,1,30,4,9,0,13,2,30,5,3,0,8,0,30,4,9,0,13,4,30,4,9,0,13,1,30,9,0,0,9,1,-15,3,1
2,2,25,1,30,9,5,0,14,0,30,6,0,0,6,0,30,14,0,0,14,3,30,6,8,0,14,4,30,4,2,0,6,1,-15,3,1
2,4,25,1,30,9,5,0,14,0,30,6,0,0,6,0,30,14,0,0,14,3,30,6,8,0,14,4,30,4,2,0,6,1,-15,3,1
2,1,27,1,30,5,10,0,15,2,30,2,0,0,2,0,30,5,10,0,15,1,30,8,7,0,15,2,30,5,1,0,6,1,-15,3,1
2,2,27,1,30,5,10,0,15,2,30,2,0,0,2,0,30,5,10,0,15,1,30,8,7,0,15,2,30,5,1,0,6,1,-15,3,1
2,2,29,0,30,8,6,0,14,5,30,11,1,0,12,0,30,2,12,0,14,0,30,1,13,0,14,4,30,9,0,0,9,1,-15,3,1
2,3,31,2,30,9,3,0,12,4,30,8,0,0,8,3,30,8,4,0,12,0,30,5,7,0,12,0,30,4,2,0,6,1,-15,3,1
2,4,31,2,30,9,3,0,12,4,30,8,0,0,8,3,30,8,4,0,12,0,30,5,7,0,12,0,30,4,2,0,6,1,-15,3,1
2,3,4,3,30,7,1,0,8,4,30,4,0,0,4,0,30,1,7,0,8,0,30,3,5,0,8,2,30,4,0,0,4,0,-27,3,0
2,3,5,0,30,0,5,0,5,2,30,4,0,0,4,0,30,1,4,0,5,0,30,1,4,0,5,0,30,0,2,0,2,0,-27,3,0
2,2,6,0,30,7,2,0,9,4,30,2,0,0,2,0,30,3,6,0,9,0,30,5,4,0,9,0,30,5,0,0,5,0,-27,3,0
2,4,8,2,30,7,0,0,7,4,30,2,0,0,2,4,30,3,4,0,7,0,30,5,2,0,7,2,30,3,0,0,3,0,-27,3,0
2,1,13,3,30,5,2,0,7,2,30,4,0,0,4,0,30,5,2,0,7,5,30,7,0,0,7,4,30,4,0,0,4,1,-15,3,1
2,2,13,3,30,5,2,0,7,2,30,4,0,0,4,0,30,5,2,0,7,5,30,7,0,0,7,4,30,4,0,0,4,1,-15,3,1
2,3,13,3,30,5,2,0,7,2,30,4,0,0,4,0,30,5,2,0,7,5,30,7,0,0,7,4,30,4,0,0,4,1,-15,3,1
2,4,13,3,30,5,2,0,7,2,30,4,0,0,4,0,30,5,2,0,7,5,30,7,0,0,7,4,30,4,0,0,4,1,-15,3,1
2,1,17,4,30,10,4,0,14,4,30,6,0,0,6,3,30,5,9,0,14,2,30,7,7,0,14,1,30,4,0,0,4,1,-15,3,1
2,4,17,4,30,10,4,0,14,4,30,6,0,0,6,0,30,5,9,0,14,2,30,7,7,0,14,1,30,4,0,0,4,1,-15,3,1
2,0,19,0,30,5,8,0,13,2,30,6,2,0,8,4,30,7,6,0,13,1,30,3,10,0,13,1,30,8,1,0,9,1,-15,3,1
2,2,19,0,30,5,8,0,13,2,30,6,2,0,8,4,30,7,6,0,13,1,30,3,10,0,13,1,30,8,1,0,9,1,-15,3,1
2,4,19,0,30,5,8,0,13,2,30,6,2,0,8,4,30,7,6,0,13,0,30,3,10,0,13,1,30,8,1,0,9,1,-15,3,1
2,4,22,7,30,6,2,0,8,2,30,2,0,0,2,0,30,5,3,0,8,1,30,2,6,0,8,1,30,2,2,0,4,1,-15,3,1
2,3,33,1,30,3,8,0,11,6,30,4,0,0,4,3,30,7,4,0,11,0,30,3,8,0,11,5,30,4,0,0,4,1,-15,3,1
2,0,38,0,30,9,1,0,10,7,30,6,0,0,6,0,30,1,9,0,10,0,30,2,8,0,10,8,30,6,0,0,6,1,-15,3,1
2,3,43,2,30,11,3,0,14,8,30,6,0,0,6,0,30,4,10,0,14,0,30,1,13,0,14,6,30,5,0,0,5,1,-15,3,1
2,4,8,1,30,7,0,0,7,5,30,2,0,0,2,1,30,2,5,0,7,1,30,7,0,0,7,0,30,3,0,0,3,0,-27,3,0
2,1,13,1,30,5,2,0,7,1,30,4,0,0,4,2,30,5,2,0,7,12,30,6,1,0,7,4,30,4,0,0,4,1,-15,3,1
2,2,13,1,30,5,2,0,7,1,30,4,0,0,4,2,30,5,2,0,7,12,30,6,1,0,7,4,30,4,0,0,4,1,-15,3,1
2,4,13,1,30,5,2,0,7,1,30,4,0,0,4,2,30,5,2,0,7,12,30,6,1,0,7,4,30,4,0,0,4,1,-15,3,1
2,3,19,0,30,2,11,0,13,2,30,5,3,0,8,0,30,6,7,0,13,5,30,6,7,0,13,3,30,9,0,0,9,1,-15,3,1
2,4,19,0,30,2,11,0,13,2,30,5,3,0,8,0,30,6,7,0,13,5,30,6,7,0,13,3,30,9,0,0,9,1,-15,3,1
2,4,23,2,30,5,8,0,13,3,30,6,0,0,6,6,30,12,1,0,13,0,30,6,7,0,13,2,30,5,1,0,6,1,-15,3,1
2,1,27,1,30,6,9,0,15,4,30,1,1,0,2,0,30,9,6,0,15,0,30,10,5,0,15,1,30,2,4,0,6,1,-15,3,1
2,2,27,1,30,6,9,0,15,4,30,1,1,0,2,0,30,9,6,0,15,0,30,10,5,0,15,1,30,2,4,0,6,1,-15,3,1
2,3,8,1,30,7,0,0,7,4,30,2,0,0,2,0,30,1,6,0,7,0,30,6,1,0,7,6,30,3,0,0,3,0,-27,3,0
2,1,11,3,30,4,8,0,12,1,30,4,0,0,4,0,30,5,7,0,12,6,30,3,9,0,12,3,30,4,0,0,4,1,-15,3,1
2,3,11,3,30,4,8,0,12,1,30,4,0,0,4,0,30,5,7,0,12,6,30,3,9,0,12,3,30,4,0,0,4,1,-15,3,1
2,2,13,2,30,7,0,0,7,0,30,4,0,0,4,2,30,6,1,0,7,7,30,6,1,0,7,0,30,4,0,0,4,1,-15,3,1
2,4,13,2,30,7,0,0,7,0,30,4,0,0,4,2,30,6,1,0,7,7,30,6,1,0,7,0,30,4,0,0,4,1,-15,3,1
2,2,19,0,30,3,10,0,13,2,30,4,4,0,8,0,30,7,6,0,13,3,30,4,9,0,13,3,30,8,1,0,9,1,-15,3,1
2,2,25,1,30,6,8,0,14,4,30,6,0,0,6,0,30,10,4,0,14,2,30,6,8,0,14,3,30,4,2,0,6,1,-15,3,1
2,3,25,1,30,6,8,0,14,4,30,6,0,0,6,0,30,10,4,0,14,2,30,6,8,0,14,3,30,4,2,0,6,1,-15,3,1
2,4,25,1,30,6,8,0,14,4,30,6,0,0,6,0,30,10,4,0,14,2,30,6,8,0,14,3,30,4,2,0,6,1,-15,3,1
2,1,27,1,30,5,10,0,15,4,30,1,1,0,2,0,30,7,8,0,15,1,30,5,10,0,15,2,30,6,0,0,6,1,-15,3,1
2,2,27,1,30,5,10,0,15,4,30,1,1,0,2,0,30,7,8,0,15,1,30,5,10,0,15,2,30,6,0,0,6,1,-15,3,1
2,3,27,1,30,5,10,0,15,4,30,1,1,0,2,0,30,7,8,0,15,1,30,5,10,0,15,2,30,6,0,0,6,1,-15,3,1
2,2,29,0,30,4,10,0,14,6,30,12,0,0,12,0,30,4,10,0,14,0,30,0,14,0,14,5,30,9,0,0,9,1,-15,3,1
2,3,32,0,30,5,4,0,9,4,30,2,0,0,2,0,30,8,1,0,9,1,30,3,6,0,9,2,30,2,0,0,2,1,-15,3,1
2,4,32,0,30,5,4,0,9,4,30,2,0,0,2,0,30,8,1,0,9,1,30,3,6,0,9,2,30,2,0,0,2,1,-15,3,1
2,2,35,0,30,7,6,0,13,4,30,2,0,0,2,1,30,2,11,0,13,1,30,4,9,0,13,5,30,8,0,0,8,1,-15,3,1
2,4,17,4,30,6,8,0,14,3,30,6,0,0,6,0,30,8,6,0,14,0,30,8,6,0,14,4,30,4,0,0,4,1,-15,3,1
2,4,23,1,30,5,8,0,13,2,30,6,0,0,6,9,30,10,3,0,13,0,30,5,8,0,13,0,30,5,1,0,6,1,-15,3,1
2,2,25,1,30,5,9,0,14,2,30,6,0,0,6,1,30,14,0,0,14,1,30,5,9,0,14,3,30,5,1,0,6,1,-15,3,1
2,3,25,1,30,5,9,0,14,2,30,6,0,0,6,1,30,14,0,0,14,1,30,5,9,0,14,3,30,5,1,0,6,1,-15,3,1
2,1,5,0,30,1,4,0,5,2,30,4,0,0,4,0,30,1,4,0,5,0,30,4,1,0,5,0,30,0,2,0,2,0,-27,3,0
2,1,13,2,30,6,1,0,7,0,30,4,0,0,4,1,30,6,1,0,7,7,30,7,0,0,7,4,30,4,0,0,4,1,-15,3,1
2,2,13,2,30,6,1,0,7,0,30,4,0,0,4,1,30,6,1,0,7,7,30,7,0,0,7,4,30,4,0,0,4,1,-15,3,1
2,1,17,3,30,11,3,0,14,3,30,6,0,0,6,0,30,4,10,0,14,1,30,5,9,0,14,1,30,2,2,0,4,1,-15,3,1
2,2,17,3,30,11,3,0,14,3,30,6,0,0,6,0,30,4,10,0,14,1,30,5,9,0,14,1,30,2,2,0,4,1,-15,3,1
2,3,17,3,30,11,3,0,14,3,30,6,0,0,6,0,30,4,10,0,14,1,30,5,9,0,14,1,30,2,2,0,4,1,-15,3,1
2,4,17,3,30,11,3,0,14,3,30,6,0,0,6,0,30,4,10,0,14,1,30,5,9,0,14,1,30,2,2,0,4,1,-15,3,1
2,2,19,0,30,3,10,0,13,2,30,6,2,0,8,0,30,7,6,0,13,9,30,4,9,0,13,0,30,8,1,0,9,1,-15,3,1
2,2,21,2,30,7,3,0,10,3,30,6,0,0,6,0,30,5,5,0,10,3,30,5,5,0,10,0,30,3,1,0,4,1,-15,3,1
2,1,23,1,30,4,9,0,13,0,30,6,0,0,6,4,30,11,2,0,13,6,30,6,7,0,13,4,30,6,0,0,6,1,-15,3,1
2,4,23,1,30,4,9,0,13,0,30,6,0,0,6,4,30,11,2,0,13,4,30,6,7,0,13,4,30,6,0,0,6,1,-15,3,1
2,2,25,1,30,5,9,0,14,6,30,6,0,0,6,0,30,6,8,0,14,3,30,9,5,0,14,0,30,6,0,0,6,1,-15,3,1
2,2,27,3,30,6,9,0,15,4,30,2,0,0,2,2,30,10,5,0,15,0,30,7,8,0,15,0,30,4,2,0,6,1,-15,3,1
2,4,27,3,30,6,9,0,15,4,30,2,0,0,2,2,30,10,5,0,15,0,30,7,8,0,15,0,30,4,2,0,6,1,-15,3,1
2,2,29,1,30,5,9,0,14,6,30,9,3,0,12,0,30,8,6,0,14,0,30,1,13,0,14,3,30,9,0,0,9,1,-15,3,1
2,4,31,1,30,4,8,0,12,6,30,8,0,0,8,8,30,9,3,0,12,0,30,3,9,0,12,2,30,5,1,0,6,1,-15,3,1
