0,1,2,3,4,5,6,7,8,9,10,11,12,13,14,15,16,17,18,19,20,21,22,23,24,25,26,27,28,29,30,31,32,33,34,35,36
2,4,16,1,30,5,4,0,9,2,30,7,1,0,8,1,30,2,7,0,9,0,30,0,9,0,9,0,30,4,0,0,4,1,-15,3,1
2,4,13,1,30,3,0,0,3,0,30,2,0,0,2,0,30,3,0,0,3,3,30,2,1,0,3,2,30,2,0,0,2,1,-15,3,1
2,3,36,0,30,1,8,0,9,5,30,2,0,0,2,10,30,6,3,0,9,1,30,6,3,0,9,9,30,3,0,0,3,1,-15,3,1
2,4,31,0,30,6,6,0,12,3,30,8,0,0,8,6,30,12,0,0,12,0,30,3,9,0,12,0,30,1,5,0,6,1,-15,3,1
2,4,16,0,30,4,5,0,9,2,30,8,0,0,8,0,30,1,8,0,9,0,30,3,6,0,9,3,30,4,0,0,4,1,-15,3,1
2,1,13,5,30,3,0,0,3,1,30,2,0,0,2,0,30,3,0,0,3,3,30,2,1,0,3,1,30,2,0,0,2,1,-15,3,1
2,3,31,2,30,0,4,0,4,4,30,4,0,0,4,2,30,1,3,0,4,0,30,1,3,0,4,0,30,3,0,0,3,1,-15,3,1
2,4,19,2,30,2,3,0,5,0,30,2,0,0,2,1,30,4,1,0,5,0,30,2,3,0,5,2,30,2,1,0,3,1,-15,3,1
2,3,25,1,30,1,3,0,4,2,30,2,0,0,2,0,30,3,1,0,4,0,30,0,4,0,4,0,30,1,0,0,1,1,-15,3,1
2,2,31,0,30,1,3,0,4,3,30,4,0,0,4,6,30,1,3,0,4,0,30,1,3,0,4,0,30,0,3,0,3,1,-15,3,1
2,4,31,0,30,1,3,0,4,3,30,4,0,0,4,5,30,3,1,0,4,0,30,1,3,0,4,0,30,0,3,0,3,1,-15,3,1
2,4,24,1,30,5,1,0,6,3,30,4,0,0,4,4,30,3,3,0,6,0,30,2,4,0,6,0,30,4,0,0,4,1,-15,3,1
2,3,27,0,30,1,4,0,5,0,30,0,0,0,0,3,30,5,0,0,5,3,30,2,3,0,5,5,30,4,0,0,4,1,-15,3,1
2,3,24,1,30,6,0,0,6,2,30,4,0,0,4,0,30,5,1,0,6,0,30,1,5,0,6,0,30,4,0,0,4,1,-15,3,1
2,4,23,0,30,2,3,0,5,1,30,4,0,0,4,2,30,3,2,0,5,0,30,0,5,0,5,1,30,2,0,0,2,1,-15,3,1
2,4,23,0,30,3,2,0,5,2,30,4,0,0,4,4,30,2,3,0,5,0,30,0,5,0,5,2,30,2,0,0,2,1,-15,3,1
2,4,8,0,30,6,1,0,7,2,30,2,0,0,2,6,30,7,0,0,7,0,30,4,3,0,7,0,30,3,0,0,3,0,-27,3,0
2,4,4,3,30,8,0,0,8,3,30,4,0,0,4,0,30,6,2,0,8,0,30,3,5,0,8,1,30,4,0,0,4,0,-27,3,0
2,1,5,1,30,6,6,0,12,2,30,6,4,0,10,3,30,5,7,0,12,0,30,6,6,0,12,1,30,3,3,0,6,0,-27,3,0
2,4,7,0,30,4,5,0,9,1,30,4,0,0,4,2,30,6,3,0,9,8,30,3,6,0,9,2,30,6,0,0,6,0,-27,3,0
2,3,31,0,30,2,2,0,4,2,30,4,0,0,4,0,30,1,3,0,4,0,30,1,3,0,4,0,30,2,1,0,3,1,-15,3,1
2,4,31,1,30,3,1,0,4,0,30,4,0,0,4,3,30,2,2,0,4,0,30,1,3,0,4,0,30,0,3,0,3,1,-15,3,1
2,2,31,0,30,0,4,0,4,1,30,4,0,0,4,1,30,4,0,0,4,0,30,1,3,0,4,0,30,0,3,0,3,1,-15,3,1
2,4,31,0,30,0,4,0,4,1,30,4,0,0,4,0,30,4,0,0,4,0,30,1,3,0,4,0,30,1,2,0,3,1,-15,3,1
2,4,31,0,30,0,4,0,4,3,30,4,0,0,4,10,30,4,0,0,4,0,30,1,3,0,4,0,30,1,2,0,3,1,-15,3,1
2,4,31,0,30,2,2,0,4,2,30,4,0,0,4,6,30,3,1,0,4,0,30,3,1,0,4,0,30,2,1,0,3,1,-15,3,1
2,1,24,0,30,4,2,0,6,3,30,4,0,0,4,10,30,6,0,0,6,0,30,1,5,0,6,2,30,4,0,0,4,1,-15,3,1
2,4,17,0,30,1,3,0,4,0,30,2,0,0,2,1,30,0,4,0,4,2,30,1,3,0,4,4,30,1,0,0,1,1,-15,3,1
2,3,31,0,30,2,2,0,4,3,30,4,0,0,4,2,30,3,1,0,4,0,30,1,3,0,4,0,30,0,3,0,3,1,-15,3,1
2,2,31,0,30,0,4,0,4,2,30,4,0,0,4,3,30,2,2,0,4,0,30,1,3,0,4,0,30,2,1,0,3,1,-15,3,1
2,4,9,1,30,8,3,0,11,2,30,6,0,0,6,2,30,8,3,0,11,1,30,3,8,0,11,1,30,4,0,0,4,0,-27,3,0
2,3,24,2,30,6,0,0,6,3,30,4,0,0,4,3,30,5,1,0,6,0,30,1,5,0,6,2,30,4,0,0,4,1,-15,3,1
2,3,23,0,30,4,1,0,5,2,30,4,0,0,4,7,30,4,1,0,5,0,30,0,5,0,5,1,30,1,1,0,2,1,-15,3,1
2,1,5,1,30,4,8,0,12,2,30,10,0,0,10,0,30,4,8,0,12,0,30,7,5,0,12,1,30,4,2,0,6,0,-27,3,0
2,4,27,0,30,2,3,0,5,1,30,0,0,0,0,3,30,3,2,0,5,0,30,2,3,0,5,4,30,4,0,0,4,1,-15,3,1
2,3,3,1,30,6,5,0,11,2,30,8,0,0,8,1,30,5,6,0,11,4,30,3,8,0,11,1,30,5,2,0,7,0,-27,3,0
2,4,32,0,30,5,4,0,9,4,30,2,0,0,2,5,30,9,0,0,9,1,30,3,6,0,9,1,30,2,0,0,2,1,-15,3,1
2,4,24,0,30,5,1,0,6,2,30,3,1,0,4,4,30,5,1,0,6,0,30,1,5,0,6,3,30,4,0,0,4,1,-15,3,1
2,2,9,0,30,2,2,0,4,1,30,2,0,0,2,0,30,3,1,0,4,0,30,1,3,0,4,1,30,1,0,0,1,0,-27,3,0
2,3,7,1,30,4,5,0,9,2,30,4,0,0,4,0,30,8,1,0,9,2,30,3,6,0,9,2,30,6,0,0,6,0,-27,3,0
2,4,23,0,30,2,3,0,5,2,30,4,0,0,4,7,30,5,0,0,5,0,30,0,5,0,5,4,30,2,0,0,2,1,-15,3,1
2,4,20,0,30,5,3,0,8,1,30,7,1,0,8,0,30,6,2,0,8,0,30,1,7,0,8,2,30,5,0,0,5,1,-15,3,1
2,4,31,0,30,0,4,0,4,4,30,4,0,0,4,0,30,1,3,0,4,4,30,3,1,0,4,2,30,3,0,0,3,1,-15,3,1
2,2,4,2,30,6,2,0,8,3,30,4,0,0,4,0,30,6,2,0,8,0,30,4,4,0,8,2,30,3,1,0,4,0,-27,3,0
2,4,31,3,30,6,6,0,12,4,30,8,0,0,8,9,30,12,0,0,12,0,30,3,9,0,12,0,30,5,1,0,6,1,-15,3,1
2,2,17,1,30,1,3,0,4,0,30,2,0,0,2,1,30,2,2,0,4,2,30,0,4,0,4,3,30,1,0,0,1,1,-15,3,1
2,3,28,0,30,1,7,0,8,0,30,4,0,0,4,0,30,7,1,0,8,0,30,2,6,0,8,2,30,3,1,0,4,1,-15,3,1
2,1,31,0,30,1,3,0,4,3,30,4,0,0,4,0,30,3,1,0,4,0,30,1,3,0,4,0,30,2,1,0,3,1,-15,3,1
2,2,25,3,30,0,4,0,4,2,30,2,0,0,2,0,30,4,0,0,4,0,30,0,4,0,4,1,30,1,0,0,1,1,-15,3,1
2,3,24,0,30,4,2,0,6,0,30,4,0,0,4,4,30,5,1,0,6,0,30,3,3,0,6,3,30,4,0,0,4,1,-15,3,1
2,0,20,0,30,3,5,0,8,0,30,6,2,0,8,0,30,6,2,0,8,0,30,3,5,0,8,1,30,4,1,0,5,1,-15,3,1
2,4,5,1,30,6,6,0,12,2,30,8,2,0,10,0,30,6,6,0,12,0,30,8,4,0,12,3,30,4,2,0,6,0,-27,3,0
2,4,4,3,30,8,0,0,8,3,30,4,0,0,4,0,30,6,2,0,8,0,30,4,4,0,8,1,30,4,0,0,4,0,-27,3,0
2,3,9,0,30,2,2,0,4,1,30,2,0,0,2,5,30,4,0,0,4,0,30,1,3,0,4,3,30,1,0,0,1,0,-27,3,0
2,3,15,5,30,3,1,0,4,0,30,6,0,0,6,0,30,2,2,0,4,2,30,2,2,0,4,3,30,4,0,0,4,1,-15,3,1
2,3,4,3,30,8,0,0,8,3,30,4,0,0,4,1,30,7,1,0,8,0,30,4,4,0,8,1,30,4,0,0,4,0,-27,3,0
2,0,23,0,30,2,3,0,5,2,30,3,1,0,4,8,30,5,0,0,5,0,30,0,5,0,5,2,30,2,0,0,2,1,-15,3,1
2,4,9,0,30,2,2,0,4,2,30,2,0,0,2,4,30,2,2,0,4,0,30,1,3,0,4,1,30,0,1,0,1,0,-27,3,0
2,4,14,0,30,3,6,0,9,0,30,5,1,0,6,6,30,9,0,0,9,2,30,9,0,0,9,1,30,4,0,0,4,1,-15,3,1
2,4,9,1,30,7,4,0,11,1,30,5,1,0,6,5,30,10,1,0,11,1,30,2,9,0,11,2,30,2,2,0,4,0,-27,3,0
2,2,5,0,30,1,4,0,5,2,30,4,0,0,4,4,30,3,2,0,5,0,30,1,4,0,5,0,30,0,2,0,2,0,-27,3,0
2,4,3,0,30,0,4,0,4,0,30,4,0,0,4,0,30,3,1,0,4,1,30,2,2,0,4,0,30,1,2,0,3,0,-27,3,0
2,1,5,4,30,6,6,0,12,3,30,6,4,0,10,1,30,6,6,0,12,0,30,8,4,0,12,1,30,2,4,0,6,0,-27,3,0
2,2,25,6,30,0,4,0,4,3,30,2,0,0,2,0,30,4,0,0,4,0,30,0,4,0,4,1,30,1,0,0,1,1,-15,3,1
2,3,9,0,30,6,5,0,11,0,30,6,0,0,6,0,30,11,0,0,11,2,30,3,8,0,11,3,30,4,0,0,4,0,-27,3,0
2,1,5,1,30,7,5,0,12,3,30,6,4,0,10,1,30,3,9,0,12,0,30,7,5,0,12,2,30,4,2,0,6,0,-27,3,0
2,4,25,2,30,1,3,0,4,1,30,2,0,0,2,0,30,4,0,0,4,0,30,1,3,0,4,2,30,1,0,0,1,1,-15,3,1
2,1,5,1,30,7,5,0,12,2,30,7,3,0,10,0,30,6,6,0,12,0,30,7,5,0,12,3,30,1,5,0,6,0,-27,3,0
2,4,9,0,30,2,2,0,4,1,30,2,0,0,2,0,30,3,1,0,4,0,30,1,3,0,4,3,30,1,0,0,1,0,-27,3,0
2,4,8,0,30,7,0,0,7,1,30,2,0,0,2,1,30,7,0,0,7,0,30,3,4,0,7,3,30,3,0,0,3,0,-27,3,0
2,4,28,0,30,1,7,0,8,5,30,4,0,0,4,3,30,1,7,0,8,0,30,8,0,0,8,0,30,4,0,0,4,1,-15,3,1
2,1,5,1,30,6,6,0,12,2,30,7,3,0,10,1,30,5,7,0,12,0,30,8,4,0,12,1,30,2,4,0,6,0,-27,3,0
2,3,25,1,30,2,2,0,4,2,30,2,0,0,2,0,30,4,0,0,4,2,30,0,4,0,4,0,30,1,0,0,1,1,-15,3,1
2,3,5,1,30,8,4,0,12,3,30,7,3,0,10,1,30,4,8,0,12,0,30,6,6,0,12,1,30,1,5,0,6,0,-27,3,0
2,3,8,2,30,7,0,0,7,2,30,2,0,0,2,1,30,7,0,0,7,0,30,7,0,0,7,2,30,3,0,0,3,0,-27,3,0
2,3,5,0,30,1,4,0,5,2,30,3,1,0,4,0,30,2,3,0,5,0,30,1,4,0,5,1,30,2,0,0,2,0,-27,3,0
2,4,7,1,30,3,6,0,9,2,30,4,0,0,4,1,30,7,2,0,9,4,30,3,6,0,9,2,30,3,3,0,6,0,-27,3,0
2,2,25,2,30,0,4,0,4,2,30,2,0,0,2,4,30,4,0,0,4,1,30,0,4,0,4,0,30,1,0,0,1,1,-15,3,1
2,0,31,0,30,0,4,0,4,4,30,4,0,0,4,0,30,1,3,0,4,3,30,4,0,0,4,2,30,3,0,0,3,1,-15,3,1
2,4,30,2,30,3,2,0,5,5,30,2,0,0,2,2,30,2,3,0,5,2,30,3,2,0,5,0,30,2,1,0,3,1,-15,3,1
2,4,36,2,30,4,5,0,9,4,30,2,0,0,2,1,30,9,0,0,9,1,30,1,8,0,9,1,30,2,1,0,3,1,-15,3,1
2,3,24,0,30,5,1,0,6,3,30,3,1,0,4,7,30,6,0,0,6,0,30,1,5,0,6,2,30,4,0,0,4,1,-15,3,1
2,4,11,0,30,3,1,0,4,0,30,0,0,0,0,1,30,2,2,0,4,0,30,1,3,0,4,0,30,1,0,0,1,1,-15,3,1
2,4,24,5,30,6,0,0,6,0,30,4,0,0,4,3,30,4,2,0,6,0,30,2,4,0,6,0,30,3,1,0,4,1,-15,3,1
2,2,20,0,30,2,6,0,8,1,30,5,3,0,8,0,30,6,2,0,8,0,30,3,5,0,8,1,30,4,1,0,5,1,-15,3,1
2,4,23,0,30,3,2,0,5,1,30,4,0,0,4,0,30,3,2,0,5,0,30,0,5,0,5,5,30,2,0,0,2,1,-15,3,1
2,2,5,1,30,5,7,0,12,3,30,6,4,0,10,1,30,3,9,0,12,3,30,7,5,0,12,1,30,3,3,0,6,0,-27,3,0
2,2,28,0,30,0,8,0,8,5,30,4,0,0,4,0,30,1,7,0,8,0,30,8,0,0,8,4,30,4,0,0,4,1,-15,3,1
2,2,24,0,30,2,4,0,6,3,30,4,0,0,4,4,30,1,5,0,6,6,30,2,4,0,6,2,30,4,0,0,4,1,-15,3,1
2,4,23,0,30,2,3,0,5,1,30,4,0,0,4,1,30,5,0,0,5,1,30,1,4,0,5,4,30,2,0,0,2,1,-15,3,1
2,3,31,0,30,0,4,0,4,2,30,4,0,0,4,6,30,3,1,0,4,0,30,1,3,0,4,0,30,3,0,0,3,1,-15,3,1
2,1,29,0,30,0,5,0,5,4,30,8,0,0,8,0,30,2,3,0,5,0,30,0,5,0,5,0,30,4,0,0,4,1,-15,3,1
2,2,3,1,30,4,7,0,11,0,30,8,0,0,8,0,30,9,2,0,11,2,30,5,6,0,11,3,30,2,5,0,7,0,-27,3,0
2,4,3,0,30,4,7,0,11,2,30,8,0,0,8,0,30,4,7,0,11,0,30,7,4,0,11,1,30,3,4,0,7,0,-27,3,0
2,4,7,1,30,3,6,0,9,2,30,4,0,0,4,0,30,5,4,0,9,1,30,3,6,0,9,3,30,6,0,0,6,0,-27,3,0
2,1,23,0,30,2,3,0,5,1,30,4,0,0,4,1,30,5,0,0,5,0,30,4,1,0,5,1,30,2,0,0,2,1,-15,3,1
2,2,24,0,30,5,1,0,6,2,30,3,1,0,4,3,30,2,4,0,6,0,30,3,3,0,6,2,30,4,0,0,4,1,-15,3,1
2,4,32,0,30,4,5,0,9,4,30,2,0,0,2,2,30,8,1,0,9,1,30,3,6,0,9,4,30,2,0,0,2,1,-15,3,1
2,3,32,0,30,5,4,0,9,4,30,2,0,0,2,2,30,9,0,0,9,1,30,2,7,0,9,1,30,2,0,0,2,1,-15,3,1
2,4,16,0,30,7,2,0,9,1,30,7,1,0,8,0,30,3,6,0,9,0,30,1,8,0,9,0,30,4,0,0,4,1,-15,3,1
2,2,28,0,30,2,6,0,8,4,30,4,0,0,4,0,30,1,7,0,8,0,30,4,4,0,8,1,30,3,1,0,4,1,-15,3,1
2,3,23,0,30,3,2,0,5,2,30,4,0,0,4,6,30,5,0,0,5,0,30,0,5,0,5,3,30,2,0,0,2,1,-15,3,1
2,3,5,1,30,5,7,0,12,2,30,6,4,0,10,1,30,6,6,0,12,0,30,6,6,0,12,3,30,3,3,0,6,0,-27,3,0
2,3,31,1,30,2,2,0,4,2,30,4,0,0,4,0,30,3,1,0,4,0,30,1,3,0,4,0,30,3,0,0,3,1,-15,3,1
2,4,7,0,30,4,5,0,9,2,30,4,0,0,4,2,30,6,3,0,9,0,30,2,7,0,9,2,30,3,3,0,6,0,-27,3,0
2,4,8,2,30,7,0,0,7,3,30,2,0,0,2,3,30,5,2,0,7,0,30,6,1,0,7,2,30,3,0,0,3,0,-27,3,0
2,4,4,2,30,6,2,0,8,3,30,4,0,0,4,0,30,6,2,0,8,0,30,4,4,0,8,2,30,3,1,0,4,0,-27,3,0
2,1,31,0,30,0,4,0,4,3,30,4,0,0,4,1,30,4,0,0,4,0,30,2,2,0,4,0,30,3,0,0,3,1,-15,3,1
2,4,24,0,30,6,0,0,6,2,30,3,1,0,4,4,30,6,0,0,6,0,30,1,5,0,6,4,30,4,0,0,4,1,-15,3,1
2,4,31,0,30,2,2,0,4,0,30,4,0,0,4,2,30,4,0,0,4,0,30,1,3,0,4,0,30,0,3,0,3,1,-15,3,1
2,2,5,0,30,2,3,0,5,0,30,2,2,0,4,0,30,0,5,0,5,0,30,2,3,0,5,0,30,0,2,0,2,0,-27,3,0
2,4,28,0,30,1,7,0,8,3,30,4,0,0,4,0,30,6,2,0,8,0,30,2,6,0,8,2,30,4,0,0,4,1,-15,3,1
2,2,16,0,30,5,4,0,9,1,30,8,0,0,8,1,30,4,5,0,9,0,30,1,8,0,9,0,30,4,0,0,4,1,-15,3,1
2,1,24,0,30,4,2,0,6,2,30,3,1,0,4,4,30,6,0,0,6,0,30,1,5,0,6,0,30,4,0,0,4,1,-15,3,1
2,2,31,0,30,1,3,0,4,3,30,4,0,0,4,0,30,1,3,0,4,0,30,1,3,0,4,1,30,3,0,0,3,1,-15,3,1
2,3,24,0,30,3,3,0,6,0,30,4,0,0,4,10,30,6,0,0,6,0,30,1,5,0,6,2,30,3,1,0,4,1,-15,3,1
2,4,17,1,30,1,3,0,4,1,30,2,0,0,2,4,30,0,4,0,4,2,30,2,2,0,4,2,30,1,0,0,1,1,-15,3,1
2,4,9,1,30,5,6,0,11,1,30,6,0,0,6,3,30,10,1,0,11,1,30,5,6,0,11,5,30,2,2,0,4,0,-27,3,0
2,4,19,3,30,2,3,0,5,1,30,2,0,0,2,0,30,3,2,0,5,0,30,1,4,0,5,3,30,3,0,0,3,1,-15,3,1
2,2,30,2,30,3,2,0,5,5,30,2,0,0,2,2,30,2,3,0,5,3,30,2,3,0,5,0,30,2,1,0,3,1,-15,3,1
2,4,24,0,30,5,1,0,6,2,30,4,0,0,4,0,30,2,4,0,6,0,30,1,5,0,6,2,30,4,0,0,4,1,-15,3,1
2,2,4,2,30,6,2,0,8,3,30,4,0,0,4,0,30,5,3,0,8,0,30,5,3,0,8,2,30,3,1,0,4,0,-27,3,0
2,3,7,0,30,2,2,0,4,1,30,2,0,0,2,0,30,2,2,0,4,0,30,1,3,0,4,3,30,2,0,0,2,0,-27,3,0
2,3,31,0,30,1,3,0,4,3,30,4,0,0,4,5,30,3,1,0,4,0,30,1,3,0,4,0,30,3,0,0,3,1,-15,3,1
2,3,17,1,30,1,3,0,4,0,30,2,0,0,2,1,30,1,3,0,4,3,30,1,3,0,4,0,30,1,0,0,1,1,-15,3,1
2,4,45,0,30,0,5,0,5,5,30,4,0,0,4,6,30,5,0,0,5,0,30,1,4,0,5,4,30,2,0,0,2,1,-15,3,1
2,3,28,0,30,2,6,0,8,4,30,4,0,0,4,2,30,2,6,0,8,0,30,4,4,0,8,3,30,4,0,0,4,1,-15,3,1
2,3,23,2,30,2,3,0,5,2,30,4,0,0,4,3,30,2,3,0,5,0,30,0,5,0,5,0,30,2,0,0,2,1,-15,3,1
2,1,5,1,30,6,6,0,12,3,30,7,3,0,10,1,30,3,9,0,12,0,30,7,5,0,12,0,30,6,0,0,6,0,-27,3,0
2,2,31,0,30,0,4,0,4,3,30,4,0,0,4,5,30,4,0,0,4,0,30,1,3,0,4,0,30,3,0,0,3,1,-15,3,1
2,2,5,1,30,6,6,0,12,2,30,7,3,0,10,0,30,4,8,0,12,0,30,7,5,0,12,1,30,4,2,0,6,0,-27,3,0
2,3,25,2,30,1,3,0,4,2,30,2,0,0,2,0,30,1,3,0,4,0,30,0,4,0,4,0,30,1,0,0,1,1,-15,3,1
2,3,9,0,30,6,5,0,11,2,30,6,0,0,6,1,30,6,5,0,11,1,30,3,8,0,11,3,30,4,0,0,4,0,-27,3,0
2,4,28,0,30,0,8,0,8,5,30,4,0,0,4,0,30,1,7,0,8,0,30,6,2,0,8,2,30,4,0,0,4,1,-15,3,1
2,4,24,0,30,3,3,0,6,2,30,4,0,0,4,3,30,6,0,0,6,0,30,3,3,0,6,1,30,4,0,0,4,1,-15,3,1
2,1,5,0,30,2,3,0,5,2,30,3,1,0,4,4,30,2,3,0,5,0,30,1,4,0,5,0,30,0,2,0,2,0,-27,3,0
2,4,23,0,30,2,3,0,5,2,30,4,0,0,4,3,30,4,1,0,5,0,30,0,5,0,5,2,30,2,0,0,2,1,-15,3,1
2,0,24,0,30,5,1,0,6,2,30,3,1,0,4,4,30,2,4,0,6,0,30,1,5,0,6,1,30,4,0,0,4,1,-15,3,1
2,4,23,0,30,3,2,0,5,2,30,4,0,0,4,2,30,3,2,0,5,0,30,0,5,0,5,2,30,2,0,0,2,1,-15,3,1
2,2,24,0,30,4,2,0,6,2,30,3,1,0,4,0,30,2,4,0,6,0,30,4,2,0,6,3,30,4,0,0,4,1,-15,3,1
2,3,13,1,30,3,0,0,3,0,30,2,0,0,2,6,30,3,0,0,3,1,30,1,2,0,3,1,30,2,0,0,2,1,-15,3,1
2,3,28,0,30,1,7,0,8,3,30,4,0,0,4,0,30,4,4,0,8,0,30,6,2,0,8,0,30,2,2,0,4,1,-15,3,1
2,4,21,4,30,3,0,0,3,0,30,2,0,0,2,0,30,2,1,0,3,0,30,0,3,0,3,1,30,1,0,0,1,1,-15,3,1
2,3,27,0,30,1,4,0,5,0,30,0,0,0,0,0,30,5,0,0,5,0,30,2,3,0,5,0,30,4,0,0,4,1,-15,3,1
2,1,23,0,30,2,3,0,5,1,30,3,1,0,4,3,30,4,1,0,5,0,30,0,5,0,5,1,30,2,0,0,2,1,-15,3,1
2,3,24,0,30,6,0,0,6,2,30,4,0,0,4,8,30,6,0,0,6,0,30,1,5,0,6,1,30,4,0,0,4,1,-15,3,1
2,3,9,0,30,1,3,0,4,1,30,2,0,0,2,1,30,3,1,0,4,0,30,1,3,0,4,3,30,1,0,0,1,0,-27,3,0
2,4,9,0,30,6,5,0,11,2,30,6,0,0,6,8,30,9,2,0,11,1,30,3,8,0,11,2,30,3,1,0,4,0,-27,3,0
2,4,3,0,30,4,7,0,11,1,30,8,0,0,8,0,30,7,4,0,11,7,30,4,7,0,11,1,30,2,5,0,7,0,-27,3,0
2,4,3,0,30,4,7,0,11,3,30,8,0,0,8,1,30,2,9,0,11,0,30,7,4,0,11,1,30,4,3,0,7,0,-27,3,0
2,2,3,0,30,4,7,0,11,2,30,7,1,0,8,3,30,3,8,0,11,2,30,5,6,0,11,1,30,2,5,0,7,0,-27,3,0
2,4,31,1,30,1,3,0,4,3,30,4,0,0,4,3,30,2,2,0,4,0,30,1,3,0,4,0,30,2,1,0,3,1,-15,3,1
2,4,17,1,30,2,2,0,4,0,30,2,0,0,2,1,30,2,2,0,4,2,30,1,3,0,4,0,30,1,0,0,1,1,-15,3,1
2,3,24,0,30,3,3,0,6,2,30,4,0,0,4,1,30,6,0,0,6,0,30,1,5,0,6,1,30,4,0,0,4,1,-15,3,1
2,1,13,3,30,7,0,0,7,1,30,4,0,0,4,1,30,6,1,0,7,0,30,5,2,0,7,2,30,4,0,0,4,1,-15,3,1
2,2,5,0,30,2,3,0,5,0,30,2,2,0,4,0,30,1,4,0,5,0,30,1,4,0,5,1,30,2,0,0,2,0,-27,3,0
2,2,5,0,30,2,3,0,5,0,30,3,1,0,4,0,30,0,5,0,5,0,30,1,4,0,5,0,30,1,1,0,2,0,-27,3,0
2,3,9,0,30,6,5,0,11,2,30,6,0,0,6,2,30,9,2,0,11,5,30,3,8,0,11,4,30,4,0,0,4,0,-27,3,0
2,3,23,0,30,2,3,0,5,2,30,4,0,0,4,7,30,4,1,0,5,0,30,0,5,0,5,2,30,2,0,0,2,1,-15,3,1
2,3,24,0,30,6,0,0,6,1,30,4,0,0,4,3,30,6,0,0,6,0,30,1,5,0,6,0,30,2,2,0,4,1,-15,3,1
2,2,31,1,30,3,1,0,4,4,30,4,0,0,4,0,30,1,3,0,4,0,30,1,3,0,4,0,30,1,2,0,3,1,-15,3,1
2,1,24,0,30,4,2,0,6,3,30,4,0,0,4,10,30,5,1,0,6,0,30,1,5,0,6,2,30,4,0,0,4,1,-15,3,1
2,2,17,3,30,2,2,0,4,1,30,2,0,0,2,1,30,0,4,0,4,2,30,1,3,0,4,3,30,1,0,0,1,1,-15,3,1
2,3,3,0,30,1,3,0,4,1,30,4,0,0,4,1,30,2,2,0,4,0,30,0,4,0,4,0,30,1,2,0,3,0,-27,3,0
2,4,24,0,30,6,0,0,6,2,30,4,0,0,4,0,30,4,2,0,6,0,30,1,5,0,6,2,30,4,0,0,4,1,-15,3,1
2,2,23,0,30,2,3,0,5,1,30,4,0,0,4,4,30,3,2,0,5,0,30,0,5,0,5,5,30,2,0,0,2,1,-15,3,1
2,3,31,0,30,0,4,0,4,2,30,4,0,0,4,1,30,4,0,0,4,2,30,4,0,0,4,0,30,1,2,0,3,1,-15,3,1
2,2,7,4,30,4,5,0,9,2,30,4,0,0,4,0,30,8,1,0,9,0,30,3,6,0,9,2,30,5,1,0,6,0,-27,3,0
2,2,3,0,30,4,7,0,11,2,30,8,0,0,8,0,30,5,6,0,11,6,30,3,8,0,11,1,30,7,0,0,7,0,-27,3,0
2,1,7,0,30,3,1,0,4,0,30,2,0,0,2,4,30,3,1,0,4,0,30,1,3,0,4,2,30,2,0,0,2,0,-27,3,0
2,3,4,2,30,8,0,0,8,3,30,2,2,0,4,1,30,8,0,0,8,0,30,2,6,0,8,1,30,4,0,0,4,0,-27,3,0
2,4,9,0,30,2,2,0,4,1,30,2,0,0,2,3,30,2,2,0,4,0,30,1,3,0,4,1,30,1,0,0,1,0,-27,3,0
2,2,20,0,30,0,8,0,8,3,30,8,0,0,8,1,30,2,6,0,8,0,30,5,3,0,8,1,30,3,2,0,5,1,-15,3,1
2,4,24,0,30,4,2,0,6,2,30,3,1,0,4,4,30,6,0,0,6,0,30,1,5,0,6,3,30,4,0,0,4,1,-15,3,1
2,1,31,0,30,2,2,0,4,4,30,4,0,0,4,0,30,1,3,0,4,1,30,2,2,0,4,0,30,3,0,0,3,1,-15,3,1
2,4,24,1,30,6,0,0,6,2,30,3,1,0,4,0,30,6,0,0,6,2,30,2,4,0,6,0,30,3,1,0,4,1,-15,3,1
2,0,31,0,30,0,4,0,4,2,30,4,0,0,4,3,30,3,1,0,4,0,30,1,3,0,4,0,30,0,3,0,3,1,-15,3,1
2,3,3,2,30,4,7,0,11,3,30,8,0,0,8,3,30,3,8,0,11,1,30,6,5,0,11,1,30,2,5,0,7,0,-27,3,0
2,4,27,0,30,1,4,0,5,0,30,0,0,0,0,3,30,5,0,0,5,0,30,2,3,0,5,2,30,4,0,0,4,1,-15,3,1
2,1,31,0,30,2,2,0,4,1,30,4,0,0,4,1,30,4,0,0,4,2,30,1,3,0,4,2,30,3,0,0,3,1,-15,3,1
2,4,11,1,30,2,2,0,4,0,30,0,0,0,0,0,30,1,3,0,4,2,30,2,2,0,4,0,30,1,0,0,1,1,-15,3,1
2,4,17,0,30,2,2,0,4,0,30,2,0,0,2,1,30,0,4,0,4,2,30,1,3,0,4,4,30,1,0,0,1,1,-15,3,1
2,1,5,1,30,4,8,0,12,2,30,8,2,0,10,0,30,6,6,0,12,0,30,8,4,0,12,1,30,2,4,0,6,0,-27,3,0
2,4,4,2,30,6,2,0,8,4,30,2,2,0,4,3,30,5,3,0,8,0,30,7,1,0,8,2,30,4,0,0,4,0,-27,3,0
2,3,9,0,30,5,6,0,11,1,30,6,0,0,6,1,30,10,1,0,11,2,30,4,7,0,11,2,30,3,1,0,4,0,-27,3,0
2,3,31,0,30,1,3,0,4,3,30,4,0,0,4,4,30,1,3,0,4,0,30,1,3,0,4,0,30,1,2,0,3,1,-15,3,1
2,4,4,2,30,5,3,0,8,4,30,4,0,0,4,3,30,3,5,0,8,0,30,1,7,0,8,0,30,4,0,0,4,0,-27,3,0
2,1,23,0,30,2,3,0,5,1,30,4,0,0,4,0,30,4,1,0,5,0,30,0,5,0,5,2,30,2,0,0,2,1,-15,3,1
2,4,23,0,30,5,0,0,5,3,30,4,0,0,4,11,30,3,2,0,5,0,30,0,5,0,5,2,30,2,0,0,2,1,-15,3,1
2,4,9,4,30,5,6,0,11,1,30,6,0,0,6,3,30,11,0,0,11,2,30,3,8,0,11,0,30,2,2,0,4,0,-27,3,0
2,3,23,1,30,2,11,0,13,0,30,6,0,0,6,5,30,13,0,0,13,1,30,6,7,0,13,3,30,6,0,0,6,1,-15,3,1
2,3,20,0,30,1,7,0,8,1,30,8,0,0,8,0,30,4,4,0,8,4,30,3,5,0,8,2,30,5,0,0,5,1,-15,3,1
2,4,9,0,30,2,2,0,4,0,30,2,0,0,2,0,30,1,3,0,4,0,30,1,3,0,4,3,30,1,0,0,1,0,-27,3,0
2,4,28,0,30,0,8,0,8,5,30,4,0,0,4,0,30,1,7,0,8,0,30,8,0,0,8,1,30,3,1,0,4,1,-15,3,1
2,3,7,0,30,2,2,0,4,1,30,2,0,0,2,0,30,3,1,0,4,0,30,0,4,0,4,2,30,2,0,0,2,0,-27,3,0
2,1,15,0,30,2,2,0,4,0,30,6,0,0,6,7,30,3,1,0,4,2,30,4,0,0,4,0,30,3,1,0,4,1,-15,3,1
2,4,23,0,30,4,1,0,5,1,30,4,0,0,4,1,30,5,0,0,5,0,30,0,5,0,5,1,30,2,0,0,2,1,-15,3,1
2,4,7,5,30,3,1,0,4,0,30,2,0,0,2,1,30,2,2,0,4,0,30,0,4,0,4,2,30,2,0,0,2,0,-27,3,0
2,3,16,0,30,7,2,0,9,1,30,5,3,0,8,1,30,3,6,0,9,0,30,1,8,0,9,0,30,4,0,0,4,1,-15,3,1
2,1,5,1,30,8,4,0,12,2,30,4,6,0,10,0,30,7,5,0,12,0,30,6,6,0,12,2,30,3,3,0,6,0,-27,3,0
2,2,5,0,30,3,9,0,12,2,30,8,2,0,10,0,30,3,9,0,12,0,30,7,5,0,12,2,30,6,0,0,6,0,-27,3,0
2,1,5,2,30,4,8,0,12,2,30,8,2,0,10,0,30,7,5,0,12,0,30,10,2,0,12,1,30,3,3,0,6,0,-27,3,0
2,3,31,3,30,2,2,0,4,3,30,4,0,0,4,0,30,2,2,0,4,0,30,1,3,0,4,0,30,2,1,0,3,1,-15,3,1
2,3,7,1,30,6,3,0,9,2,30,4,0,0,4,0,30,8,1,0,9,0,30,3,6,0,9,1,30,5,1,0,6,0,-27,3,0
2,4,14,0,30,4,5,0,9,2,30,5,1,0,6,3,30,4,5,0,9,0,30,8,1,0,9,4,30,4,0,0,4,1,-15,3,1
2,4,17,1,30,1,3,0,4,1,30,2,0,0,2,2,30,2,2,0,4,2,30,1,3,0,4,0,30,1,0,0,1,1,-15,3,1
2,2,31,1,30,3,9,0,12,4,30,8,0,0,8,4,30,11,1,0,12,0,30,5,7,0,12,1,30,4,2,0,6,1,-15,3,1
2,1,24,0,30,5,1,0,6,3,30,4,0,0,4,7,30,3,3,0,6,0,30,1,5,0,6,3,30,4,0,0,4,1,-15,3,1
2,1,9,1,30,3,8,0,11,0,30,6,0,0,6,3,30,11,0,0,11,6,30,3,8,0,11,4,30,4,0,0,4,0,-27,3,0
2,4,27,3,30,4,1,0,5,2,30,0,0,0,0,0,30,5,0,0,5,0,30,1,4,0,5,0,30,2,2,0,4,1,-15,3,1
2,4,23,0,30,2,3,0,5,1,30,3,1,0,4,3,30,4,1,0,5,0,30,0,5,0,5,0,30,2,0,0,2,1,-15,3,1
2,4,9,0,30,4,7,0,11,3,30,6,0,0,6,2,30,8,3,0,11,2,30,5,6,0,11,0,30,4,0,0,4,0,-27,3,0
2,4,25,2,30,0,4,0,4,2,30,2,0,0,2,0,30,4,0,0,4,0,30,0,4,0,4,1,30,1,0,0,1,1,-15,3,1
2,2,9,0,30,2,2,0,4,1,30,2,0,0,2,3,30,2,2,0,4,0,30,1,3,0,4,1,30,1,0,0,1,0,-27,3,0
2,4,9,0,30,0,4,0,4,1,30,2,0,0,2,0,30,2,2,0,4,0,30,2,2,0,4,1,30,1,0,0,1,0,-27,3,0
2,1,31,1,30,3,1,0,4,3,30,4,0,0,4,0,30,1,3,0,4,0,30,1,3,0,4,0,30,1,2,0,3,1,-15,3,1
2,4,29,0,30,0,5,0,5,3,30,8,0,0,8,2,30,2,3,0,5,0,30,1,4,0,5,0,30,4,0,0,4,1,-15,3,1
2,4,32,0,30,2,7,0,9,4,30,2,0,0,2,1,30,8,1,0,9,1,30,2,7,0,9,4,30,2,0,0,2,1,-15,3,1
2,4,27,4,30,2,3,0,5,1,30,0,0,0,0,0,30,4,1,0,5,0,30,2,3,0,5,4,30,4,0,0,4,1,-15,3,1
2,2,11,0,30,2,2,0,4,0,30,0,0,0,0,6,30,4,0,0,4,0,30,2,2,0,4,0,30,1,0,0,1,1,-15,3,1
2,2,23,0,30,2,3,0,5,2,30,4,0,0,4,5,30,4,1,0,5,0,30,0,5,0,5,3,30,2,0,0,2,1,-15,3,1
2,1,28,0,30,1,7,0,8,5,30,4,0,0,4,0,30,1,7,0,8,0,30,8,0,0,8,4,30,3,1,0,4,1,-15,3,1
2,3,23,0,30,2,3,0,5,1,30,4,0,0,4,2,30,5,0,0,5,3,30,1,4,0,5,6,30,2,0,0,2,1,-15,3,1
2,4,9,0,30,2,2,0,4,1,30,2,0,0,2,3,30,4,0,0,4,0,30,1,3,0,4,0,30,0,1,0,1,0,-27,3,0
2,4,7,0,30,4,5,0,9,3,30,4,0,0,4,1,30,6,3,0,9,0,30,7,2,0,9,3,30,5,1,0,6,0,-27,3,0
2,4,32,0,30,6,3,0,9,4,30,2,0,0,2,4,30,9,0,0,9,1,30,2,7,0,9,4,30,2,0,0,2,1,-15,3,1
2,4,15,0,30,2,2,0,4,0,30,5,1,0,6,0,30,2,2,0,4,3,30,4,0,0,4,2,30,4,0,0,4,1,-15,3,1
2,4,3,0,30,1,3,0,4,0,30,4,0,0,4,0,30,0,4,0,4,1,30,2,2,0,4,0,30,2,1,0,3,0,-27,3,0
2,1,24,0,30,6,0,0,6,3,30,3,1,0,4,6,30,4,2,0,6,0,30,1,5,0,6,1,30,4,0,0,4,1,-15,3,1
2,4,4,2,30,6,2,0,8,3,30,4,0,0,4,0,30,7,1,0,8,0,30,3,5,0,8,2,30,3,1,0,4,0,-27,3,0
2,4,3,1,30,4,7,0,11,2,30,8,0,0,8,0,30,4,7,0,11,3,30,5,6,0,11,0,30,3,4,0,7,0,-27,3,0
2,3,31,1,30,2,2,0,4,3,30,4,0,0,4,1,30,4,0,0,4,0,30,1,3,0,4,0,30,2,1,0,3,1,-15,3,1
2,2,31,2,30,0,4,0,4,2,30,4,0,0,4,3,30,2,2,0,4,0,30,1,3,0,4,0,30,1,2,0,3,1,-15,3,1
2,2,5,0,30,8,4,0,12,1,30,4,6,0,10,0,30,8,4,0,12,0,30,6,6,0,12,2,30,5,1,0,6,0,-27,3,0
2,3,24,2,30,6,0,0,6,2,30,4,0,0,4,0,30,5,1,0,6,1,30,1,5,0,6,1,30,4,0,0,4,1,-15,3,1
2,3,30,2,30,2,3,0,5,4,30,2,0,0,2,2,30,1,4,0,5,2,30,1,4,0,5,2,30,3,0,0,3,1,-15,3,1
2,3,9,0,30,2,2,0,4,1,30,2,0,0,2,2,30,2,2,0,4,0,30,1,3,0,4,3,30,1,0,0,1,0,-27,3,0
2,1,9,0,30,2,2,0,4,2,30,2,0,0,2,4,30,2,2,0,4,0,30,1,3,0,4,0,30,1,0,0,1,0,-27,3,0
2,0,20,0,30,1,7,0,8,0,30,7,1,0,8,1,30,8,0,0,8,0,30,1,7,0,8,2,30,3,2,0,5,1,-15,3,1
2,1,24,0,30,5,1,0,6,3,30,4,0,0,4,9,30,6,0,0,6,0,30,1,5,0,6,1,30,4,0,0,4,1,-15,3,1
2,4,31,1,30,2,2,0,4,4,30,4,0,0,4,3,30,2,2,0,4,0,30,1,3,0,4,0,30,3,0,0,3,1,-15,3,1
2,3,25,1,30,0,4,0,4,0,30,2,0,0,2,2,30,4,0,0,4,0,30,0,4,0,4,2,30,1,0,0,1,1,-15,3,1
2,3,31,1,30,2,2,0,4,4,30,4,0,0,4,0,30,1,3,0,4,0,30,1,3,0,4,0,30,1,2,0,3,1,-15,3,1
2,4,31,0,30,2,2,0,4,2,30,4,0,0,4,3,30,4,0,0,4,0,30,1,3,0,4,0,30,0,3,0,3,1,-15,3,1
2,3,30,6,30,3,2,0,5,4,30,2,0,0,2,1,30,2,3,0,5,3,30,1,4,0,5,0,30,3,0,0,3,1,-15,3,1
2,2,15,0,30,1,3,0,4,0,30,6,0,0,6,0,30,2,2,0,4,8,30,4,0,0,4,2,30,4,0,0,4,1,-15,3,1
2,4,7,0,30,3,6,0,9,2,30,4,0,0,4,0,30,6,3,0,9,4,30,3,6,0,9,3,30,6,0,0,6,0,-27,3,0
2,3,26,0,30,6,3,0,9,4,30,3,1,0,4,8,30,3,6,0,9,0,30,3,6,0,9,2,30,3,0,0,3,1,-15,3,1
2,4,30,2,30,2,3,0,5,4,30,2,0,0,2,1,30,2,3,0,5,2,30,1,4,0,5,0,30,3,0,0,3,1,-15,3,1
2,3,17,2,30,1,3,0,4,0,30,2,0,0,2,0,30,0,4,0,4,2,30,1,3,0,4,4,30,1,0,0,1,1,-15,3,1
2,2,9,0,30,1,3,0,4,2,30,2,0,0,2,4,30,2,2,0,4,0,30,1,3,0,4,1,30,1,0,0,1,0,-27,3,0
2,2,3,1,30,4,7,0,11,2,30,8,0,0,8,1,30,6,5,0,11,4,30,5,6,0,11,1,30,4,3,0,7,0,-27,3,0
2,4,31,0,30,0,4,0,4,3,30,4,0,0,4,1,30,4,0,0,4,2,30,3,1,0,4,1,30,3,0,0,3,1,-15,3,1
2,1,5,1,30,4,8,0,12,2,30,9,1,0,10,0,30,6,6,0,12,0,30,8,4,0,12,1,30,6,0,0,6,0,-27,3,0
2,1,28,0,30,3,5,0,8,4,30,4,0,0,4,4,30,5,3,0,8,0,30,2,6,0,8,3,30,4,0,0,4,1,-15,3,1
2,4,28,0,30,1,7,0,8,5,30,4,0,0,4,2,30,2,6,0,8,0,30,6,2,0,8,5,30,4,0,0,4,1,-15,3,1
2,4,24,3,30,6,0,0,6,2,30,4,0,0,4,4,30,1,5,0,6,0,30,1,5,0,6,6,30,4,0,0,4,1,-15,3,1
2,4,24,2,30,6,0,0,6,3,30,4,0,0,4,0,30,4,2,0,6,0,30,1,5,0,6,0,30,4,0,0,4,1,-15,3,1
2,1,5,1,30,6,6,0,12,3,30,9,1,0,10,1,30,3,9,0,12,0,30,7,5,0,12,1,30,1,5,0,6,0,-27,3,0
2,1,31,2,30,0,4,0,4,4,30,4,0,0,4,2,30,1,3,0,4,0,30,1,3,0,4,0,30,3,0,0,3,1,-15,3,1
2,2,9,0,30,2,2,0,4,0,30,2,0,0,2,2,30,4,0,0,4,5,30,2,2,0,4,2,30,1,0,0,1,0,-27,3,0
2,0,5,1,30,7,5,0,12,2,30,7,3,0,10,0,30,5,7,0,12,0,30,7,5,0,12,3,30,4,2,0,6,0,-27,3,0
2,3,4,0,30,6,2,0,8,4,30,4,0,0,4,1,30,3,5,0,8,0,30,4,4,0,8,5,30,4,0,0,4,0,-27,3,0
2,3,25,2,30,1,3,0,4,2,30,2,0,0,2,3,30,3,1,0,4,2,30,3,1,0,4,0,30,1,0,0,1,1,-15,3,1
2,2,15,0,30,2,2,0,4,0,30,5,1,0,6,0,30,2,2,0,4,6,30,4,0,0,4,0,30,1,3,0,4,1,-15,3,1
2,4,23,0,30,1,4,0,5,1,30,4,0,0,4,5,30,5,0,0,5,0,30,0,5,0,5,6,30,2,0,0,2,1,-15,3,1
2,4,25,6,30,1,3,0,4,3,30,2,0,0,2,0,30,1,3,0,4,0,30,0,4,0,4,0,30,1,0,0,1,1,-15,3,1
2,4,28,0,30,0,8,0,8,4,30,4,0,0,4,0,30,4,4,0,8,0,30,6,2,0,8,4,30,4,0,0,4,1,-15,3,1
2,4,31,0,30,2,2,0,4,2,30,4,0,0,4,3,30,2,2,0,4,0,30,1,3,0,4,0,30,2,1,0,3,1,-15,3,1
2,4,24,0,30,5,1,0,6,2,30,3,1,0,4,6,30,6,0,0,6,0,30,1,5,0,6,1,30,4,0,0,4,1,-15,3,1
2,3,27,0,30,2,3,0,5,0,30,0,0,0,0,0,30,5,0,0,5,0,30,2,3,0,5,4,30,4,0,0,4,1,-15,3,1
2,3,17,7,30,1,3,0,4,2,30,2,0,0,2,1,30,2,2,0,4,2,30,1,3,0,4,1,30,1,0,0,1,1,-15,3,1
2,3,16,0,30,6,3,0,9,1,30,8,0,0,8,1,30,4,5,0,9,0,30,1,8,0,9,2,30,4,0,0,4,1,-15,3,1
2,4,24,0,30,5,1,0,6,3,30,4,0,0,4,7,30,2,4,0,6,0,30,1,5,0,6,0,30,4,0,0,4,1,-15,3,1
2,0,31,0,30,1,3,0,4,3,30,4,0,0,4,4,30,1,3,0,4,0,30,1,3,0,4,0,30,0,3,0,3,1,-15,3,1
2,3,7,0,30,2,2,0,4,2,30,2,0,0,2,4,30,2,2,0,4,0,30,0,4,0,4,1,30,2,0,0,2,0,-27,3,0
2,1,16,0,30,7,2,0,9,2,30,6,2,0,8,3,30,2,7,0,9,0,30,1,8,0,9,1,30,4,0,0,4,1,-15,3,1
2,2,24,0,30,2,4,0,6,2,30,4,0,0,4,4,30,6,0,0,6,0,30,1,5,0,6,3,30,4,0,0,4,1,-15,3,1
2,4,5,0,30,2,3,0,5,0,30,0,4,0,4,0,30,0,5,0,5,2,30,2,3,0,5,0,30,2,0,0,2,0,-27,3,0
2,1,31,1,30,2,2,0,4,3,30,4,0,0,4,4,30,4,0,0,4,0,30,1,3,0,4,0,30,0,3,0,3,1,-15,3,1
2,1,5,1,30,5,7,0,12,3,30,9,1,0,10,0,30,3,9,0,12,1,30,7,5,0,12,1,30,4,2,0,6,0,-27,3,0
2,3,17,1,30,2,2,0,4,1,30,2,0,0,2,1,30,0,4,0,4,3,30,1,3,0,4,0,30,1,0,0,1,1,-15,3,1
2,4,7,1,30,4,5,0,9,1,30,4,0,0,4,2,30,6,3,0,9,2,30,3,6,0,9,2,30,5,1,0,6,0,-27,3,0
2,4,30,2,30,3,2,0,5,4,30,2,0,0,2,7,30,2,3,0,5,3,30,1,4,0,5,1,30,3,0,0,3,1,-15,3,1
2,4,24,0,30,3,3,0,6,3,30,4,0,0,4,7,30,6,0,0,6,0,30,1,5,0,6,0,30,3,1,0,4,1,-15,3,1
2,4,3,1,30,4,7,0,11,1,30,8,0,0,8,0,30,7,4,0,11,1,30,1,10,0,11,1,30,7,0,0,7,0,-27,3,0
2,3,28,0,30,3,5,0,8,4,30,4,0,0,4,0,30,1,7,0,8,0,30,2,6,0,8,1,30,3,1,0,4,1,-15,3,1
2,4,24,0,30,4,2,0,6,2,30,4,0,0,4,0,30,3,3,0,6,0,30,2,4,0,6,2,30,4,0,0,4,1,-15,3,1
2,4,5,1,30,4,8,0,12,3,30,7,3,0,10,0,30,3,9,0,12,0,30,7,5,0,12,2,30,6,0,0,6,0,-27,3,0
2,2,23,5,30,5,0,0,5,3,30,4,0,0,4,2,30,5,0,0,5,0,30,0,5,0,5,0,30,2,0,0,2,1,-15,3,1
2,3,31,0,30,1,3,0,4,3,30,4,0,0,4,0,30,2,2,0,4,0,30,1,3,0,4,0,30,2,1,0,3,1,-15,3,1
2,4,9,0,30,3,1,0,4,1,30,2,0,0,2,6,30,4,0,0,4,0,30,1,3,0,4,1,30,1,0,0,1,0,-27,3,0
2,3,24,0,30,3,3,0,6,2,30,4,0,0,4,6,30,6,0,0,6,0,30,1,5,0,6,6,30,4,0,0,4,1,-15,3,1
2,2,5,0,30,2,3,0,5,2,30,1,3,0,4,0,30,4,1,0,5,0,30,1,4,0,5,0,30,1,1,0,2,0,-27,3,0
2,3,5,2,30,6,6,0,12,3,30,9,1,0,10,0,30,6,6,0,12,0,30,8,4,0,12,1,30,5,1,0,6,0,-27,3,0
2,4,13,2,30,3,0,0,3,0,30,2,0,0,2,0,30,2,1,0,3,0,30,2,1,0,3,2,30,2,0,0,2,1,-15,3,1
2,2,5,0,30,2,3,0,5,0,30,3,1,0,4,0,30,0,5,0,5,0,30,1,4,0,5,0,30,2,0,0,2,0,-27,3,0
2,2,31,1,30,1,3,0,4,4,30,4,0,0,4,0,30,1,3,0,4,2,30,3,1,0,4,2,30,3,0,0,3,1,-15,3,1
2,4,5,1,30,7,5,0,12,2,30,6,4,0,10,0,30,7,5,0,12,1,30,7,5,0,12,1,30,2,4,0,6,0,-27,3,0
2,4,17,1,30,1,3,0,4,0,30,2,0,0,2,2,30,1,3,0,4,2,30,1,3,0,4,0,30,1,0,0,1,1,-15,3,1
2,4,9,0,30,3,1,0,4,2,30,2,0,0,2,5,30,2,2,0,4,0,30,0,4,0,4,0,30,1,0,0,1,0,-27,3,0
2,4,31,0,30,0,4,0,4,3,30,4,0,0,4,2,30,4,0,0,4,0,30,4,0,0,4,2,30,3,0,0,3,1,-15,3,1
2,2,9,1,30,5,6,0,11,1,30,6,0,0,6,4,30,11,0,0,11,1,30,3,8,0,11,2,30,3,1,0,4,0,-27,3,0
2,4,17,1,30,1,3,0,4,0,30,2,0,0,2,0,30,1,3,0,4,2,30,0,4,0,4,3,30,1,0,0,1,1,-15,3,1
2,3,31,0,30,0,4,0,4,3,30,4,0,0,4,2,30,3,1,0,4,0,30,1,3,0,4,0,30,1,2,0,3,1,-15,3,1
2,4,9,0,30,7,4,0,11,1,30,6,0,0,6,2,30,11,0,0,11,2,30,3,8,0,11,1,30,3,1,0,4,0,-27,3,0
2,2,24,0,30,5,1,0,6,2,30,4,0,0,4,4,30,3,3,0,6,0,30,0,6,0,6,3,30,4,0,0,4,1,-15,3,1
2,1,24,0,30,6,0,0,6,2,30,3,1,0,4,6,30,3,3,0,6,0,30,3,3,0,6,0,30,3,1,0,4,1,-15,3,1
2,4,23,0,30,1,4,0,5,1,30,4,0,0,4,1,30,3,2,0,5,0,30,0,5,0,5,0,30,1,1,0,2,1,-15,3,1
2,4,13,4,30,7,0,0,7,0,30,4,0,0,4,6,30,7,0,0,7,1,30,3,4,0,7,3,30,4,0,0,4,1,-15,3,1
2,1,31,0,30,0,4,0,4,2,30,4,0,0,4,9,30,4,0,0,4,0,30,1,3,0,4,0,30,3,0,0,3,1,-15,3,1
2,4,5,0,30,7,5,0,12,2,30,8,2,0,10,0,30,7,5,0,12,0,30,8,4,0,12,2,30,2,4,0,6,0,-27,3,0
2,4,7,0,30,2,2,0,4,1,30,2,0,0,2,0,30,4,0,0,4,0,30,1,3,0,4,1,30,1,1,0,2,0,-27,3,0
2,2,5,0,30,3,2,0,5,0,30,4,0,0,4,0,30,0,5,0,5,0,30,1,4,0,5,0,30,0,2,0,2,0,-27,3,0
2,3,15,0,30,2,2,0,4,0,30,5,1,0,6,5,30,3,1,0,4,1,30,2,2,0,4,0,30,2,2,0,4,1,-15,3,1
2,4,7,1,30,4,5,0,9,1,30,3,1,0,4,0,30,7,2,0,9,4,30,3,6,0,9,1,30,5,1,0,6,0,-27,3,0
2,4,9,1,30,7,4,0,11,1,30,6,0,0,6,3,30,11,0,0,11,0,30,3,8,0,11,0,30,2,2,0,4,0,-27,3,0
2,2,25,1,30,2,2,0,4,0,30,2,0,0,2,6,30,4,0,0,4,0,30,0,4,0,4,0,30,1,0,0,1,1,-15,3,1
2,4,25,2,30,3,1,0,4,2,30,2,0,0,2,0,30,1,3,0,4,0,30,0,4,0,4,0,30,1,0,0,1,1,-15,3,1
2,2,15,0,30,2,2,0,4,0,30,6,0,0,6,0,30,2,2,0,4,5,30,4,0,0,4,1,30,4,0,0,4,1,-15,3,1
2,2,31,1,30,1,3,0,4,2,30,4,0,0,4,2,30,3,1,0,4,0,30,1,3,0,4,0,30,0,3,0,3,1,-15,3,1
2,1,20,0,30,0,8,0,8,1,30,7,1,0,8,0,30,6,2,0,8,0,30,4,4,0,8,1,30,4,1,0,5,1,-15,3,1
2,4,30,2,30,3,2,0,5,3,30,2,0,0,2,1,30,2,3,0,5,3,30,1,4,0,5,1,30,3,0,0,3,1,-15,3,1
2,2,23,0,30,2,3,0,5,1,30,4,0,0,4,1,30,5,0,0,5,0,30,0,5,0,5,5,30,2,0,0,2,1,-15,3,1
2,3,3,2,30,5,6,0,11,2,30,7,1,0,8,0,30,4,7,0,11,1,30,5,6,0,11,4,30,2,5,0,7,0,-27,3,0
2,4,31,0,30,1,3,0,4,1,30,4,0,0,4,1,30,4,0,0,4,0,30,1,3,0,4,1,30,3,0,0,3,1,-15,3,1
2,3,31,6,30,1,3,0,4,3,30,4,0,0,4,0,30,1,3,0,4,0,30,1,3,0,4,0,30,3,0,0,3,1,-15,3,1
2,3,3,1,30,5,6,0,11,2,30,8,0,0,8,0,30,5,6,0,11,4,30,4,7,0,11,0,30,2,5,0,7,0,-27,3,0
2,3,14,0,30,3,6,0,9,1,30,6,0,0,6,3,30,5,4,0,9,0,30,8,1,0,9,4,30,4,0,0,4,1,-15,3,1
2,1,14,0,30,2,7,0,9,1,30,6,0,0,6,3,30,3,6,0,9,0,30,6,3,0,9,4,30,4,0,0,4,1,-15,3,1
2,4,9,0,30,2,2,0,4,0,30,2,0,0,2,4,30,3,1,0,4,0,30,1,3,0,4,1,30,1,0,0,1,0,-27,3,0
2,4,17,1,30,1,3,0,4,1,30,2,0,0,2,1,30,0,4,0,4,3,30,1,3,0,4,3,30,1,0,0,1,1,-15,3,1
2,1,5,5,30,7,5,0,12,3,30,5,5,0,10,0,30,6,6,0,12,0,30,7,5,0,12,1,30,3,3,0,6,0,-27,3,0
2,1,15,2,30,3,1,0,4,0,30,6,0,0,6,0,30,2,2,0,4,1,30,2,2,0,4,0,30,4,0,0,4,1,-15,3,1
2,4,28,0,30,1,7,0,8,4,30,4,0,0,4,0,30,4,4,0,8,0,30,3,5,0,8,4,30,4,0,0,4,1,-15,3,1
2,2,5,1,30,6,6,0,12,3,30,8,2,0,10,0,30,3,9,0,12,0,30,7,5,0,12,1,30,5,1,0,6,0,-27,3,0
2,3,24,0,30,5,1,0,6,0,30,3,1,0,4,10,30,4,2,0,6,0,30,1,5,0,6,0,30,4,0,0,4,1,-15,3,1
2,2,25,1,30,0,4,0,4,1,30,2,0,0,2,0,30,4,0,0,4,0,30,2,2,0,4,2,30,1,0,0,1,1,-15,3,1
2,3,9,1,30,7,4,0,11,2,30,6,0,0,6,1,30,7,4,0,11,1,30,3,8,0,11,2,30,4,0,0,4,0,-27,3,0
2,3,3,0,30,3,8,0,11,2,30,8,0,0,8,0,30,6,5,0,11,1,30,8,3,0,11,1,30,2,5,0,7,0,-27,3,0
2,4,13,4,30,7,0,0,7,0,30,4,0,0,4,2,30,5,2,0,7,0,30,4,3,0,7,4,30,4,0,0,4,1,-15,3,1
2,2,16,1,30,7,2,0,9,2,30,8,0,0,8,2,30,2,7,0,9,0,30,0,9,0,9,0,30,4,0,0,4,1,-15,3,1
2,4,7,0,30,4,0,0,4,0,30,2,0,0,2,0,30,1,3,0,4,0,30,1,3,0,4,1,30,1,1,0,2,0,-27,3,0
2,2,24,0,30,6,0,0,6,1,30,4,0,0,4,3,30,2,4,0,6,0,30,1,5,0,6,2,30,4,0,0,4,1,-15,3,1
2,4,24,0,30,3,3,0,6,2,30,3,1,0,4,2,30,5,1,0,6,0,30,2,4,0,6,3,30,4,0,0,4,1,-15,3,1
2,2,31,0,30,0,4,0,4,3,30,4,0,0,4,2,30,3,1,0,4,0,30,1,3,0,4,2,30,3,0,0,3,1,-15,3,1
2,2,20,0,30,2,6,0,8,0,30,7,1,0,8,0,30,6,2,0,8,0,30,3,5,0,8,1,30,1,4,0,5,1,-15,3,1
2,4,3,2,30,5,6,0,11,2,30,8,0,0,8,2,30,4,7,0,11,3,30,4,7,0,11,1,30,2,5,0,7,0,-27,3,0
2,4,3,0,30,5,6,0,11,2,30,8,0,0,8,0,30,5,6,0,11,0,30,4,7,0,11,1,30,3,4,0,7,0,-27,3,0
2,4,24,2,30,6,0,0,6,3,30,4,0,0,4,3,30,5,1,0,6,0,30,1,5,0,6,2,30,4,0,0,4,1,-15,3,1
2,1,3,1,30,4,7,0,11,4,30,7,1,0,8,4,30,2,9,0,11,4,30,7,4,0,11,3,30,3,4,0,7,0,-27,3,0
2,1,23,0,30,3,2,0,5,2,30,4,0,0,4,7,30,4,1,0,5,0,30,0,5,0,5,2,30,2,0,0,2,1,-15,3,1
2,4,20,0,30,0,8,0,8,1,30,7,1,0,8,1,30,6,2,0,8,0,30,2,6,0,8,0,30,4,1,0,5,1,-15,3,1
2,2,31,1,30,4,8,0,12,2,30,8,0,0,8,6,30,12,0,0,12,0,30,3,9,0,12,1,30,4,2,0,6,1,-15,3,1
2,1,25,2,30,1,3,0,4,2,30,2,0,0,2,4,30,4,0,0,4,0,30,1,3,0,4,0,30,1,0,0,1,1,-15,3,1
2,2,9,0,30,7,4,0,11,2,30,6,0,0,6,6,30,8,3,0,11,1,30,3,8,0,11,3,30,2,2,0,4,0,-27,3,0
2,0,31,0,30,0,4,0,4,1,30,4,0,0,4,4,30,4,0,0,4,3,30,3,1,0,4,4,30,3,0,0,3,1,-15,3,1
2,3,9,4,30,3,1,0,4,3,30,2,0,0,2,7,30,1,3,0,4,0,30,1,3,0,4,0,30,1,0,0,1,0,-27,3,0
2,3,4,2,30,8,0,0,8,4,30,2,2,0,4,9,30,3,5,0,8,0,30,2,6,0,8,1,30,3,1,0,4,0,-27,3,0
2,4,28,0,30,2,6,0,8,5,30,4,0,0,4,0,30,1,7,0,8,0,30,5,3,0,8,1,30,4,0,0,4,1,-15,3,1
2,2,31,0,30,0,4,0,4,3,30,4,0,0,4,2,30,3,1,0,4,2,30,4,0,0,4,0,30,0,3,0,3,1,-15,3,1
2,3,31,0,30,1,3,0,4,2,30,4,0,0,4,3,30,2,2,0,4,0,30,1,3,0,4,0,30,3,0,0,3,1,-15,3,1
2,4,31,0,30,0,4,0,4,1,30,4,0,0,4,1,30,4,0,0,4,0,30,1,3,0,4,0,30,1,2,0,3,1,-15,3,1
2,4,16,1,30,6,3,0,9,2,30,8,0,0,8,2,30,2,7,0,9,0,30,0,9,0,9,0,30,3,1,0,4,1,-15,3,1
2,2,23,0,30,2,3,0,5,2,30,4,0,0,4,6,30,5,0,0,5,0,30,0,5,0,5,2,30,2,0,0,2,1,-15,3,1
2,3,31,0,30,2,2,0,4,3,30,4,0,0,4,6,30,4,0,0,4,0,30,1,3,0,4,0,30,3,0,0,3,1,-15,3,1
2,3,5,0,30,2,3,0,5,2,30,3,1,0,4,0,30,3,2,0,5,0,30,1,4,0,5,0,30,0,2,0,2,0,-27,3,0
2,4,35,1,30,2,2,0,4,0,30,0,0,0,0,5,30,4,0,0,4,0,30,1,3,0,4,3,30,3,0,0,3,1,-15,3,1
2,3,25,1,30,0,4,0,4,2,30,2,0,0,2,3,30,4,0,0,4,0,30,0,4,0,4,1,30,1,0,0,1,1,-15,3,1
2,1,4,0,30,6,2,0,8,3,30,3,1,0,4,5,30,4,4,0,8,0,30,4,4,0,8,2,30,4,0,0,4,0,-27,3,0
2,1,37,3,30,5,6,0,11,4,30,2,6,0,8,6,30,11,0,0,11,2,30,6,5,0,11,5,30,5,1,0,6,1,-15,3,1
2,1,31,0,30,2,2,0,4,3,30,4,0,0,4,2,30,3,1,0,4,0,30,3,1,0,4,2,30,3,0,0,3,1,-15,3,1
2,2,24,0,30,6,0,0,6,1,30,4,0,0,4,0,30,5,1,0,6,0,30,1,5,0,6,3,30,4,0,0,4,1,-15,3,1
2,4,24,0,30,1,5,0,6,2,30,4,0,0,4,4,30,6,0,0,6,0,30,2,4,0,6,2,30,4,0,0,4,1,-15,3,1
2,2,5,1,30,6,6,0,12,2,30,8,2,0,10,0,30,4,8,0,12,0,30,7,5,0,12,1,30,2,4,0,6,0,-27,3,0
2,4,16,0,30,7,2,0,9,1,30,8,0,0,8,0,30,3,6,0,9,0,30,1,8,0,9,0,30,4,0,0,4,1,-15,3,1
2,4,8,0,30,7,0,0,7,2,30,2,0,0,2,4,30,7,0,0,7,0,30,7,0,0,7,1,30,3,0,0,3,0,-27,3,0
2,1,16,0,30,6,3,0,9,1,30,7,1,0,8,0,30,3,6,0,9,0,30,1,8,0,9,1,30,4,0,0,4,1,-15,3,1
2,0,5,2,30,7,5,0,12,3,30,3,7,0,10,2,30,5,7,0,12,0,30,7,5,0,12,1,30,3,3,0,6,0,-27,3,0
2,3,5,1,30,5,7,0,12,2,30,3,7,0,10,0,30,3,9,0,12,0,30,7,5,0,12,1,30,4,2,0,6,0,-27,3,0
2,4,9,0,30,2,2,0,4,1,30,2,0,0,2,5,30,4,0,0,4,0,30,1,3,0,4,3,30,1,0,0,1,0,-27,3,0
2,3,3,0,30,5,6,0,11,0,30,8,0,0,8,0,30,2,9,0,11,4,30,1,10,0,11,1,30,2,5,0,7,0,-27,3,0
2,0,20,0,30,1,7,0,8,1,30,8,0,0,8,0,30,4,4,0,8,0,30,5,3,0,8,1,30,3,2,0,5,1,-15,3,1
2,3,5,1,30,5,7,0,12,3,30,7,3,0,10,0,30,4,8,0,12,4,30,6,6,0,12,1,30,1,5,0,6,0,-27,3,0
2,2,5,1,30,4,8,0,12,2,30,7,3,0,10,0,30,7,5,0,12,0,30,8,4,0,12,4,30,4,2,0,6,0,-27,3,0
2,2,31,0,30,0,4,0,4,3,30,4,0,0,4,3,30,2,2,0,4,0,30,3,1,0,4,1,30,3,0,0,3,1,-15,3,1
2,4,9,0,30,6,5,0,11,1,30,6,0,0,6,6,30,11,0,0,11,2,30,3,8,0,11,0,30,1,3,0,4,0,-27,3,0
2,4,8,1,30,7,0,0,7,3,30,2,0,0,2,6,30,4,3,0,7,0,30,1,6,0,7,1,30,3,0,0,3,0,-27,3,0
2,2,9,0,30,1,3,0,4,2,30,2,0,0,2,3,30,1,3,0,4,0,30,1,3,0,4,0,30,1,0,0,1,0,-27,3,0
2,4,23,1,30,6,7,0,13,0,30,6,0,0,6,5,30,13,0,0,13,0,30,5,8,0,13,1,30,6,0,0,6,1,-15,3,1
2,3,9,1,30,7,4,0,11,1,30,5,1,0,6,5,30,10,1,0,11,1,30,2,9,0,11,2,30,2,2,0,4,0,-27,3,0
2,4,5,1,30,7,5,0,12,3,30,9,1,0,10,1,30,5,7,0,12,0,30,7,5,0,12,1,30,2,4,0,6,0,-27,3,0
2,4,24,0,30,2,4,0,6,0,30,3,1,0,4,6,30,6,0,0,6,0,30,3,3,0,6,4,30,4,0,0,4,1,-15,3,1
2,4,16,0,30,5,4,0,9,1,30,7,1,0,8,2,30,4,5,0,9,0,30,1,8,0,9,0,30,4,0,0,4,1,-15,3,1
2,1,9,0,30,1,3,0,4,2,30,2,0,0,2,2,30,2,2,0,4,0,30,1,3,0,4,0,30,1,0,0,1,0,-27,3,0
2,1,25,1,30,2,2,0,4,2,30,2,0,0,2,3,30,4,0,0,4,0,30,0,4,0,4,0,30,1,0,0,1,1,-15,3,1
2,3,30,2,30,3,2,0,5,2,30,2,0,0,2,1,30,2,3,0,5,0,30,1,4,0,5,1,30,2,1,0,3,1,-15,3,1
2,1,23,0,30,2,3,0,5,2,30,4,0,0,4,7,30,5,0,0,5,0,30,0,5,0,5,3,30,2,0,0,2,1,-15,3,1
2,3,24,3,30,4,2,0,6,3,30,4,0,0,4,2,30,3,3,0,6,0,30,2,4,0,6,0,30,4,0,0,4,1,-15,3,1
2,3,23,0,30,2,3,0,5,1,30,4,0,0,4,1,30,5,0,0,5,0,30,0,5,0,5,1,30,1,1,0,2,1,-15,3,1
2,3,5,1,30,7,5,0,12,2,30,6,4,0,10,0,30,6,6,0,12,0,30,7,5,0,12,3,30,4,2,0,6,0,-27,3,0
2,4,27,0,30,1,4,0,5,0,30,0,0,0,0,0,30,3,2,0,5,0,30,4,1,0,5,0,30,4,0,0,4,1,-15,3,1
2,4,23,0,30,3,2,0,5,0,30,4,0,0,4,0,30,5,0,0,5,0,30,0,5,0,5,1,30,2,0,0,2,1,-15,3,1
2,4,5,1,30,5,7,0,12,2,30,7,3,0,10,0,30,8,4,0,12,0,30,8,4,0,12,1,30,3,3,0,6,0,-27,3,0
2,2,17,1,30,1,3,0,4,0,30,2,0,0,2,3,30,1,3,0,4,2,30,0,4,0,4,3,30,1,0,0,1,1,-15,3,1
2,4,20,0,30,1,7,0,8,0,30,7,1,0,8,0,30,6,2,0,8,0,30,5,3,0,8,0,30,4,1,0,5,1,-15,3,1
2,4,16,3,30,7,2,0,9,1,30,8,0,0,8,1,30,5,4,0,9,0,30,1,8,0,9,0,30,2,2,0,4,1,-15,3,1
2,3,7,0,30,2,7,0,9,1,30,3,1,0,4,0,30,8,1,0,9,5,30,2,7,0,9,3,30,5,1,0,6,0,-27,3,0
2,4,23,0,30,2,3,0,5,2,30,4,0,0,4,4,30,4,1,0,5,0,30,0,5,0,5,4,30,2,0,0,2,1,-15,3,1
2,2,24,0,30,3,3,0,6,0,30,4,0,0,4,2,30,6,0,0,6,0,30,1,5,0,6,0,30,4,0,0,4,1,-15,3,1
2,4,31,0,30,2,2,0,4,2,30,4,0,0,4,5,30,4,0,0,4,0,30,1,3,0,4,0,30,1,2,0,3,1,-15,3,1
2,4,3,0,30,1,3,0,4,2,30,4,0,0,4,1,30,2,2,0,4,1,30,2,2,0,4,1,30,3,0,0,3,0,-27,3,0
2,4,24,0,30,4,2,0,6,2,30,4,0,0,4,9,30,6,0,0,6,0,30,1,5,0,6,0,30,4,0,0,4,1,-15,3,1
2,4,28,0,30,0,8,0,8,4,30,4,0,0,4,2,30,3,5,0,8,0,30,3,5,0,8,3,30,4,0,0,4,1,-15,3,1
2,3,25,1,30,2,2,0,4,0,30,2,0,0,2,5,30,4,0,0,4,0,30,0,4,0,4,0,30,1,0,0,1,1,-15,3,1
2,4,9,1,30,6,5,0,11,1,30,5,1,0,6,2,30,11,0,0,11,1,30,3,8,0,11,2,30,3,1,0,4,0,-27,3,0
2,4,30,2,30,4,1,0,5,3,30,2,0,0,2,3,30,2,3,0,5,2,30,2,3,0,5,1,30,3,0,0,3,1,-15,3,1
2,1,5,1,30,5,7,0,12,2,30,7,3,0,10,0,30,5,7,0,12,0,30,7,5,0,12,1,30,5,1,0,6,0,-27,3,0
2,1,25,2,30,3,1,0,4,0,30,2,0,0,2,4,30,4,0,0,4,0,30,0,4,0,4,0,30,1,0,0,1,1,-15,3,1
2,3,31,0,30,0,4,0,4,4,30,4,0,0,4,0,30,3,1,0,4,3,30,4,0,0,4,0,30,3,0,0,3,1,-15,3,1
2,3,17,1,30,2,2,0,4,0,30,2,0,0,2,0,30,0,4,0,4,2,30,1,3,0,4,3,30,1,0,0,1,1,-15,3,1
2,4,17,5,30,3,1,0,4,2,30,2,0,0,2,1,30,1,3,0,4,2,30,1,3,0,4,0,30,1,0,0,1,1,-15,3,1
2,2,29,0,30,2,3,0,5,3,30,8,0,0,8,0,30,3,2,0,5,0,30,1,4,0,5,0,30,4,0,0,4,1,-15,3,1
2,4,30,0,30,3,2,0,5,3,30,2,0,0,2,4,30,1,4,0,5,2,30,2,3,0,5,0,30,2,1,0,3,1,-15,3,1
2,4,15,1,30,3,1,0,4,0,30,6,0,0,6,0,30,2,2,0,4,1,30,1,3,0,4,0,30,2,2,0,4,1,-15,3,1
2,4,23,0,30,2,3,0,5,2,30,4,0,0,4,5,30,5,0,0,5,0,30,0,5,0,5,2,30,2,0,0,2,1,-15,3,1
2,4,14,0,30,3,6,0,9,0,30,6,0,0,6,0,30,7,2,0,9,0,30,5,4,0,9,3,30,4,0,0,4,1,-15,3,1
2,4,9,0,30,2,2,0,4,1,30,2,0,0,2,4,30,4,0,0,4,0,30,1,3,0,4,1,30,1,0,0,1,0,-27,3,0
2,4,7,1,30,4,5,0,9,1,30,4,0,0,4,3,30,6,3,0,9,5,30,2,7,0,9,1,30,4,2,0,6,0,-27,3,0
2,3,3,0,30,4,7,0,11,2,30,8,0,0,8,0,30,1,10,0,11,5,30,3,8,0,11,3,30,7,0,0,7,0,-27,3,0
2,4,9,0,30,2,2,0,4,2,30,2,0,0,2,3,30,2,2,0,4,1,30,1,3,0,4,0,30,1,0,0,1,0,-27,3,0
2,4,3,0,30,4,7,0,11,2,30,8,0,0,8,1,30,4,7,0,11,0,30,4,7,0,11,1,30,3,4,0,7,0,-27,3,0
2,2,31,0,30,0,4,0,4,2,30,4,0,0,4,2,30,3,1,0,4,2,30,2,2,0,4,1,30,3,0,0,3,1,-15,3,1
2,4,24,0,30,4,2,0,6,0,30,3,1,0,4,4,30,6,0,0,6,0,30,1,5,0,6,3,30,4,0,0,4,1,-15,3,1
2,4,24,0,30,6,0,0,6,0,30,4,0,0,4,4,30,6,0,0,6,0,30,1,5,0,6,4,30,4,0,0,4,1,-15,3,1
2,0,5,1,30,4,8,0,12,2,30,8,2,0,10,3,30,8,4,0,12,0,30,8,4,0,12,2,30,3,3,0,6,0,-27,3,0
2,4,2,0,30,6,4,0,10,3,30,4,0,0,4,5,30,4,6,0,10,0,30,6,4,0,10,0,30,7,1,0,8,0,-27,3,0
2,3,27,0,30,1,4,0,5,0,30,0,0,0,0,2,30,5,0,0,5,0,30,2,3,0,5,1,30,4,0,0,4,1,-15,3,1
2,1,17,1,30,2,2,0,4,0,30,2,0,0,2,1,30,0,4,0,4,2,30,1,3,0,4,4,30,1,0,0,1,1,-15,3,1
2,4,16,0,30,7,2,0,9,1,30,7,1,0,8,2,30,2,7,0,9,0,30,1,8,0,9,0,30,2,2,0,4,1,-15,3,1
2,4,16,0,30,5,4,0,9,2,30,8,0,0,8,0,30,1,8,0,9,0,30,1,8,0,9,0,30,2,2,0,4,1,-15,3,1
2,1,20,0,30,1,7,0,8,1,30,7,1,0,8,1,30,8,0,0,8,0,30,1,7,0,8,1,30,4,1,0,5,1,-15,3,1
2,3,2,0,30,6,4,0,10,0,30,4,0,0,4,5,30,9,1,0,10,0,30,5,5,0,10,1,30,2,6,0,8,0,-27,3,0
2,2,4,2,30,7,1,0,8,3,30,4,0,0,4,1,30,4,4,0,8,0,30,5,3,0,8,3,30,4,0,0,4,0,-27,3,0
2,3,5,0,30,2,3,0,5,0,30,0,4,0,4,0,30,0,5,0,5,0,30,1,4,0,5,0,30,1,1,0,2,0,-27,3,0
2,4,24,0,30,6,0,0,6,2,30,4,0,0,4,1,30,6,0,0,6,2,30,1,5,0,6,0,30,4,0,0,4,1,-15,3,1
2,4,9,1,30,6,5,0,11,1,30,6,0,0,6,4,30,11,0,0,11,0,30,3,8,0,11,3,30,2,2,0,4,0,-27,3,0
2,4,10,0,30,3,6,0,9,0,30,4,0,0,4,0,30,5,4,0,9,0,30,5,4,0,9,2,30,4,1,0,5,1,-15,3,1
2,4,28,0,30,1,7,0,8,5,30,4,0,0,4,0,30,1,7,0,8,1,30,6,2,0,8,1,30,3,1,0,4,1,-15,3,1
2,1,31,0,30,0,4,0,4,3,30,4,0,0,4,0,30,1,3,0,4,2,30,3,1,0,4,3,30,3,0,0,3,1,-15,3,1
2,4,17,1,30,1,3,0,4,1,30,2,0,0,2,0,30,0,4,0,4,2,30,1,3,0,4,2,30,1,0,0,1,1,-15,3,1
2,4,23,0,30,3,2,0,5,1,30,4,0,0,4,6,30,4,1,0,5,0,30,0,5,0,5,0,30,2,0,0,2,1,-15,3,1
2,4,17,1,30,1,3,0,4,1,30,2,0,0,2,2,30,0,4,0,4,2,30,0,4,0,4,3,30,1,0,0,1,1,-15,3,1
2,2,30,2,30,3,2,0,5,4,30,2,0,0,2,1,30,2,3,0,5,3,30,1,4,0,5,0,30,2,1,0,3,1,-15,3,1
2,3,9,0,30,2,2,0,4,1,30,2,0,0,2,1,30,4,0,0,4,0,30,1,3,0,4,0,30,1,0,0,1,0,-27,3,0
2,3,20,1,30,4,4,0,8,0,30,6,2,0,8,0,30,8,0,0,8,0,30,6,2,0,8,2,30,3,2,0,5,1,-15,3,1
2,4,9,0,30,1,3,0,4,1,30,2,0,0,2,5,30,3,1,0,4,0,30,1,3,0,4,2,30,1,0,0,1,0,-27,3,0
2,2,13,3,30,7,0,0,7,1,30,4,0,0,4,1,30,5,2,0,7,0,30,6,1,0,7,5,30,4,0,0,4,1,-15,3,1
2,4,31,0,30,0,4,0,4,2,30,4,0,0,4,3,30,4,0,0,4,0,30,1,3,0,4,0,30,2,1,0,3,1,-15,3,1
2,0,5,1,30,4,8,0,12,3,30,8,2,0,10,1,30,3,9,0,12,0,30,8,4,0,12,1,30,6,0,0,6,0,-27,3,0
2,3,31,0,30,0,4,0,4,3,30,4,0,0,4,2,30,4,0,0,4,0,30,1,3,0,4,0,30,3,0,0,3,1,-15,3,1
2,3,23,2,30,5,0,0,5,2,30,4,0,0,4,3,30,4,1,0,5,0,30,0,5,0,5,2,30,2,0,0,2,1,-15,3,1
2,4,31,2,30,1,3,0,4,3,30,4,0,0,4,0,30,2,2,0,4,0,30,1,3,0,4,0,30,0,3,0,3,1,-15,3,1
2,3,32,0,30,5,4,0,9,3,30,2,0,0,2,1,30,8,1,0,9,1,30,3,6,0,9,4,30,2,0,0,2,1,-15,3,1
2,1,31,0,30,1,3,0,4,3,30,4,0,0,4,5,30,4,0,0,4,0,30,1,3,0,4,0,30,1,2,0,3,1,-15,3,1
2,4,3,1,30,4,7,0,11,2,30,8,0,0,8,0,30,7,4,0,11,5,30,4,7,0,11,1,30,4,3,0,7,0,-27,3,0
2,4,30,8,30,2,3,0,5,5,30,2,0,0,2,1,30,2,3,0,5,3,30,1,4,0,5,0,30,2,1,0,3,1,-15,3,1
2,4,28,0,30,4,4,0,8,4,30,4,0,0,4,0,30,4,4,0,8,0,30,6,2,0,8,2,30,3,1,0,4,1,-15,3,1
2,4,9,2,30,2,2,0,4,2,30,2,0,0,2,3,30,4,0,0,4,0,30,1,3,0,4,0,30,0,1,0,1,0,-27,3,0
2,4,30,2,30,3,2,0,5,3,30,2,0,0,2,0,30,5,0,0,5,2,30,1,4,0,5,2,30,3,0,0,3,1,-15,3,1
2,1,31,4,30,1,3,0,4,4,30,4,0,0,4,3,30,2,2,0,4,0,30,1,3,0,4,0,30,0,3,0,3,1,-15,3,1
2,4,31,0,30,0,4,0,4,1,30,4,0,0,4,0,30,1,3,0,4,0,30,2,2,0,4,0,30,0,3,0,3,1,-15,3,1
2,3,25,1,30,0,4,0,4,1,30,2,0,0,2,1,30,4,0,0,4,2,30,0,4,0,4,2,30,1,0,0,1,1,-15,3,1
2,3,4,3,30,6,2,0,8,0,30,4,0,0,4,0,30,6,2,0,8,0,30,4,4,0,8,2,30,4,0,0,4,0,-27,3,0
2,2,25,2,30,3,1,0,4,2,30,2,0,0,2,1,30,4,0,0,4,0,30,0,4,0,4,1,30,1,0,0,1,1,-15,3,1
2,2,16,0,30,4,5,0,9,1,30,7,1,0,8,0,30,5,4,0,9,0,30,3,6,0,9,1,30,4,0,0,4,1,-15,3,1
2,4,9,0,30,6,5,0,11,0,30,6,0,0,6,5,30,10,1,0,11,1,30,3,8,0,11,1,30,3,1,0,4,0,-27,3,0
2,4,17,1,30,2,2,0,4,0,30,2,0,0,2,1,30,0,4,0,4,2,30,0,4,0,4,3,30,1,0,0,1,1,-15,3,1
2,3,7,1,30,4,5,0,9,2,30,4,0,0,4,1,30,5,4,0,9,5,30,2,7,0,9,1,30,5,1,0,6,0,-27,3,0
2,1,24,0,30,3,3,0,6,2,30,4,0,0,4,5,30,6,0,0,6,0,30,3,3,0,6,3,30,4,0,0,4,1,-15,3,1
2,3,5,1,30,3,9,0,12,2,30,7,3,0,10,2,30,7,5,0,12,0,30,7,5,0,12,0,30,3,3,0,6,0,-27,3,0
2,4,18,0,30,6,2,0,8,0,30,4,0,0,4,1,30,5,3,0,8,0,30,3,5,0,8,1,30,5,0,0,5,1,-15,3,1
2,4,17,1,30,1,3,0,4,1,30,2,0,0,2,1,30,0,4,0,4,4,30,1,3,0,4,2,30,1,0,0,1,1,-15,3,1
2,4,32,0,30,2,7,0,9,4,30,2,0,0,2,3,30,9,0,0,9,1,30,3,6,0,9,4,30,2,0,0,2,1,-15,3,1
2,2,7,0,30,3,6,0,9,1,30,4,0,0,4,2,30,6,3,0,9,4,30,3,6,0,9,1,30,3,3,0,6,0,-27,3,0
2,4,15,3,30,3,1,0,4,0,30,6,0,0,6,0,30,3,1,0,4,1,30,2,2,0,4,0,30,2,2,0,4,1,-15,3,1
2,4,7,0,30,3,1,0,4,0,30,2,0,0,2,2,30,3,1,0,4,0,30,1,3,0,4,3,30,1,1,0,2,0,-27,3,0
2,3,5,1,30,5,7,0,12,2,30,9,1,0,10,0,30,5,7,0,12,0,30,8,4,0,12,1,30,4,2,0,6,0,-27,3,0
2,4,30,5,30,3,2,0,5,5,30,2,0,0,2,2,30,2,3,0,5,2,30,2,3,0,5,0,30,2,1,0,3,1,-15,3,1
2,4,5,1,30,3,9,0,12,2,30,6,4,0,10,1,30,5,7,0,12,0,30,8,4,0,12,2,30,4,2,0,6,0,-27,3,0
2,1,17,1,30,1,3,0,4,0,30,2,0,0,2,2,30,1,3,0,4,2,30,0,4,0,4,3,30,1,0,0,1,1,-15,3,1
2,3,25,2,30,0,4,0,4,2,30,2,0,0,2,0,30,2,2,0,4,2,30,3,1,0,4,0,30,1,0,0,1,1,-15,3,1
2,3,32,0,30,7,2,0,9,3,30,2,0,0,2,6,30,9,0,0,9,1,30,3,6,0,9,2,30,2,0,0,2,1,-15,3,1
2,4,7,2,30,4,5,0,9,2,30,4,0,0,4,1,30,7,2,0,9,4,30,3,6,0,9,2,30,4,2,0,6,0,-27,3,0
2,1,5,0,30,1,4,0,5,2,30,2,2,0,4,1,30,5,0,0,5,0,30,2,3,0,5,1,30,0,2,0,2,0,-27,3,0
2,3,9,0,30,3,1,0,4,1,30,2,0,0,2,6,30,4,0,0,4,0,30,1,3,0,4,2,30,1,0,0,1,0,-27,3,0
2,2,23,0,30,2,3,0,5,0,30,4,0,0,4,3,30,5,0,0,5,7,30,1,4,0,5,4,30,2,0,0,2,1,-15,3,1
2,2,13,2,30,5,2,0,7,0,30,4,0,0,4,3,30,7,0,0,7,4,30,5,2,0,7,6,30,4,0,0,4,1,-15,3,1
2,4,32,0,30,6,3,0,9,3,30,2,0,0,2,1,30,9,0,0,9,1,30,2,7,0,9,5,30,2,0,0,2,1,-15,3,1
2,4,31,0,30,0,4,0,4,3,30,4,0,0,4,4,30,3,1,0,4,1,30,4,0,0,4,0,30,3,0,0,3,1,-15,3,1
2,3,13,5,30,3,0,0,3,1,30,2,0,0,2,1,30,3,0,0,3,0,30,2,1,0,3,1,30,2,0,0,2,1,-15,3,1
2,3,30,2,30,4,1,0,5,2,30,2,0,0,2,4,30,2,3,0,5,3,30,2,3,0,5,6,30,2,1,0,3,1,-15,3,1
2,4,16,0,30,7,2,0,9,1,30,7,1,0,8,1,30,3,6,0,9,0,30,1,8,0,9,1,30,4,0,0,4,1,-15,3,1
2,4,5,1,30,6,6,0,12,3,30,5,5,0,10,0,30,4,8,0,12,0,30,8,4,0,12,1,30,3,3,0,6,0,-27,3,0
2,4,9,0,30,2,2,0,4,0,30,1,1,0,2,7,30,4,0,0,4,0,30,1,3,0,4,0,30,1,0,0,1,0,-27,3,0
2,0,31,3,30,5,7,0,12,3,30,8,0,0,8,5,30,11,1,0,12,0,30,3,9,0,12,2,30,3,3,0,6,1,-15,3,1
2,4,24,0,30,4,2,0,6,0,30,4,0,0,4,3,30,6,0,0,6,0,30,1,5,0,6,2,30,4,0,0,4,1,-15,3,1
2,4,7,0,30,4,0,0,4,1,30,2,0,0,2,3,30,2,2,0,4,0,30,1,3,0,4,2,30,2,0,0,2,0,-27,3,0
2,1,23,0,30,2,3,0,5,0,30,4,0,0,4,3,30,4,1,0,5,0,30,0,5,0,5,1,30,1,1,0,2,1,-15,3,1
2,2,31,0,30,0,4,0,4,3,30,4,0,0,4,2,30,1,3,0,4,0,30,3,1,0,4,1,30,3,0,0,3,1,-15,3,1
2,4,27,0,30,1,4,0,5,1,30,0,0,0,0,3,30,5,0,0,5,0,30,2,3,0,5,0,30,2,2,0,4,1,-15,3,1
2,3,3,2,30,5,6,0,11,1,30,8,0,0,8,2,30,8,3,0,11,4,30,2,9,0,11,1,30,2,5,0,7,0,-27,3,0
2,2,24,0,30,2,4,0,6,3,30,4,0,0,4,3,30,1,5,0,6,0,30,3,3,0,6,2,30,4,0,0,4,1,-15,3,1
2,3,28,0,30,2,6,0,8,4,30,4,0,0,4,1,30,3,5,0,8,0,30,2,6,0,8,1,30,4,0,0,4,1,-15,3,1
2,2,25,2,30,0,4,0,4,1,30,2,0,0,2,0,30,1,3,0,4,0,30,1,3,0,4,3,30,1,0,0,1,1,-15,3,1
2,1,9,0,30,2,2,0,4,1,30,2,0,0,2,1,30,4,0,0,4,0,30,1,3,0,4,0,30,1,0,0,1,0,-27,3,0
2,4,25,6,30,1,3,0,4,3,30,2,0,0,2,0,30,4,0,0,4,0,30,0,4,0,4,0,30,1,0,0,1,1,-15,3,1
2,4,27,2,30,3,2,0,5,0,30,0,0,0,0,4,30,5,0,0,5,0,30,2,3,0,5,3,30,4,0,0,4,1,-15,3,1
2,4,2,0,30,6,4,0,10,0,30,4,0,0,4,5,30,9,1,0,10,0,30,5,5,0,10,1,30,2,6,0,8,0,-27,3,0
2,4,23,0,30,5,0,0,5,2,30,4,0,0,4,7,30,5,0,0,5,0,30,0,5,0,5,1,30,1,1,0,2,1,-15,3,1
2,3,24,0,30,5,1,0,6,2,30,3,1,0,4,4,30,4,2,0,6,0,30,1,5,0,6,0,30,3,1,0,4,1,-15,3,1
2,4,16,0,30,6,3,0,9,1,30,8,0,0,8,0,30,2,7,0,9,0,30,0,9,0,9,0,30,3,1,0,4,1,-15,3,1
2,4,5,0,30,6,6,0,12,2,30,7,3,0,10,0,30,8,4,0,12,0,30,8,4,0,12,1,30,2,4,0,6,0,-27,3,0
2,4,4,0,30,8,0,0,8,3,30,4,0,0,4,0,30,5,3,0,8,0,30,4,4,0,8,1,30,3,1,0,4,0,-27,3,0
2,3,3,1,30,5,6,0,11,3,30,8,0,0,8,4,30,3,8,0,11,0,30,7,4,0,11,1,30,2,5,0,7,0,-27,3,0
2,2,5,1,30,8,4,0,12,2,30,7,3,0,10,0,30,7,5,0,12,0,30,7,5,0,12,1,30,2,4,0,6,0,-27,3,0
2,1,25,1,30,1,3,0,4,2,30,2,0,0,2,5,30,4,0,0,4,0,30,0,4,0,4,1,30,1,0,0,1,1,-15,3,1
2,1,31,0,30,0,4,0,4,3,30,4,0,0,4,3,30,2,2,0,4,0,30,1,3,0,4,0,30,0,3,0,3,1,-15,3,1
2,1,5,1,30,6,6,0,12,2,30,7,3,0,10,2,30,6,6,0,12,0,30,7,5,0,12,2,30,2,4,0,6,0,-27,3,0
2,4,13,4,30,6,1,0,7,2,30,4,0,0,4,8,30,7,0,0,7,1,30,5,2,0,7,2,30,3,1,0,4,1,-15,3,1
2,2,5,1,30,7,5,0,12,2,30,9,1,0,10,0,30,6,6,0,12,0,30,7,5,0,12,2,30,4,2,0,6,0,-27,3,0
2,3,25,0,30,1,3,0,4,2,30,2,0,0,2,4,30,4,0,0,4,0,30,0,4,0,4,0,30,1,0,0,1,1,-15,3,1
2,3,13,7,30,3,0,0,3,0,30,2,0,0,2,1,30,3,0,0,3,3,30,2,1,0,3,3,30,2,0,0,2,1,-15,3,1
2,4,32,0,30,6,3,0,9,3,30,2,0,0,2,3,30,9,0,0,9,1,30,2,7,0,9,2,30,2,0,0,2,1,-15,3,1
2,3,21,3,30,3,0,0,3,1,30,2,0,0,2,0,30,2,1,0,3,0,30,3,0,0,3,1,30,1,0,0,1,1,-15,3,1
2,4,9,0,30,3,1,0,4,2,30,2,0,0,2,3,30,1,3,0,4,0,30,2,2,0,4,3,30,1,0,0,1,0,-27,3,0
2,1,23,1,30,3,2,0,5,2,30,4,0,0,4,2,30,3,2,0,5,0,30,0,5,0,5,1,30,2,0,0,2,1,-15,3,1
2,4,23,0,30,2,3,0,5,1,30,4,0,0,4,3,30,4,1,0,5,0,30,1,4,0,5,1,30,1,1,0,2,1,-15,3,1
2,4,13,2,30,6,1,0,7,0,30,4,0,0,4,2,30,7,0,0,7,0,30,6,1,0,7,4,30,4,0,0,4,1,-15,3,1
2,2,24,0,30,3,3,0,6,2,30,4,0,0,4,2,30,6,0,0,6,0,30,1,5,0,6,2,30,4,0,0,4,1,-15,3,1
2,3,24,0,30,3,3,0,6,0,30,4,0,0,4,2,30,6,0,0,6,0,30,1,5,0,6,0,30,4,0,0,4,1,-15,3,1
2,2,20,0,30,1,7,0,8,1,30,8,0,0,8,0,30,4,4,0,8,0,30,5,3,0,8,1,30,4,1,0,5,1,-15,3,1
2,4,30,2,30,3,2,0,5,4,30,2,0,0,2,1,30,2,3,0,5,2,30,2,3,0,5,0,30,3,0,0,3,1,-15,3,1
2,3,9,0,30,6,5,0,11,1,30,6,0,0,6,2,30,11,0,0,11,4,30,3,8,0,11,4,30,1,3,0,4,0,-27,3,0
2,4,22,1,30,5,3,0,8,2,30,2,0,0,2,2,30,4,4,0,8,1,30,3,5,0,8,3,30,1,3,0,4,1,-15,3,1
2,3,11,0,30,3,1,0,4,0,30,0,0,0,0,0,30,0,4,0,4,0,30,1,3,0,4,0,30,1,0,0,1,1,-15,3,1
2,3,13,3,30,3,0,0,3,1,30,2,0,0,2,4,30,3,0,0,3,0,30,1,2,0,3,2,30,2,0,0,2,1,-15,3,1
2,3,7,0,30,4,5,0,9,2,30,4,0,0,4,3,30,7,2,0,9,6,30,1,8,0,9,3,30,6,0,0,6,0,-27,3,0
2,4,23,0,30,2,3,0,5,2,30,4,0,0,4,7,30,3,2,0,5,1,30,0,5,0,5,1,30,2,0,0,2,1,-15,3,1
2,4,9,0,30,6,5,0,11,0,30,6,0,0,6,3,30,11,0,0,11,1,30,3,8,0,11,1,30,4,0,0,4,0,-27,3,0
2,3,28,0,30,1,7,0,8,4,30,4,0,0,4,0,30,1,7,0,8,0,30,5,3,0,8,3,30,4,0,0,4,1,-15,3,1
2,3,9,0,30,5,6,0,11,1,30,6,0,0,6,1,30,11,0,0,11,2,30,3,8,0,11,4,30,2,2,0,4,0,-27,3,0
2,3,16,0,30,6,3,0,9,1,30,8,0,0,8,0,30,2,7,0,9,0,30,0,9,0,9,0,30,3,1,0,4,1,-15,3,1
2,4,28,0,30,5,3,0,8,3,30,4,0,0,4,2,30,6,2,0,8,0,30,2,6,0,8,2,30,1,3,0,4,1,-15,3,1
2,2,9,1,30,6,5,0,11,2,30,6,0,0,6,1,30,9,2,0,11,2,30,3,8,0,11,2,30,4,0,0,4,0,-27,3,0
2,2,30,2,30,2,3,0,5,2,30,2,0,0,2,2,30,2,3,0,5,2,30,1,4,0,5,6,30,2,1,0,3,1,-15,3,1
2,4,30,0,30,3,2,0,5,3,30,2,0,0,2,1,30,2,3,0,5,3,30,1,4,0,5,0,30,2,1,0,3,1,-15,3,1
2,4,16,0,30,7,2,0,9,0,30,6,2,0,8,3,30,5,4,0,9,0,30,1,8,0,9,0,30,4,0,0,4,1,-15,3,1
2,4,25,1,30,2,2,0,4,2,30,2,0,0,2,5,30,4,0,0,4,1,30,0,4,0,4,0,30,1,0,0,1,1,-15,3,1
2,4,25,3,30,1,3,0,4,2,30,2,0,0,2,2,30,4,0,0,4,0,30,0,4,0,4,1,30,1,0,0,1,1,-15,3,1
2,4,32,0,30,4,5,0,9,3,30,2,0,0,2,1,30,8,1,0,9,1,30,3,6,0,9,3,30,2,0,0,2,1,-15,3,1
2,2,5,2,30,6,6,0,12,2,30,5,5,0,10,0,30,8,4,0,12,0,30,8,4,0,12,2,30,4,2,0,6,0,-27,3,0
2,1,31,0,30,0,4,0,4,2,30,4,0,0,4,6,30,4,0,0,4,0,30,1,3,0,4,2,30,3,0,0,3,1,-15,3,1
2,1,31,0,30,0,4,0,4,3,30,4,0,0,4,6,30,4,0,0,4,0,30,1,3,0,4,0,30,3,0,0,3,1,-15,3,1
2,2,4,3,30,8,0,0,8,3,30,4,0,0,4,1,30,6,2,0,8,0,30,5,3,0,8,0,30,4,0,0,4,0,-27,3,0
2,3,9,0,30,1,3,0,4,2,30,2,0,0,2,2,30,2,2,0,4,0,30,1,3,0,4,2,30,1,0,0,1,0,-27,3,0
2,3,9,1,30,6,5,0,11,1,30,6,0,0,6,2,30,11,0,0,11,1,30,3,8,0,11,4,30,3,1,0,4,0,-27,3,0
2,4,17,1,30,2,2,0,4,0,30,2,0,0,2,0,30,3,1,0,4,2,30,1,3,0,4,3,30,1,0,0,1,1,-15,3,1
2,4,3,0,30,1,3,0,4,0,30,4,0,0,4,2,30,2,2,0,4,0,30,1,3,0,4,0,30,1,2,0,3,0,-27,3,0
2,3,30,2,30,3,2,0,5,4,30,2,0,0,2,1,30,2,3,0,5,3,30,2,3,0,5,2,30,3,0,0,3,1,-15,3,1
2,4,23,0,30,1,4,0,5,2,30,4,0,0,4,10,30,5,0,0,5,0,30,0,5,0,5,1,30,1,1,0,2,1,-15,3,1
2,3,16,1,30,5,4,0,9,2,30,8,0,0,8,0,30,2,7,0,9,0,30,2,7,0,9,0,30,1,3,0,4,1,-15,3,1
2,3,13,1,30,5,2,0,7,0,30,4,0,0,4,2,30,6,1,0,7,2,30,6,1,0,7,5,30,4,0,0,4,1,-15,3,1
2,2,14,0,30,5,4,0,9,1,30,6,0,0,6,3,30,4,5,0,9,0,30,6,3,0,9,5,30,4,0,0,4,1,-15,3,1
2,4,7,0,30,1,3,0,4,1,30,2,0,0,2,0,30,2,2,0,4,0,30,1,3,0,4,2,30,1,1,0,2,0,-27,3,0
2,3,32,0,30,6,3,0,9,3,30,2,0,0,2,3,30,9,0,0,9,1,30,2,7,0,9,2,30,2,0,0,2,1,-15,3,1
2,4,23,0,30,1,4,0,5,2,30,4,0,0,4,9,30,5,0,0,5,3,30,2,3,0,5,1,30,1,1,0,2,1,-15,3,1
2,4,17,1,30,1,3,0,4,0,30,2,0,0,2,2,30,1,3,0,4,1,30,1,3,0,4,4,30,1,0,0,1,1,-15,3,1
2,4,5,1,30,5,7,0,12,2,30,8,2,0,10,0,30,5,7,0,12,0,30,8,4,0,12,5,30,3,3,0,6,0,-27,3,0
2,4,25,5,30,3,1,0,4,3,30,2,0,0,2,1,30,4,0,0,4,0,30,0,4,0,4,0,30,0,1,0,1,1,-15,3,1
2,1,15,4,30,4,0,0,4,0,30,6,0,0,6,0,30,3,1,0,4,1,30,2,2,0,4,1,30,4,0,0,4,1,-15,3,1
2,3,9,0,30,2,2,0,4,2,30,2,0,0,2,0,30,2,2,0,4,0,30,2,2,0,4,0,30,1,0,0,1,0,-27,3,0
2,4,30,2,30,3,2,0,5,3,30,2,0,0,2,1,30,2,3,0,5,4,30,1,4,0,5,4,30,3,0,0,3,1,-15,3,1
2,4,3,0,30,4,7,0,11,2,30,8,0,0,8,1,30,6,5,0,11,0,30,4,7,0,11,2,30,5,2,0,7,0,-27,3,0
2,4,25,0,30,1,3,0,4,2,30,2,0,0,2,6,30,4,0,0,4,0,30,0,4,0,4,0,30,1,0,0,1,1,-15,3,1
2,2,15,3,30,2,2,0,4,0,30,6,0,0,6,0,30,3,1,0,4,1,30,1,3,0,4,1,30,4,0,0,4,1,-15,3,1
2,3,27,0,30,1,4,0,5,2,30,0,0,0,0,0,30,4,1,0,5,0,30,2,3,0,5,0,30,4,0,0,4,1,-15,3,1
2,3,31,0,30,0,4,0,4,2,30,4,0,0,4,4,30,3,1,0,4,0,30,1,3,0,4,0,30,1,2,0,3,1,-15,3,1
2,1,5,0,30,2,3,0,5,0,30,2,2,0,4,1,30,5,0,0,5,0,30,1,4,0,5,1,30,0,2,0,2,0,-27,3,0
2,3,7,0,30,2,2,0,4,2,30,2,0,0,2,4,30,1,3,0,4,0,30,0,4,0,4,1,30,1,1,0,2,0,-27,3,0
2,3,5,0,30,7,5,0,12,2,30,7,3,0,10,2,30,5,7,0,12,0,30,6,6,0,12,1,30,1,5,0,6,0,-27,3,0
2,4,24,0,30,5,1,0,6,2,30,3,1,0,4,4,30,5,1,0,6,0,30,3,3,0,6,1,30,4,0,0,4,1,-15,3,1
2,4,17,1,30,2,2,0,4,0,30,2,0,0,2,1,30,2,2,0,4,2,30,0,4,0,4,4,30,1,0,0,1,1,-15,3,1
2,4,3,0,30,0,4,0,4,2,30,4,0,0,4,3,30,2,2,0,4,0,30,0,4,0,4,1,30,3,0,0,3,0,-27,3,0
2,4,17,1,30,2,2,0,4,1,30,2,0,0,2,1,30,0,4,0,4,2,30,1,3,0,4,0,30,1,0,0,1,1,-15,3,1
2,4,31,1,30,3,1,0,4,2,30,4,0,0,4,1,30,4,0,0,4,0,30,1,3,0,4,0,30,3,0,0,3,1,-15,3,1
2,4,13,1,30,3,0,0,3,0,30,2,0,0,2,1,30,3,0,0,3,3,30,3,0,0,3,2,30,2,0,0,2,1,-15,3,1
2,0,23,0,30,2,3,0,5,2,30,4,0,0,4,7,30,4,1,0,5,0,30,0,5,0,5,1,30,2,0,0,2,1,-15,3,1
2,3,5,1,30,4,8,0,12,2,30,4,6,0,10,0,30,7,5,0,12,0,30,7,5,0,12,1,30,5,1,0,6,0,-27,3,0
2,4,15,0,30,2,2,0,4,0,30,6,0,0,6,0,30,2,2,0,4,3,30,4,0,0,4,0,30,3,1,0,4,1,-15,3,1
2,4,27,0,30,1,4,0,5,0,30,0,0,0,0,3,30,5,0,0,5,3,30,2,3,0,5,5,30,4,0,0,4,1,-15,3,1
2,4,7,1,30,4,5,0,9,2,30,4,0,0,4,1,30,6,3,0,9,5,30,2,7,0,9,2,30,6,0,0,6,0,-27,3,0
2,4,9,0,30,1,3,0,4,1,30,2,0,0,2,2,30,3,1,0,4,0,30,1,3,0,4,0,30,0,1,0,1,0,-27,3,0
2,2,20,0,30,4,4,0,8,0,30,5,3,0,8,0,30,5,3,0,8,0,30,2,6,0,8,1,30,4,1,0,5,1,-15,3,1
2,1,23,0,30,3,2,0,5,0,30,4,0,0,4,0,30,5,0,0,5,0,30,0,5,0,5,2,30,2,0,0,2,1,-15,3,1
2,4,24,3,30,6,0,0,6,3,30,3,1,0,4,1,30,2,4,0,6,0,30,1,5,0,6,1,30,4,0,0,4,1,-15,3,1
2,2,3,8,30,4,7,0,11,3,30,8,0,0,8,0,30,6,5,0,11,4,30,4,7,0,11,2,30,2,5,0,7,0,-27,3,0
2,4,25,2,30,2,2,0,4,2,30,2,0,0,2,0,30,4,0,0,4,0,30,0,4,0,4,0,30,0,1,0,1,1,-15,3,1
2,3,24,0,30,2,4,0,6,0,30,3,1,0,4,6,30,6,0,0,6,0,30,3,3,0,6,4,30,4,0,0,4,1,-15,3,1
2,3,23,0,30,2,3,0,5,2,30,4,0,0,4,3,30,3,2,0,5,0,30,0,5,0,5,1,30,2,0,0,2,1,-15,3,1
2,4,23,0,30,3,2,0,5,1,30,4,0,0,4,3,30,4,1,0,5,0,30,0,5,0,5,0,30,2,0,0,2,1,-15,3,1
2,4,32,0,30,6,3,0,9,3,30,2,0,0,2,3,30,9,0,0,9,1,30,3,6,0,9,2,30,2,0,0,2,1,-15,3,1
2,4,31,0,30,1,3,0,4,2,30,4,0,0,4,3,30,4,0,0,4,0,30,1,3,0,4,0,30,0,3,0,3,1,-15,3,1
2,4,7,0,30,0,4,0,4,1,30,2,0,0,2,1,30,4,0,0,4,0,30,0,4,0,4,1,30,2,0,0,2,0,-27,3,0
2,0,31,1,30,1,3,0,4,0,30,3,1,0,4,2,30,4,0,0,4,0,30,1,3,0,4,0,30,1,2,0,3,1,-15,3,1
2,4,17,2,30,2,2,0,4,1,30,2,0,0,2,1,30,0,4,0,4,2,30,1,3,0,4,2,30,1,0,0,1,1,-15,3,1
2,2,4,2,30,7,1,0,8,3,30,4,0,0,4,3,30,6,2,0,8,0,30,0,8,0,8,3,30,3,1,0,4,0,-27,3,0
2,4,27,0,30,1,4,0,5,0,30,0,0,0,0,1,30,5,0,0,5,0,30,2,3,0,5,4,30,3,1,0,4,1,-15,3,1
2,3,17,1,30,1,3,0,4,0,30,2,0,0,2,1,30,1,3,0,4,2,30,1,3,0,4,4,30,1,0,0,1,1,-15,3,1
2,4,24,0,30,4,2,0,6,2,30,4,0,0,4,7,30,6,0,0,6,0,30,1,5,0,6,2,30,4,0,0,4,1,-15,3,1
2,4,35,1,30,1,3,0,4,1,30,0,0,0,0,4,30,4,0,0,4,0,30,1,3,0,4,0,30,2,1,0,3,1,-15,3,1
2,4,30,3,30,5,0,0,5,5,30,2,0,0,2,4,30,1,4,0,5,2,30,1,4,0,5,0,30,2,1,0,3,1,-15,3,1
2,3,7,0,30,2,7,0,9,1,30,4,0,0,4,1,30,7,2,0,9,5,30,2,7,0,9,2,30,3,3,0,6,0,-27,3,0
2,4,24,1,30,3,3,0,6,2,30,4,0,0,4,3,30,4,2,0,6,0,30,3,3,0,6,5,30,4,0,0,4,1,-15,3,1
2,2,4,3,30,7,1,0,8,3,30,4,0,0,4,0,30,6,2,0,8,1,30,4,4,0,8,1,30,4,0,0,4,0,-27,3,0
2,1,31,0,30,1,3,0,4,2,30,4,0,0,4,4,30,1,3,0,4,0,30,1,3,0,4,0,30,3,0,0,3,1,-15,3,1
2,4,32,0,30,2,7,0,9,3,30,2,0,0,2,5,30,9,0,0,9,1,30,2,7,0,9,2,30,2,0,0,2,1,-15,3,1
2,3,31,2,30,0,4,0,4,2,30,4,0,0,4,1,30,2,2,0,4,0,30,1,3,0,4,0,30,3,0,0,3,1,-15,3,1
2,0,3,1,30,4,7,0,11,2,30,8,0,0,8,0,30,7,4,0,11,2,30,9,2,0,11,1,30,2,5,0,7,0,-27,3,0
2,3,25,1,30,0,4,0,4,0,30,2,0,0,2,0,30,4,0,0,4,0,30,0,4,0,4,5,30,1,0,0,1,1,-15,3,1
2,3,30,2,30,3,2,0,5,3,30,2,0,0,2,4,30,2,3,0,5,3,30,1,4,0,5,0,30,2,1,0,3,1,-15,3,1
2,3,4,2,30,3,5,0,8,0,30,2,2,0,4,3,30,4,4,0,8,1,30,7,1,0,8,3,30,4,0,0,4,0,-27,3,0
2,4,9,0,30,6,5,0,11,1,30,6,0,0,6,4,30,11,0,0,11,0,30,3,8,0,11,4,30,2,2,0,4,0,-27,3,0
2,4,9,0,30,2,2,0,4,1,30,2,0,0,2,5,30,4,0,0,4,0,30,4,0,0,4,1,30,1,0,0,1,0,-27,3,0
2,3,17,1,30,1,3,0,4,0,30,2,0,0,2,1,30,2,2,0,4,0,30,1,3,0,4,2,30,1,0,0,1,1,-15,3,1
2,4,32,0,30,5,4,0,9,3,30,2,0,0,2,1,30,9,0,0,9,1,30,3,6,0,9,3,30,2,0,0,2,1,-15,3,1
2,2,5,1,30,5,7,0,12,2,30,7,3,0,10,0,30,3,9,0,12,0,30,7,5,0,12,1,30,1,5,0,6,0,-27,3,0
2,3,12,0,30,4,3,0,7,0,30,4,2,0,6,1,30,5,2,0,7,0,30,6,1,0,7,4,30,2,1,0,3,1,-15,3,1
2,3,5,1,30,7,5,0,12,2,30,5,5,0,10,0,30,6,6,0,12,0,30,8,4,0,12,3,30,4,2,0,6,0,-27,3,0
2,2,25,6,30,1,3,0,4,3,30,2,0,0,2,0,30,1,3,0,4,0,30,0,4,0,4,3,30,1,0,0,1,1,-15,3,1
2,4,7,0,30,3,6,0,9,1,30,3,1,0,4,1,30,9,0,0,9,4,30,2,7,0,9,5,30,4,2,0,6,0,-27,3,0
2,4,4,2,30,4,4,0,8,3,30,4,0,0,4,1,30,6,2,0,8,0,30,6,2,0,8,3,30,3,1,0,4,0,-27,3,0
2,2,17,3,30,2,2,0,4,1,30,2,0,0,2,2,30,0,4,0,4,2,30,1,3,0,4,3,30,1,0,0,1,1,-15,3,1
2,4,30,2,30,3,2,0,5,5,30,2,0,0,2,4,30,2,3,0,5,3,30,1,4,0,5,0,30,3,0,0,3,1,-15,3,1
2,3,9,0,30,3,1,0,4,1,30,2,0,0,2,0,30,4,0,0,4,0,30,1,3,0,4,3,30,1,0,0,1,0,-27,3,0
2,4,28,0,30,1,7,0,8,4,30,4,0,0,4,3,30,1,7,0,8,0,30,4,4,0,8,2,30,4,0,0,4,1,-15,3,1
2,2,5,1,30,5,7,0,12,2,30,3,7,0,10,0,30,3,9,0,12,0,30,7,5,0,12,1,30,4,2,0,6,0,-27,3,0
2,2,25,1,30,0,4,0,4,2,30,2,0,0,2,2,30,4,0,0,4,0,30,0,4,0,4,1,30,1,0,0,1,1,-15,3,1
2,4,23,0,30,4,1,0,5,2,30,4,0,0,4,3,30,4,1,0,5,0,30,0,5,0,5,2,30,2,0,0,2,1,-15,3,1
2,4,16,0,30,6,3,0,9,1,30,8,0,0,8,2,30,4,5,0,9,0,30,2,7,0,9,0,30,3,1,0,4,1,-15,3,1
2,2,9,0,30,2,2,0,4,2,30,2,0,0,2,0,30,2,2,0,4,0,30,1,3,0,4,1,30,1,0,0,1,0,-27,3,0
2,2,24,6,30,6,0,0,6,4,30,4,0,0,4,3,30,2,4,0,6,0,30,1,5,0,6,0,30,4,0,0,4,1,-15,3,1
2,3,27,0,30,1,4,0,5,0,30,0,0,0,0,3,30,5,0,0,5,0,30,2,3,0,5,4,30,4,0,0,4,1,-15,3,1
2,4,30,2,30,3,2,0,5,3,30,2,0,0,2,4,30,2,3,0,5,2,30,1,4,0,5,0,30,2,1,0,3,1,-15,3,1
2,4,32,0,30,8,1,0,9,3,30,2,0,0,2,4,30,9,0,0,9,1,30,2,7,0,9,2,30,2,0,0,2,1,-15,3,1
2,3,15,0,30,4,0,0,4,0,30,5,1,0,6,2,30,3,1,0,4,1,30,2,2,0,4,0,30,2,2,0,4,1,-15,3,1
2,1,14,5,30,5,4,0,9,1,30,6,0,0,6,1,30,9,0,0,9,0,30,7,2,0,9,0,30,4,0,0,4,1,-15,3,1
2,2,37,2,30,5,6,0,11,4,30,7,1,0,8,4,30,10,1,0,11,0,30,3,8,0,11,3,30,4,2,0,6,1,-15,3,1
2,1,5,0,30,0,5,0,5,2,30,3,1,0,4,2,30,3,2,0,5,0,30,1,4,0,5,1,30,1,1,0,2,0,-27,3,0
2,3,17,1,30,1,3,0,4,1,30,2,0,0,2,1,30,1,3,0,4,6,30,1,3,0,4,2,30,1,0,0,1,1,-15,3,1
2,4,9,0,30,2,2,0,4,0,30,2,0,0,2,3,30,4,0,0,4,0,30,1,3,0,4,0,30,1,0,0,1,0,-27,3,0
2,2,5,2,30,7,5,0,12,2,30,5,5,0,10,0,30,5,7,0,12,2,30,6,6,0,12,0,30,3,3,0,6,0,-27,3,0
2,4,20,0,30,2,6,0,8,0,30,6,2,0,8,1,30,5,3,0,8,0,30,2,6,0,8,0,30,5,0,0,5,1,-15,3,1
2,4,24,0,30,4,2,0,6,2,30,3,1,0,4,3,30,4,2,0,6,0,30,1,5,0,6,5,30,4,0,0,4,1,-15,3,1
2,2,9,0,30,2,2,0,4,2,30,2,0,0,2,1,30,2,2,0,4,0,30,1,3,0,4,1,30,1,0,0,1,0,-27,3,0
2,2,27,0,30,2,3,0,5,1,30,0,0,0,0,3,30,5,0,0,5,0,30,2,3,0,5,2,30,4,0,0,4,1,-15,3,1
2,4,7,0,30,5,4,0,9,2,30,4,0,0,4,3,30,6,3,0,9,4,30,2,7,0,9,1,30,6,0,0,6,0,-27,3,0
2,3,25,1,30,2,2,0,4,2,30,2,0,0,2,3,30,4,0,0,4,0,30,0,4,0,4,1,30,1,0,0,1,1,-15,3,1
2,4,25,1,30,0,4,0,4,2,30,2,0,0,2,12,30,4,0,0,4,0,30,0,4,0,4,0,30,1,0,0,1,1,-15,3,1
2,4,23,0,30,1,4,0,5,0,30,4,0,0,4,3,30,4,1,0,5,0,30,0,5,0,5,3,30,2,0,0,2,1,-15,3,1
2,3,17,1,30,1,3,0,4,1,30,2,0,0,2,1,30,0,4,0,4,2,30,1,3,0,4,2,30,1,0,0,1,1,-15,3,1
2,3,31,0,30,1,3,0,4,2,30,4,0,0,4,0,30,2,2,0,4,0,30,1,3,0,4,0,30,0,3,0,3,1,-15,3,1
2,4,24,0,30,4,2,0,6,2,30,4,0,0,4,4,30,6,0,0,6,0,30,1,5,0,6,4,30,4,0,0,4,1,-15,3,1
2,4,7,0,30,3,6,0,9,2,30,4,0,0,4,1,30,7,2,0,9,4,30,3,6,0,9,3,30,5,1,0,6,0,-27,3,0
2,4,9,0,30,6,5,0,11,2,30,6,0,0,6,2,30,8,3,0,11,1,30,3,8,0,11,1,30,4,0,0,4,0,-27,3,0
2,2,3,0,30,3,8,0,11,0,30,8,0,0,8,0,30,2,9,0,11,2,30,5,6,0,11,1,30,2,5,0,7,0,-27,3,0
2,4,31,1,30,1,3,0,4,3,30,4,0,0,4,2,30,4,0,0,4,0,30,3,1,0,4,2,30,3,0,0,3,1,-15,3,1
2,4,3,2,30,5,6,0,11,2,30,8,0,0,8,0,30,5,6,0,11,4,30,4,7,0,11,1,30,2,5,0,7,0,-27,3,0
2,3,20,0,30,1,7,0,8,0,30,8,0,0,8,0,30,7,1,0,8,0,30,1,7,0,8,0,30,4,1,0,5,1,-15,3,1
2,2,23,0,30,2,3,0,5,1,30,4,0,0,4,6,30,5,0,0,5,0,30,0,5,0,5,2,30,2,0,0,2,1,-15,3,1
2,3,28,0,30,1,7,0,8,5,30,4,0,0,4,0,30,1,7,0,8,0,30,6,2,0,8,3,30,4,0,0,4,1,-15,3,1
2,1,3,1,30,4,7,0,11,2,30,7,1,0,8,0,30,5,6,0,11,4,30,1,10,0,11,1,30,6,1,0,7,0,-27,3,0
2,1,28,0,30,2,6,0,8,4,30,4,0,0,4,0,30,1,7,0,8,0,30,4,4,0,8,4,30,4,0,0,4,1,-15,3,1
2,4,31,2,30,1,3,0,4,2,30,4,0,0,4,1,30,4,0,0,4,0,30,1,3,0,4,0,30,3,0,0,3,1,-15,3,1
2,4,5,0,30,6,6,0,12,2,30,8,2,0,10,0,30,5,7,0,12,0,30,8,4,0,12,0,30,2,4,0,6,0,-27,3,0
2,4,5,1,30,4,8,0,12,2,30,8,2,0,10,1,30,5,7,0,12,0,30,8,4,0,12,2,30,2,4,0,6,0,-27,3,0
2,4,4,4,30,8,0,0,8,3,30,4,0,0,4,0,30,7,1,0,8,0,30,3,5,0,8,3,30,3,1,0,4,0,-27,3,0
2,3,5,1,30,4,8,0,12,2,30,6,4,0,10,2,30,7,5,0,12,0,30,7,5,0,12,2,30,5,1,0,6,0,-27,3,0
2,3,30,2,30,3,2,0,5,4,30,2,0,0,2,1,30,2,3,0,5,2,30,2,3,0,5,0,30,3,0,0,3,1,-15,3,1
2,1,5,0,30,0,5,0,5,0,30,2,2,0,4,0,30,1,4,0,5,0,30,1,4,0,5,0,30,0,2,0,2,0,-27,3,0
2,4,8,0,30,6,1,0,7,3,30,2,0,0,2,3,30,5,2,0,7,0,30,4,3,0,7,2,30,3,0,0,3,0,-27,3,0
2,4,9,0,30,0,4,0,4,0,30,2,0,0,2,3,30,4,0,0,4,0,30,1,3,0,4,2,30,1,0,0,1,0,-27,3,0
2,3,25,2,30,0,4,0,4,1,30,2,0,0,2,6,30,4,0,0,4,0,30,0,4,0,4,2,30,1,0,0,1,1,-15,3,1
2,3,17,0,30,2,2,0,4,0,30,2,0,0,2,1,30,1,3,0,4,2,30,1,3,0,4,4,30,1,0,0,1,1,-15,3,1
2,4,28,0,30,2,6,0,8,5,30,4,0,0,4,0,30,1,7,0,8,0,30,5,3,0,8,2,30,4,0,0,4,1,-15,3,1
2,4,27,1,30,3,2,0,5,2,30,0,0,0,0,1,30,5,0,0,5,0,30,1,4,0,5,0,30,4,0,0,4,1,-15,3,1
2,4,28,0,30,5,3,0,8,4,30,4,0,0,4,3,30,6,2,0,8,0,30,2,6,0,8,1,30,2,2,0,4,1,-15,3,1
2,2,5,1,30,7,5,0,12,2,30,6,4,0,10,2,30,6,6,0,12,0,30,6,6,0,12,1,30,1,5,0,6,0,-27,3,0
2,4,7,1,30,6,3,0,9,1,30,4,0,0,4,0,30,8,1,0,9,0,30,1,8,0,9,2,30,5,1,0,6,0,-27,3,0
2,3,16,0,30,4,5,0,9,1,30,8,0,0,8,2,30,3,6,0,9,0,30,1,8,0,9,2,30,4,0,0,4,1,-15,3,1
2,4,8,0,30,7,0,0,7,3,30,2,0,0,2,6,30,5,2,0,7,0,30,4,3,0,7,4,30,3,0,0,3,0,-27,3,0
2,3,13,2,30,3,0,0,3,0,30,2,0,0,2,0,30,3,0,0,3,0,30,1,2,0,3,2,30,2,0,0,2,1,-15,3,1
2,2,5,1,30,5,7,0,12,2,30,7,3,0,10,0,30,7,5,0,12,0,30,8,4,0,12,2,30,4,2,0,6,0,-27,3,0
2,4,30,3,30,3,2,0,5,5,30,2,0,0,2,0,30,3,2,0,5,3,30,1,4,0,5,0,30,3,0,0,3,1,-15,3,1
2,2,31,0,30,0,4,0,4,3,30,4,0,0,4,0,30,2,2,0,4,2,30,3,1,0,4,1,30,3,0,0,3,1,-15,3,1
2,2,9,0,30,2,2,0,4,1,30,2,0,0,2,4,30,4,0,0,4,1,30,1,3,0,4,2,30,1,0,0,1,0,-27,3,0
2,3,5,1,30,5,7,0,12,2,30,7,3,0,10,0,30,7,5,0,12,0,30,8,4,0,12,3,30,5,1,0,6,0,-27,3,0
2,4,23,0,30,5,0,0,5,2,30,4,0,0,4,6,30,3,2,0,5,0,30,0,5,0,5,1,30,1,1,0,2,1,-15,3,1
2,4,15,0,30,3,1,0,4,0,30,5,1,0,6,0,30,2,2,0,4,1,30,2,2,0,4,0,30,2,2,0,4,1,-15,3,1
2,4,31,0,30,0,4,0,4,4,30,4,0,0,4,3,30,2,2,0,4,4,30,4,0,0,4,0,30,1,2,0,3,1,-15,3,1
2,4,4,2,30,6,2,0,8,3,30,4,0,0,4,0,30,7,1,0,8,0,30,4,4,0,8,1,30,4,0,0,4,0,-27,3,0
2,2,31,0,30,0,4,0,4,1,30,4,0,0,4,4,30,4,0,0,4,0,30,2,2,0,4,0,30,0,3,0,3,1,-15,3,1
2,4,32,0,30,4,5,0,9,4,30,2,0,0,2,2,30,9,0,0,9,1,30,3,6,0,9,3,30,2,0,0,2,1,-15,3,1
2,3,5,1,30,6,6,0,12,2,30,6,4,0,10,0,30,5,7,0,12,0,30,6,6,0,12,3,30,4,2,0,6,0,-27,3,0
2,2,31,0,30,0,4,0,4,3,30,4,0,0,4,0,30,1,3,0,4,1,30,4,0,0,4,3,30,3,0,0,3,1,-15,3,1
2,3,25,3,30,2,2,0,4,2,30,2,0,0,2,1,30,4,0,0,4,0,30,0,4,0,4,3,30,1,0,0,1,1,-15,3,1
2,4,7,0,30,1,3,0,4,1,30,2,0,0,2,4,30,3,1,0,4,0,30,1,3,0,4,2,30,2,0,0,2,0,-27,3,0
2,3,13,1,30,4,3,0,7,0,30,4,0,0,4,3,30,7,0,0,7,3,30,6,1,0,7,2,30,3,1,0,4,1,-15,3,1
2,3,33,0,30,1,2,0,3,1,30,2,0,0,2,5,30,3,0,0,3,0,30,1,2,0,3,3,30,2,0,0,2,1,-15,3,1
2,1,5,1,30,6,6,0,12,2,30,6,4,0,10,0,30,3,9,0,12,1,30,5,7,0,12,1,30,6,0,0,6,0,-27,3,0
2,4,25,2,30,3,1,0,4,2,30,2,0,0,2,0,30,4,0,0,4,0,30,0,4,0,4,0,30,1,0,0,1,1,-15,3,1
2,4,13,1,30,3,0,0,3,0,30,2,0,0,2,3,30,3,0,0,3,0,30,1,2,0,3,1,30,2,0,0,2,1,-15,3,1
2,4,24,0,30,4,2,0,6,0,30,3,1,0,4,0,30,6,0,0,6,5,30,2,4,0,6,5,30,4,0,0,4,1,-15,3,1
2,3,9,0,30,1,3,0,4,0,30,2,0,0,2,4,30,4,0,0,4,0,30,1,3,0,4,3,30,1,0,0,1,0,-27,3,0
2,1,31,0,30,1,3,0,4,3,30,4,0,0,4,3,30,4,0,0,4,0,30,3,1,0,4,0,30,3,0,0,3,1,-15,3,1
2,3,24,0,30,6,0,0,6,3,30,3,1,0,4,9,30,6,0,0,6,0,30,1,5,0,6,0,30,4,0,0,4,1,-15,3,1
2,3,26,0,30,8,1,0,9,3,30,4,0,0,4,6,30,4,5,0,9,0,30,2,7,0,9,3,30,2,1,0,3,1,-15,3,1
2,3,13,1,30,5,2,0,7,0,30,4,0,0,4,8,30,7,0,0,7,5,30,6,1,0,7,5,30,4,0,0,4,1,-15,3,1
2,1,5,1,30,6,6,0,12,2,30,7,3,0,10,0,30,4,8,0,12,0,30,6,6,0,12,2,30,4,2,0,6,0,-27,3,0
2,3,9,0,30,3,1,0,4,1,30,2,0,0,2,6,30,4,0,0,4,0,30,1,3,0,4,1,30,1,0,0,1,0,-27,3,0
2,3,14,0,30,4,5,0,9,0,30,5,1,0,6,3,30,9,0,0,9,1,30,9,0,0,9,4,30,4,0,0,4,1,-15,3,1
2,2,24,1,30,3,3,0,6,3,30,3,1,0,4,4,30,4,2,0,6,0,30,1,5,0,6,4,30,4,0,0,4,1,-15,3,1
2,4,32,0,30,2,7,0,9,3,30,2,0,0,2,3,30,7,2,0,9,1,30,3,6,0,9,3,30,2,0,0,2,1,-15,3,1
2,4,31,0,30,0,4,0,4,2,30,4,0,0,4,5,30,4,0,0,4,0,30,1,3,0,4,0,30,3,0,0,3,1,-15,3,1
2,2,4,2,30,8,0,0,8,0,30,4,0,0,4,0,30,6,2,0,8,0,30,3,5,0,8,1,30,3,1,0,4,0,-27,3,0
2,3,7,1,30,4,5,0,9,1,30,4,0,0,4,1,30,8,1,0,9,0,30,3,6,0,9,1,30,4,2,0,6,0,-27,3,0
2,4,16,0,30,4,5,0,9,1,30,8,0,0,8,0,30,3,6,0,9,0,30,0,9,0,9,0,30,3,1,0,4,1,-15,3,1
2,3,17,2,30,2,2,0,4,0,30,2,0,0,2,1,30,2,2,0,4,2,30,1,3,0,4,4,30,1,0,0,1,1,-15,3,1
2,4,24,1,30,6,0,0,6,2,30,4,0,0,4,0,30,4,2,0,6,0,30,1,5,0,6,1,30,4,0,0,4,1,-15,3,1
2,4,9,0,30,3,1,0,4,1,30,2,0,0,2,2,30,4,0,0,4,0,30,1,3,0,4,0,30,1,0,0,1,0,-27,3,0
2,4,28,0,30,5,3,0,8,4,30,4,0,0,4,0,30,5,3,0,8,0,30,4,4,0,8,3,30,4,0,0,4,1,-15,3,1
2,4,17,1,30,2,2,0,4,1,30,2,0,0,2,2,30,1,3,0,4,0,30,1,3,0,4,2,30,1,0,0,1,1,-15,3,1
2,4,24,0,30,5,1,0,6,2,30,3,1,0,4,2,30,6,0,0,6,0,30,1,5,0,6,5,30,4,0,0,4,1,-15,3,1
2,4,7,1,30,5,4,0,9,3,30,4,0,0,4,8,30,6,3,0,9,4,30,3,6,0,9,1,30,4,2,0,6,0,-27,3,0
2,4,7,0,30,4,5,0,9,3,30,4,0,0,4,0,30,6,3,0,9,3,30,5,4,0,9,3,30,6,0,0,6,0,-27,3,0
2,1,24,1,30,6,0,0,6,2,30,3,1,0,4,2,30,6,0,0,6,2,30,2,4,0,6,0,30,3,1,0,4,1,-15,3,1
2,3,23,0,30,1,4,0,5,1,30,4,0,0,4,3,30,4,1,0,5,0,30,0,5,0,5,3,30,2,0,0,2,1,-15,3,1
2,1,23,0,30,2,3,0,5,2,30,4,0,0,4,7,30,4,1,0,5,0,30,0,5,0,5,1,30,2,0,0,2,1,-15,3,1
2,1,3,1,30,4,7,0,11,1,30,8,0,0,8,0,30,5,6,0,11,5,30,3,8,0,11,1,30,2,5,0,7,0,-27,3,0
2,3,20,0,30,2,6,0,8,0,30,6,2,0,8,0,30,5,3,0,8,5,30,1,7,0,8,3,30,5,0,0,5,1,-15,3,1
2,3,31,3,30,3,9,0,12,4,30,8,0,0,8,3,30,11,1,0,12,0,30,3,9,0,12,0,30,4,2,0,6,1,-15,3,1
2,4,3,4,30,4,7,0,11,0,30,7,1,0,8,3,30,9,2,0,11,5,30,2,9,0,11,1,30,4,3,0,7,0,-27,3,0
2,1,24,1,30,6,0,0,6,2,30,4,0,0,4,4,30,4,2,0,6,0,30,3,3,0,6,0,30,4,0,0,4,1,-15,3,1
2,0,31,1,30,2,2,0,4,4,30,4,0,0,4,4,30,1,3,0,4,0,30,1,3,0,4,0,30,2,1,0,3,1,-15,3,1
2,3,15,1,30,3,1,0,4,0,30,5,1,0,6,0,30,2,2,0,4,1,30,4,0,0,4,1,30,4,0,0,4,1,-15,3,1
2,2,9,1,30,7,4,0,11,1,30,6,0,0,6,1,30,10,1,0,11,1,30,3,8,0,11,3,30,3,1,0,4,0,-27,3,0
2,2,15,0,30,2,2,0,4,0,30,5,1,0,6,4,30,2,2,0,4,1,30,2,2,0,4,0,30,4,0,0,4,1,-15,3,1
2,3,9,0,30,2,2,0,4,1,30,2,0,0,2,2,30,4,0,0,4,0,30,1,3,0,4,2,30,1,0,0,1,0,-27,3,0
2,3,23,0,30,2,3,0,5,2,30,4,0,0,4,7,30,5,0,0,5,0,30,0,5,0,5,2,30,2,0,0,2,1,-15,3,1
2,4,23,0,30,4,1,0,5,2,30,4,0,0,4,3,30,2,3,0,5,0,30,0,5,0,5,2,30,2,0,0,2,1,-15,3,1
2,1,29,1,30,2,3,0,5,3,30,8,0,0,8,0,30,4,1,0,5,0,30,1,4,0,5,1,30,4,0,0,4,1,-15,3,1
2,3,5,0,30,2,3,0,5,2,30,3,1,0,4,1,30,2,3,0,5,0,30,3,2,0,5,0,30,0,2,0,2,0,-27,3,0
2,4,13,0,30,3,0,0,3,0,30,2,0,0,2,1,30,3,0,0,3,7,30,3,0,0,3,2,30,2,0,0,2,1,-15,3,1
2,1,23,0,30,4,1,0,5,1,30,4,0,0,4,4,30,4,1,0,5,0,30,0,5,0,5,4,30,2,0,0,2,1,-15,3,1
2,4,5,0,30,1,4,0,5,0,30,3,1,0,4,0,30,0,5,0,5,0,30,2,3,0,5,0,30,2,0,0,2,0,-27,3,0
2,2,5,1,30,6,6,0,12,0,30,6,4,0,10,0,30,10,2,0,12,0,30,9,3,0,12,3,30,4,2,0,6,0,-27,3,0
2,3,7,0,30,1,3,0,4,0,30,2,0,0,2,4,30,4,0,0,4,0,30,1,3,0,4,1,30,1,1,0,2,0,-27,3,0
2,4,31,0,30,1,3,0,4,3,30,4,0,0,4,0,30,1,3,0,4,0,30,3,1,0,4,2,30,3,0,0,3,1,-15,3,1
2,3,17,1,30,1,3,0,4,0,30,2,0,0,2,2,30,3,1,0,4,2,30,2,2,0,4,3,30,1,0,0,1,1,-15,3,1
2,2,17,1,30,2,2,0,4,0,30,2,0,0,2,2,30,1,3,0,4,5,30,1,3,0,4,2,30,1,0,0,1,1,-15,3,1
2,2,24,0,30,3,3,0,6,2,30,4,0,0,4,4,30,5,1,0,6,0,30,1,5,0,6,5,30,4,0,0,4,1,-15,3,1
2,1,15,5,30,2,2,0,4,0,30,6,0,0,6,1,30,4,0,0,4,1,30,1,3,0,4,2,30,4,0,0,4,1,-15,3,1
2,2,23,0,30,2,3,0,5,1,30,4,0,0,4,6,30,5,0,0,5,0,30,0,5,0,5,5,30,1,1,0,2,1,-15,3,1
2,2,5,0,30,2,3,0,5,2,30,2,2,0,4,0,30,3,2,0,5,0,30,1,4,0,5,0,30,1,1,0,2,0,-27,3,0
2,3,31,0,30,1,3,0,4,2,30,4,0,0,4,1,30,4,0,0,4,0,30,1,3,0,4,0,30,3,0,0,3,1,-15,3,1
2,4,24,1,30,4,2,0,6,2,30,3,1,0,4,0,30,3,3,0,6,0,30,1,5,0,6,4,30,4,0,0,4,1,-15,3,1
2,3,28,0,30,1,7,0,8,4,30,4,0,0,4,0,30,4,4,0,8,0,30,7,1,0,8,2,30,4,0,0,4,1,-15,3,1
2,1,28,2,30,3,5,0,8,5,30,4,0,0,4,2,30,2,6,0,8,0,30,5,3,0,8,1,30,4,0,0,4,1,-15,3,1
2,4,3,0,30,3,8,0,11,2,30,8,0,0,8,0,30,3,8,0,11,0,30,6,5,0,11,1,30,3,4,0,7,0,-27,3,0
2,4,17,1,30,2,2,0,4,0,30,2,0,0,2,1,30,3,1,0,4,2,30,1,3,0,4,4,30,1,0,0,1,1,-15,3,1
2,4,7,0,30,2,7,0,9,1,30,4,0,0,4,3,30,6,3,0,9,1,30,4,5,0,9,4,30,6,0,0,6,0,-27,3,0
2,3,3,1,30,4,7,0,11,2,30,8,0,0,8,0,30,6,5,0,11,0,30,6,5,0,11,1,30,2,5,0,7,0,-27,3,0
2,3,25,2,30,4,0,0,4,1,30,2,0,0,2,1,30,4,0,0,4,0,30,3,1,0,4,0,30,0,1,0,1,1,-15,3,1
2,2,25,4,30,2,2,0,4,3,30,2,0,0,2,0,30,2,2,0,4,0,30,0,4,0,4,0,30,1,0,0,1,1,-15,3,1
2,0,33,1,30,2,9,0,11,4,30,4,0,0,4,7,30,11,0,0,11,2,30,3,8,0,11,6,30,4,0,0,4,1,-15,3,1
2,4,9,1,30,4,0,0,4,2,30,2,0,0,2,6,30,4,0,0,4,0,30,1,3,0,4,1,30,1,0,0,1,0,-27,3,0
2,1,31,0,30,0,4,0,4,4,30,4,0,0,4,0,30,1,3,0,4,2,30,3,1,0,4,1,30,3,0,0,3,1,-15,3,1
2,4,14,0,30,5,4,0,9,0,30,6,0,0,6,0,30,9,0,0,9,0,30,7,2,0,9,4,30,4,0,0,4,1,-15,3,1
2,1,24,0,30,6,0,0,6,2,30,3,1,0,4,2,30,6,0,0,6,0,30,1,5,0,6,2,30,4,0,0,4,1,-15,3,1
2,1,28,0,30,1,7,0,8,3,30,4,0,0,4,0,30,7,1,0,8,0,30,2,6,0,8,2,30,4,0,0,4,1,-15,3,1
2,2,20,1,30,3,5,0,8,1,30,6,2,0,8,0,30,6,2,0,8,0,30,6,2,0,8,2,30,4,1,0,5,1,-15,3,1
2,4,7,1,30,3,6,0,9,2,30,4,0,0,4,1,30,6,3,0,9,4,30,2,7,0,9,3,30,5,1,0,6,0,-27,3,0
2,2,17,2,30,4,0,0,4,1,30,2,0,0,2,1,30,3,1,0,4,2,30,1,3,0,4,2,30,1,0,0,1,1,-15,3,1
2,1,5,1,30,8,4,0,12,3,30,5,5,0,10,3,30,6,6,0,12,0,30,7,5,0,12,1,30,1,5,0,6,0,-27,3,0
2,2,15,2,30,3,1,0,4,0,30,6,0,0,6,0,30,2,2,0,4,1,30,2,2,0,4,0,30,4,0,0,4,1,-15,3,1
2,2,23,0,30,2,3,0,5,1,30,4,0,0,4,0,30,4,1,0,5,0,30,0,5,0,5,0,30,2,0,0,2,1,-15,3,1
2,2,23,0,30,3,2,0,5,1,30,4,0,0,4,2,30,4,1,0,5,0,30,0,5,0,5,5,30,2,0,0,2,1,-15,3,1
2,4,25,2,30,0,4,0,4,2,30,2,0,0,2,0,30,1,3,0,4,0,30,1,3,0,4,3,30,1,0,0,1,1,-15,3,1
2,4,13,3,30,7,0,0,7,1,30,4,0,0,4,2,30,6,1,0,7,0,30,6,1,0,7,4,30,4,0,0,4,1,-15,3,1
2,4,7,0,30,5,4,0,9,2,30,4,0,0,4,2,30,6,3,0,9,4,30,3,6,0,9,1,30,4,2,0,6,0,-27,3,0
2,4,27,0,30,1,4,0,5,1,30,0,0,0,0,0,30,4,1,0,5,1,30,5,0,0,5,3,30,4,0,0,4,1,-15,3,1
2,3,9,0,30,1,3,0,4,0,30,2,0,0,2,5,30,4,0,0,4,0,30,1,3,0,4,1,30,1,0,0,1,0,-27,3,0
2,3,24,0,30,3,3,0,6,1,30,4,0,0,4,0,30,4,2,0,6,0,30,2,4,0,6,3,30,4,0,0,4,1,-15,3,1
2,1,20,0,30,2,6,0,8,1,30,7,1,0,8,0,30,3,5,0,8,0,30,4,4,0,8,1,30,3,2,0,5,1,-15,3,1
2,4,17,1,30,1,3,0,4,0,30,2,0,0,2,2,30,1,3,0,4,2,30,0,4,0,4,4,30,1,0,0,1,1,-15,3,1
2,1,23,0,30,2,3,0,5,2,30,4,0,0,4,11,30,5,0,0,5,0,30,0,5,0,5,1,30,1,1,0,2,1,-15,3,1
2,3,5,2,30,4,8,0,12,2,30,5,5,0,10,0,30,8,4,0,12,0,30,7,5,0,12,0,30,4,2,0,6,0,-27,3,0
2,4,15,0,30,2,2,0,4,0,30,6,0,0,6,1,30,3,1,0,4,3,30,4,0,0,4,0,30,4,0,0,4,1,-15,3,1
2,2,9,0,30,2,2,0,4,1,30,2,0,0,2,0,30,3,1,0,4,0,30,1,3,0,4,0,30,1,0,0,1,0,-27,3,0
2,3,9,0,30,2,2,0,4,1,30,2,0,0,2,3,30,3,1,0,4,0,30,1,3,0,4,3,30,1,0,0,1,0,-27,3,0
2,4,9,2,30,3,1,0,4,2,30,2,0,0,2,0,30,3,1,0,4,0,30,1,3,0,4,1,30,1,0,0,1,0,-27,3,0
2,3,5,0,30,1,4,0,5,2,30,4,0,0,4,4,30,3,2,0,5,0,30,1,4,0,5,0,30,0,2,0,2,0,-27,3,0
2,1,5,0,30,2,3,0,5,2,30,2,2,0,4,3,30,1,4,0,5,0,30,1,4,0,5,1,30,0,2,0,2,0,-27,3,0
2,2,31,0,30,1,3,0,4,3,30,4,0,0,4,0,30,1,3,0,4,0,30,1,3,0,4,0,30,0,3,0,3,1,-15,3,1
2,2,24,0,30,2,4,0,6,2,30,4,0,0,4,4,30,5,1,0,6,0,30,1,5,0,6,0,30,4,0,0,4,1,-15,3,1
2,4,7,0,30,3,6,0,9,1,30,4,0,0,4,0,30,8,1,0,9,0,30,2,7,0,9,2,30,5,1,0,6,0,-27,3,0
2,3,5,1,30,6,6,0,12,2,30,4,6,0,10,2,30,6,6,0,12,0,30,7,5,0,12,1,30,3,3,0,6,0,-27,3,0
2,1,31,0,30,0,4,0,4,3,30,4,0,0,4,3,30,4,0,0,4,0,30,1,3,0,4,0,30,3,0,0,3,1,-15,3,1
2,4,5,0,30,6,6,0,12,2,30,8,2,0,10,0,30,5,7,0,12,0,30,8,4,0,12,1,30,1,5,0,6,0,-27,3,0
2,3,32,0,30,2,7,0,9,2,30,2,0,0,2,0,30,7,2,0,9,1,30,3,6,0,9,2,30,2,0,0,2,1,-15,3,1
2,0,28,0,30,5,3,0,8,3,30,4,0,0,4,0,30,8,0,0,8,0,30,2,6,0,8,2,30,4,0,0,4,1,-15,3,1
2,4,31,0,30,1,3,0,4,1,30,4,0,0,4,2,30,4,0,0,4,0,30,1,3,0,4,1,30,3,0,0,3,1,-15,3,1
2,3,4,2,30,8,0,0,8,3,30,4,0,0,4,0,30,7,1,0,8,0,30,2,6,0,8,2,30,4,0,0,4,0,-27,3,0
2,3,23,0,30,2,3,0,5,2,30,4,0,0,4,5,30,5,0,0,5,0,30,0,5,0,5,2,30,2,0,0,2,1,-15,3,1
2,3,27,0,30,1,4,0,5,0,30,0,0,0,0,0,30,5,0,0,5,5,30,5,0,0,5,0,30,2,2,0,4,1,-15,3,1
2,3,5,1,30,5,7,0,12,3,30,7,3,0,10,3,30,5,7,0,12,0,30,7,5,0,12,0,30,2,4,0,6,0,-27,3,0
2,4,30,0,30,3,2,0,5,4,30,2,0,0,2,2,30,2,3,0,5,3,30,1,4,0,5,1,30,2,1,0,3,1,-15,3,1
2,4,7,0,30,4,5,0,9,2,30,4,0,0,4,0,30,6,3,0,9,5,30,4,5,0,9,2,30,6,0,0,6,0,-27,3,0
2,4,21,2,30,0,3,0,3,0,30,2,0,0,2,0,30,2,1,0,3,0,30,0,3,0,3,2,30,1,0,0,1,1,-15,3,1
2,4,7,1,30,3,6,0,9,2,30,3,1,0,4,0,30,8,1,0,9,4,30,2,7,0,9,0,30,4,2,0,6,0,-27,3,0
2,4,23,0,30,1,4,0,5,1,30,4,0,0,4,3,30,5,0,0,5,0,30,0,5,0,5,1,30,2,0,0,2,1,-15,3,1
2,4,23,0,30,2,3,0,5,2,30,4,0,0,4,6,30,5,0,0,5,0,30,0,5,0,5,0,30,1,1,0,2,1,-15,3,1
2,3,5,1,30,6,6,0,12,2,30,8,2,0,10,0,30,5,7,0,12,0,30,7,5,0,12,1,30,3,3,0,6,0,-27,3,0
2,4,31,1,30,3,1,0,4,2,30,4,0,0,4,1,30,4,0,0,4,0,30,1,3,0,4,0,30,2,1,0,3,1,-15,3,1
2,3,20,0,30,2,6,0,8,1,30,6,2,0,8,0,30,8,0,0,8,0,30,1,7,0,8,1,30,5,0,0,5,1,-15,3,1
2,3,13,2,30,5,2,0,7,0,30,4,0,0,4,2,30,6,1,0,7,1,30,5,2,0,7,4,30,4,0,0,4,1,-15,3,1
2,4,9,1,30,6,5,0,11,1,30,6,0,0,6,5,30,10,1,0,11,3,30,3,8,0,11,3,30,3,1,0,4,0,-27,3,0
2,4,25,1,30,0,4,0,4,2,30,2,0,0,2,0,30,3,1,0,4,3,30,0,4,0,4,0,30,1,0,0,1,1,-15,3,1
2,3,31,0,30,2,2,0,4,3,30,4,0,0,4,5,30,4,0,0,4,0,30,1,3,0,4,0,30,0,3,0,3,1,-15,3,1
2,3,24,0,30,3,3,0,6,2,30,3,1,0,4,4,30,6,0,0,6,0,30,1,5,0,6,0,30,3,1,0,4,1,-15,3,1
2,4,23,0,30,3,2,0,5,0,30,4,0,0,4,7,30,3,2,0,5,0,30,0,5,0,5,2,30,2,0,0,2,1,-15,3,1
2,3,31,2,30,6,6,0,12,4,30,8,0,0,8,9,30,11,1,0,12,0,30,3,9,0,12,0,30,1,5,0,6,1,-15,3,1
2,4,31,0,30,0,4,0,4,3,30,4,0,0,4,3,30,4,0,0,4,0,30,3,1,0,4,0,30,3,0,0,3,1,-15,3,1
2,4,30,2,30,3,2,0,5,5,30,2,0,0,2,1,30,1,4,0,5,4,30,1,4,0,5,0,30,3,0,0,3,1,-15,3,1
2,4,27,0,30,1,4,0,5,1,30,0,0,0,0,4,30,2,3,0,5,0,30,2,3,0,5,5,30,4,0,0,4,1,-15,3,1
2,1,23,0,30,3,2,0,5,1,30,4,0,0,4,0,30,3,2,0,5,0,30,4,1,0,5,0,30,2,0,0,2,1,-15,3,1
2,2,29,1,30,2,3,0,5,4,30,8,0,0,8,0,30,1,4,0,5,0,30,3,2,0,5,1,30,4,0,0,4,1,-15,3,1
2,2,25,6,30,1,3,0,4,3,30,2,0,0,2,0,30,3,1,0,4,0,30,2,2,0,4,2,30,1,0,0,1,1,-15,3,1
2,1,31,0,30,1,3,0,4,3,30,4,0,0,4,4,30,4,0,0,4,0,30,1,3,0,4,2,30,3,0,0,3,1,-15,3,1
2,1,5,1,30,5,7,0,12,1,30,5,5,0,10,0,30,8,4,0,12,0,30,7,5,0,12,2,30,4,2,0,6,0,-27,3,0
2,3,5,0,30,5,7,0,12,2,30,8,2,0,10,0,30,4,8,0,12,1,30,7,5,0,12,3,30,6,0,0,6,0,-27,3,0
2,4,24,1,30,6,0,0,6,3,30,3,1,0,4,6,30,5,1,0,6,0,30,1,5,0,6,0,30,4,0,0,4,1,-15,3,1
2,4,31,0,30,1,3,0,4,2,30,4,0,0,4,4,30,3,1,0,4,0,30,1,3,0,4,0,30,1,2,0,3,1,-15,3,1
2,2,9,1,30,7,4,0,11,1,30,6,0,0,6,1,30,11,0,0,11,1,30,3,8,0,11,2,30,2,2,0,4,0,-27,3,0
2,4,15,1,30,3,1,0,4,0,30,6,0,0,6,8,30,3,1,0,4,1,30,4,0,0,4,0,30,2,2,0,4,1,-15,3,1
2,2,5,1,30,4,8,0,12,2,30,5,5,0,10,0,30,5,7,0,12,0,30,7,5,0,12,2,30,6,0,0,6,0,-27,3,0
2,2,24,3,30,3,3,0,6,3,30,4,0,0,4,3,30,6,0,0,6,0,30,1,5,0,6,3,30,4,0,0,4,1,-15,3,1
2,2,5,1,30,5,7,0,12,2,30,6,4,0,10,0,30,3,9,0,12,0,30,8,4,0,12,1,30,1,5,0,6,0,-27,3,0
2,3,31,0,30,2,2,0,4,2,30,4,0,0,4,3,30,4,0,0,4,0,30,1,3,0,4,0,30,1,2,0,3,1,-15,3,1
2,2,9,0,30,2,2,0,4,1,30,2,0,0,2,0,30,4,0,0,4,0,30,1,3,0,4,0,30,1,0,0,1,0,-27,3,0
2,2,5,1,30,6,6,0,12,2,30,6,4,0,10,0,30,6,6,0,12,0,30,7,5,0,12,1,30,3,3,0,6,0,-27,3,0
2,3,5,1,30,5,7,0,12,2,30,2,8,0,10,0,30,7,5,0,12,1,30,8,4,0,12,2,30,4,2,0,6,0,-27,3,0
2,4,9,1,30,3,1,0,4,2,30,2,0,0,2,3,30,2,2,0,4,0,30,1,3,0,4,2,30,1,0,0,1,0,-27,3,0
2,3,9,0,30,1,3,0,4,1,30,2,0,0,2,2,30,4,0,0,4,0,30,1,3,0,4,2,30,1,0,0,1,0,-27,3,0
2,1,23,0,30,2,3,0,5,1,30,4,0,0,4,5,30,5,0,0,5,0,30,1,4,0,5,1,30,2,0,0,2,1,-15,3,1
2,2,25,1,30,0,4,0,4,2,30,2,0,0,2,4,30,4,0,0,4,0,30,0,4,0,4,1,30,1,0,0,1,1,-15,3,1
2,3,9,0,30,6,5,0,11,1,30,6,0,0,6,4,30,11,0,0,11,1,30,3,8,0,11,3,30,2,2,0,4,0,-27,3,0
2,3,3,0,30,3,8,0,11,0,30,8,0,0,8,0,30,2,9,0,11,2,30,5,6,0,11,1,30,2,5,0,7,0,-27,3,0
2,4,24,0,30,4,2,0,6,2,30,4,0,0,4,0,30,4,2,0,6,0,30,1,5,0,6,4,30,4,0,0,4,1,-15,3,1
2,3,9,0,30,2,2,0,4,1,30,2,0,0,2,0,30,4,0,0,4,0,30,0,4,0,4,1,30,1,0,0,1,0,-27,3,0
2,4,16,0,30,4,5,0,9,1,30,8,0,0,8,0,30,4,5,0,9,0,30,1,8,0,9,0,30,4,0,0,4,1,-15,3,1
2,4,9,1,30,7,4,0,11,3,30,6,0,0,6,4,30,9,2,0,11,2,30,7,4,0,11,3,30,2,2,0,4,0,-27,3,0
2,4,5,1,30,7,5,0,12,2,30,6,4,0,10,0,30,7,5,0,12,0,30,6,6,0,12,2,30,2,4,0,6,0,-27,3,0
2,4,16,0,30,5,4,0,9,1,30,7,1,0,8,0,30,3,6,0,9,0,30,0,9,0,9,1,30,4,0,0,4,1,-15,3,1
2,2,13,2,30,7,0,0,7,1,30,4,0,0,4,2,30,7,0,0,7,2,30,5,2,0,7,4,30,4,0,0,4,1,-15,3,1
2,4,27,0,30,2,3,0,5,1,30,0,0,0,0,2,30,5,0,0,5,0,30,3,2,0,5,3,30,4,0,0,4,1,-15,3,1
2,4,23,0,30,2,3,0,5,2,30,4,0,0,4,0,30,2,3,0,5,0,30,0,5,0,5,3,30,2,0,0,2,1,-15,3,1
2,2,9,2,30,4,0,0,4,3,30,2,0,0,2,5,30,2,2,0,4,0,30,1,3,0,4,3,30,1,0,0,1,0,-27,3,0
2,4,24,0,30,2,4,0,6,2,30,4,0,0,4,0,30,6,0,0,6,0,30,2,4,0,6,1,30,4,0,0,4,1,-15,3,1
2,4,9,0,30,2,2,0,4,2,30,2,0,0,2,0,30,1,3,0,4,0,30,1,3,0,4,1,30,1,0,0,1,0,-27,3,0
2,4,29,0,30,0,5,0,5,4,30,8,0,0,8,0,30,1,4,0,5,0,30,0,5,0,5,0,30,4,0,0,4,1,-15,3,1
2,1,31,0,30,0,4,0,4,2,30,4,0,0,4,1,30,4,0,0,4,0,30,1,3,0,4,0,30,3,0,0,3,1,-15,3,1
2,4,31,3,30,5,7,0,12,3,30,8,0,0,8,6,30,12,0,0,12,0,30,3,9,0,12,0,30,1,5,0,6,1,-15,3,1
2,3,31,0,30,2,2,0,4,3,30,4,0,0,4,1,30,2,2,0,4,0,30,4,0,0,4,0,30,2,1,0,3,1,-15,3,1
2,4,24,0,30,3,3,0,6,3,30,3,1,0,4,3,30,2,4,0,6,0,30,1,5,0,6,5,30,4,0,0,4,1,-15,3,1
2,4,13,7,30,7,0,0,7,0,30,4,0,0,4,6,30,7,0,0,7,3,30,5,2,0,7,0,30,3,1,0,4,1,-15,3,1
2,4,5,0,30,2,3,0,5,2,30,3,1,0,4,0,30,3,2,0,5,0,30,1,4,0,5,1,30,0,2,0,2,0,-27,3,0
2,3,3,0,30,5,6,0,11,2,30,8,0,0,8,1,30,6,5,0,11,1,30,8,3,0,11,1,30,2,5,0,7,0,-27,3,0
2,4,32,0,30,4,5,0,9,4,30,2,0,0,2,3,30,9,0,0,9,1,30,2,7,0,9,3,30,2,0,0,2,1,-15,3,1
2,3,7,1,30,4,5,0,9,2,30,4,0,0,4,2,30,6,3,0,9,1,30,3,6,0,9,1,30,5,1,0,6,0,-27,3,0
2,0,5,1,30,8,4,0,12,3,30,4,6,0,10,4,30,6,6,0,12,0,30,6,6,0,12,1,30,3,3,0,6,0,-27,3,0
2,2,24,0,30,5,1,0,6,2,30,3,1,0,4,4,30,6,0,0,6,0,30,1,5,0,6,1,30,4,0,0,4,1,-15,3,1
2,4,27,0,30,1,4,0,5,1,30,0,0,0,0,4,30,5,0,0,5,0,30,2,3,0,5,0,30,3,1,0,4,1,-15,3,1
2,4,24,0,30,5,1,0,6,2,30,4,0,0,4,0,30,6,0,0,6,0,30,1,5,0,6,3,30,4,0,0,4,1,-15,3,1
2,4,25,0,30,1,3,0,4,0,30,2,0,0,2,3,30,4,0,0,4,0,30,1,3,0,4,5,30,1,0,0,1,1,-15,3,1
2,4,7,0,30,1,3,0,4,1,30,2,0,0,2,2,30,2,2,0,4,0,30,1,3,0,4,2,30,2,0,0,2,0,-27,3,0
2,3,30,5,30,2,3,0,5,4,30,2,0,0,2,2,30,2,3,0,5,3,30,1,4,0,5,0,30,2,1,0,3,1,-15,3,1
2,4,9,1,30,5,6,0,11,2,30,6,0,0,6,1,30,10,1,0,11,2,30,3,8,0,11,2,30,3,1,0,4,0,-27,3,0
2,4,7,0,30,2,2,0,4,0,30,2,0,0,2,0,30,1,3,0,4,0,30,1,3,0,4,2,30,2,0,0,2,0,-27,3,0
2,3,24,4,30,6,0,0,6,4,30,4,0,0,4,4,30,1,5,0,6,0,30,1,5,0,6,0,30,4,0,0,4,1,-15,3,1
2,4,31,0,30,2,2,0,4,3,30,4,0,0,4,3,30,2,2,0,4,0,30,1,3,0,4,2,30,3,0,0,3,1,-15,3,1
2,1,28,0,30,1,7,0,8,4,30,4,0,0,4,0,30,1,7,0,8,0,30,5,3,0,8,3,30,4,0,0,4,1,-15,3,1
2,2,4,4,30,8,0,0,8,3,30,4,0,0,4,0,30,6,2,0,8,0,30,3,5,0,8,1,30,3,1,0,4,0,-27,3,0
2,4,23,0,30,2,3,0,5,2,30,4,0,0,4,4,30,1,4,0,5,0,30,0,5,0,5,0,30,1,1,0,2,1,-15,3,1
2,3,24,0,30,5,1,0,6,2,30,3,1,0,4,5,30,6,0,0,6,0,30,1,5,0,6,0,30,3,1,0,4,1,-15,3,1
2,4,7,1,30,3,6,0,9,2,30,4,0,0,4,0,30,5,4,0,9,0,30,4,5,0,9,1,30,4,2,0,6,0,-27,3,0
2,3,20,0,30,1,7,0,8,1,30,8,0,0,8,1,30,6,2,0,8,0,30,4,4,0,8,1,30,4,1,0,5,1,-15,3,1
2,1,28,0,30,1,7,0,8,5,30,4,0,0,4,1,30,1,7,0,8,0,30,6,2,0,8,4,30,4,0,0,4,1,-15,3,1
2,1,7,0,30,4,5,0,9,1,30,4,0,0,4,7,30,8,1,0,9,5,30,4,5,0,9,4,30,4,2,0,6,0,-27,3,0
2,2,9,0,30,6,5,0,11,0,30,6,0,0,6,5,30,10,1,0,11,3,30,3,8,0,11,2,30,4,0,0,4,0,-27,3,0
2,4,27,0,30,1,4,0,5,1,30,0,0,0,0,0,30,3,2,0,5,0,30,2,3,0,5,4,30,4,0,0,4,1,-15,3,1
2,4,9,0,30,2,2,0,4,2,30,1,1,0,2,5,30,1,3,0,4,0,30,1,3,0,4,1,30,1,0,0,1,0,-27,3,0
2,2,31,2,30,1,3,0,4,4,30,4,0,0,4,4,30,2,2,0,4,1,30,2,2,0,4,0,30,3,0,0,3,1,-15,3,1
2,3,7,1,30,4,5,0,9,2,30,4,0,0,4,2,30,6,3,0,9,4,30,3,6,0,9,1,30,6,0,0,6,0,-27,3,0
2,3,7,0,30,4,5,0,9,2,30,4,0,0,4,1,30,6,3,0,9,2,30,2,7,0,9,2,30,5,1,0,6,0,-27,3,0
2,4,3,0,30,2,2,0,4,2,30,4,0,0,4,2,30,1,3,0,4,0,30,0,4,0,4,0,30,1,2,0,3,0,-27,3,0
2,3,24,1,30,6,0,0,6,3,30,3,1,0,4,7,30,2,4,0,6,0,30,1,5,0,6,4,30,4,0,0,4,1,-15,3,1
2,2,24,0,30,5,1,0,6,2,30,3,1,0,4,5,30,6,0,0,6,0,30,1,5,0,6,0,30,4,0,0,4,1,-15,3,1
2,4,15,0,30,1,3,0,4,0,30,6,0,0,6,0,30,2,2,0,4,6,30,4,0,0,4,0,30,2,2,0,4,1,-15,3,1
2,3,13,3,30,7,0,0,7,1,30,4,0,0,4,10,30,6,1,0,7,2,30,5,2,0,7,5,30,4,0,0,4,1,-15,3,1
2,3,5,1,30,4,8,0,12,2,30,9,1,0,10,0,30,6,6,0,12,1,30,8,4,0,12,2,30,4,2,0,6,0,-27,3,0
2,2,31,1,30,2,2,0,4,4,30,4,0,0,4,0,30,1,3,0,4,0,30,1,3,0,4,1,30,3,0,0,3,1,-15,3,1
2,4,30,3,30,3,2,0,5,3,30,2,0,0,2,1,30,2,3,0,5,3,30,2,3,0,5,1,30,3,0,0,3,1,-15,3,1
2,4,9,0,30,3,1,0,4,2,30,2,0,0,2,3,30,4,0,0,4,0,30,1,3,0,4,0,30,1,0,0,1,0,-27,3,0
2,3,31,0,30,2,2,0,4,3,30,4,0,0,4,1,30,2,2,0,4,1,30,2,2,0,4,0,30,3,0,0,3,1,-15,3,1
2,3,9,0,30,7,4,0,11,1,30,6,0,0,6,1,30,10,1,0,11,5,30,3,8,0,11,4,30,4,0,0,4,0,-27,3,0
2,3,32,0,30,1,8,0,9,3,30,2,0,0,2,0,30,6,3,0,9,1,30,2,7,0,9,4,30,2,0,0,2,1,-15,3,1
2,4,25,2,30,0,4,0,4,1,30,2,0,0,2,0,30,2,2,0,4,0,30,2,2,0,4,4,30,1,0,0,1,1,-15,3,1
2,4,23,2,30,5,0,0,5,0,30,4,0,0,4,4,30,5,0,0,5,0,30,0,5,0,5,1,30,2,0,0,2,1,-15,3,1
2,4,29,0,30,0,5,0,5,4,30,8,0,0,8,0,30,3,2,0,5,0,30,2,3,0,5,1,30,4,0,0,4,1,-15,3,1
2,3,33,1,30,2,9,0,11,5,30,4,0,0,4,10,30,8,3,0,11,1,30,4,7,0,11,7,30,4,0,0,4,1,-15,3,1
2,4,31,0,30,0,4,0,4,2,30,4,0,0,4,3,30,2,2,0,4,0,30,1,3,0,4,1,30,3,0,0,3,1,-15,3,1
2,2,5,0,30,2,3,0,5,2,30,3,1,0,4,4,30,2,3,0,5,0,30,1,4,0,5,1,30,0,2,0,2,0,-27,3,0
2,1,31,0,30,0,4,0,4,1,30,4,0,0,4,1,30,4,0,0,4,0,30,1,3,0,4,0,30,2,1,0,3,1,-15,3,1
2,3,5,0,30,6,6,0,12,2,30,6,4,0,10,0,30,6,6,0,12,0,30,7,5,0,12,2,30,5,1,0,6,0,-27,3,0
2,3,25,3,30,0,4,0,4,3,30,2,0,0,2,0,30,1,3,0,4,0,30,0,4,0,4,0,30,1,0,0,1,1,-15,3,1
2,4,24,0,30,5,1,0,6,2,30,4,0,0,4,2,30,6,0,0,6,0,30,2,4,0,6,1,30,4,0,0,4,1,-15,3,1
2,4,9,0,30,6,5,0,11,2,30,6,0,0,6,5,30,9,2,0,11,1,30,3,8,0,11,2,30,4,0,0,4,0,-27,3,0
2,4,7,0,30,2,2,0,4,2,30,2,0,0,2,2,30,2,2,0,4,0,30,1,3,0,4,1,30,2,0,0,2,0,-27,3,0
2,4,30,2,30,3,2,0,5,4,30,2,0,0,2,1,30,1,4,0,5,2,30,1,4,0,5,1,30,3,0,0,3,1,-15,3,1
2,4,5,1,30,7,5,0,12,2,30,6,4,0,10,1,30,5,7,0,12,0,30,7,5,0,12,1,30,3,3,0,6,0,-27,3,0
2,4,20,5,30,3,5,0,8,1,30,8,0,0,8,0,30,5,3,0,8,0,30,1,7,0,8,1,30,3,2,0,5,1,-15,3,1
2,1,5,0,30,1,4,0,5,2,30,4,0,0,4,0,30,2,3,0,5,0,30,1,4,0,5,1,30,1,1,0,2,0,-27,3,0
2,3,17,1,30,1,3,0,4,1,30,2,0,0,2,2,30,0,4,0,4,2,30,1,3,0,4,0,30,1,0,0,1,1,-15,3,1
2,4,23,0,30,2,3,0,5,1,30,4,0,0,4,2,30,5,0,0,5,0,30,0,5,0,5,5,30,2,0,0,2,1,-15,3,1
2,4,30,2,30,2,3,0,5,3,30,2,0,0,2,1,30,2,3,0,5,4,30,2,3,0,5,2,30,3,0,0,3,1,-15,3,1
2,2,5,1,30,6,6,0,12,2,30,6,4,0,10,0,30,7,5,0,12,0,30,6,6,0,12,1,30,4,2,0,6,0,-27,3,0
2,3,25,3,30,1,3,0,4,2,30,2,0,0,2,1,30,4,0,0,4,0,30,0,4,0,4,0,30,1,0,0,1,1,-15,3,1
2,3,12,0,30,5,2,0,7,0,30,3,3,0,6,0,30,6,1,0,7,3,30,6,1,0,7,5,30,3,0,0,3,1,-15,3,1
2,4,31,0,30,1,3,0,4,3,30,4,0,0,4,4,30,3,1,0,4,0,30,1,3,0,4,0,30,3,0,0,3,1,-15,3,1
2,1,26,0,30,6,3,0,9,4,30,4,0,0,4,4,30,5,4,0,9,0,30,1,8,0,9,1,30,3,0,0,3,1,-15,3,1
2,4,9,0,30,3,1,0,4,2,30,2,0,0,2,3,30,1,3,0,4,0,30,1,3,0,4,3,30,1,0,0,1,0,-27,3,0
2,2,25,3,30,1,3,0,4,3,30,2,0,0,2,5,30,4,0,0,4,0,30,0,4,0,4,1,30,1,0,0,1,1,-15,3,1
2,3,24,0,30,4,2,0,6,2,30,3,1,0,4,0,30,6,0,0,6,0,30,1,5,0,6,4,30,4,0,0,4,1,-15,3,1
2,4,27,0,30,4,1,0,5,1,30,0,0,0,0,2,30,5,0,0,5,0,30,2,3,0,5,2,30,4,0,0,4,1,-15,3,1
2,4,5,0,30,8,4,0,12,2,30,5,5,0,10,0,30,4,8,0,12,0,30,6,6,0,12,2,30,4,2,0,6,0,-27,3,0
2,3,5,1,30,6,6,0,12,2,30,6,4,0,10,0,30,6,6,0,12,0,30,6,6,0,12,0,30,5,1,0,6,0,-27,3,0
2,4,27,0,30,1,4,0,5,2,30,0,0,0,0,0,30,4,1,0,5,0,30,2,3,0,5,0,30,4,0,0,4,1,-15,3,1
2,3,23,0,30,3,2,0,5,0,30,4,0,0,4,8,30,5,0,0,5,0,30,0,5,0,5,0,30,2,0,0,2,1,-15,3,1
2,3,25,0,30,1,3,0,4,0,30,2,0,0,2,0,30,1,3,0,4,0,30,0,4,0,4,1,30,1,0,0,1,1,-15,3,1
2,4,16,0,30,6,3,0,9,2,30,7,1,0,8,3,30,2,7,0,9,0,30,1,8,0,9,0,30,1,3,0,4,1,-15,3,1
2,3,23,0,30,2,3,0,5,0,30,4,0,0,4,1,30,5,0,0,5,0,30,0,5,0,5,1,30,1,1,0,2,1,-15,3,1
2,4,31,0,30,0,4,0,4,3,30,4,0,0,4,7,30,4,0,0,4,0,30,3,1,0,4,0,30,3,0,0,3,1,-15,3,1
2,1,25,3,30,3,1,0,4,2,30,2,0,0,2,3,30,4,0,0,4,0,30,0,4,0,4,0,30,1,0,0,1,1,-15,3,1
2,4,15,0,30,3,1,0,4,0,30,5,1,0,6,0,30,2,2,0,4,3,30,4,0,0,4,3,30,4,0,0,4,1,-15,3,1
2,4,31,0,30,3,1,0,4,2,30,4,0,0,4,0,30,4,0,0,4,0,30,1,3,0,4,0,30,1,2,0,3,1,-15,3,1
2,4,9,4,30,2,2,0,4,0,30,2,0,0,2,4,30,1,3,0,4,0,30,1,3,0,4,2,30,1,0,0,1,0,-27,3,0
2,4,24,0,30,6,0,0,6,3,30,4,0,0,4,7,30,6,0,0,6,0,30,1,5,0,6,2,30,4,0,0,4,1,-15,3,1
2,3,31,0,30,0,4,0,4,3,30,4,0,0,4,3,30,2,2,0,4,3,30,3,1,0,4,2,30,3,0,0,3,1,-15,3,1
2,3,27,0,30,1,4,0,5,2,30,0,0,0,0,0,30,2,3,0,5,4,30,1,4,0,5,0,30,4,0,0,4,1,-15,3,1
2,1,24,0,30,5,1,0,6,0,30,4,0,0,4,0,30,6,0,0,6,0,30,1,5,0,6,1,30,4,0,0,4,1,-15,3,1
2,4,27,0,30,2,3,0,5,0,30,0,0,0,0,4,30,5,0,0,5,0,30,1,4,0,5,1,30,4,0,0,4,1,-15,3,1
2,4,23,0,30,3,2,0,5,2,30,4,0,0,4,5,30,5,0,0,5,0,30,0,5,0,5,1,30,2,0,0,2,1,-15,3,1
2,3,31,0,30,2,2,0,4,3,30,4,0,0,4,0,30,1,3,0,4,0,30,1,3,0,4,0,30,3,0,0,3,1,-15,3,1
2,4,17,1,30,1,3,0,4,0,30,2,0,0,2,1,30,2,2,0,4,2,30,1,3,0,4,0,30,1,0,0,1,1,-15,3,1
2,4,17,1,30,2,2,0,4,0,30,2,0,0,2,1,30,1,3,0,4,2,30,1,3,0,4,3,30,1,0,0,1,1,-15,3,1
2,4,24,0,30,3,3,0,6,2,30,3,1,0,4,3,30,6,0,0,6,0,30,1,5,0,6,3,30,4,0,0,4,1,-15,3,1
2,3,23,0,30,1,4,0,5,1,30,4,0,0,4,4,30,5,0,0,5,0,30,0,5,0,5,3,30,2,0,0,2,1,-15,3,1
2,3,25,2,30,1,3,0,4,2,30,2,0,0,2,0,30,2,2,0,4,0,30,0,4,0,4,1,30,1,0,0,1,1,-15,3,1
2,3,13,8,30,3,0,0,3,0,30,2,0,0,2,0,30,1,2,0,3,3,30,3,0,0,3,5,30,2,0,0,2,1,-15,3,1
2,3,25,4,30,0,4,0,4,2,30,2,0,0,2,0,30,3,1,0,4,2,30,2,2,0,4,2,30,1,0,0,1,1,-15,3,1
2,4,9,0,30,3,1,0,4,0,30,2,0,0,2,3,30,3,1,0,4,0,30,1,3,0,4,2,30,1,0,0,1,0,-27,3,0
2,1,9,0,30,1,3,0,4,2,30,2,0,0,2,3,30,1,3,0,4,0,30,1,3,0,4,2,30,1,0,0,1,0,-27,3,0
2,2,31,0,30,3,1,0,4,2,30,4,0,0,4,3,30,2,2,0,4,0,30,1,3,0,4,0,30,0,3,0,3,1,-15,3,1
2,4,16,0,30,6,3,0,9,1,30,8,0,0,8,1,30,3,6,0,9,0,30,2,7,0,9,0,30,2,2,0,4,1,-15,3,1
2,3,16,0,30,6,3,0,9,1,30,7,1,0,8,2,30,4,5,0,9,0,30,1,8,0,9,0,30,3,1,0,4,1,-15,3,1
2,4,12,0,30,3,4,0,7,0,30,4,2,0,6,2,30,4,3,0,7,3,30,6,1,0,7,2,30,2,1,0,3,1,-15,3,1
2,4,25,2,30,1,3,0,4,2,30,2,0,0,2,1,30,3,1,0,4,0,30,0,4,0,4,1,30,1,0,0,1,1,-15,3,1
2,4,31,0,30,1,3,0,4,2,30,4,0,0,4,0,30,2,2,0,4,0,30,1,3,0,4,0,30,1,2,0,3,1,-15,3,1
2,4,24,0,30,5,1,0,6,2,30,3,1,0,4,0,30,4,2,0,6,0,30,5,1,0,6,0,30,3,1,0,4,1,-15,3,1
2,4,9,0,30,6,5,0,11,0,30,6,0,0,6,8,30,11,0,0,11,2,30,3,8,0,11,3,30,1,3,0,4,0,-27,3,0
2,2,24,0,30,4,2,0,6,2,30,4,0,0,4,3,30,3,3,0,6,0,30,1,5,0,6,3,30,4,0,0,4,1,-15,3,1
2,3,4,2,30,7,1,0,8,3,30,4,0,0,4,0,30,6,2,0,8,0,30,2,6,0,8,2,30,3,1,0,4,0,-27,3,0
2,4,9,0,30,3,1,0,4,2,30,2,0,0,2,0,30,1,3,0,4,0,30,1,3,0,4,4,30,1,0,0,1,0,-27,3,0
2,4,5,1,30,7,5,0,12,2,30,7,3,0,10,0,30,6,6,0,12,0,30,7,5,0,12,1,30,1,5,0,6,0,-27,3,0
2,3,20,0,30,1,7,0,8,1,30,6,2,0,8,0,30,5,3,0,8,0,30,6,2,0,8,2,30,4,1,0,5,1,-15,3,1
2,4,9,0,30,7,4,0,11,1,30,6,0,0,6,3,30,11,0,0,11,1,30,3,8,0,11,3,30,2,2,0,4,0,-27,3,0
2,3,8,3,30,7,0,0,7,3,30,2,0,0,2,3,30,7,0,0,7,0,30,5,2,0,7,2,30,3,0,0,3,0,-27,3,0
2,4,27,0,30,1,4,0,5,2,30,0,0,0,0,6,30,5,0,0,5,0,30,2,3,0,5,0,30,4,0,0,4,1,-15,3,1
2,3,23,2,30,4,1,0,5,2,30,4,0,0,4,0,30,3,2,0,5,0,30,0,5,0,5,1,30,2,0,0,2,1,-15,3,1
2,4,20,0,30,2,6,0,8,1,30,7,1,0,8,2,30,6,2,0,8,1,30,5,3,0,8,0,30,4,1,0,5,1,-15,3,1
2,4,31,0,30,1,3,0,4,2,30,4,0,0,4,2,30,4,0,0,4,0,30,1,3,0,4,2,30,3,0,0,3,1,-15,3,1
2,4,15,2,30,4,0,0,4,0,30,6,0,0,6,0,30,4,0,0,4,1,30,1,3,0,4,1,30,3,1,0,4,1,-15,3,1
2,2,15,5,30,4,0,0,4,1,30,6,0,0,6,0,30,4,0,0,4,1,30,2,2,0,4,0,30,2,2,0,4,1,-15,3,1
2,3,5,0,30,7,5,0,12,2,30,7,3,0,10,0,30,3,9,0,12,0,30,6,6,0,12,2,30,6,0,0,6,0,-27,3,0
2,4,31,0,30,2,2,0,4,4,30,4,0,0,4,0,30,1,3,0,4,3,30,1,3,0,4,0,30,0,3,0,3,1,-15,3,1
2,3,9,0,30,3,8,0,11,1,30,6,0,0,6,0,30,9,2,0,11,1,30,3,8,0,11,3,30,4,0,0,4,0,-27,3,0
2,3,32,0,30,2,7,0,9,4,30,2,0,0,2,1,30,7,2,0,9,1,30,3,6,0,9,3,30,2,0,0,2,1,-15,3,1
2,3,31,0,30,1,3,0,4,2,30,4,0,0,4,5,30,4,0,0,4,0,30,1,3,0,4,0,30,1,2,0,3,1,-15,3,1
2,3,9,0,30,2,2,0,4,2,30,2,0,0,2,4,30,0,4,0,4,0,30,1,3,0,4,0,30,1,0,0,1,0,-27,3,0
2,2,23,0,30,2,3,0,5,0,30,4,0,0,4,5,30,5,0,0,5,0,30,0,5,0,5,5,30,2,0,0,2,1,-15,3,1
2,4,23,1,30,5,8,0,13,0,30,6,0,0,6,7,30,13,0,0,13,0,30,6,7,0,13,3,30,5,1,0,6,1,-15,3,1
2,2,31,0,30,1,3,0,4,1,30,4,0,0,4,0,30,4,0,0,4,0,30,1,3,0,4,0,30,2,1,0,3,1,-15,3,1
2,3,29,1,30,2,3,0,5,4,30,8,0,0,8,0,30,2,3,0,5,0,30,0,5,0,5,0,30,4,0,0,4,1,-15,3,1
2,2,25,2,30,1,3,0,4,0,30,2,0,0,2,4,30,4,0,0,4,0,30,2,2,0,4,7,30,1,0,0,1,1,-15,3,1
2,2,5,1,30,6,6,0,12,2,30,7,3,0,10,0,30,6,6,0,12,0,30,6,6,0,12,1,30,4,2,0,6,0,-27,3,0
2,1,17,1,30,1,3,0,4,0,30,2,0,0,2,1,30,1,3,0,4,2,30,1,3,0,4,3,30,1,0,0,1,1,-15,3,1
2,3,31,0,30,1,3,0,4,3,30,4,0,0,4,0,30,2,2,0,4,0,30,1,3,0,4,2,30,3,0,0,3,1,-15,3,1
2,1,24,0,30,6,0,0,6,2,30,4,0,0,4,2,30,3,3,0,6,0,30,1,5,0,6,2,30,4,0,0,4,1,-15,3,1
2,3,13,2,30,3,0,0,3,1,30,2,0,0,2,0,30,1,2,0,3,2,30,2,1,0,3,2,30,2,0,0,2,1,-15,3,1
2,2,24,2,30,4,2,0,6,3,30,4,0,0,4,0,30,3,3,0,6,0,30,1,5,0,6,1,30,4,0,0,4,1,-15,3,1
2,4,5,1,30,7,5,0,12,3,30,2,8,0,10,0,30,3,9,0,12,0,30,7,5,0,12,1,30,5,1,0,6,0,-27,3,0
2,3,17,2,30,1,3,0,4,0,30,2,0,0,2,1,30,2,2,0,4,2,30,1,3,0,4,3,30,1,0,0,1,1,-15,3,1
2,4,30,2,30,4,1,0,5,3,30,2,0,0,2,2,30,2,3,0,5,2,30,1,4,0,5,2,30,3,0,0,3,1,-15,3,1
2,4,9,0,30,6,5,0,11,2,30,6,0,0,6,4,30,10,1,0,11,1,30,3,8,0,11,0,30,4,0,0,4,0,-27,3,0
2,2,13,1,30,3,0,0,3,0,30,2,0,0,2,0,30,3,0,0,3,4,30,2,1,0,3,0,30,2,0,0,2,1,-15,3,1
2,4,20,0,30,1,7,0,8,0,30,7,1,0,8,1,30,8,0,0,8,0,30,1,7,0,8,2,30,3,2,0,5,1,-15,3,1
2,4,25,0,30,0,4,0,4,2,30,2,0,0,2,0,30,4,0,0,4,0,30,0,4,0,4,0,30,1,0,0,1,1,-15,3,1
2,4,9,0,30,4,7,0,11,2,30,6,0,0,6,5,30,8,3,0,11,3,30,3,8,0,11,5,30,2,2,0,4,0,-27,3,0
2,4,13,3,30,6,1,0,7,1,30,4,0,0,4,2,30,6,1,0,7,0,30,7,0,0,7,4,30,4,0,0,4,1,-15,3,1
2,4,3,1,30,4,7,0,11,0,30,8,0,0,8,0,30,5,6,0,11,1,30,4,7,0,11,1,30,3,4,0,7,0,-27,3,0
2,2,20,0,30,2,6,0,8,1,30,5,3,0,8,3,30,7,1,0,8,0,30,1,7,0,8,2,30,4,1,0,5,1,-15,3,1
2,1,4,2,30,5,3,0,8,2,30,4,0,0,4,0,30,6,2,0,8,0,30,4,4,0,8,3,30,4,0,0,4,0,-27,3,0
2,2,20,0,30,2,6,0,8,0,30,6,2,0,8,2,30,8,0,0,8,0,30,2,6,0,8,1,30,3,2,0,5,1,-15,3,1
2,4,31,0,30,2,2,0,4,3,30,4,0,0,4,1,30,2,2,0,4,1,30,2,2,0,4,0,30,3,0,0,3,1,-15,3,1
2,4,15,0,30,2,2,0,4,0,30,6,0,0,6,0,30,2,2,0,4,4,30,2,2,0,4,0,30,3,1,0,4,1,-15,3,1
2,2,31,0,30,2,2,0,4,3,30,4,0,0,4,2,30,3,1,0,4,0,30,3,1,0,4,2,30,3,0,0,3,1,-15,3,1
2,3,28,0,30,2,6,0,8,4,30,4,0,0,4,0,30,1,7,0,8,0,30,4,4,0,8,2,30,4,0,0,4,1,-15,3,1
2,4,5,1,30,4,8,0,12,0,30,7,3,0,10,0,30,8,4,0,12,0,30,8,4,0,12,2,30,2,4,0,6,0,-27,3,0
2,3,5,1,30,4,8,0,12,3,30,7,3,0,10,0,30,3,9,0,12,1,30,8,4,0,12,3,30,6,0,0,6,0,-27,3,0
2,4,13,3,30,5,2,0,7,0,30,4,0,0,4,6,30,7,0,0,7,3,30,6,1,0,7,5,30,4,0,0,4,1,-15,3,1
2,4,9,0,30,2,2,0,4,1,30,2,0,0,2,8,30,2,2,0,4,0,30,1,3,0,4,2,30,1,0,0,1,0,-27,3,0
2,2,16,0,30,6,3,0,9,1,30,8,0,0,8,5,30,3,6,0,9,0,30,1,8,0,9,0,30,2,2,0,4,1,-15,3,1
2,2,17,1,30,1,3,0,4,0,30,2,0,0,2,1,30,1,3,0,4,5,30,1,3,0,4,4,30,1,0,0,1,1,-15,3,1
2,4,7,0,30,3,6,0,9,1,30,3,1,0,4,3,30,6,3,0,9,7,30,3,6,0,9,4,30,6,0,0,6,0,-27,3,0
2,4,8,2,30,7,0,0,7,3,30,2,0,0,2,6,30,7,0,0,7,0,30,4,3,0,7,1,30,3,0,0,3,0,-27,3,0
2,2,7,0,30,2,7,0,9,0,30,4,0,0,4,5,30,6,3,0,9,4,30,3,6,0,9,2,30,5,1,0,6,0,-27,3,0
2,4,27,0,30,1,4,0,5,2,30,0,0,0,0,1,30,4,1,0,5,3,30,4,1,0,5,0,30,4,0,0,4,1,-15,3,1
2,2,17,1,30,2,2,0,4,0,30,2,0,0,2,2,30,0,4,0,4,2,30,0,4,0,4,2,30,1,0,0,1,1,-15,3,1
2,2,31,0,30,1,3,0,4,1,30,4,0,0,4,1,30,4,0,0,4,0,30,1,3,0,4,0,30,1,2,0,3,1,-15,3,1
2,2,25,2,30,0,4,0,4,2,30,2,0,0,2,3,30,4,0,0,4,0,30,0,4,0,4,0,30,1,0,0,1,1,-15,3,1
2,3,25,2,30,0,4,0,4,0,30,2,0,0,2,3,30,4,0,0,4,0,30,0,4,0,4,2,30,1,0,0,1,1,-15,3,1
2,4,21,0,30,2,1,0,3,0,30,2,0,0,2,0,30,2,1,0,3,0,30,1,2,0,3,1,30,1,0,0,1,1,-15,3,1
2,0,31,2,30,1,3,0,4,4,30,4,0,0,4,0,30,1,3,0,4,0,30,3,1,0,4,0,30,3,0,0,3,1,-15,3,1
2,4,5,1,30,6,6,0,12,2,30,6,4,0,10,0,30,4,8,0,12,1,30,7,5,0,12,1,30,2,4,0,6,0,-27,3,0
2,3,23,0,30,2,3,0,5,1,30,4,0,0,4,2,30,4,1,0,5,0,30,0,5,0,5,2,30,2,0,0,2,1,-15,3,1
2,3,31,0,30,1,3,0,4,3,30,4,0,0,4,3,30,4,0,0,4,0,30,3,1,0,4,0,30,3,0,0,3,1,-15,3,1
2,2,31,1,30,1,3,0,4,3,30,4,0,0,4,0,30,1,3,0,4,0,30,1,3,0,4,0,30,1,2,0,3,1,-15,3,1
2,4,30,1,30,5,0,0,5,3,30,2,0,0,2,0,30,2,3,0,5,3,30,1,4,0,5,0,30,2,1,0,3,1,-15,3,1
2,4,9,0,30,2,2,0,4,2,30,2,0,0,2,0,30,2,2,0,4,0,30,4,0,0,4,0,30,1,0,0,1,0,-27,3,0
2,3,9,0,30,2,2,0,4,2,30,2,0,0,2,3,30,3,1,0,4,0,30,1,3,0,4,1,30,1,0,0,1,0,-27,3,0
2,3,9,0,30,8,3,0,11,2,30,6,0,0,6,3,30,9,2,0,11,0,30,3,8,0,11,3,30,4,0,0,4,0,-27,3,0
2,2,9,0,30,3,1,0,4,2,30,2,0,0,2,6,30,1,3,0,4,0,30,1,3,0,4,2,30,1,0,0,1,0,-27,3,0
2,3,8,3,30,7,0,0,7,3,30,2,0,0,2,4,30,6,1,0,7,0,30,6,1,0,7,1,30,3,0,0,3,0,-27,3,0
2,4,5,2,30,6,6,0,12,2,30,7,3,0,10,0,30,6,6,0,12,0,30,8,4,0,12,1,30,4,2,0,6,0,-27,3,0
2,2,23,0,30,2,3,0,5,1,30,4,0,0,4,2,30,5,0,0,5,3,30,1,4,0,5,6,30,2,0,0,2,1,-15,3,1
2,0,24,0,30,4,2,0,6,2,30,4,0,0,4,4,30,1,5,0,6,0,30,3,3,0,6,2,30,4,0,0,4,1,-15,3,1
2,2,31,0,30,1,3,0,4,2,30,4,0,0,4,2,30,3,1,0,4,0,30,1,3,0,4,0,30,0,3,0,3,1,-15,3,1
2,3,31,0,30,1,3,0,4,0,30,4,0,0,4,1,30,4,0,0,4,4,30,3,1,0,4,1,30,3,0,0,3,1,-15,3,1
2,4,23,0,30,4,1,0,5,2,30,4,0,0,4,5,30,5,0,0,5,0,30,0,5,0,5,0,30,2,0,0,2,1,-15,3,1
2,3,31,0,30,0,4,0,4,3,30,4,0,0,4,4,30,1,3,0,4,0,30,4,0,0,4,0,30,1,2,0,3,1,-15,3,1
2,2,30,2,30,2,3,0,5,2,30,2,0,0,2,1,30,1,4,0,5,2,30,1,4,0,5,4,30,3,0,0,3,1,-15,3,1
2,3,4,2,30,6,2,0,8,3,30,4,0,0,4,0,30,6,2,0,8,0,30,4,4,0,8,2,30,3,1,0,4,0,-27,3,0
2,4,31,0,30,1,3,0,4,2,30,4,0,0,4,3,30,4,0,0,4,0,30,1,3,0,4,0,30,3,0,0,3,1,-15,3,1
2,4,25,2,30,0,4,0,4,2,30,2,0,0,2,2,30,3,1,0,4,0,30,0,4,0,4,1,30,1,0,0,1,1,-15,3,1
2,3,9,0,30,5,6,0,11,1,30,6,0,0,6,2,30,10,1,0,11,5,30,3,8,0,11,5,30,4,0,0,4,0,-27,3,0
2,4,31,2,30,1,3,0,4,2,30,4,0,0,4,0,30,2,2,0,4,0,30,1,3,0,4,0,30,0,3,0,3,1,-15,3,1
2,3,7,1,30,3,6,0,9,1,30,4,0,0,4,3,30,8,1,0,9,4,30,3,6,0,9,1,30,3,3,0,6,0,-27,3,0
2,4,9,0,30,5,6,0,11,1,30,6,0,0,6,3,30,11,0,0,11,1,30,3,8,0,11,4,30,2,2,0,4,0,-27,3,0
2,4,9,0,30,2,2,0,4,1,30,1,1,0,2,2,30,4,0,0,4,0,30,1,3,0,4,2,30,1,0,0,1,0,-27,3,0
2,1,7,1,30,4,5,0,9,2,30,3,1,0,4,2,30,6,3,0,9,5,30,3,6,0,9,4,30,6,0,0,6,0,-27,3,0
2,4,5,1,30,4,8,0,12,2,30,4,6,0,10,1,30,6,6,0,12,0,30,8,4,0,12,1,30,6,0,0,6,0,-27,3,0
2,2,9,0,30,1,3,0,4,1,30,2,0,0,2,1,30,4,0,0,4,1,30,4,0,0,4,2,30,1,0,0,1,0,-27,3,0
2,4,15,0,30,2,2,0,4,0,30,5,1,0,6,4,30,3,1,0,4,0,30,4,0,0,4,0,30,3,1,0,4,1,-15,3,1
2,4,25,2,30,0,4,0,4,2,30,2,0,0,2,1,30,4,0,0,4,0,30,0,4,0,4,1,30,1,0,0,1,1,-15,3,1
2,3,28,0,30,1,7,0,8,3,30,4,0,0,4,3,30,2,6,0,8,0,30,5,3,0,8,1,30,4,0,0,4,1,-15,3,1
2,3,28,0,30,1,7,0,8,3,30,4,0,0,4,0,30,4,4,0,8,0,30,3,5,0,8,1,30,3,1,0,4,1,-15,3,1
2,4,23,0,30,3,2,0,5,0,30,4,0,0,4,2,30,3,2,0,5,0,30,0,5,0,5,4,30,2,0,0,2,1,-15,3,1
2,4,24,0,30,2,4,0,6,2,30,4,0,0,4,4,30,5,1,0,6,0,30,1,5,0,6,0,30,4,0,0,4,1,-15,3,1
2,4,31,2,30,0,4,0,4,3,30,4,0,0,4,1,30,2,2,0,4,0,30,1,3,0,4,0,30,1,2,0,3,1,-15,3,1
2,1,13,3,30,3,0,0,3,0,30,2,0,0,2,3,30,3,0,0,3,4,30,2,1,0,3,4,30,2,0,0,2,1,-15,3,1
2,1,29,0,30,0,5,0,5,4,30,8,0,0,8,1,30,3,2,0,5,0,30,1,4,0,5,1,30,4,0,0,4,1,-15,3,1
2,3,9,0,30,1,3,0,4,0,30,2,0,0,2,4,30,1,3,0,4,0,30,1,3,0,4,0,30,1,0,0,1,0,-27,3,0
2,1,28,0,30,3,5,0,8,3,30,4,0,0,4,2,30,6,2,0,8,0,30,2,6,0,8,3,30,3,1,0,4,1,-15,3,1
2,3,9,0,30,1,3,0,4,1,30,2,0,0,2,3,30,3,1,0,4,0,30,1,3,0,4,3,30,1,0,0,1,0,-27,3,0
2,4,16,0,30,4,5,0,9,1,30,8,0,0,8,0,30,3,6,0,9,0,30,1,8,0,9,0,30,4,0,0,4,1,-15,3,1
2,4,7,1,30,4,5,0,9,2,30,4,0,0,4,2,30,6,3,0,9,0,30,2,7,0,9,2,30,6,0,0,6,0,-27,3,0
2,4,24,0,30,4,2,0,6,2,30,4,0,0,4,0,30,3,3,0,6,0,30,3,3,0,6,5,30,4,0,0,4,1,-15,3,1
2,2,24,0,30,4,2,0,6,2,30,4,0,0,4,5,30,6,0,0,6,0,30,1,5,0,6,1,30,4,0,0,4,1,-15,3,1
2,3,31,2,30,8,4,0,12,3,30,8,0,0,8,6,30,12,0,0,12,0,30,3,9,0,12,0,30,4,2,0,6,1,-15,3,1
2,2,31,0,30,0,4,0,4,2,30,4,0,0,4,1,30,4,0,0,4,0,30,1,3,0,4,2,30,3,0,0,3,1,-15,3,1
2,4,13,5,30,3,0,0,3,0,30,2,0,0,2,0,30,3,0,0,3,3,30,2,1,0,3,0,30,2,0,0,2,1,-15,3,1
2,0,23,0,30,3,2,0,5,2,30,3,1,0,4,9,30,5,0,0,5,0,30,0,5,0,5,1,30,1,1,0,2,1,-15,3,1
2,4,7,0,30,4,5,0,9,2,30,4,0,0,4,3,30,6,3,0,9,1,30,2,7,0,9,0,30,6,0,0,6,0,-27,3,0
2,4,32,0,30,6,3,0,9,3,30,2,0,0,2,3,30,9,0,0,9,1,30,2,7,0,9,1,30,2,0,0,2,1,-15,3,1
2,3,16,0,30,5,4,0,9,2,30,8,0,0,8,3,30,1,8,0,9,0,30,1,8,0,9,1,30,4,0,0,4,1,-15,3,1
2,4,7,0,30,2,7,0,9,1,30,4,0,0,4,0,30,8,1,0,9,4,30,3,6,0,9,1,30,5,1,0,6,0,-27,3,0
2,4,30,2,30,3,2,0,5,3,30,2,0,0,2,2,30,2,3,0,5,3,30,2,3,0,5,1,30,3,0,0,3,1,-15,3,1
2,0,20,0,30,1,7,0,8,1,30,8,0,0,8,0,30,4,4,0,8,0,30,5,3,0,8,1,30,4,1,0,5,1,-15,3,1
2,3,31,0,30,0,4,0,4,2,30,4,0,0,4,5,30,4,0,0,4,0,30,2,2,0,4,1,30,3,0,0,3,1,-15,3,1
2,4,31,0,30,1,3,0,4,3,30,4,0,0,4,0,30,3,1,0,4,0,30,1,3,0,4,0,30,1,2,0,3,1,-15,3,1
2,2,7,0,30,4,5,0,9,1,30,3,1,0,4,4,30,7,2,0,9,0,30,4,5,0,9,1,30,4,2,0,6,0,-27,3,0
2,3,4,2,30,6,2,0,8,3,30,4,0,0,4,0,30,5,3,0,8,0,30,4,4,0,8,0,30,4,0,0,4,0,-27,3,0
2,4,8,0,30,5,2,0,7,2,30,2,0,0,2,1,30,7,0,0,7,1,30,3,4,0,7,3,30,3,0,0,3,0,-27,3,0
2,2,15,3,30,4,0,0,4,0,30,6,0,0,6,2,30,4,0,0,4,1,30,1,3,0,4,0,30,2,2,0,4,1,-15,3,1
2,4,9,3,30,5,6,0,11,3,30,6,0,0,6,4,30,11,0,0,11,1,30,8,3,0,11,0,30,3,1,0,4,0,-27,3,0
2,4,9,0,30,3,1,0,4,2,30,2,0,0,2,4,30,2,2,0,4,0,30,1,3,0,4,2,30,1,0,0,1,0,-27,3,0
2,2,5,1,30,6,6,0,12,3,30,7,3,0,10,1,30,5,7,0,12,0,30,8,4,0,12,1,30,4,2,0,6,0,-27,3,0
2,4,32,0,30,3,6,0,9,4,30,2,0,0,2,3,30,9,0,0,9,0,30,2,7,0,9,3,30,2,0,0,2,1,-15,3,1
2,3,16,0,30,5,4,0,9,2,30,8,0,0,8,3,30,1,8,0,9,0,30,0,9,0,9,0,30,4,0,0,4,1,-15,3,1
2,3,7,0,30,3,6,0,9,2,30,4,0,0,4,5,30,7,2,0,9,4,30,2,7,0,9,1,30,5,1,0,6,0,-27,3,0
2,2,27,0,30,1,4,0,5,1,30,0,0,0,0,4,30,5,0,0,5,1,30,3,2,0,5,0,30,4,0,0,4,1,-15,3,1
2,2,13,4,30,3,0,0,3,1,30,2,0,0,2,4,30,2,1,0,3,1,30,1,2,0,3,2,30,2,0,0,2,1,-15,3,1
2,4,16,0,30,4,5,0,9,0,30,8,0,0,8,0,30,4,5,0,9,0,30,1,8,0,9,0,30,3,1,0,4,1,-15,3,1
2,3,27,0,30,1,4,0,5,0,30,0,0,0,0,0,30,4,1,0,5,0,30,2,3,0,5,1,30,4,0,0,4,1,-15,3,1
2,4,9,0,30,2,2,0,4,1,30,2,0,0,2,0,30,4,0,0,4,0,30,4,0,0,4,4,30,1,0,0,1,0,-27,3,0
2,3,27,0,30,1,4,0,5,0,30,0,0,0,0,0,30,5,0,0,5,0,30,2,3,0,5,1,30,4,0,0,4,1,-15,3,1
2,2,9,0,30,1,3,0,4,0,30,2,0,0,2,4,30,1,3,0,4,0,30,1,3,0,4,3,30,1,0,0,1,0,-27,3,0
2,1,29,1,30,0,5,0,5,4,30,8,0,0,8,0,30,4,1,0,5,0,30,1,4,0,5,0,30,4,0,0,4,1,-15,3,1
2,4,9,4,30,2,2,0,4,1,30,2,0,0,2,0,30,4,0,0,4,0,30,0,4,0,4,2,30,1,0,0,1,0,-27,3,0
2,3,16,0,30,6,3,0,9,1,30,8,0,0,8,1,30,3,6,0,9,0,30,1,8,0,9,1,30,4,0,0,4,1,-15,3,1
2,4,25,2,30,1,3,0,4,0,30,2,0,0,2,0,30,3,1,0,4,0,30,0,4,0,4,0,30,1,0,0,1,1,-15,3,1
2,0,24,1,30,6,0,0,6,2,30,3,1,0,4,2,30,6,0,0,6,2,30,2,4,0,6,0,30,3,1,0,4,1,-15,3,1
2,4,17,1,30,2,2,0,4,0,30,2,0,0,2,3,30,1,3,0,4,2,30,1,3,0,4,2,30,1,0,0,1,1,-15,3,1
2,4,15,0,30,2,2,0,4,0,30,5,1,0,6,3,30,4,0,0,4,1,30,4,0,0,4,0,30,2,2,0,4,1,-15,3,1
2,2,5,0,30,1,4,0,5,0,30,4,0,0,4,0,30,0,5,0,5,0,30,1,4,0,5,0,30,1,1,0,2,0,-27,3,0
2,1,28,0,30,5,3,0,8,4,30,4,0,0,4,1,30,3,5,0,8,0,30,2,6,0,8,2,30,3,1,0,4,1,-15,3,1
2,4,2,0,30,7,3,0,10,2,30,4,0,0,4,1,30,10,0,0,10,0,30,9,1,0,10,1,30,4,4,0,8,0,-27,3,0
2,4,3,1,30,0,4,0,4,0,30,4,0,0,4,1,30,4,0,0,4,0,30,0,4,0,4,0,30,3,0,0,3,0,-27,3,0
2,3,16,1,30,8,1,0,9,2,30,8,0,0,8,3,30,2,7,0,9,0,30,0,9,0,9,0,30,1,3,0,4,1,-15,3,1
2,3,37,8,30,5,6,0,11,4,30,2,6,0,8,7,30,11,0,0,11,2,30,2,9,0,11,3,30,5,1,0,6,1,-15,3,1
2,4,15,0,30,2,2,0,4,0,30,6,0,0,6,0,30,2,2,0,4,5,30,1,3,0,4,1,30,4,0,0,4,1,-15,3,1
2,4,4,0,30,7,1,0,8,3,30,4,0,0,4,0,30,4,4,0,8,0,30,4,4,0,8,3,30,4,0,0,4,0,-27,3,0
2,3,24,0,30,4,2,0,6,1,30,3,1,0,4,0,30,4,2,0,6,0,30,1,5,0,6,3,30,4,0,0,4,1,-15,3,1
2,3,7,0,30,3,1,0,4,2,30,2,0,0,2,2,30,2,2,0,4,0,30,1,3,0,4,3,30,1,1,0,2,0,-27,3,0
2,3,9,0,30,5,6,0,11,0,30,6,0,0,6,5,30,8,3,0,11,1,30,3,8,0,11,1,30,4,0,0,4,0,-27,3,0
2,3,5,0,30,6,6,0,12,2,30,6,4,0,10,3,30,5,7,0,12,1,30,5,7,0,12,1,30,4,2,0,6,0,-27,3,0
2,4,45,0,30,0,5,0,5,4,30,4,0,0,4,4,30,5,0,0,5,0,30,1,4,0,5,2,30,2,0,0,2,1,-15,3,1
2,3,24,0,30,5,1,0,6,2,30,4,0,0,4,4,30,6,0,0,6,0,30,3,3,0,6,1,30,4,0,0,4,1,-15,3,1
2,2,4,0,30,6,2,0,8,3,30,4,0,0,4,0,30,5,3,0,8,0,30,3,5,0,8,3,30,4,0,0,4,0,-27,3,0
2,3,3,0,30,5,6,0,11,1,30,8,0,0,8,1,30,5,6,0,11,1,30,2,9,0,11,1,30,2,5,0,7,0,-27,3,0
2,1,1,0,30,7,3,0,10,2,30,2,0,0,2,8,30,7,3,0,10,0,30,6,4,0,10,0,30,6,0,0,6,0,-27,3,0
2,4,7,1,30,4,5,0,9,2,30,4,0,0,4,2,30,6,3,0,9,4,30,3,6,0,9,2,30,6,0,0,6,0,-27,3,0
2,4,24,0,30,4,2,0,6,0,30,4,0,0,4,4,30,4,2,0,6,0,30,2,4,0,6,3,30,4,0,0,4,1,-15,3,1
2,4,14,1,30,3,6,0,9,1,30,6,0,0,6,0,30,6,3,0,9,0,30,6,3,0,9,0,30,4,0,0,4,1,-15,3,1
2,1,33,2,30,5,6,0,11,5,30,4,0,0,4,12,30,11,0,0,11,0,30,3,8,0,11,3,30,4,0,0,4,1,-15,3,1
2,4,33,0,30,1,2,0,3,2,30,2,0,0,2,12,30,1,2,0,3,0,30,1,2,0,3,4,30,2,0,0,2,1,-15,3,1
2,4,30,2,30,3,2,0,5,4,30,2,0,0,2,5,30,2,3,0,5,3,30,2,3,0,5,0,30,2,1,0,3,1,-15,3,1
2,3,13,2,30,3,0,0,3,0,30,2,0,0,2,1,30,3,0,0,3,4,30,1,2,0,3,2,30,2,0,0,2,1,-15,3,1
2,1,5,1,30,5,7,0,12,3,30,8,2,0,10,1,30,3,9,0,12,0,30,8,4,0,12,1,30,4,2,0,6,0,-27,3,0
2,4,4,2,30,3,5,0,8,4,30,4,0,0,4,1,30,2,6,0,8,0,30,5,3,0,8,2,30,4,0,0,4,0,-27,3,0
2,3,7,0,30,4,5,0,9,2,30,4,0,0,4,1,30,6,3,0,9,1,30,3,6,0,9,1,30,6,0,0,6,0,-27,3,0
2,4,7,0,30,3,1,0,4,0,30,2,0,0,2,4,30,3,1,0,4,0,30,1,3,0,4,2,30,2,0,0,2,0,-27,3,0
2,3,15,3,30,2,2,0,4,0,30,6,0,0,6,2,30,4,0,0,4,3,30,2,2,0,4,0,30,4,0,0,4,1,-15,3,1
2,4,24,0,30,4,2,0,6,2,30,4,0,0,4,5,30,6,0,0,6,0,30,1,5,0,6,3,30,4,0,0,4,1,-15,3,1
2,4,17,1,30,1,3,0,4,0,30,2,0,0,2,2,30,2,2,0,4,2,30,0,4,0,4,3,30,1,0,0,1,1,-15,3,1
2,2,9,1,30,6,5,0,11,1,30,6,0,0,6,2,30,11,0,0,11,2,30,3,8,0,11,2,30,4,0,0,4,0,-27,3,0
2,4,32,0,30,7,2,0,9,4,30,2,0,0,2,6,30,9,0,0,9,1,30,3,6,0,9,2,30,2,0,0,2,1,-15,3,1
2,4,17,1,30,1,3,0,4,0,30,2,0,0,2,0,30,0,4,0,4,3,30,1,3,0,4,4,30,1,0,0,1,1,-15,3,1
2,3,4,2,30,8,0,0,8,0,30,4,0,0,4,2,30,6,2,0,8,0,30,3,5,0,8,2,30,3,1,0,4,0,-27,3,0
2,2,31,2,30,0,4,0,4,3,30,4,0,0,4,1,30,4,0,0,4,0,30,1,3,0,4,0,30,3,0,0,3,1,-15,3,1
2,2,4,2,30,8,0,0,8,2,30,4,0,0,4,0,30,6,2,0,8,0,30,0,8,0,8,2,30,4,0,0,4,0,-27,3,0
2,4,9,0,30,4,7,0,11,2,30,6,0,0,6,2,30,8,3,0,11,2,30,4,7,0,11,4,30,4,0,0,4,0,-27,3,0
2,1,17,1,30,1,3,0,4,0,30,2,0,0,2,1,30,1,3,0,4,2,30,1,3,0,4,2,30,1,0,0,1,1,-15,3,1
2,4,30,2,30,3,2,0,5,2,30,2,0,0,2,1,30,1,4,0,5,2,30,1,4,0,5,2,30,3,0,0,3,1,-15,3,1
2,4,17,1,30,1,3,0,4,1,30,2,0,0,2,3,30,1,3,0,4,2,30,1,3,0,4,1,30,1,0,0,1,1,-15,3,1
2,1,7,0,30,3,6,0,9,1,30,3,1,0,4,2,30,6,3,0,9,5,30,3,6,0,9,1,30,5,1,0,6,0,-27,3,0
2,1,43,1,30,2,3,0,5,3,30,4,0,0,4,10,30,4,1,0,5,0,30,0,5,0,5,1,30,2,0,0,2,1,-15,3,1
2,4,17,2,30,2,2,0,4,1,30,2,0,0,2,1,30,0,4,0,4,2,30,4,0,0,4,4,30,1,0,0,1,1,-15,3,1
2,4,9,0,30,1,3,0,4,2,30,2,0,0,2,4,30,2,2,0,4,0,30,1,3,0,4,0,30,1,0,0,1,0,-27,3,0
2,4,17,1,30,2,2,0,4,1,30,2,0,0,2,2,30,0,4,0,4,2,30,1,3,0,4,3,30,1,0,0,1,1,-15,3,1
2,1,17,1,30,2,2,0,4,0,30,2,0,0,2,4,30,1,3,0,4,2,30,1,3,0,4,1,30,1,0,0,1,1,-15,3,1
2,4,25,2,30,2,2,0,4,1,30,2,0,0,2,0,30,4,0,0,4,0,30,2,2,0,4,3,30,1,0,0,1,1,-15,3,1
2,4,25,2,30,2,2,0,4,1,30,2,0,0,2,1,30,4,0,0,4,0,30,3,1,0,4,2,30,1,0,0,1,1,-15,3,1
2,3,8,1,30,7,0,0,7,3,30,2,0,0,2,6,30,4,3,0,7,0,30,7,0,0,7,2,30,3,0,0,3,0,-27,3,0
2,3,28,0,30,2,6,0,8,4,30,4,0,0,4,1,30,6,2,0,8,0,30,6,2,0,8,2,30,4,0,0,4,1,-15,3,1
2,3,25,2,30,1,3,0,4,1,30,2,0,0,2,0,30,3,1,0,4,0,30,1,3,0,4,2,30,1,0,0,1,1,-15,3,1
2,3,23,0,30,2,3,0,5,2,30,4,0,0,4,0,30,3,2,0,5,0,30,1,4,0,5,0,30,2,0,0,2,1,-15,3,1
2,3,16,0,30,5,4,0,9,1,30,8,0,0,8,0,30,4,5,0,9,0,30,0,9,0,9,1,30,4,0,0,4,1,-15,3,1
2,4,23,0,30,1,4,0,5,2,30,4,0,0,4,7,30,3,2,0,5,0,30,1,4,0,5,1,30,1,1,0,2,1,-15,3,1
2,3,7,0,30,2,2,0,4,1,30,2,0,0,2,1,30,3,1,0,4,0,30,1,3,0,4,2,30,1,1,0,2,0,-27,3,0
2,1,24,0,30,4,2,0,6,2,30,3,1,0,4,6,30,6,0,0,6,0,30,1,5,0,6,0,30,4,0,0,4,1,-15,3,1
2,1,5,1,30,5,7,0,12,2,30,7,3,0,10,0,30,6,6,0,12,0,30,8,4,0,12,2,30,3,3,0,6,0,-27,3,0
2,0,13,4,30,7,0,0,7,1,30,4,0,0,4,5,30,7,0,0,7,1,30,4,3,0,7,5,30,4,0,0,4,1,-15,3,1
2,2,5,2,30,5,7,0,12,2,30,8,2,0,10,2,30,6,6,0,12,0,30,9,3,0,12,1,30,2,4,0,6,0,-27,3,0
2,2,17,1,30,1,3,0,4,0,30,2,0,0,2,2,30,1,3,0,4,2,30,2,2,0,4,4,30,1,0,0,1,1,-15,3,1
2,3,24,0,30,4,2,0,6,2,30,4,0,0,4,2,30,6,0,0,6,0,30,1,5,0,6,1,30,4,0,0,4,1,-15,3,1
2,2,13,1,30,7,0,0,7,0,30,4,0,0,4,6,30,7,0,0,7,4,30,5,2,0,7,7,30,4,0,0,4,1,-15,3,1
2,4,5,1,30,5,7,0,12,2,30,9,1,0,10,0,30,3,9,0,12,0,30,7,5,0,12,0,30,5,1,0,6,0,-27,3,0
2,4,17,1,30,1,3,0,4,0,30,2,0,0,2,1,30,1,3,0,4,1,30,1,3,0,4,2,30,1,0,0,1,1,-15,3,1
2,1,24,2,30,6,0,0,6,3,30,3,1,0,4,0,30,5,1,0,6,0,30,0,6,0,6,4,30,4,0,0,4,1,-15,3,1
2,2,11,6,30,1,3,0,4,0,30,0,0,0,0,1,30,3,1,0,4,0,30,2,2,0,4,1,30,1,0,0,1,1,-15,3,1
2,3,13,0,30,3,0,0,3,0,30,2,0,0,2,2,30,3,0,0,3,2,30,3,0,0,3,3,30,2,0,0,2,1,-15,3,1
2,4,4,3,30,8,0,0,8,3,30,4,0,0,4,1,30,6,2,0,8,0,30,0,8,0,8,1,30,4,0,0,4,0,-27,3,0
2,4,13,3,30,7,0,0,7,1,30,4,0,0,4,2,30,6,1,0,7,0,30,6,1,0,7,5,30,4,0,0,4,1,-15,3,1
2,4,23,0,30,2,3,0,5,1,30,4,0,0,4,0,30,3,2,0,5,0,30,2,3,0,5,3,30,2,0,0,2,1,-15,3,1
2,4,17,1,30,1,3,0,4,1,30,2,0,0,2,1,30,1,3,0,4,3,30,0,4,0,4,2,30,1,0,0,1,1,-15,3,1
2,2,31,0,30,0,4,0,4,3,30,4,0,0,4,1,30,4,0,0,4,1,30,4,0,0,4,0,30,2,1,0,3,1,-15,3,1
2,3,31,0,30,0,4,0,4,4,30,4,0,0,4,0,30,1,3,0,4,2,30,4,0,0,4,0,30,2,1,0,3,1,-15,3,1
2,3,31,1,30,4,8,0,12,3,30,8,0,0,8,4,30,12,0,0,12,0,30,3,9,0,12,0,30,2,4,0,6,1,-15,3,1
2,3,23,0,30,2,3,0,5,1,30,4,0,0,4,0,30,2,3,0,5,0,30,0,5,0,5,4,30,2,0,0,2,1,-15,3,1
2,4,25,3,30,0,4,0,4,0,30,2,0,0,2,4,30,4,0,0,4,0,30,0,4,0,4,2,30,1,0,0,1,1,-15,3,1
2,4,24,0,30,5,1,0,6,2,30,4,0,0,4,5,30,6,0,0,6,0,30,1,5,0,6,1,30,4,0,0,4,1,-15,3,1
2,3,23,0,30,2,3,0,5,1,30,4,0,0,4,5,30,5,0,0,5,0,30,0,5,0,5,6,30,2,0,0,2,1,-15,3,1
2,4,16,0,30,4,5,0,9,2,30,8,0,0,8,3,30,1,8,0,9,0,30,1,8,0,9,0,30,3,1,0,4,1,-15,3,1
2,2,9,0,30,1,3,0,4,0,30,2,0,0,2,6,30,4,0,0,4,0,30,1,3,0,4,1,30,1,0,0,1,0,-27,3,0
2,4,9,0,30,1,3,0,4,1,30,2,0,0,2,6,30,3,1,0,4,4,30,1,3,0,4,1,30,1,0,0,1,0,-27,3,0
2,4,24,0,30,3,3,0,6,3,30,4,0,0,4,11,30,2,4,0,6,0,30,1,5,0,6,1,30,4,0,0,4,1,-15,3,1
2,3,15,2,30,4,0,0,4,0,30,6,0,0,6,0,30,2,2,0,4,1,30,2,2,0,4,0,30,1,3,0,4,1,-15,3,1
2,4,13,2,30,3,0,0,3,0,30,2,0,0,2,0,30,2,1,0,3,2,30,3,0,0,3,3,30,2,0,0,2,1,-15,3,1
2,4,5,0,30,2,3,0,5,2,30,2,2,0,4,1,30,2,3,0,5,0,30,1,4,0,5,0,30,2,0,0,2,0,-27,3,0
2,2,31,0,30,0,4,0,4,2,30,4,0,0,4,1,30,4,0,0,4,0,30,1,3,0,4,0,30,3,0,0,3,1,-15,3,1
2,2,31,0,30,0,4,0,4,2,30,4,0,0,4,4,30,1,3,0,4,0,30,3,1,0,4,0,30,1,2,0,3,1,-15,3,1
2,4,16,0,30,6,3,0,9,2,30,8,0,0,8,2,30,3,6,0,9,0,30,1,8,0,9,0,30,4,0,0,4,1,-15,3,1
2,4,31,0,30,0,4,0,4,4,30,4,0,0,4,7,30,2,2,0,4,0,30,2,2,0,4,0,30,3,0,0,3,1,-15,3,1
2,3,24,0,30,5,1,0,6,0,30,4,0,0,4,3,30,6,0,0,6,0,30,1,5,0,6,5,30,4,0,0,4,1,-15,3,1
2,4,4,3,30,8,0,0,8,0,30,2,2,0,4,0,30,7,1,0,8,0,30,4,4,0,8,2,30,4,0,0,4,0,-27,3,0
2,4,7,0,30,3,1,0,4,0,30,2,0,0,2,1,30,3,1,0,4,0,30,1,3,0,4,0,30,2,0,0,2,0,-27,3,0
2,3,5,0,30,3,2,0,5,0,30,4,0,0,4,2,30,2,3,0,5,0,30,1,4,0,5,0,30,0,2,0,2,0,-27,3,0
2,3,4,4,30,8,0,0,8,3,30,4,0,0,4,3,30,8,0,0,8,0,30,0,8,0,8,1,30,4,0,0,4,0,-27,3,0
2,2,5,1,30,6,6,0,12,2,30,5,5,0,10,2,30,6,6,0,12,0,30,8,4,0,12,2,30,3,3,0,6,0,-27,3,0
2,2,5,1,30,6,6,0,12,3,30,7,3,0,10,0,30,3,9,0,12,0,30,7,5,0,12,2,30,6,0,0,6,0,-27,3,0
2,4,23,0,30,1,4,0,5,2,30,4,0,0,4,0,30,2,3,0,5,0,30,0,5,0,5,2,30,2,0,0,2,1,-15,3,1
2,0,24,0,30,6,0,0,6,2,30,3,1,0,4,7,30,4,2,0,6,0,30,3,3,0,6,1,30,4,0,0,4,1,-15,3,1
2,0,21,2,30,6,4,0,10,3,30,4,2,0,6,6,30,6,4,0,10,1,30,5,5,0,10,3,30,4,0,0,4,1,-15,3,1
2,3,3,1,30,4,7,0,11,2,30,7,1,0,8,0,30,3,8,0,11,0,30,7,4,0,11,1,30,3,4,0,7,0,-27,3,0
2,4,13,3,30,6,1,0,7,0,30,4,0,0,4,7,30,6,1,0,7,5,30,6,1,0,7,0,30,4,0,0,4,1,-15,3,1
2,1,5,0,30,1,4,0,5,0,30,3,1,0,4,0,30,0,5,0,5,0,30,2,3,0,5,0,30,2,0,0,2,0,-27,3,0
2,3,9,0,30,3,1,0,4,1,30,2,0,0,2,2,30,4,0,0,4,0,30,1,3,0,4,0,30,0,1,0,1,0,-27,3,0
2,1,4,3,30,8,0,0,8,3,30,4,0,0,4,0,30,6,2,0,8,0,30,4,4,0,8,2,30,4,0,0,4,0,-27,3,0
2,4,9,0,30,2,2,0,4,0,30,2,0,0,2,0,30,2,2,0,4,0,30,1,3,0,4,0,30,1,0,0,1,0,-27,3,0
2,2,9,0,30,3,1,0,4,2,30,2,0,0,2,3,30,1,3,0,4,0,30,0,4,0,4,1,30,1,0,0,1,0,-27,3,0
2,4,27,0,30,1,4,0,5,2,30,0,0,0,0,0,30,1,4,0,5,0,30,2,3,0,5,2,30,4,0,0,4,1,-15,3,1
2,4,27,0,30,1,4,0,5,2,30,0,0,0,0,0,30,2,3,0,5,1,30,4,1,0,5,0,30,4,0,0,4,1,-15,3,1
2,0,20,0,30,1,7,0,8,0,30,6,2,0,8,3,30,8,0,0,8,0,30,1,7,0,8,1,30,4,1,0,5,1,-15,3,1
2,4,8,2,30,7,0,0,7,3,30,2,0,0,2,3,30,6,1,0,7,0,30,4,3,0,7,3,30,3,0,0,3,0,-27,3,0
2,4,28,0,30,4,4,0,8,4,30,4,0,0,4,0,30,1,7,0,8,0,30,1,7,0,8,2,30,4,0,0,4,1,-15,3,1
2,3,31,0,30,1,3,0,4,3,30,4,0,0,4,2,30,2,2,0,4,0,30,1,3,0,4,0,30,1,2,0,3,1,-15,3,1
2,3,5,1,30,5,7,0,12,2,30,8,2,0,10,0,30,6,6,0,12,0,30,8,4,0,12,2,30,4,2,0,6,0,-27,3,0
2,4,32,0,30,4,5,0,9,3,30,2,0,0,2,1,30,9,0,0,9,1,30,4,5,0,9,4,30,2,0,0,2,1,-15,3,1
2,0,9,4,30,7,4,0,11,3,30,6,0,0,6,3,30,6,5,0,11,1,30,3,8,0,11,1,30,3,1,0,4,0,-27,3,0
2,0,5,1,30,4,8,0,12,3,30,9,1,0,10,0,30,3,9,0,12,1,30,8,4,0,12,2,30,6,0,0,6,0,-27,3,0
2,4,15,0,30,2,2,0,4,0,30,4,2,0,6,0,30,2,2,0,4,1,30,4,0,0,4,0,30,4,0,0,4,1,-15,3,1
2,2,7,1,30,4,5,0,9,1,30,3,1,0,4,3,30,9,0,0,9,1,30,2,7,0,9,1,30,4,2,0,6,0,-27,3,0
2,4,36,0,30,7,2,0,9,4,30,1,1,0,2,6,30,7,2,0,9,0,30,1,8,0,9,3,30,3,0,0,3,1,-15,3,1
2,2,7,0,30,2,2,0,4,0,30,2,0,0,2,2,30,2,2,0,4,0,30,1,3,0,4,2,30,2,0,0,2,0,-27,3,0
2,3,16,0,30,7,2,0,9,1,30,8,0,0,8,1,30,3,6,0,9,0,30,1,8,0,9,1,30,4,0,0,4,1,-15,3,1
2,2,31,0,30,0,4,0,4,3,30,4,0,0,4,2,30,3,1,0,4,1,30,4,0,0,4,3,30,3,0,0,3,1,-15,3,1
2,4,13,2,30,3,0,0,3,0,30,2,0,0,2,2,30,3,0,0,3,4,30,3,0,0,3,0,30,2,0,0,2,1,-15,3,1
2,2,4,2,30,5,3,0,8,3,30,4,0,0,4,1,30,5,3,0,8,0,30,5,3,0,8,1,30,4,0,0,4,0,-27,3,0
2,3,17,2,30,2,2,0,4,1,30,2,0,0,2,1,30,0,4,0,4,2,30,1,3,0,4,3,30,1,0,0,1,1,-15,3,1
2,1,27,0,30,1,4,0,5,0,30,0,0,0,0,0,30,5,0,0,5,0,30,2,3,0,5,5,30,4,0,0,4,1,-15,3,1
2,4,24,0,30,5,1,0,6,2,30,4,0,0,4,5,30,6,0,0,6,0,30,1,5,0,6,0,30,3,1,0,4,1,-15,3,1
2,4,31,0,30,0,4,0,4,3,30,4,0,0,4,4,30,3,1,0,4,0,30,1,3,0,4,1,30,3,0,0,3,1,-15,3,1
2,2,24,0,30,5,1,0,6,3,30,4,0,0,4,4,30,1,5,0,6,0,30,1,5,0,6,5,30,4,0,0,4,1,-15,3,1
2,4,25,3,30,2,2,0,4,0,30,2,0,0,2,0,30,3,1,0,4,0,30,0,4,0,4,0,30,1,0,0,1,1,-15,3,1
2,2,5,1,30,5,7,0,12,1,30,7,3,0,10,0,30,8,4,0,12,0,30,8,4,0,12,4,30,3,3,0,6,0,-27,3,0
2,2,29,1,30,2,3,0,5,3,30,8,0,0,8,0,30,2,3,0,5,0,30,0,5,0,5,0,30,4,0,0,4,1,-15,3,1
2,3,16,0,30,6,3,0,9,1,30,8,0,0,8,1,30,4,5,0,9,0,30,1,8,0,9,0,30,2,2,0,4,1,-15,3,1
2,3,9,1,30,10,1,0,11,1,30,6,0,0,6,0,30,11,0,0,11,0,30,2,9,0,11,2,30,4,0,0,4,0,-27,3,0
2,4,20,0,30,1,7,0,8,0,30,5,3,0,8,0,30,8,0,0,8,0,30,1,7,0,8,0,30,3,2,0,5,1,-15,3,1
2,4,27,4,30,4,1,0,5,2,30,0,0,0,0,1,30,5,0,0,5,0,30,2,3,0,5,0,30,3,1,0,4,1,-15,3,1
2,0,31,0,30,3,1,0,4,1,30,4,0,0,4,9,30,4,0,0,4,0,30,1,3,0,4,0,30,1,2,0,3,1,-15,3,1
2,1,4,3,30,8,0,0,8,3,30,4,0,0,4,1,30,5,3,0,8,0,30,4,4,0,8,1,30,3,1,0,4,0,-27,3,0
2,3,9,0,30,2,2,0,4,0,30,2,0,0,2,0,30,1,3,0,4,0,30,1,3,0,4,2,30,1,0,0,1,0,-27,3,0
2,3,25,4,30,1,3,0,4,3,30,2,0,0,2,0,30,3,1,0,4,0,30,0,4,0,4,0,30,1,0,0,1,1,-15,3,1
2,3,3,0,30,4,7,0,11,3,30,8,0,0,8,4,30,3,8,0,11,0,30,7,4,0,11,1,30,3,4,0,7,0,-27,3,0
2,4,22,1,30,3,5,0,8,3,30,2,0,0,2,6,30,8,0,0,8,0,30,2,6,0,8,2,30,2,2,0,4,1,-15,3,1
2,1,31,1,30,2,2,0,4,2,30,4,0,0,4,2,30,4,0,0,4,0,30,1,3,0,4,0,30,0,3,0,3,1,-15,3,1
2,4,8,1,30,7,0,0,7,2,30,2,0,0,2,4,30,7,0,0,7,0,30,4,3,0,7,1,30,3,0,0,3,0,-27,3,0
2,4,20,0,30,0,8,0,8,1,30,7,1,0,8,1,30,7,1,0,8,0,30,2,6,0,8,1,30,4,1,0,5,1,-15,3,1
2,2,5,1,30,7,5,0,12,1,30,7,3,0,10,0,30,9,3,0,12,1,30,7,5,0,12,1,30,4,2,0,6,0,-27,3,0
2,0,31,0,30,1,3,0,4,3,30,4,0,0,4,0,30,3,1,0,4,0,30,1,3,0,4,1,30,3,0,0,3,1,-15,3,1
2,4,8,1,30,7,0,0,7,0,30,2,0,0,2,5,30,7,0,0,7,1,30,7,0,0,7,1,30,3,0,0,3,0,-27,3,0
2,1,9,0,30,3,1,0,4,2,30,2,0,0,2,7,30,1,3,0,4,0,30,1,3,0,4,2,30,1,0,0,1,0,-27,3,0
2,3,31,2,30,1,3,0,4,3,30,4,0,0,4,5,30,4,0,0,4,0,30,1,3,0,4,0,30,1,2,0,3,1,-15,3,1
2,2,15,1,30,4,0,0,4,0,30,6,0,0,6,0,30,3,1,0,4,2,30,3,1,0,4,0,30,3,1,0,4,1,-15,3,1
2,3,31,0,30,0,4,0,4,4,30,4,0,0,4,0,30,1,3,0,4,2,30,3,1,0,4,0,30,2,1,0,3,1,-15,3,1
2,3,3,0,30,4,7,0,11,2,30,8,0,0,8,0,30,5,6,0,11,4,30,3,8,0,11,2,30,5,2,0,7,0,-27,3,0
2,1,26,0,30,4,5,0,9,4,30,4,0,0,4,7,30,3,6,0,9,0,30,1,8,0,9,5,30,3,0,0,3,1,-15,3,1
2,4,13,2,30,3,0,0,3,2,30,2,0,0,2,8,30,3,0,0,3,3,30,3,0,0,3,1,30,2,0,0,2,1,-15,3,1
2,3,32,0,30,6,3,0,9,4,30,2,0,0,2,4,30,9,0,0,9,1,30,2,7,0,9,4,30,2,0,0,2,1,-15,3,1
2,3,32,0,30,3,6,0,9,3,30,2,0,0,2,0,30,7,2,0,9,1,30,3,6,0,9,5,30,2,0,0,2,1,-15,3,1
2,4,13,1,30,6,1,0,7,1,30,4,0,0,4,6,30,5,2,0,7,0,30,5,2,0,7,4,30,4,0,0,4,1,-15,3,1
2,3,46,0,30,0,8,0,8,7,30,4,0,0,4,16,30,4,4,0,8,0,30,0,8,0,8,2,30,4,0,0,4,1,-15,3,1
2,2,13,3,30,6,1,0,7,0,30,4,0,0,4,2,30,6,1,0,7,0,30,5,2,0,7,1,30,4,0,0,4,1,-15,3,1
2,2,31,0,30,1,3,0,4,2,30,4,0,0,4,2,30,4,0,0,4,0,30,1,3,0,4,2,30,3,0,0,3,1,-15,3,1
2,3,23,0,30,2,3,0,5,2,30,3,1,0,4,6,30,5,0,0,5,0,30,0,5,0,5,4,30,2,0,0,2,1,-15,3,1
2,3,11,6,30,1,3,0,4,0,30,0,0,0,0,1,30,3,1,0,4,0,30,2,2,0,4,1,30,1,0,0,1,1,-15,3,1
2,4,9,0,30,2,2,0,4,1,30,2,0,0,2,10,30,4,0,0,4,1,30,1,3,0,4,0,30,1,0,0,1,0,-27,3,0
2,4,9,0,30,1,10,0,11,1,30,6,0,0,6,3,30,10,1,0,11,5,30,3,8,0,11,2,30,3,1,0,4,0,-27,3,0
2,2,24,0,30,5,1,0,6,0,30,4,0,0,4,6,30,6,0,0,6,0,30,1,5,0,6,2,30,4,0,0,4,1,-15,3,1
2,4,32,2,30,2,7,0,9,4,30,2,0,0,2,0,30,9,0,0,9,1,30,3,6,0,9,3,30,2,0,0,2,1,-15,3,1
2,2,24,0,30,5,1,0,6,2,30,4,0,0,4,0,30,2,4,0,6,0,30,2,4,0,6,3,30,4,0,0,4,1,-15,3,1
2,3,13,2,30,3,0,0,3,0,30,2,0,0,2,0,30,3,0,0,3,3,30,3,0,0,3,3,30,2,0,0,2,1,-15,3,1
2,2,4,2,30,6,2,0,8,3,30,4,0,0,4,0,30,5,3,0,8,0,30,4,4,0,8,4,30,4,0,0,4,0,-27,3,0
2,3,32,0,30,2,7,0,9,4,30,2,0,0,2,1,30,9,0,0,9,1,30,3,6,0,9,3,30,2,0,0,2,1,-15,3,1
2,3,28,0,30,2,6,0,8,5,30,4,0,0,4,0,30,1,7,0,8,0,30,7,1,0,8,0,30,2,2,0,4,1,-15,3,1
2,1,29,0,30,0,5,0,5,4,30,8,0,0,8,1,30,5,0,0,5,0,30,1,4,0,5,1,30,4,0,0,4,1,-15,3,1
2,3,23,0,30,2,3,0,5,2,30,4,0,0,4,11,30,2,3,0,5,0,30,0,5,0,5,5,30,2,0,0,2,1,-15,3,1
2,2,31,0,30,0,4,0,4,2,30,4,0,0,4,1,30,4,0,0,4,2,30,4,0,0,4,0,30,1,2,0,3,1,-15,3,1
2,1,28,0,30,3,5,0,8,4,30,4,0,0,4,0,30,1,7,0,8,0,30,2,6,0,8,4,30,4,0,0,4,1,-15,3,1
2,4,27,0,30,1,4,0,5,1,30,0,0,0,0,3,30,5,0,0,5,0,30,2,3,0,5,0,30,3,1,0,4,1,-15,3,1
2,2,23,0,30,2,3,0,5,0,30,4,0,0,4,0,30,3,2,0,5,0,30,0,5,0,5,3,30,2,0,0,2,1,-15,3,1
2,0,31,0,30,1,3,0,4,4,30,4,0,0,4,0,30,1,3,0,4,0,30,3,1,0,4,0,30,3,0,0,3,1,-15,3,1
2,4,30,2,30,4,1,0,5,3,30,2,0,0,2,1,30,2,3,0,5,2,30,1,4,0,5,6,30,3,0,0,3,1,-15,3,1
2,4,27,0,30,1,4,0,5,1,30,0,0,0,0,1,30,5,0,0,5,0,30,3,2,0,5,0,30,3,1,0,4,1,-15,3,1
2,3,23,0,30,3,2,0,5,1,30,4,0,0,4,0,30,1,4,0,5,0,30,0,5,0,5,2,30,2,0,0,2,1,-15,3,1
2,4,7,2,30,4,5,0,9,2,30,4,0,0,4,6,30,7,2,0,9,5,30,2,7,0,9,3,30,6,0,0,6,0,-27,3,0
2,4,30,2,30,3,2,0,5,3,30,2,0,0,2,2,30,2,3,0,5,3,30,1,4,0,5,0,30,2,1,0,3,1,-15,3,1
2,4,9,2,30,7,4,0,11,1,30,6,0,0,6,6,30,11,0,0,11,1,30,3,8,0,11,2,30,2,2,0,4,0,-27,3,0
2,2,13,0,30,7,0,0,7,0,30,4,0,0,4,4,30,7,0,0,7,3,30,3,4,0,7,3,30,4,0,0,4,1,-15,3,1
2,4,23,0,30,3,2,0,5,2,30,4,0,0,4,3,30,4,1,0,5,0,30,0,5,0,5,2,30,2,0,0,2,1,-15,3,1
2,3,31,0,30,2,2,0,4,3,30,4,0,0,4,0,30,2,2,0,4,0,30,1,3,0,4,0,30,1,2,0,3,1,-15,3,1
2,2,5,0,30,1,4,0,5,2,30,0,4,0,4,0,30,3,2,0,5,0,30,1,4,0,5,1,30,1,1,0,2,0,-27,3,0
2,3,17,0,30,2,2,0,4,0,30,2,0,0,2,2,30,0,4,0,4,2,30,2,2,0,4,4,30,1,0,0,1,1,-15,3,1
2,3,28,0,30,0,8,0,8,3,30,4,0,0,4,0,30,1,7,0,8,0,30,4,4,0,8,1,30,4,0,0,4,1,-15,3,1
2,3,5,1,30,5,7,0,12,2,30,7,3,0,10,0,30,6,6,0,12,0,30,8,4,0,12,3,30,3,3,0,6,0,-27,3,0
2,2,3,0,30,5,6,0,11,1,30,8,0,0,8,0,30,6,5,0,11,3,30,2,9,0,11,1,30,7,0,0,7,0,-27,3,0
2,4,17,1,30,1,3,0,4,0,30,2,0,0,2,0,30,0,4,0,4,3,30,0,4,0,4,1,30,1,0,0,1,1,-15,3,1
2,1,5,0,30,7,5,0,12,2,30,6,4,0,10,0,30,5,7,0,12,0,30,7,5,0,12,3,30,6,0,0,6,0,-27,3,0
2,4,4,3,30,8,0,0,8,3,30,4,0,0,4,1,30,6,2,0,8,0,30,5,3,0,8,0,30,4,0,0,4,0,-27,3,0
2,3,16,0,30,4,5,0,9,1,30,8,0,0,8,1,30,3,6,0,9,0,30,1,8,0,9,0,30,2,2,0,4,1,-15,3,1
2,4,27,0,30,1,4,0,5,0,30,0,0,0,0,0,30,2,3,0,5,0,30,2,3,0,5,0,30,3,1,0,4,1,-15,3,1
2,2,5,2,30,7,5,0,12,2,30,5,5,0,10,0,30,7,5,0,12,0,30,7,5,0,12,1,30,4,2,0,6,0,-27,3,0
2,2,27,0,30,2,3,0,5,0,30,0,0,0,0,0,30,4,1,0,5,0,30,1,4,0,5,5,30,4,0,0,4,1,-15,3,1
2,4,8,1,30,7,0,0,7,3,30,2,0,0,2,7,30,4,3,0,7,1,30,6,1,0,7,4,30,3,0,0,3,0,-27,3,0
2,3,31,0,30,0,4,0,4,3,30,4,0,0,4,5,30,4,0,0,4,0,30,1,3,0,4,0,30,2,1,0,3,1,-15,3,1
2,3,13,1,30,3,0,0,3,1,30,2,0,0,2,0,30,3,0,0,3,4,30,3,0,0,3,0,30,2,0,0,2,1,-15,3,1
2,4,9,0,30,1,3,0,4,2,30,2,0,0,2,6,30,1,3,0,4,0,30,1,3,0,4,2,30,1,0,0,1,0,-27,3,0
2,4,9,2,30,5,6,0,11,2,30,6,0,0,6,3,30,11,0,0,11,1,30,5,6,0,11,1,30,4,0,0,4,0,-27,3,0
2,4,32,0,30,7,2,0,9,4,30,2,0,0,2,3,30,9,0,0,9,0,30,2,7,0,9,4,30,2,0,0,2,1,-15,3,1
2,3,24,0,30,6,0,0,6,2,30,4,0,0,4,4,30,3,3,0,6,0,30,1,5,0,6,1,30,4,0,0,4,1,-15,3,1
2,1,31,0,30,1,3,0,4,3,30,4,0,0,4,3,30,2,2,0,4,0,30,1,3,0,4,1,30,3,0,0,3,1,-15,3,1
2,3,5,2,30,6,6,0,12,3,30,7,3,0,10,0,30,5,7,0,12,0,30,8,4,0,12,2,30,4,2,0,6,0,-27,3,0
2,3,24,1,30,6,0,0,6,3,30,4,0,0,4,8,30,6,0,0,6,0,30,1,5,0,6,0,30,4,0,0,4,1,-15,3,1
2,3,29,0,30,0,5,0,5,3,30,8,0,0,8,2,30,2,3,0,5,0,30,1,4,0,5,0,30,4,0,0,4,1,-15,3,1
2,2,17,1,30,2,2,0,4,0,30,2,0,0,2,2,30,0,4,0,4,2,30,1,3,0,4,3,30,1,0,0,1,1,-15,3,1
2,3,23,0,30,3,2,0,5,1,30,4,0,0,4,0,30,5,0,0,5,0,30,0,5,0,5,3,30,2,0,0,2,1,-15,3,1
2,3,24,0,30,3,3,0,6,2,30,4,0,0,4,0,30,4,2,0,6,2,30,1,5,0,6,6,30,4,0,0,4,1,-15,3,1
2,3,11,0,30,1,3,0,4,0,30,0,0,0,0,6,30,4,0,0,4,0,30,4,0,0,4,0,30,1,0,0,1,1,-15,3,1
2,3,7,0,30,1,3,0,4,0,30,2,0,0,2,0,30,1,3,0,4,0,30,1,3,0,4,1,30,2,0,0,2,0,-27,3,0
2,4,31,0,30,0,4,0,4,4,30,4,0,0,4,0,30,1,3,0,4,4,30,3,1,0,4,3,30,3,0,0,3,1,-15,3,1
2,4,24,0,30,4,2,0,6,1,30,4,0,0,4,3,30,6,0,0,6,2,30,5,1,0,6,0,30,3,1,0,4,1,-15,3,1
2,3,16,1,30,4,5,0,9,2,30,8,0,0,8,0,30,1,8,0,9,0,30,2,7,0,9,0,30,3,1,0,4,1,-15,3,1
2,1,5,1,30,8,4,0,12,2,30,7,3,0,10,0,30,4,8,0,12,0,30,6,6,0,12,2,30,2,4,0,6,0,-27,3,0
2,4,30,2,30,3,2,0,5,4,30,2,0,0,2,1,30,1,4,0,5,3,30,1,4,0,5,2,30,3,0,0,3,1,-15,3,1
2,1,9,0,30,1,3,0,4,0,30,2,0,0,2,9,30,4,0,0,4,0,30,1,3,0,4,0,30,1,0,0,1,0,-27,3,0
2,4,23,0,30,2,3,0,5,1,30,4,0,0,4,4,30,5,0,0,5,0,30,0,5,0,5,2,30,2,0,0,2,1,-15,3,1
2,4,31,3,30,4,8,0,12,3,30,8,0,0,8,4,30,11,1,0,12,0,30,3,9,0,12,0,30,1,5,0,6,1,-15,3,1
2,2,24,1,30,3,3,0,6,2,30,3,1,0,4,0,30,6,0,0,6,0,30,5,1,0,6,0,30,4,0,0,4,1,-15,3,1
2,3,20,0,30,1,7,0,8,0,30,8,0,0,8,1,30,8,0,0,8,0,30,2,6,0,8,1,30,3,2,0,5,1,-15,3,1
2,4,17,1,30,2,2,0,4,1,30,2,0,0,2,3,30,0,4,0,4,2,30,0,4,0,4,1,30,1,0,0,1,1,-15,3,1
2,4,25,2,30,0,4,0,4,1,30,2,0,0,2,0,30,3,1,0,4,3,30,1,3,0,4,4,30,1,0,0,1,1,-15,3,1
2,3,24,0,30,4,2,0,6,0,30,4,0,0,4,1,30,6,0,0,6,0,30,1,5,0,6,5,30,4,0,0,4,1,-15,3,1
2,3,17,1,30,1,3,0,4,0,30,2,0,0,2,4,30,0,4,0,4,2,30,1,3,0,4,4,30,1,0,0,1,1,-15,3,1
2,2,7,0,30,3,1,0,4,0,30,2,0,0,2,0,30,1,3,0,4,0,30,1,3,0,4,1,30,1,1,0,2,0,-27,3,0
2,4,30,0,30,3,2,0,5,2,30,2,0,0,2,0,30,2,3,0,5,2,30,1,4,0,5,1,30,3,0,0,3,1,-15,3,1
2,4,9,0,30,1,3,0,4,0,30,2,0,0,2,9,30,4,0,0,4,0,30,1,3,0,4,0,30,1,0,0,1,0,-27,3,0
2,3,25,2,30,1,3,0,4,2,30,2,0,0,2,0,30,2,2,0,4,0,30,0,4,0,4,2,30,1,0,0,1,1,-15,3,1
2,1,17,2,30,2,2,0,4,0,30,2,0,0,2,1,30,1,3,0,4,2,30,1,3,0,4,3,30,1,0,0,1,1,-15,3,1
2,3,7,0,30,4,5,0,9,2,30,4,0,0,4,2,30,6,3,0,9,5,30,2,7,0,9,1,30,5,1,0,6,0,-27,3,0
2,1,4,2,30,6,2,0,8,3,30,4,0,0,4,0,30,5,3,0,8,0,30,4,4,0,8,4,30,4,0,0,4,0,-27,3,0
2,4,5,0,30,0,5,0,5,0,30,2,2,0,4,0,30,4,1,0,5,2,30,1,4,0,5,0,30,2,0,0,2,0,-27,3,0
2,4,9,0,30,5,6,0,11,2,30,6,0,0,6,5,30,7,4,0,11,0,30,3,8,0,11,0,30,4,0,0,4,0,-27,3,0
2,4,23,0,30,2,3,0,5,2,30,4,0,0,4,5,30,4,1,0,5,0,30,0,5,0,5,2,30,2,0,0,2,1,-15,3,1
2,4,25,2,30,1,3,0,4,1,30,2,0,0,2,1,30,4,0,0,4,2,30,1,3,0,4,4,30,1,0,0,1,1,-15,3,1
2,1,5,1,30,6,6,0,12,3,30,7,3,0,10,0,30,3,9,0,12,0,30,8,4,0,12,3,30,5,1,0,6,0,-27,3,0
2,4,8,1,30,7,0,0,7,0,30,2,0,0,2,2,30,6,1,0,7,0,30,6,1,0,7,3,30,3,0,0,3,0,-27,3,0
2,2,23,0,30,1,4,0,5,2,30,4,0,0,4,6,30,5,0,0,5,0,30,0,5,0,5,2,30,2,0,0,2,1,-15,3,1
2,2,28,0,30,1,7,0,8,3,30,4,0,0,4,0,30,5,3,0,8,1,30,5,3,0,8,1,30,4,0,0,4,1,-15,3,1
2,1,5,3,30,9,3,0,12,3,30,4,6,0,10,0,30,4,8,0,12,0,30,6,6,0,12,1,30,4,2,0,6,0,-27,3,0
2,3,9,0,30,4,7,0,11,1,30,6,0,0,6,4,30,11,0,0,11,5,30,3,8,0,11,4,30,4,0,0,4,0,-27,3,0
2,4,9,0,30,1,3,0,4,1,30,2,0,0,2,0,30,2,2,0,4,0,30,1,3,0,4,0,30,1,0,0,1,0,-27,3,0
2,4,5,0,30,4,8,0,12,2,30,9,1,0,10,0,30,6,6,0,12,1,30,7,5,0,12,1,30,5,1,0,6,0,-27,3,0
2,4,23,0,30,2,3,0,5,0,30,4,0,0,4,2,30,5,0,0,5,0,30,0,5,0,5,4,30,2,0,0,2,1,-15,3,1
2,2,17,1,30,1,3,0,4,0,30,2,0,0,2,3,30,0,4,0,4,2,30,1,3,0,4,4,30,1,0,0,1,1,-15,3,1
2,1,23,0,30,3,2,0,5,2,30,4,0,0,4,7,30,5,0,0,5,0,30,0,5,0,5,1,30,2,0,0,2,1,-15,3,1
2,1,24,0,30,5,1,0,6,2,30,3,1,0,4,5,30,5,1,0,6,0,30,1,5,0,6,2,30,4,0,0,4,1,-15,3,1
2,3,23,0,30,1,4,0,5,2,30,4,0,0,4,10,30,5,0,0,5,0,30,0,5,0,5,1,30,2,0,0,2,1,-15,3,1
2,4,28,0,30,2,6,0,8,4,30,4,0,0,4,0,30,6,2,0,8,0,30,6,2,0,8,2,30,3,1,0,4,1,-15,3,1
2,4,7,0,30,2,2,0,4,1,30,2,0,0,2,0,30,4,0,0,4,0,30,0,4,0,4,2,30,2,0,0,2,0,-27,3,0
2,3,25,1,30,2,2,0,4,1,30,2,0,0,2,3,30,4,0,0,4,0,30,2,2,0,4,3,30,1,0,0,1,1,-15,3,1
2,3,13,1,30,3,0,0,3,0,30,2,0,0,2,3,30,3,0,0,3,3,30,2,1,0,3,3,30,2,0,0,2,1,-15,3,1
2,4,2,0,30,7,3,0,10,3,30,4,0,0,4,4,30,4,6,0,10,0,30,4,6,0,10,1,30,7,1,0,8,0,-27,3,0
2,4,32,0,30,3,6,0,9,3,30,2,0,0,2,1,30,9,0,0,9,1,30,3,6,0,9,3,30,2,0,0,2,1,-15,3,1
2,4,24,0,30,4,2,0,6,2,30,4,0,0,4,8,30,5,1,0,6,0,30,1,5,0,6,0,30,4,0,0,4,1,-15,3,1
2,4,25,2,30,1,3,0,4,0,30,2,0,0,2,1,30,4,0,0,4,0,30,0,4,0,4,1,30,1,0,0,1,1,-15,3,1
2,4,13,1,30,3,0,0,3,0,30,2,0,0,2,1,30,3,0,0,3,4,30,1,2,0,3,3,30,2,0,0,2,1,-15,3,1
2,1,5,1,30,4,8,0,12,2,30,8,2,0,10,0,30,4,8,0,12,1,30,7,5,0,12,1,30,5,1,0,6,0,-27,3,0
2,4,24,0,30,3,3,0,6,2,30,4,0,0,4,4,30,5,1,0,6,0,30,1,5,0,6,0,30,3,1,0,4,1,-15,3,1
2,1,15,4,30,1,3,0,4,0,30,4,2,0,6,0,30,4,0,0,4,1,30,2,2,0,4,0,30,2,2,0,4,1,-15,3,1
2,2,24,2,30,6,0,0,6,3,30,4,0,0,4,0,30,2,4,0,6,0,30,1,5,0,6,4,30,4,0,0,4,1,-15,3,1
2,4,23,0,30,4,1,0,5,2,30,4,0,0,4,9,30,5,0,0,5,0,30,0,5,0,5,1,30,2,0,0,2,1,-15,3,1
2,4,28,0,30,1,7,0,8,5,30,4,0,0,4,0,30,1,7,0,8,0,30,7,1,0,8,1,30,4,0,0,4,1,-15,3,1
2,2,5,1,30,6,6,0,12,2,30,6,4,0,10,0,30,7,5,0,12,0,30,7,5,0,12,1,30,4,2,0,6,0,-27,3,0
2,4,23,0,30,2,3,0,5,2,30,4,0,0,4,7,30,5,0,0,5,0,30,0,5,0,5,3,30,2,0,0,2,1,-15,3,1
2,2,24,0,30,3,3,0,6,2,30,4,0,0,4,3,30,5,1,0,6,0,30,1,5,0,6,3,30,4,0,0,4,1,-15,3,1
2,4,3,1,30,5,6,0,11,1,30,8,0,0,8,7,30,7,4,0,11,4,30,1,10,0,11,1,30,2,5,0,7,0,-27,3,0
2,4,21,0,30,0,3,0,3,0,30,2,0,0,2,0,30,2,1,0,3,0,30,1,2,0,3,1,30,1,0,0,1,1,-15,3,1
2,4,23,0,30,2,3,0,5,1,30,4,0,0,4,0,30,2,3,0,5,0,30,2,3,0,5,4,30,2,0,0,2,1,-15,3,1
2,4,23,0,30,2,3,0,5,2,30,4,0,0,4,3,30,3,2,0,5,0,30,0,5,0,5,1,30,1,1,0,2,1,-15,3,1
2,2,20,0,30,2,6,0,8,1,30,7,1,0,8,0,30,5,3,0,8,0,30,2,6,0,8,1,30,4,1,0,5,1,-15,3,1
2,2,25,4,30,2,2,0,4,0,30,2,0,0,2,0,30,1,3,0,4,0,30,0,4,0,4,0,30,1,0,0,1,1,-15,3,1
2,3,5,1,30,4,8,0,12,2,30,8,2,0,10,3,30,5,7,0,12,0,30,8,4,0,12,1,30,0,6,0,6,0,-27,3,0
2,3,25,2,30,3,1,0,4,1,30,2,0,0,2,1,30,4,0,0,4,1,30,1,3,0,4,4,30,1,0,0,1,1,-15,3,1
2,3,7,1,30,4,5,0,9,1,30,4,0,0,4,2,30,9,0,0,9,4,30,3,6,0,9,3,30,6,0,0,6,0,-27,3,0
2,4,24,0,30,6,0,0,6,2,30,4,0,0,4,0,30,2,4,0,6,0,30,1,5,0,6,5,30,4,0,0,4,1,-15,3,1
2,4,25,2,30,4,0,0,4,2,30,2,0,0,2,0,30,4,0,0,4,0,30,0,4,0,4,3,30,1,0,0,1,1,-15,3,1
2,4,24,0,30,4,2,0,6,0,30,4,0,0,4,7,30,6,0,0,6,0,30,1,5,0,6,1,30,4,0,0,4,1,-15,3,1
2,1,24,0,30,3,3,0,6,2,30,3,1,0,4,5,30,5,1,0,6,0,30,2,4,0,6,2,30,3,1,0,4,1,-15,3,1
2,3,31,0,30,0,4,0,4,3,30,4,0,0,4,1,30,4,0,0,4,0,30,1,3,0,4,1,30,3,0,0,3,1,-15,3,1
2,2,25,1,30,1,3,0,4,2,30,2,0,0,2,5,30,4,0,0,4,0,30,0,4,0,4,3,30,1,0,0,1,1,-15,3,1
2,3,31,0,30,1,3,0,4,3,30,4,0,0,4,3,30,2,2,0,4,0,30,1,3,0,4,0,30,1,2,0,3,1,-15,3,1
2,4,25,1,30,0,4,0,4,2,30,2,0,0,2,1,30,3,1,0,4,0,30,0,4,0,4,0,30,1,0,0,1,1,-15,3,1
2,3,31,0,30,1,3,0,4,2,30,4,0,0,4,3,30,4,0,0,4,0,30,1,3,0,4,0,30,1,2,0,3,1,-15,3,1
2,4,7,0,30,1,3,0,4,1,30,2,0,0,2,3,30,1,3,0,4,0,30,1,3,0,4,2,30,2,0,0,2,0,-27,3,0
2,2,34,0,30,3,6,0,9,4,30,8,0,0,8,1,30,9,0,0,9,0,30,4,5,0,9,3,30,6,0,0,6,1,-15,3,1
2,2,5,0,30,5,7,0,12,2,30,8,2,0,10,1,30,6,6,0,12,0,30,8,4,0,12,1,30,5,1,0,6,0,-27,3,0
2,2,24,0,30,4,2,0,6,2,30,3,1,0,4,0,30,4,2,0,6,4,30,2,4,0,6,2,30,4,0,0,4,1,-15,3,1
2,3,24,2,30,5,1,0,6,3,30,4,0,0,4,4,30,6,0,0,6,0,30,1,5,0,6,2,30,4,0,0,4,1,-15,3,1
2,3,17,1,30,1,3,0,4,0,30,2,0,0,2,1,30,0,4,0,4,1,30,1,3,0,4,2,30,1,0,0,1,1,-15,3,1
2,4,17,0,30,1,3,0,4,0,30,2,0,0,2,1,30,0,4,0,4,3,30,0,4,0,4,4,30,1,0,0,1,1,-15,3,1
2,4,23,0,30,2,3,0,5,2,30,4,0,0,4,7,30,2,3,0,5,1,30,2,3,0,5,1,30,2,0,0,2,1,-15,3,1
2,3,13,2,30,3,0,0,3,0,30,2,0,0,2,0,30,3,0,0,3,5,30,2,1,0,3,3,30,2,0,0,2,1,-15,3,1
2,3,3,1,30,5,6,0,11,0,30,8,0,0,8,0,30,9,2,0,11,2,30,3,8,0,11,1,30,3,4,0,7,0,-27,3,0
2,4,31,2,30,2,2,0,4,3,30,4,0,0,4,3,30,2,2,0,4,0,30,1,3,0,4,0,30,1,2,0,3,1,-15,3,1
2,4,9,0,30,2,2,0,4,2,30,2,0,0,2,1,30,3,1,0,4,0,30,1,3,0,4,0,30,1,0,0,1,0,-27,3,0
2,1,23,0,30,3,2,0,5,2,30,4,0,0,4,7,30,4,1,0,5,0,30,0,5,0,5,1,30,2,0,0,2,1,-15,3,1
2,4,23,0,30,4,1,0,5,2,30,4,0,0,4,0,30,2,3,0,5,0,30,0,5,0,5,1,30,2,0,0,2,1,-15,3,1
2,3,13,2,30,6,1,0,7,1,30,4,0,0,4,7,30,7,0,0,7,3,30,6,1,0,7,4,30,4,0,0,4,1,-15,3,1
2,4,9,0,30,1,3,0,4,2,30,2,0,0,2,3,30,2,2,0,4,0,30,1,3,0,4,2,30,1,0,0,1,0,-27,3,0
2,4,9,0,30,3,1,0,4,1,30,2,0,0,2,0,30,3,1,0,4,0,30,1,3,0,4,3,30,1,0,0,1,0,-27,3,0
2,3,24,0,30,4,2,0,6,2,30,4,0,0,4,8,30,4,2,0,6,0,30,1,5,0,6,0,30,4,0,0,4,1,-15,3,1
2,3,32,0,30,5,4,0,9,4,30,2,0,0,2,5,30,9,0,0,9,1,30,3,6,0,9,2,30,2,0,0,2,1,-15,3,1
2,4,23,0,30,2,3,0,5,2,30,4,0,0,4,4,30,1,4,0,5,0,30,0,5,0,5,2,30,2,0,0,2,1,-15,3,1
2,3,14,0,30,5,4,0,9,0,30,5,1,0,6,2,30,9,0,0,9,0,30,6,3,0,9,0,30,4,0,0,4,1,-15,3,1
2,1,20,0,30,0,8,0,8,1,30,8,0,0,8,2,30,8,0,0,8,0,30,2,6,0,8,1,30,5,0,0,5,1,-15,3,1
2,4,4,2,30,5,3,0,8,3,30,4,0,0,4,0,30,3,5,0,8,0,30,4,4,0,8,4,30,4,0,0,4,0,-27,3,0
2,4,30,4,30,5,0,0,5,3,30,2,0,0,2,1,30,2,3,0,5,2,30,1,4,0,5,0,30,2,1,0,3,1,-15,3,1
2,4,9,0,30,3,1,0,4,2,30,2,0,0,2,2,30,4,0,0,4,0,30,1,3,0,4,0,30,1,0,0,1,0,-27,3,0
2,4,23,0,30,2,3,0,5,2,30,4,0,0,4,0,30,1,4,0,5,0,30,0,5,0,5,0,30,2,0,0,2,1,-15,3,1
2,3,25,0,30,0,4,0,4,0,30,2,0,0,2,0,30,3,1,0,4,0,30,2,2,0,4,2,30,1,0,0,1,1,-15,3,1
2,4,28,0,30,1,7,0,8,4,30,4,0,0,4,0,30,1,7,0,8,0,30,4,4,0,8,1,30,4,0,0,4,1,-15,3,1
2,3,5,1,30,5,7,0,12,3,30,8,2,0,10,0,30,4,8,0,12,1,30,8,4,0,12,2,30,4,2,0,6,0,-27,3,0
2,3,24,0,30,4,2,0,6,2,30,4,0,0,4,8,30,6,0,0,6,0,30,2,4,0,6,1,30,4,0,0,4,1,-15,3,1
2,1,9,0,30,2,2,0,4,0,30,2,0,0,2,3,30,3,1,0,4,0,30,1,3,0,4,0,30,1,0,0,1,0,-27,3,0
2,4,9,0,30,2,2,0,4,1,30,2,0,0,2,3,30,4,0,0,4,1,30,1,3,0,4,2,30,1,0,0,1,0,-27,3,0
2,4,9,0,30,2,2,0,4,1,30,2,0,0,2,3,30,4,0,0,4,4,30,1,3,0,4,2,30,1,0,0,1,0,-27,3,0
2,4,31,0,30,1,3,0,4,2,30,4,0,0,4,0,30,1,3,0,4,0,30,1,3,0,4,0,30,0,3,0,3,1,-15,3,1
2,4,8,1,30,7,0,0,7,2,30,2,0,0,2,6,30,5,2,0,7,1,30,7,0,0,7,5,30,3,0,0,3,0,-27,3,0
2,2,31,0,30,2,2,0,4,2,30,4,0,0,4,4,30,4,0,0,4,0,30,1,3,0,4,0,30,1,2,0,3,1,-15,3,1
2,4,5,1,30,6,6,0,12,2,30,7,3,0,10,1,30,5,7,0,12,0,30,7,5,0,12,1,30,1,5,0,6,0,-27,3,0
2,4,5,1,30,6,6,0,12,2,30,8,2,0,10,0,30,5,7,0,12,0,30,7,5,0,12,1,30,5,1,0,6,0,-27,3,0
2,4,17,1,30,3,1,0,4,1,30,2,0,0,2,2,30,0,4,0,4,2,30,1,3,0,4,3,30,1,0,0,1,1,-15,3,1
2,4,16,0,30,4,5,0,9,1,30,8,0,0,8,2,30,3,6,0,9,0,30,1,8,0,9,2,30,4,0,0,4,1,-15,3,1
2,2,5,0,30,2,3,0,5,2,30,3,1,0,4,0,30,3,2,0,5,0,30,1,4,0,5,0,30,1,1,0,2,0,-27,3,0
2,3,13,2,30,3,0,0,3,0,30,2,0,0,2,0,30,3,0,0,3,0,30,2,1,0,3,2,30,2,0,0,2,1,-15,3,1
2,4,24,6,30,5,1,0,6,3,30,3,1,0,4,1,30,6,0,0,6,0,30,1,5,0,6,0,30,4,0,0,4,1,-15,3,1
2,1,31,3,30,1,3,0,4,4,30,4,0,0,4,0,30,1,3,0,4,0,30,1,3,0,4,0,30,3,0,0,3,1,-15,3,1
2,2,23,0,30,3,2,0,5,0,30,4,0,0,4,6,30,4,1,0,5,0,30,0,5,0,5,2,30,2,0,0,2,1,-15,3,1
2,4,24,0,30,4,2,0,6,2,30,4,0,0,4,4,30,4,2,0,6,0,30,1,5,0,6,1,30,4,0,0,4,1,-15,3,1
2,4,27,0,30,1,4,0,5,1,30,0,0,0,0,0,30,4,1,0,5,0,30,2,3,0,5,1,30,4,0,0,4,1,-15,3,1
2,4,9,0,30,7,4,0,11,1,30,6,0,0,6,5,30,10,1,0,11,1,30,4,7,0,11,3,30,1,3,0,4,0,-27,3,0
2,1,23,0,30,2,3,0,5,1,30,4,0,0,4,3,30,3,2,0,5,0,30,0,5,0,5,3,30,2,0,0,2,1,-15,3,1
2,4,14,0,30,4,5,0,9,0,30,6,0,0,6,0,30,8,1,0,9,0,30,6,3,0,9,2,30,4,0,0,4,1,-15,3,1
2,2,24,0,30,5,1,0,6,2,30,4,0,0,4,0,30,4,2,0,6,0,30,2,4,0,6,1,30,4,0,0,4,1,-15,3,1
2,4,23,0,30,2,3,0,5,2,30,4,0,0,4,4,30,2,3,0,5,0,30,0,5,0,5,2,30,2,0,0,2,1,-15,3,1
2,4,3,1,30,4,7,0,11,0,30,8,0,0,8,3,30,11,0,0,11,4,30,2,9,0,11,2,30,3,4,0,7,0,-27,3,0
2,3,3,1,30,4,7,0,11,3,30,8,0,0,8,4,30,2,9,0,11,0,30,7,4,0,11,1,30,2,5,0,7,0,-27,3,0
2,3,7,0,30,4,5,0,9,1,30,4,0,0,4,2,30,6,3,0,9,4,30,3,6,0,9,1,30,6,0,0,6,0,-27,3,0
2,3,11,0,30,2,2,0,4,0,30,0,0,0,0,3,30,3,1,0,4,0,30,1,3,0,4,0,30,1,0,0,1,1,-15,3,1
2,1,5,0,30,5,7,0,12,2,30,7,3,0,10,0,30,6,6,0,12,1,30,8,4,0,12,1,30,6,0,0,6,0,-27,3,0
2,2,16,0,30,7,2,0,9,2,30,8,0,0,8,3,30,2,7,0,9,0,30,1,8,0,9,0,30,4,0,0,4,1,-15,3,1
2,3,17,1,30,1,3,0,4,0,30,2,0,0,2,1,30,1,3,0,4,2,30,0,4,0,4,0,30,1,0,0,1,1,-15,3,1
2,2,28,0,30,3,5,0,8,3,30,4,0,0,4,2,30,3,5,0,8,0,30,4,4,0,8,3,30,4,0,0,4,1,-15,3,1
2,3,5,1,30,6,6,0,12,2,30,6,4,0,10,0,30,5,7,0,12,0,30,7,5,0,12,1,30,4,2,0,6,0,-27,3,0
2,1,13,0,30,3,0,0,3,0,30,2,0,0,2,4,30,3,0,0,3,3,30,3,0,0,3,3,30,2,0,0,2,1,-15,3,1
2,2,5,1,30,8,4,0,12,2,30,4,6,0,10,0,30,3,9,0,12,0,30,6,6,0,12,0,30,4,2,0,6,0,-27,3,0
2,4,23,0,30,2,3,0,5,2,30,4,0,0,4,11,30,3,2,0,5,0,30,0,5,0,5,2,30,2,0,0,2,1,-15,3,1
2,3,28,0,30,4,4,0,8,4,30,4,0,0,4,3,30,2,6,0,8,0,30,2,6,0,8,1,30,4,0,0,4,1,-15,3,1
2,4,28,0,30,2,6,0,8,4,30,4,0,0,4,0,30,1,7,0,8,0,30,4,4,0,8,2,30,4,0,0,4,1,-15,3,1
2,3,24,0,30,4,2,0,6,0,30,4,0,0,4,8,30,6,0,0,6,0,30,1,5,0,6,0,30,3,1,0,4,1,-15,3,1
2,4,24,0,30,2,4,0,6,3,30,4,0,0,4,10,30,6,0,0,6,0,30,1,5,0,6,2,30,4,0,0,4,1,-15,3,1
2,3,24,1,30,6,0,0,6,0,30,3,1,0,4,1,30,6,0,0,6,0,30,1,5,0,6,4,30,4,0,0,4,1,-15,3,1
2,3,14,4,30,9,0,0,9,1,30,6,0,0,6,0,30,7,2,0,9,0,30,2,7,0,9,0,30,4,0,0,4,1,-15,3,1
2,1,23,1,30,5,0,0,5,2,30,4,0,0,4,11,30,2,3,0,5,0,30,0,5,0,5,1,30,1,1,0,2,1,-15,3,1
2,3,27,0,30,3,2,0,5,0,30,0,0,0,0,2,30,5,0,0,5,0,30,2,3,0,5,4,30,4,0,0,4,1,-15,3,1
2,4,9,1,30,4,0,0,4,2,30,2,0,0,2,2,30,2,2,0,4,1,30,1,3,0,4,0,30,1,0,0,1,0,-27,3,0
2,2,17,1,30,1,3,0,4,0,30,2,0,0,2,1,30,1,3,0,4,2,30,2,2,0,4,3,30,1,0,0,1,1,-15,3,1
2,4,9,0,30,3,1,0,4,1,30,2,0,0,2,6,30,4,0,0,4,0,30,1,3,0,4,2,30,1,0,0,1,0,-27,3,0
2,2,9,0,30,1,3,0,4,0,30,2,0,0,2,5,30,4,0,0,4,0,30,1,3,0,4,1,30,1,0,0,1,0,-27,3,0
2,3,5,1,30,3,9,0,12,2,30,9,1,0,10,0,30,3,9,0,12,0,30,8,4,0,12,1,30,4,2,0,6,0,-27,3,0
2,1,24,0,30,6,0,0,6,2,30,4,0,0,4,10,30,6,0,0,6,0,30,1,5,0,6,0,30,4,0,0,4,1,-15,3,1
2,4,23,2,30,6,7,0,13,1,30,6,0,0,6,8,30,12,1,0,13,0,30,6,7,0,13,2,30,6,0,0,6,1,-15,3,1
2,1,5,1,30,6,6,0,12,3,30,7,3,0,10,0,30,3,9,0,12,0,30,6,6,0,12,4,30,6,0,0,6,0,-27,3,0
2,1,3,1,30,4,7,0,11,1,30,8,0,0,8,0,30,8,3,0,11,2,30,9,2,0,11,1,30,2,5,0,7,0,-27,3,0
2,4,21,1,30,3,0,0,3,0,30,2,0,0,2,0,30,2,1,0,3,0,30,1,2,0,3,1,30,1,0,0,1,1,-15,3,1
2,4,31,1,30,1,3,0,4,3,30,4,0,0,4,2,30,3,1,0,4,0,30,1,3,0,4,0,30,3,0,0,3,1,-15,3,1
2,4,4,2,30,6,2,0,8,4,30,4,0,0,4,5,30,5,3,0,8,0,30,5,3,0,8,1,30,3,1,0,4,0,-27,3,0
2,3,16,0,30,6,3,0,9,2,30,8,0,0,8,1,30,1,8,0,9,0,30,1,8,0,9,0,30,4,0,0,4,1,-15,3,1
2,4,17,1,30,1,3,0,4,0,30,2,0,0,2,1,30,2,2,0,4,4,30,1,3,0,4,2,30,1,0,0,1,1,-15,3,1
2,1,9,0,30,2,2,0,4,2,30,1,1,0,2,5,30,1,3,0,4,0,30,1,3,0,4,1,30,1,0,0,1,0,-27,3,0
2,4,24,0,30,3,3,0,6,3,30,4,0,0,4,7,30,3,3,0,6,0,30,2,4,0,6,0,30,3,1,0,4,1,-15,3,1
2,1,24,0,30,4,2,0,6,2,30,4,0,0,4,5,30,6,0,0,6,0,30,1,5,0,6,2,30,4,0,0,4,1,-15,3,1
2,4,9,0,30,1,3,0,4,0,30,2,0,0,2,3,30,4,0,0,4,0,30,1,3,0,4,3,30,1,0,0,1,0,-27,3,0
2,4,25,2,30,3,1,0,4,2,30,2,0,0,2,2,30,4,0,0,4,0,30,1,3,0,4,1,30,1,0,0,1,1,-15,3,1
2,1,20,0,30,2,6,0,8,0,30,8,0,0,8,0,30,8,0,0,8,0,30,3,5,0,8,1,30,5,0,0,5,1,-15,3,1
2,3,24,0,30,3,3,0,6,2,30,4,0,0,4,5,30,6,0,0,6,0,30,1,5,0,6,0,30,3,1,0,4,1,-15,3,1
2,4,23,0,30,2,3,0,5,2,30,4,0,0,4,8,30,4,1,0,5,0,30,0,5,0,5,6,30,2,0,0,2,1,-15,3,1
2,4,31,1,30,1,3,0,4,2,30,4,0,0,4,0,30,4,0,0,4,0,30,1,3,0,4,0,30,0,3,0,3,1,-15,3,1
2,2,15,1,30,4,0,0,4,0,30,5,1,0,6,0,30,2,2,0,4,2,30,1,3,0,4,2,30,4,0,0,4,1,-15,3,1
2,4,5,1,30,6,6,0,12,2,30,7,3,0,10,0,30,6,6,0,12,0,30,6,6,0,12,2,30,3,3,0,6,0,-27,3,0
2,3,13,2,30,3,0,0,3,1,30,2,0,0,2,0,30,3,0,0,3,3,30,3,0,0,3,2,30,2,0,0,2,1,-15,3,1
2,4,11,0,30,1,3,0,4,0,30,0,0,0,0,3,30,2,2,0,4,0,30,2,2,0,4,1,30,1,0,0,1,1,-15,3,1
2,2,24,0,30,4,2,0,6,2,30,4,0,0,4,3,30,6,0,0,6,0,30,2,4,0,6,1,30,4,0,0,4,1,-15,3,1
2,2,3,1,30,5,6,0,11,2,30,8,0,0,8,0,30,3,8,0,11,0,30,4,7,0,11,1,30,2,5,0,7,0,-27,3,0
2,2,4,5,30,8,0,0,8,3,30,4,0,0,4,0,30,7,1,0,8,0,30,4,4,0,8,1,30,3,1,0,4,0,-27,3,0
2,3,5,1,30,5,7,0,12,3,30,8,2,0,10,1,30,3,9,0,12,0,30,7,5,0,12,3,30,5,1,0,6,0,-27,3,0
2,4,23,0,30,2,3,0,5,1,30,4,0,0,4,2,30,3,2,0,5,0,30,4,1,0,5,4,30,2,0,0,2,1,-15,3,1
2,4,7,0,30,4,5,0,9,2,30,4,0,0,4,3,30,6,3,0,9,5,30,4,5,0,9,2,30,5,1,0,6,0,-27,3,0
2,0,31,1,30,6,6,0,12,3,30,8,0,0,8,6,30,11,1,0,12,0,30,3,9,0,12,0,30,3,3,0,6,1,-15,3,1
2,4,24,0,30,6,0,0,6,2,30,4,0,0,4,0,30,4,2,0,6,0,30,2,4,0,6,0,30,3,1,0,4,1,-15,3,1
2,4,8,1,30,7,0,0,7,1,30,2,0,0,2,0,30,6,1,0,7,0,30,4,3,0,7,0,30,3,0,0,3,0,-27,3,0
2,3,4,2,30,8,0,0,8,3,30,4,0,0,4,0,30,6,2,0,8,0,30,3,5,0,8,2,30,4,0,0,4,0,-27,3,0
2,3,23,0,30,2,3,0,5,1,30,4,0,0,4,0,30,5,0,0,5,0,30,0,5,0,5,4,30,2,0,0,2,1,-15,3,1
2,3,13,4,30,6,1,0,7,1,30,4,0,0,4,0,30,6,1,0,7,0,30,6,1,0,7,5,30,4,0,0,4,1,-15,3,1
2,3,5,1,30,6,6,0,12,3,30,7,3,0,10,0,30,3,9,0,12,0,30,7,5,0,12,2,30,6,0,0,6,0,-27,3,0
2,3,23,0,30,2,3,0,5,1,30,4,0,0,4,2,30,4,1,0,5,0,30,1,4,0,5,3,30,2,0,0,2,1,-15,3,1
2,3,32,0,30,4,5,0,9,3,30,2,0,0,2,0,30,9,0,0,9,1,30,2,7,0,9,2,30,2,0,0,2,1,-15,3,1
2,3,24,0,30,4,2,0,6,2,30,4,0,0,4,2,30,4,2,0,6,0,30,1,5,0,6,1,30,4,0,0,4,1,-15,3,1
2,3,8,1,30,7,0,0,7,3,30,2,0,0,2,3,30,7,0,0,7,0,30,5,2,0,7,1,30,3,0,0,3,0,-27,3,0
2,4,25,1,30,0,4,0,4,2,30,2,0,0,2,0,30,4,0,0,4,0,30,0,4,0,4,1,30,1,0,0,1,1,-15,3,1
2,0,31,2,30,1,3,0,4,3,30,4,0,0,4,0,30,1,3,0,4,1,30,2,2,0,4,1,30,3,0,0,3,1,-15,3,1
2,2,16,0,30,5,4,0,9,2,30,8,0,0,8,1,30,2,7,0,9,0,30,1,8,0,9,1,30,4,0,0,4,1,-15,3,1
2,4,31,0,30,0,4,0,4,1,30,4,0,0,4,7,30,4,0,0,4,0,30,1,3,0,4,0,30,1,2,0,3,1,-15,3,1
2,4,29,0,30,1,4,0,5,4,30,6,2,0,8,0,30,1,4,0,5,0,30,1,4,0,5,0,30,4,0,0,4,1,-15,3,1
2,3,4,0,30,6,2,0,8,4,30,3,1,0,4,2,30,3,5,0,8,0,30,5,3,0,8,4,30,4,0,0,4,0,-27,3,0
2,4,27,0,30,1,4,0,5,2,30,0,0,0,0,0,30,4,1,0,5,0,30,1,4,0,5,0,30,4,0,0,4,1,-15,3,1
2,4,29,0,30,0,5,0,5,4,30,8,0,0,8,1,30,2,3,0,5,0,30,1,4,0,5,2,30,4,0,0,4,1,-15,3,1
2,4,35,1,30,2,2,0,4,1,30,0,0,0,0,5,30,4,0,0,4,0,30,1,3,0,4,5,30,3,0,0,3,1,-15,3,1
2,4,25,3,30,3,1,0,4,3,30,2,0,0,2,0,30,3,1,0,4,0,30,0,4,0,4,0,30,1,0,0,1,1,-15,3,1
2,4,13,1,30,5,2,0,7,0,30,4,0,0,4,1,30,5,2,0,7,3,30,6,1,0,7,3,30,4,0,0,4,1,-15,3,1
2,2,9,1,30,3,1,0,4,2,30,2,0,0,2,3,30,2,2,0,4,0,30,1,3,0,4,2,30,1,0,0,1,0,-27,3,0
2,3,13,1,30,3,4,0,7,0,30,4,0,0,4,5,30,6,1,0,7,4,30,7,0,0,7,4,30,4,0,0,4,1,-15,3,1
2,2,14,0,30,3,6,0,9,0,30,6,0,0,6,1,30,8,1,0,9,0,30,6,3,0,9,5,30,4,0,0,4,1,-15,3,1
2,4,20,0,30,2,6,0,8,1,30,8,0,0,8,0,30,5,3,0,8,0,30,2,6,0,8,1,30,4,1,0,5,1,-15,3,1
2,3,24,0,30,3,3,0,6,2,30,3,1,0,4,1,30,6,0,0,6,0,30,1,5,0,6,1,30,4,0,0,4,1,-15,3,1
2,0,5,1,30,6,6,0,12,3,30,4,6,0,10,3,30,3,9,0,12,0,30,7,5,0,12,1,30,4,2,0,6,0,-27,3,0
2,1,31,1,30,1,3,0,4,4,30,4,0,0,4,0,30,1,3,0,4,2,30,3,1,0,4,2,30,3,0,0,3,1,-15,3,1
2,2,29,0,30,0,5,0,5,4,30,8,0,0,8,0,30,1,4,0,5,0,30,0,5,0,5,1,30,4,0,0,4,1,-15,3,1
2,1,28,0,30,2,6,0,8,3,30,4,0,0,4,1,30,4,4,0,8,0,30,6,2,0,8,4,30,3,1,0,4,1,-15,3,1
2,2,13,1,30,3,0,0,3,0,30,2,0,0,2,0,30,3,0,0,3,5,30,3,0,0,3,0,30,2,0,0,2,1,-15,3,1
2,2,4,4,30,8,0,0,8,3,30,4,0,0,4,0,30,5,3,0,8,0,30,3,5,0,8,1,30,4,0,0,4,0,-27,3,0
2,4,23,0,30,2,3,0,5,1,30,4,0,0,4,1,30,5,0,0,5,0,30,0,5,0,5,4,30,2,0,0,2,1,-15,3,1
2,4,31,0,30,1,3,0,4,2,30,4,0,0,4,2,30,1,3,0,4,0,30,1,3,0,4,0,30,3,0,0,3,1,-15,3,1
2,4,33,2,30,5,6,0,11,3,30,4,0,0,4,5,30,9,2,0,11,0,30,3,8,0,11,3,30,4,0,0,4,1,-15,3,1
2,2,13,3,30,7,0,0,7,1,30,4,0,0,4,2,30,5,2,0,7,2,30,4,3,0,7,6,30,4,0,0,4,1,-15,3,1
2,2,26,0,30,5,4,0,9,4,30,4,0,0,4,3,30,7,2,0,9,0,30,2,7,0,9,6,30,1,2,0,3,1,-15,3,1
2,4,7,0,30,3,1,0,4,0,30,2,0,0,2,3,30,3,1,0,4,0,30,1,3,0,4,3,30,2,0,0,2,0,-27,3,0
2,2,31,2,30,7,5,0,12,3,30,8,0,0,8,5,30,12,0,0,12,0,30,3,9,0,12,1,30,2,4,0,6,1,-15,3,1
2,4,3,0,30,4,7,0,11,3,30,8,0,0,8,0,30,2,9,0,11,1,30,5,6,0,11,1,30,5,2,0,7,0,-27,3,0
2,3,23,0,30,3,2,0,5,1,30,4,0,0,4,1,30,4,1,0,5,0,30,0,5,0,5,1,30,2,0,0,2,1,-15,3,1
2,3,9,0,30,3,1,0,4,1,30,2,0,0,2,3,30,4,0,0,4,0,30,1,3,0,4,0,30,1,0,0,1,0,-27,3,0
2,3,31,0,30,1,3,0,4,2,30,4,0,0,4,4,30,4,0,0,4,0,30,1,3,0,4,3,30,3,0,0,3,1,-15,3,1
2,4,9,0,30,5,6,0,11,2,30,6,0,0,6,2,30,9,2,0,11,2,30,3,8,0,11,2,30,3,1,0,4,0,-27,3,0
2,4,22,1,30,4,4,0,8,2,30,2,0,0,2,0,30,4,4,0,8,1,30,4,4,0,8,1,30,2,2,0,4,1,-15,3,1
2,4,24,0,30,5,1,0,6,2,30,4,0,0,4,4,30,6,0,0,6,0,30,1,5,0,6,5,30,4,0,0,4,1,-15,3,1
2,3,25,2,30,0,4,0,4,1,30,2,0,0,2,0,30,1,3,0,4,0,30,0,4,0,4,2,30,1,0,0,1,1,-15,3,1
2,4,7,0,30,4,5,0,9,2,30,4,0,0,4,2,30,6,3,0,9,4,30,3,6,0,9,5,30,6,0,0,6,0,-27,3,0
2,4,7,0,30,5,4,0,9,1,30,4,0,0,4,2,30,8,1,0,9,0,30,2,7,0,9,1,30,5,1,0,6,0,-27,3,0
2,2,13,3,30,3,0,0,3,0,30,2,0,0,2,0,30,2,1,0,3,3,30,2,1,0,3,3,30,2,0,0,2,1,-15,3,1
2,4,25,0,30,4,0,0,4,1,30,2,0,0,2,0,30,4,0,0,4,0,30,2,2,0,4,3,30,1,0,0,1,1,-15,3,1
2,3,5,1,30,6,6,0,12,2,30,7,3,0,10,0,30,7,5,0,12,1,30,7,5,0,12,2,30,4,2,0,6,0,-27,3,0
2,3,9,1,30,5,6,0,11,1,30,6,0,0,6,4,30,11,0,0,11,0,30,3,8,0,11,3,30,2,2,0,4,0,-27,3,0
2,3,3,1,30,4,7,0,11,3,30,8,0,0,8,0,30,2,9,0,11,3,30,5,6,0,11,1,30,5,2,0,7,0,-27,3,0
2,4,9,0,30,4,7,0,11,1,30,6,0,0,6,5,30,11,0,0,11,1,30,5,6,0,11,2,30,3,1,0,4,0,-27,3,0
2,3,15,0,30,1,3,0,4,0,30,6,0,0,6,0,30,2,2,0,4,6,30,4,0,0,4,0,30,1,3,0,4,1,-15,3,1
2,3,23,0,30,2,3,0,5,2,30,4,0,0,4,0,30,1,4,0,5,0,30,1,4,0,5,1,30,2,0,0,2,1,-15,3,1
2,3,17,1,30,2,2,0,4,1,30,2,0,0,2,2,30,1,3,0,4,2,30,1,3,0,4,1,30,1,0,0,1,1,-15,3,1
2,0,4,2,30,6,2,0,8,4,30,2,2,0,4,6,30,3,5,0,8,0,30,4,4,0,8,2,30,3,1,0,4,0,-27,3,0
2,4,4,2,30,8,0,0,8,0,30,4,0,0,4,2,30,6,2,0,8,0,30,3,5,0,8,2,30,3,1,0,4,0,-27,3,0
2,4,31,0,30,1,3,0,4,3,30,4,0,0,4,0,30,4,0,0,4,0,30,1,3,0,4,0,30,3,0,0,3,1,-15,3,1
2,2,9,3,30,3,1,0,4,2,30,2,0,0,2,1,30,3,1,0,4,0,30,1,3,0,4,2,30,1,0,0,1,0,-27,3,0
2,4,7,0,30,3,6,0,9,2,30,4,0,0,4,0,30,7,2,0,9,4,30,7,2,0,9,2,30,3,3,0,6,0,-27,3,0
2,0,5,2,30,5,7,0,12,3,30,8,2,0,10,0,30,3,9,0,12,0,30,7,5,0,12,1,30,6,0,0,6,0,-27,3,0
2,4,24,0,30,4,2,0,6,3,30,4,0,0,4,7,30,6,0,0,6,0,30,1,5,0,6,4,30,3,1,0,4,1,-15,3,1
2,4,3,0,30,3,8,0,11,2,30,8,0,0,8,0,30,2,9,0,11,3,30,5,6,0,11,1,30,3,4,0,7,0,-27,3,0
2,2,13,2,30,6,1,0,7,0,30,4,0,0,4,5,30,7,0,0,7,0,30,5,2,0,7,5,30,4,0,0,4,1,-15,3,1
2,4,11,0,30,1,3,0,4,0,30,0,0,0,0,0,30,0,4,0,4,1,30,2,2,0,4,0,30,1,0,0,1,1,-15,3,1
2,3,9,1,30,7,4,0,11,2,30,6,0,0,6,1,30,9,2,0,11,0,30,3,8,0,11,2,30,3,1,0,4,0,-27,3,0
2,2,37,0,30,7,4,0,11,4,30,6,2,0,8,6,30,11,0,0,11,2,30,3,8,0,11,3,30,6,0,0,6,1,-15,3,1
2,4,30,2,30,3,2,0,5,4,30,2,0,0,2,1,30,2,3,0,5,2,30,2,3,0,5,1,30,3,0,0,3,1,-15,3,1
2,4,16,0,30,7,2,0,9,1,30,5,3,0,8,0,30,3,6,0,9,0,30,1,8,0,9,0,30,2,2,0,4,1,-15,3,1
2,4,28,0,30,3,5,0,8,4,30,4,0,0,4,2,30,2,6,0,8,0,30,2,6,0,8,0,30,4,0,0,4,1,-15,3,1
2,4,4,9,30,8,0,0,8,3,30,2,2,0,4,0,30,5,3,0,8,0,30,0,8,0,8,4,30,4,0,0,4,0,-27,3,0
2,4,23,0,30,5,0,0,5,1,30,4,0,0,4,0,30,4,1,0,5,0,30,0,5,0,5,1,30,1,1,0,2,1,-15,3,1
2,2,31,1,30,2,2,0,4,4,30,4,0,0,4,3,30,2,2,0,4,0,30,1,3,0,4,0,30,3,0,0,3,1,-15,3,1
2,2,5,1,30,6,6,0,12,3,30,8,2,0,10,0,30,3,9,0,12,0,30,7,5,0,12,4,30,6,0,0,6,0,-27,3,0
2,3,33,1,30,2,9,0,11,4,30,4,0,0,4,7,30,11,0,0,11,0,30,5,6,0,11,7,30,4,0,0,4,1,-15,3,1
2,4,25,3,30,2,2,0,4,2,30,2,0,0,2,0,30,2,2,0,4,0,30,4,0,0,4,0,30,1,0,0,1,1,-15,3,1
2,2,24,0,30,3,3,0,6,2,30,3,1,0,4,3,30,2,4,0,6,0,30,3,3,0,6,4,30,4,0,0,4,1,-15,3,1
2,1,5,1,30,5,7,0,12,2,30,8,2,0,10,0,30,6,6,0,12,0,30,8,4,0,12,1,30,2,4,0,6,0,-27,3,0
2,4,7,1,30,3,6,0,9,1,30,4,0,0,4,2,30,7,2,0,9,0,30,3,6,0,9,1,30,4,2,0,6,0,-27,3,0
2,4,7,0,30,2,2,0,4,1,30,2,0,0,2,4,30,4,0,0,4,0,30,1,3,0,4,2,30,2,0,0,2,0,-27,3,0
2,1,31,0,30,2,2,0,4,2,30,4,0,0,4,1,30,4,0,0,4,0,30,1,3,0,4,2,30,3,0,0,3,1,-15,3,1
2,3,9,0,30,2,2,0,4,2,30,2,0,0,2,4,30,1,3,0,4,0,30,2,2,0,4,2,30,1,0,0,1,0,-27,3,0
2,4,30,2,30,2,3,0,5,4,30,2,0,0,2,1,30,2,3,0,5,3,30,1,4,0,5,2,30,3,0,0,3,1,-15,3,1
2,4,27,2,30,2,3,0,5,3,30,0,0,0,0,0,30,1,4,0,5,0,30,1,4,0,5,0,30,4,0,0,4,1,-15,3,1
2,0,5,1,30,6,6,0,12,2,30,6,4,0,10,0,30,6,6,0,12,0,30,8,4,0,12,2,30,4,2,0,6,0,-27,3,0
2,4,24,0,30,5,1,0,6,2,30,3,1,0,4,8,30,6,0,0,6,4,30,1,5,0,6,1,30,4,0,0,4,1,-15,3,1
2,2,20,0,30,2,6,0,8,1,30,7,1,0,8,0,30,5,3,0,8,0,30,6,2,0,8,1,30,3,2,0,5,1,-15,3,1
2,3,23,0,30,2,3,0,5,2,30,4,0,0,4,6,30,4,1,0,5,0,30,0,5,0,5,2,30,2,0,0,2,1,-15,3,1
2,4,28,0,30,5,3,0,8,3,30,4,0,0,4,2,30,3,5,0,8,0,30,2,6,0,8,2,30,3,1,0,4,1,-15,3,1
2,3,24,0,30,4,2,0,6,1,30,4,0,0,4,8,30,6,0,0,6,0,30,2,4,0,6,1,30,4,0,0,4,1,-15,3,1
2,3,31,0,30,0,4,0,4,3,30,4,0,0,4,1,30,2,2,0,4,0,30,4,0,0,4,2,30,3,0,0,3,1,-15,3,1
2,4,8,4,30,6,1,0,7,3,30,2,0,0,2,2,30,7,0,0,7,0,30,0,7,0,7,2,30,3,0,0,3,0,-27,3,0
2,4,31,2,30,6,6,0,12,4,30,8,0,0,8,9,30,10,2,0,12,0,30,3,9,0,12,0,30,2,4,0,6,1,-15,3,1
2,4,28,0,30,2,6,0,8,3,30,4,0,0,4,0,30,4,4,0,8,0,30,4,4,0,8,0,30,3,1,0,4,1,-15,3,1
2,3,23,0,30,2,3,0,5,1,30,4,0,0,4,0,30,2,3,0,5,0,30,0,5,0,5,2,30,2,0,0,2,1,-15,3,1
2,2,31,1,30,1,3,0,4,3,30,4,0,0,4,0,30,1,3,0,4,1,30,2,2,0,4,2,30,3,0,0,3,1,-15,3,1
2,3,24,0,30,4,2,0,6,2,30,3,1,0,4,0,30,4,2,0,6,0,30,1,5,0,6,3,30,4,0,0,4,1,-15,3,1
2,2,23,0,30,2,3,0,5,2,30,4,0,0,4,4,30,5,0,0,5,0,30,0,5,0,5,1,30,2,0,0,2,1,-15,3,1
2,3,17,1,30,1,3,0,4,0,30,2,0,0,2,2,30,1,3,0,4,2,30,1,3,0,4,3,30,1,0,0,1,1,-15,3,1
2,3,5,1,30,4,8,0,12,0,30,6,4,0,10,0,30,9,3,0,12,0,30,8,4,0,12,2,30,3,3,0,6,0,-27,3,0
2,1,3,1,30,4,7,0,11,0,30,8,0,0,8,3,30,7,4,0,11,6,30,5,6,0,11,1,30,3,4,0,7,0,-27,3,0
2,3,7,1,30,5,4,0,9,2,30,4,0,0,4,2,30,6,3,0,9,4,30,2,7,0,9,1,30,6,0,0,6,0,-27,3,0
2,4,24,0,30,3,3,0,6,1,30,4,0,0,4,0,30,6,0,0,6,0,30,1,5,0,6,0,30,4,0,0,4,1,-15,3,1
2,4,32,0,30,5,4,0,9,4,30,2,0,0,2,2,30,9,0,0,9,1,30,3,6,0,9,3,30,2,0,0,2,1,-15,3,1
2,0,20,0,30,5,3,0,8,1,30,7,1,0,8,0,30,6,2,0,8,0,30,1,7,0,8,2,30,5,0,0,5,1,-15,3,1
2,4,23,0,30,1,4,0,5,2,30,4,0,0,4,3,30,3,2,0,5,0,30,0,5,0,5,1,30,2,0,0,2,1,-15,3,1
2,2,5,1,30,6,6,0,12,2,30,7,3,0,10,0,30,7,5,0,12,0,30,8,4,0,12,1,30,4,2,0,6,0,-27,3,0
2,4,3,0,30,5,6,0,11,2,30,8,0,0,8,0,30,5,6,0,11,0,30,6,5,0,11,1,30,2,5,0,7,0,-27,3,0
2,4,31,2,30,0,4,0,4,3,30,4,0,0,4,0,30,2,2,0,4,0,30,1,3,0,4,0,30,2,1,0,3,1,-15,3,1
2,3,8,2,30,7,0,0,7,0,30,2,0,0,2,2,30,7,0,0,7,0,30,5,2,0,7,0,30,3,0,0,3,0,-27,3,0
2,1,24,1,30,6,0,0,6,2,30,4,0,0,4,6,30,6,0,0,6,0,30,1,5,0,6,2,30,4,0,0,4,1,-15,3,1
2,3,31,1,30,1,3,0,4,3,30,4,0,0,4,0,30,2,2,0,4,1,30,2,2,0,4,0,30,3,0,0,3,1,-15,3,1
2,4,7,0,30,1,3,0,4,0,30,2,0,0,2,2,30,2,2,0,4,0,30,1,3,0,4,1,30,2,0,0,2,0,-27,3,0
2,4,13,1,30,3,0,0,3,0,30,2,0,0,2,0,30,3,0,0,3,4,30,1,2,0,3,2,30,2,0,0,2,1,-15,3,1
2,3,24,0,30,5,1,0,6,0,30,3,1,0,4,3,30,5,1,0,6,0,30,1,5,0,6,3,30,4,0,0,4,1,-15,3,1
2,4,7,0,30,4,5,0,9,0,30,4,0,0,4,3,30,6,3,0,9,0,30,3,6,0,9,1,30,4,2,0,6,0,-27,3,0
2,3,25,1,30,4,0,0,4,2,30,2,0,0,2,1,30,4,0,0,4,0,30,0,4,0,4,1,30,1,0,0,1,1,-15,3,1
2,4,9,0,30,2,2,0,4,2,30,1,1,0,2,0,30,2,2,0,4,0,30,1,3,0,4,0,30,1,0,0,1,0,-27,3,0
2,2,20,0,30,0,8,0,8,1,30,8,0,0,8,0,30,5,3,0,8,0,30,3,5,0,8,1,30,3,2,0,5,1,-15,3,1
2,3,9,0,30,0,4,0,4,1,30,2,0,0,2,5,30,3,1,0,4,0,30,3,1,0,4,2,30,1,0,0,1,0,-27,3,0
2,4,23,0,30,2,3,0,5,2,30,4,0,0,4,7,30,5,0,0,5,0,30,0,5,0,5,2,30,2,0,0,2,1,-15,3,1
2,4,23,0,30,3,2,0,5,2,30,4,0,0,4,1,30,3,2,0,5,0,30,0,5,0,5,1,30,2,0,0,2,1,-15,3,1
2,4,25,0,30,2,2,0,4,1,30,2,0,0,2,1,30,4,0,0,4,0,30,0,4,0,4,3,30,1,0,0,1,1,-15,3,1
2,2,31,0,30,0,4,0,4,1,30,4,0,0,4,4,30,4,0,0,4,0,30,1,3,0,4,0,30,2,1,0,3,1,-15,3,1
2,3,24,0,30,4,2,0,6,2,30,3,1,0,4,5,30,6,0,0,6,0,30,2,4,0,6,6,30,4,0,0,4,1,-15,3,1
2,1,31,2,30,0,4,0,4,3,30,4,0,0,4,0,30,3,1,0,4,0,30,1,3,0,4,0,30,3,0,0,3,1,-15,3,1
2,4,30,6,30,3,2,0,5,4,30,2,0,0,2,1,30,2,3,0,5,3,30,1,4,0,5,0,30,3,0,0,3,1,-15,3,1
2,1,5,1,30,5,7,0,12,2,30,8,2,0,10,0,30,3,9,0,12,0,30,7,5,0,12,3,30,4,2,0,6,0,-27,3,0
2,4,16,1,30,6,3,0,9,1,30,8,0,0,8,1,30,3,6,0,9,0,30,0,9,0,9,0,30,4,0,0,4,1,-15,3,1
2,3,5,0,30,6,6,0,12,2,30,8,2,0,10,0,30,5,7,0,12,0,30,8,4,0,12,1,30,1,5,0,6,0,-27,3,0
2,4,32,0,30,5,4,0,9,3,30,2,0,0,2,5,30,9,0,0,9,1,30,2,7,0,9,2,30,2,0,0,2,1,-15,3,1
2,4,7,0,30,1,3,0,4,1,30,2,0,0,2,4,30,3,1,0,4,0,30,1,3,0,4,2,30,1,1,0,2,0,-27,3,0
2,1,31,0,30,0,4,0,4,3,30,4,0,0,4,2,30,3,1,0,4,2,30,3,1,0,4,2,30,3,0,0,3,1,-15,3,1
2,4,17,0,30,2,2,0,4,0,30,2,0,0,2,2,30,0,4,0,4,2,30,2,2,0,4,4,30,1,0,0,1,1,-15,3,1
2,1,24,0,30,5,1,0,6,2,30,4,0,0,4,5,30,6,0,0,6,0,30,1,5,0,6,2,30,4,0,0,4,1,-15,3,1
2,3,16,1,30,5,4,0,9,2,30,8,0,0,8,4,30,2,7,0,9,0,30,2,7,0,9,0,30,2,2,0,4,1,-15,3,1
2,2,23,0,30,2,3,0,5,2,30,4,0,0,4,3,30,2,3,0,5,0,30,0,5,0,5,2,30,2,0,0,2,1,-15,3,1
2,3,9,0,30,2,2,0,4,2,30,2,0,0,2,4,30,2,2,0,4,0,30,1,3,0,4,0,30,0,1,0,1,0,-27,3,0
2,3,11,0,30,1,3,0,4,0,30,0,0,0,0,6,30,4,0,0,4,1,30,2,2,0,4,0,30,1,0,0,1,1,-15,3,1
2,3,9,2,30,3,1,0,4,2,30,2,0,0,2,2,30,4,0,0,4,0,30,1,3,0,4,1,30,1,0,0,1,0,-27,3,0
2,3,5,0,30,0,5,0,5,0,30,4,0,0,4,2,30,1,4,0,5,0,30,1,4,0,5,0,30,1,1,0,2,0,-27,3,0
2,3,9,0,30,2,2,0,4,0,30,2,0,0,2,0,30,2,2,0,4,4,30,1,3,0,4,0,30,1,0,0,1,0,-27,3,0
2,4,24,0,30,5,1,0,6,2,30,4,0,0,4,4,30,3,3,0,6,0,30,1,5,0,6,2,30,4,0,0,4,1,-15,3,1
2,3,25,2,30,1,3,0,4,0,30,2,0,0,2,4,30,4,0,0,4,0,30,2,2,0,4,7,30,1,0,0,1,1,-15,3,1
2,4,23,0,30,2,3,0,5,2,30,4,0,0,4,11,30,4,1,0,5,0,30,0,5,0,5,2,30,2,0,0,2,1,-15,3,1
2,4,9,0,30,7,4,0,11,1,30,6,0,0,6,2,30,11,0,0,11,2,30,3,8,0,11,2,30,3,1,0,4,0,-27,3,0
2,3,23,0,30,1,4,0,5,2,30,4,0,0,4,11,30,2,3,0,5,0,30,2,3,0,5,7,30,2,0,0,2,1,-15,3,1
2,1,25,1,30,0,4,0,4,2,30,2,0,0,2,2,30,3,1,0,4,0,30,0,4,0,4,0,30,1,0,0,1,1,-15,3,1
2,3,3,0,30,6,5,0,11,0,30,8,0,0,8,1,30,7,4,0,11,4,30,1,10,0,11,1,30,2,5,0,7,0,-27,3,0
2,2,31,0,30,2,2,0,4,3,30,4,0,0,4,4,30,4,0,0,4,0,30,1,3,0,4,0,30,2,1,0,3,1,-15,3,1
2,4,24,0,30,4,2,0,6,2,30,4,0,0,4,8,30,4,2,0,6,0,30,1,5,0,6,0,30,4,0,0,4,1,-15,3,1
2,3,31,0,30,0,4,0,4,2,30,4,0,0,4,5,30,2,2,0,4,0,30,1,3,0,4,1,30,3,0,0,3,1,-15,3,1
2,2,25,1,30,0,4,0,4,1,30,2,0,0,2,0,30,3,1,0,4,2,30,1,3,0,4,4,30,1,0,0,1,1,-15,3,1
2,3,13,2,30,6,1,0,7,0,30,4,0,0,4,1,30,6,1,0,7,1,30,6,1,0,7,4,30,4,0,0,4,1,-15,3,1
2,2,26,0,30,4,5,0,9,3,30,4,0,0,4,2,30,8,1,0,9,0,30,2,7,0,9,5,30,3,0,0,3,1,-15,3,1
2,2,13,3,30,3,0,0,3,0,30,2,0,0,2,1,30,3,0,0,3,4,30,2,1,0,3,3,30,2,0,0,2,1,-15,3,1
2,2,24,0,30,5,1,0,6,2,30,3,1,0,4,3,30,6,0,0,6,0,30,1,5,0,6,2,30,4,0,0,4,1,-15,3,1
2,3,15,0,30,2,2,0,4,0,30,5,1,0,6,0,30,2,2,0,4,3,30,4,0,0,4,0,30,4,0,0,4,1,-15,3,1
2,4,23,0,30,2,3,0,5,1,30,4,0,0,4,0,30,3,2,0,5,0,30,0,5,0,5,4,30,2,0,0,2,1,-15,3,1
2,4,13,9,30,7,0,0,7,1,30,4,0,0,4,5,30,7,0,0,7,0,30,2,5,0,7,1,30,4,0,0,4,1,-15,3,1
2,4,31,0,30,1,3,0,4,2,30,4,0,0,4,0,30,4,0,0,4,2,30,4,0,0,4,0,30,1,2,0,3,1,-15,3,1
2,2,9,0,30,3,1,0,4,1,30,2,0,0,2,3,30,3,1,0,4,0,30,1,3,0,4,0,30,1,0,0,1,0,-27,3,0
2,3,8,1,30,7,0,0,7,3,30,2,0,0,2,3,30,6,1,0,7,0,30,5,2,0,7,4,30,3,0,0,3,0,-27,3,0
2,4,24,0,30,2,4,0,6,2,30,4,0,0,4,0,30,4,2,0,6,0,30,1,5,0,6,2,30,4,0,0,4,1,-15,3,1
2,4,24,0,30,4,2,0,6,2,30,4,0,0,4,4,30,5,1,0,6,0,30,1,5,0,6,0,30,3,1,0,4,1,-15,3,1
2,4,8,4,30,7,0,0,7,2,30,2,0,0,2,0,30,7,0,0,7,0,30,4,3,0,7,1,30,3,0,0,3,0,-27,3,0
2,3,24,0,30,5,1,0,6,2,30,4,0,0,4,2,30,6,0,0,6,0,30,1,5,0,6,4,30,4,0,0,4,1,-15,3,1
2,4,4,3,30,8,0,0,8,3,30,4,0,0,4,0,30,6,2,0,8,0,30,2,6,0,8,2,30,4,0,0,4,0,-27,3,0
2,3,3,1,30,4,7,0,11,3,30,8,0,0,8,4,30,4,7,0,11,0,30,7,4,0,11,1,30,2,5,0,7,0,-27,3,0
2,4,24,0,30,3,3,0,6,2,30,3,1,0,4,3,30,6,0,0,6,0,30,2,4,0,6,5,30,4,0,0,4,1,-15,3,1
2,4,23,0,30,2,3,0,5,0,30,4,0,0,4,6,30,5,0,0,5,0,30,0,5,0,5,1,30,2,0,0,2,1,-15,3,1
2,3,31,0,30,1,3,0,4,1,30,4,0,0,4,0,30,3,1,0,4,0,30,1,3,0,4,0,30,0,3,0,3,1,-15,3,1
2,3,7,0,30,1,3,0,4,1,30,2,0,0,2,3,30,2,2,0,4,0,30,1,3,0,4,2,30,2,0,0,2,0,-27,3,0
2,4,25,3,30,1,3,0,4,3,30,2,0,0,2,1,30,4,0,0,4,0,30,0,4,0,4,0,30,1,0,0,1,1,-15,3,1
2,0,9,0,30,2,2,0,4,2,30,1,1,0,2,11,30,2,2,0,4,0,30,1,3,0,4,0,30,1,0,0,1,0,-27,3,0
2,1,31,0,30,0,4,0,4,2,30,4,0,0,4,0,30,3,1,0,4,0,30,1,3,0,4,0,30,2,1,0,3,1,-15,3,1
2,3,23,5,30,5,0,0,5,3,30,4,0,0,4,2,30,5,0,0,5,0,30,0,5,0,5,0,30,2,0,0,2,1,-15,3,1
2,4,17,1,30,1,3,0,4,0,30,2,0,0,2,1,30,0,4,0,4,0,30,0,4,0,4,2,30,1,0,0,1,1,-15,3,1
2,4,17,0,30,1,3,0,4,0,30,2,0,0,2,1,30,0,4,0,4,2,30,1,3,0,4,2,30,1,0,0,1,1,-15,3,1
2,2,31,0,30,2,2,0,4,3,30,4,0,0,4,0,30,1,3,0,4,0,30,1,3,0,4,0,30,2,1,0,3,1,-15,3,1
2,4,13,0,30,6,1,0,7,0,30,4,0,0,4,2,30,7,0,0,7,1,30,5,2,0,7,4,30,4,0,0,4,1,-15,3,1
2,4,25,8,30,2,2,0,4,3,30,2,0,0,2,1,30,4,0,0,4,0,30,0,4,0,4,2,30,1,0,0,1,1,-15,3,1
2,3,9,0,30,10,1,0,11,1,30,6,0,0,6,3,30,11,0,0,11,1,30,3,8,0,11,2,30,2,2,0,4,0,-27,3,0
2,4,16,0,30,6,3,0,9,2,30,8,0,0,8,4,30,2,7,0,9,0,30,0,9,0,9,0,30,4,0,0,4,1,-15,3,1
2,4,24,1,30,6,0,0,6,2,30,4,0,0,4,2,30,6,0,0,6,0,30,1,5,0,6,0,30,3,1,0,4,1,-15,3,1
2,4,25,3,30,2,2,0,4,3,30,2,0,0,2,3,30,4,0,0,4,0,30,0,4,0,4,0,30,1,0,0,1,1,-15,3,1
2,4,3,0,30,4,7,0,11,1,30,8,0,0,8,0,30,5,6,0,11,0,30,3,8,0,11,1,30,2,5,0,7,0,-27,3,0
2,3,5,1,30,6,6,0,12,2,30,7,3,0,10,0,30,4,8,0,12,0,30,8,4,0,12,4,30,4,2,0,6,0,-27,3,0
2,3,28,0,30,1,7,0,8,5,30,4,0,0,4,0,30,1,7,0,8,0,30,7,1,0,8,0,30,3,1,0,4,1,-15,3,1
2,4,7,0,30,2,2,0,4,2,30,2,0,0,2,4,30,3,1,0,4,0,30,1,3,0,4,1,30,1,1,0,2,0,-27,3,0
2,4,9,0,30,2,2,0,4,1,30,2,0,0,2,1,30,4,0,0,4,0,30,1,3,0,4,1,30,1,0,0,1,0,-27,3,0
2,2,15,0,30,2,2,0,4,0,30,5,1,0,6,2,30,3,1,0,4,3,30,4,0,0,4,0,30,2,2,0,4,1,-15,3,1
2,2,31,1,30,1,3,0,4,4,30,4,0,0,4,0,30,1,3,0,4,0,30,1,3,0,4,0,30,3,0,0,3,1,-15,3,1
2,4,9,0,30,6,5,0,11,1,30,6,0,0,6,6,30,11,0,0,11,2,30,3,8,0,11,2,30,2,2,0,4,0,-27,3,0
2,1,4,2,30,7,1,0,8,3,30,4,0,0,4,2,30,5,3,0,8,0,30,4,4,0,8,1,30,4,0,0,4,0,-27,3,0
2,1,20,0,30,3,5,0,8,0,30,7,1,0,8,0,30,7,1,0,8,0,30,5,3,0,8,1,30,1,4,0,5,1,-15,3,1
2,4,8,2,30,7,0,0,7,2,30,2,0,0,2,3,30,7,0,0,7,0,30,5,2,0,7,1,30,3,0,0,3,0,-27,3,0
2,0,24,0,30,3,3,0,6,2,30,3,1,0,4,4,30,6,0,0,6,0,30,3,3,0,6,3,30,4,0,0,4,1,-15,3,1
2,3,16,0,30,7,2,0,9,1,30,6,2,0,8,0,30,3,6,0,9,0,30,1,8,0,9,0,30,2,2,0,4,1,-15,3,1
2,4,9,1,30,6,5,0,11,0,30,6,0,0,6,1,30,10,1,0,11,1,30,3,8,0,11,0,30,4,0,0,4,0,-27,3,0
2,4,30,2,30,3,2,0,5,2,30,2,0,0,2,1,30,1,4,0,5,0,30,1,4,0,5,3,30,3,0,0,3,1,-15,3,1
2,3,28,0,30,3,5,0,8,4,30,4,0,0,4,3,30,2,6,0,8,0,30,1,7,0,8,2,30,4,0,0,4,1,-15,3,1
2,4,31,0,30,0,4,0,4,2,30,4,0,0,4,4,30,1,3,0,4,0,30,1,3,0,4,0,30,2,1,0,3,1,-15,3,1
2,3,16,1,30,5,4,0,9,1,30,8,0,0,8,0,30,4,5,0,9,0,30,2,7,0,9,0,30,4,0,0,4,1,-15,3,1
2,1,24,0,30,3,3,0,6,2,30,4,0,0,4,7,30,6,0,0,6,1,30,1,5,0,6,4,30,4,0,0,4,1,-15,3,1
2,4,15,0,30,2,2,0,4,0,30,6,0,0,6,0,30,3,1,0,4,8,30,4,0,0,4,0,30,1,3,0,4,1,-15,3,1
2,3,23,0,30,1,4,0,5,1,30,4,0,0,4,0,30,5,0,0,5,0,30,3,2,0,5,1,30,1,1,0,2,1,-15,3,1
2,4,9,0,30,1,3,0,4,1,30,1,1,0,2,3,30,4,0,0,4,0,30,1,3,0,4,0,30,1,0,0,1,0,-27,3,0
2,3,23,0,30,2,3,0,5,2,30,4,0,0,4,10,30,4,1,0,5,0,30,1,4,0,5,1,30,1,1,0,2,1,-15,3,1
2,3,24,0,30,4,2,0,6,0,30,4,0,0,4,4,30,6,0,0,6,0,30,1,5,0,6,5,30,4,0,0,4,1,-15,3,1
2,4,7,0,30,4,5,0,9,1,30,3,1,0,4,3,30,7,2,0,9,4,30,2,7,0,9,1,30,4,2,0,6,0,-27,3,0
2,3,3,1,30,4,7,0,11,3,30,8,0,0,8,0,30,3,8,0,11,1,30,7,4,0,11,1,30,2,5,0,7,0,-27,3,0
2,3,13,2,30,3,0,0,3,0,30,2,0,0,2,0,30,3,0,0,3,4,30,2,1,0,3,2,30,2,0,0,2,1,-15,3,1
2,4,5,0,30,2,3,0,5,2,30,3,1,0,4,1,30,2,3,0,5,0,30,1,4,0,5,0,30,0,2,0,2,0,-27,3,0
2,4,31,2,30,2,2,0,4,5,30,4,0,0,4,0,30,1,3,0,4,8,30,1,3,0,4,0,30,1,2,0,3,1,-15,3,1
2,4,24,0,30,4,2,0,6,3,30,3,1,0,4,7,30,6,0,0,6,0,30,1,5,0,6,3,30,4,0,0,4,1,-15,3,1
2,3,24,0,30,4,2,0,6,2,30,4,0,0,4,3,30,6,0,0,6,0,30,2,4,0,6,2,30,4,0,0,4,1,-15,3,1
2,3,24,0,30,4,2,0,6,2,30,3,1,0,4,6,30,6,0,0,6,0,30,1,5,0,6,0,30,4,0,0,4,1,-15,3,1
2,4,25,2,30,4,0,0,4,2,30,2,0,0,2,3,30,4,0,0,4,0,30,0,4,0,4,0,30,1,0,0,1,1,-15,3,1
2,4,24,0,30,5,1,0,6,2,30,4,0,0,4,8,30,6,0,0,6,0,30,1,5,0,6,0,30,2,2,0,4,1,-15,3,1
2,4,23,0,30,4,1,0,5,1,30,4,0,0,4,3,30,5,0,0,5,0,30,0,5,0,5,1,30,1,1,0,2,1,-15,3,1
2,4,17,0,30,2,2,0,4,0,30,2,0,0,2,2,30,1,3,0,4,2,30,1,3,0,4,4,30,1,0,0,1,1,-15,3,1
2,3,28,0,30,1,7,0,8,4,30,4,0,0,4,1,30,5,3,0,8,0,30,4,4,0,8,5,30,4,0,0,4,1,-15,3,1
2,2,23,0,30,2,3,0,5,1,30,4,0,0,4,3,30,3,2,0,5,1,30,0,5,0,5,3,30,2,0,0,2,1,-15,3,1
2,1,5,1,30,7,5,0,12,3,30,4,6,0,10,0,30,5,7,0,12,0,30,7,5,0,12,3,30,6,0,0,6,0,-27,3,0
2,2,31,0,30,0,4,0,4,2,30,4,0,0,4,0,30,4,0,0,4,1,30,4,0,0,4,3,30,3,0,0,3,1,-15,3,1
2,4,17,1,30,2,2,0,4,0,30,2,0,0,2,3,30,2,2,0,4,2,30,1,3,0,4,4,30,1,0,0,1,1,-15,3,1
2,4,5,0,30,2,3,0,5,2,30,2,2,0,4,1,30,2,3,0,5,0,30,1,4,0,5,0,30,0,2,0,2,0,-27,3,0
2,3,21,0,30,2,1,0,3,0,30,2,0,0,2,0,30,2,1,0,3,0,30,0,3,0,3,0,30,1,0,0,1,1,-15,3,1
2,3,21,6,30,3,0,0,3,2,30,2,0,0,2,0,30,2,1,0,3,0,30,0,3,0,3,0,30,1,0,0,1,1,-15,3,1
2,4,11,0,30,2,2,0,4,0,30,0,0,0,0,4,30,0,4,0,4,1,30,2,2,0,4,0,30,1,0,0,1,1,-15,3,1
2,3,31,0,30,0,4,0,4,4,30,4,0,0,4,0,30,1,3,0,4,3,30,4,0,0,4,2,30,3,0,0,3,1,-15,3,1
2,4,16,0,30,7,2,0,9,1,30,8,0,0,8,1,30,4,5,0,9,0,30,2,7,0,9,0,30,2,2,0,4,1,-15,3,1
2,3,31,0,30,0,4,0,4,3,30,4,0,0,4,2,30,3,1,0,4,0,30,4,0,0,4,4,30,3,0,0,3,1,-15,3,1
2,4,24,3,30,6,0,0,6,3,30,4,0,0,4,3,30,5,1,0,6,0,30,1,5,0,6,1,30,4,0,0,4,1,-15,3,1
2,1,28,0,30,0,8,0,8,4,30,4,0,0,4,0,30,1,7,0,8,0,30,5,3,0,8,4,30,4,0,0,4,1,-15,3,1
2,4,5,0,30,1,4,0,5,2,30,3,1,0,4,0,30,3,2,0,5,0,30,1,4,0,5,0,30,2,0,0,2,0,-27,3,0
2,4,24,0,30,4,2,0,6,2,30,4,0,0,4,0,30,5,1,0,6,0,30,1,5,0,6,4,30,4,0,0,4,1,-15,3,1
2,4,16,0,30,8,1,0,9,2,30,8,0,0,8,1,30,1,8,0,9,0,30,0,9,0,9,0,30,4,0,0,4,1,-15,3,1
2,4,7,0,30,4,5,0,9,2,30,4,0,0,4,0,30,8,1,0,9,5,30,3,6,0,9,3,30,5,1,0,6,0,-27,3,0
2,3,25,2,30,3,1,0,4,1,30,2,0,0,2,3,30,4,0,0,4,0,30,0,4,0,4,0,30,1,0,0,1,1,-15,3,1
2,4,13,1,30,3,0,0,3,0,30,2,0,0,2,0,30,3,0,0,3,0,30,1,2,0,3,2,30,2,0,0,2,1,-15,3,1
2,4,32,0,30,5,4,0,9,4,30,2,0,0,2,3,30,9,0,0,9,1,30,3,6,0,9,0,30,2,0,0,2,1,-15,3,1
2,2,3,1,30,4,7,0,11,2,30,7,1,0,8,0,30,4,7,0,11,4,30,4,7,0,11,1,30,3,4,0,7,0,-27,3,0
2,3,9,0,30,2,2,0,4,1,30,2,0,0,2,3,30,2,2,0,4,0,30,1,3,0,4,1,30,1,0,0,1,0,-27,3,0
2,3,31,0,30,0,4,0,4,3,30,4,0,0,4,0,30,1,3,0,4,4,30,1,3,0,4,2,30,3,0,0,3,1,-15,3,1
2,4,27,0,30,2,3,0,5,0,30,0,0,0,0,0,30,5,0,0,5,0,30,2,3,0,5,1,30,4,0,0,4,1,-15,3,1
2,1,9,0,30,2,2,0,4,1,30,2,0,0,2,4,30,3,1,0,4,0,30,1,3,0,4,0,30,0,1,0,1,0,-27,3,0
2,4,9,0,30,7,4,0,11,1,30,6,0,0,6,3,30,11,0,0,11,0,30,3,8,0,11,4,30,2,2,0,4,0,-27,3,0
2,3,7,1,30,5,4,0,9,2,30,4,0,0,4,5,30,6,3,0,9,4,30,1,8,0,9,1,30,4,2,0,6,0,-27,3,0
2,3,5,2,30,7,5,0,12,2,30,7,3,0,10,0,30,8,4,0,12,0,30,8,4,0,12,3,30,4,2,0,6,0,-27,3,0
2,3,9,1,30,7,4,0,11,1,30,6,0,0,6,1,30,11,0,0,11,1,30,3,8,0,11,2,30,2,2,0,4,0,-27,3,0
2,1,5,5,30,8,4,0,12,4,30,3,7,0,10,0,30,4,8,0,12,0,30,7,5,0,12,1,30,5,1,0,6,0,-27,3,0
2,4,17,1,30,1,3,0,4,0,30,2,0,0,2,0,30,2,2,0,4,2,30,1,3,0,4,2,30,1,0,0,1,1,-15,3,1
2,4,37,1,30,5,6,0,11,4,30,6,2,0,8,9,30,10,1,0,11,2,30,3,8,0,11,0,30,6,0,0,6,1,-15,3,1
2,2,4,2,30,8,0,0,8,3,30,4,0,0,4,0,30,5,3,0,8,0,30,3,5,0,8,3,30,3,1,0,4,0,-27,3,0
2,2,16,0,30,5,4,0,9,2,30,8,0,0,8,3,30,1,8,0,9,0,30,1,8,0,9,1,30,4,0,0,4,1,-15,3,1
2,3,17,2,30,4,0,0,4,2,30,2,0,0,2,1,30,0,4,0,4,4,30,1,3,0,4,0,30,1,0,0,1,1,-15,3,1
2,2,5,0,30,5,7,0,12,2,30,8,2,0,10,1,30,6,6,0,12,1,30,9,3,0,12,1,30,2,4,0,6,0,-27,3,0
2,3,16,0,30,5,4,0,9,2,30,8,0,0,8,0,30,1,8,0,9,0,30,1,8,0,9,0,30,4,0,0,4,1,-15,3,1
2,3,24,0,30,5,1,0,6,2,30,4,0,0,4,4,30,2,4,0,6,0,30,3,3,0,6,0,30,4,0,0,4,1,-15,3,1
2,3,31,0,30,0,4,0,4,3,30,4,0,0,4,0,30,3,1,0,4,0,30,1,3,0,4,1,30,3,0,0,3,1,-15,3,1
2,4,31,0,30,1,3,0,4,2,30,4,0,0,4,0,30,4,0,0,4,0,30,1,3,0,4,0,30,3,0,0,3,1,-15,3,1
2,3,9,1,30,7,4,0,11,1,30,6,0,0,6,2,30,10,1,0,11,3,30,3,8,0,11,5,30,2,2,0,4,0,-27,3,0
2,1,23,0,30,2,3,0,5,1,30,4,0,0,4,3,30,4,1,0,5,0,30,0,5,0,5,4,30,2,0,0,2,1,-15,3,1
2,3,24,0,30,6,0,0,6,3,30,4,0,0,4,7,30,6,0,0,6,0,30,1,5,0,6,1,30,4,0,0,4,1,-15,3,1
2,2,23,0,30,2,3,0,5,1,30,4,0,0,4,2,30,5,0,0,5,0,30,0,5,0,5,2,30,2,0,0,2,1,-15,3,1
2,3,16,0,30,5,4,0,9,1,30,8,0,0,8,0,30,3,6,0,9,0,30,1,8,0,9,0,30,2,2,0,4,1,-15,3,1
2,3,23,0,30,3,2,0,5,2,30,4,0,0,4,3,30,3,2,0,5,0,30,1,4,0,5,3,30,2,0,0,2,1,-15,3,1
2,4,4,3,30,8,0,0,8,2,30,4,0,0,4,0,30,6,2,0,8,0,30,0,8,0,8,2,30,4,0,0,4,0,-27,3,0
2,3,9,0,30,6,5,0,11,2,30,6,0,0,6,6,30,8,3,0,11,5,30,4,7,0,11,0,30,2,2,0,4,0,-27,3,0
2,3,25,2,30,3,1,0,4,0,30,2,0,0,2,4,30,4,0,0,4,0,30,0,4,0,4,0,30,1,0,0,1,1,-15,3,1
2,2,4,2,30,8,0,0,8,3,30,4,0,0,4,1,30,6,2,0,8,0,30,4,4,0,8,1,30,3,1,0,4,0,-27,3,0
2,1,24,0,30,5,1,0,6,2,30,4,0,0,4,9,30,6,0,0,6,0,30,1,5,0,6,1,30,4,0,0,4,1,-15,3,1
2,4,30,1,30,4,1,0,5,4,30,2,0,0,2,1,30,2,3,0,5,3,30,2,3,0,5,0,30,2,1,0,3,1,-15,3,1
2,4,24,0,30,3,3,0,6,2,30,3,1,0,4,5,30,6,0,0,6,0,30,1,5,0,6,0,30,4,0,0,4,1,-15,3,1
2,3,13,5,30,3,0,0,3,0,30,2,0,0,2,0,30,2,1,0,3,4,30,2,1,0,3,2,30,2,0,0,2,1,-15,3,1
2,4,24,1,30,6,0,0,6,3,30,4,0,0,4,7,30,6,0,0,6,0,30,1,5,0,6,0,30,4,0,0,4,1,-15,3,1
2,3,32,4,30,6,3,0,9,2,30,2,0,0,2,3,30,9,0,0,9,1,30,2,7,0,9,2,30,1,1,0,2,1,-15,3,1
2,2,23,5,30,5,0,0,5,3,30,4,0,0,4,0,30,3,2,0,5,0,30,0,5,0,5,3,30,2,0,0,2,1,-15,3,1
2,4,28,0,30,5,3,0,8,3,30,4,0,0,4,0,30,5,3,0,8,0,30,2,6,0,8,0,30,4,0,0,4,1,-15,3,1
2,1,31,0,30,2,2,0,4,3,30,4,0,0,4,6,30,3,1,0,4,0,30,1,3,0,4,0,30,2,1,0,3,1,-15,3,1
2,4,9,0,30,1,3,0,4,1,30,2,0,0,2,1,30,3,1,0,4,0,30,1,3,0,4,0,30,1,0,0,1,0,-27,3,0
2,1,31,0,30,1,3,0,4,1,30,4,0,0,4,5,30,2,2,0,4,0,30,1,3,0,4,0,30,3,0,0,3,1,-15,3,1
2,4,23,0,30,2,3,0,5,2,30,4,0,0,4,5,30,3,2,0,5,0,30,0,5,0,5,2,30,2,0,0,2,1,-15,3,1
2,4,24,1,30,6,0,0,6,2,30,4,0,0,4,3,30,6,0,0,6,0,30,1,5,0,6,0,30,2,2,0,4,1,-15,3,1
2,3,24,0,30,5,1,0,6,2,30,4,0,0,4,4,30,4,2,0,6,0,30,1,5,0,6,4,30,4,0,0,4,1,-15,3,1
2,4,7,0,30,2,2,0,4,2,30,2,0,0,2,0,30,2,2,0,4,0,30,1,3,0,4,3,30,2,0,0,2,0,-27,3,0
2,1,30,3,30,3,2,0,5,3,30,2,0,0,2,1,30,2,3,0,5,2,30,2,3,0,5,0,30,2,1,0,3,1,-15,3,1
2,4,5,0,30,1,4,0,5,0,30,0,4,0,4,0,30,1,4,0,5,0,30,1,4,0,5,0,30,0,2,0,2,0,-27,3,0
2,4,31,2,30,0,4,0,4,4,30,4,0,0,4,0,30,1,3,0,4,0,30,1,3,0,4,0,30,3,0,0,3,1,-15,3,1
2,4,5,0,30,2,3,0,5,2,30,2,2,0,4,3,30,1,4,0,5,0,30,1,4,0,5,1,30,0,2,0,2,0,-27,3,0
2,4,23,0,30,2,3,0,5,2,30,4,0,0,4,7,30,3,2,0,5,0,30,0,5,0,5,1,30,1,1,0,2,1,-15,3,1
2,2,21,4,30,1,2,0,3,0,30,2,0,0,2,1,30,3,0,0,3,0,30,0,3,0,3,0,30,1,0,0,1,1,-15,3,1
2,1,5,1,30,7,5,0,12,2,30,6,4,0,10,2,30,5,7,0,12,0,30,6,6,0,12,1,30,6,0,0,6,0,-27,3,0
2,3,7,1,30,4,5,0,9,1,30,3,1,0,4,2,30,8,1,0,9,5,30,2,7,0,9,2,30,6,0,0,6,0,-27,3,0
2,3,7,1,30,4,5,0,9,2,30,4,0,0,4,4,30,7,2,0,9,5,30,3,6,0,9,1,30,3,3,0,6,0,-27,3,0
2,3,27,0,30,1,4,0,5,1,30,0,0,0,0,2,30,3,2,0,5,0,30,2,3,0,5,0,30,2,2,0,4,1,-15,3,1
2,2,5,1,30,4,8,0,12,2,30,4,6,0,10,1,30,6,6,0,12,0,30,8,4,0,12,1,30,6,0,0,6,0,-27,3,0
2,2,5,1,30,6,6,0,12,2,30,7,3,0,10,0,30,5,7,0,12,0,30,8,4,0,12,2,30,6,0,0,6,0,-27,3,0
2,2,17,1,30,1,3,0,4,1,30,2,0,0,2,4,30,0,4,0,4,2,30,1,3,0,4,2,30,1,0,0,1,1,-15,3,1
2,3,16,0,30,4,5,0,9,1,30,8,0,0,8,0,30,1,8,0,9,0,30,1,8,0,9,0,30,3,1,0,4,1,-15,3,1
2,3,25,2,30,1,3,0,4,2,30,2,0,0,2,2,30,4,0,0,4,0,30,0,4,0,4,1,30,1,0,0,1,1,-15,3,1
2,4,13,2,30,3,0,0,3,0,30,2,0,0,2,0,30,3,0,0,3,0,30,3,0,0,3,1,30,2,0,0,2,1,-15,3,1
2,3,16,0,30,5,4,0,9,2,30,8,0,0,8,1,30,1,8,0,9,0,30,1,8,0,9,0,30,4,0,0,4,1,-15,3,1
2,3,25,1,30,0,4,0,4,1,30,2,0,0,2,0,30,3,1,0,4,0,30,2,2,0,4,3,30,1,0,0,1,1,-15,3,1
2,3,16,0,30,5,4,0,9,1,30,8,0,0,8,0,30,2,7,0,9,0,30,0,9,0,9,0,30,4,0,0,4,1,-15,3,1
2,4,25,2,30,4,0,0,4,0,30,2,0,0,2,5,30,4,0,0,4,0,30,0,4,0,4,0,30,0,1,0,1,1,-15,3,1
2,2,9,0,30,6,5,0,11,3,30,6,0,0,6,5,30,6,5,0,11,1,30,6,5,0,11,1,30,3,1,0,4,0,-27,3,0
2,4,17,2,30,1,3,0,4,0,30,2,0,0,2,2,30,1,3,0,4,2,30,1,3,0,4,0,30,1,0,0,1,1,-15,3,1
2,4,23,0,30,3,2,0,5,0,30,4,0,0,4,0,30,4,1,0,5,0,30,0,5,0,5,3,30,2,0,0,2,1,-15,3,1
2,4,28,0,30,1,7,0,8,3,30,4,0,0,4,0,30,5,3,0,8,0,30,2,6,0,8,1,30,4,0,0,4,1,-15,3,1
2,1,20,0,30,1,7,0,8,1,30,8,0,0,8,0,30,4,4,0,8,0,30,5,3,0,8,1,30,3,2,0,5,1,-15,3,1
2,1,5,1,30,4,8,0,12,2,30,9,1,0,10,1,30,5,7,0,12,1,30,9,3,0,12,3,30,6,0,0,6,0,-27,3,0
2,4,9,0,30,2,2,0,4,1,30,2,0,0,2,6,30,4,0,0,4,0,30,1,3,0,4,3,30,1,0,0,1,0,-27,3,0
2,4,24,0,30,4,2,0,6,2,30,4,0,0,4,8,30,6,0,0,6,0,30,1,5,0,6,0,30,2,2,0,4,1,-15,3,1
2,4,31,1,30,0,4,0,4,0,30,4,0,0,4,5,30,4,0,0,4,0,30,1,3,0,4,0,30,0,3,0,3,1,-15,3,1
2,3,15,0,30,2,2,0,4,0,30,6,0,0,6,7,30,3,1,0,4,2,30,4,0,0,4,0,30,3,1,0,4,1,-15,3,1
2,1,37,1,30,5,6,0,11,4,30,6,2,0,8,9,30,10,1,0,11,2,30,3,8,0,11,0,30,6,0,0,6,1,-15,3,1
2,2,24,0,30,5,1,0,6,0,30,4,0,0,4,4,30,4,2,0,6,0,30,3,3,0,6,1,30,4,0,0,4,1,-15,3,1
2,1,20,0,30,2,6,0,8,2,30,6,2,0,8,0,30,1,7,0,8,0,30,3,5,0,8,1,30,4,1,0,5,1,-15,3,1
2,4,30,2,30,3,2,0,5,3,30,2,0,0,2,2,30,2,3,0,5,2,30,1,4,0,5,0,30,2,1,0,3,1,-15,3,1
2,4,7,0,30,1,3,0,4,0,30,2,0,0,2,0,30,4,0,0,4,0,30,1,3,0,4,2,30,1,1,0,2,0,-27,3,0
2,4,25,1,30,0,4,0,4,0,30,2,0,0,2,2,30,4,0,0,4,0,30,0,4,0,4,2,30,1,0,0,1,1,-15,3,1
2,2,5,0,30,5,7,0,12,2,30,7,3,0,10,0,30,6,6,0,12,1,30,8,4,0,12,1,30,6,0,0,6,0,-27,3,0
2,4,24,0,30,3,3,0,6,2,30,3,1,0,4,3,30,2,4,0,6,0,30,1,5,0,6,3,30,4,0,0,4,1,-15,3,1
2,0,15,6,30,4,0,0,4,0,30,6,0,0,6,0,30,2,2,0,4,1,30,2,2,0,4,5,30,4,0,0,4,1,-15,3,1
2,3,9,0,30,1,3,0,4,0,30,2,0,0,2,5,30,4,0,0,4,0,30,4,0,0,4,0,30,1,0,0,1,0,-27,3,0
2,3,31,1,30,2,2,0,4,2,30,4,0,0,4,0,30,4,0,0,4,0,30,1,3,0,4,2,30,3,0,0,3,1,-15,3,1
2,3,3,1,30,4,7,0,11,2,30,7,1,0,8,0,30,5,6,0,11,3,30,6,5,0,11,6,30,3,4,0,7,0,-27,3,0
2,3,9,0,30,2,2,0,4,0,30,2,0,0,2,0,30,3,1,0,4,0,30,1,3,0,4,0,30,1,0,0,1,0,-27,3,0
2,0,4,3,30,8,0,0,8,3,30,4,0,0,4,0,30,7,1,0,8,0,30,4,4,0,8,2,30,4,0,0,4,0,-27,3,0
2,3,21,2,30,0,3,0,3,0,30,2,0,0,2,0,30,2,1,0,3,0,30,0,3,0,3,2,30,1,0,0,1,1,-15,3,1
2,4,24,0,30,2,4,0,6,3,30,4,0,0,4,10,30,6,0,0,6,0,30,1,5,0,6,4,30,4,0,0,4,1,-15,3,1
2,2,3,1,30,4,7,0,11,3,30,8,0,0,8,4,30,4,7,0,11,0,30,7,4,0,11,1,30,2,5,0,7,0,-27,3,0
2,3,25,3,30,2,2,0,4,2,30,2,0,0,2,2,30,4,0,0,4,1,30,1,3,0,4,0,30,1,0,0,1,1,-15,3,1
2,4,17,1,30,0,4,0,4,0,30,2,0,0,2,2,30,1,3,0,4,2,30,1,3,0,4,4,30,1,0,0,1,1,-15,3,1
2,4,33,0,30,1,2,0,3,1,30,2,0,0,2,6,30,3,0,0,3,0,30,1,2,0,3,3,30,2,0,0,2,1,-15,3,1
2,4,7,0,30,2,2,0,4,1,30,2,0,0,2,2,30,3,1,0,4,0,30,1,3,0,4,2,30,2,0,0,2,0,-27,3,0
2,2,31,0,30,1,3,0,4,3,30,4,0,0,4,0,30,1,3,0,4,2,30,1,3,0,4,2,30,3,0,0,3,1,-15,3,1
2,4,31,0,30,0,4,0,4,2,30,4,0,0,4,5,30,4,0,0,4,0,30,2,2,0,4,1,30,3,0,0,3,1,-15,3,1
2,4,7,0,30,6,3,0,9,2,30,4,0,0,4,0,30,8,1,0,9,4,30,1,8,0,9,1,30,5,1,0,6,0,-27,3,0
2,0,20,0,30,2,6,0,8,1,30,7,1,0,8,1,30,6,2,0,8,0,30,6,2,0,8,1,30,5,0,0,5,1,-15,3,1
2,2,5,1,30,4,8,0,12,2,30,7,3,0,10,0,30,3,9,0,12,2,30,7,5,0,12,1,30,6,0,0,6,0,-27,3,0
2,4,9,0,30,2,2,0,4,1,30,2,0,0,2,5,30,4,0,0,4,0,30,1,3,0,4,0,30,1,0,0,1,0,-27,3,0
2,2,24,0,30,6,0,0,6,2,30,3,1,0,4,6,30,5,1,0,6,0,30,1,5,0,6,1,30,4,0,0,4,1,-15,3,1
2,2,23,0,30,3,2,0,5,0,30,4,0,0,4,2,30,3,2,0,5,0,30,0,5,0,5,4,30,2,0,0,2,1,-15,3,1
2,4,5,1,30,4,8,0,12,2,30,7,3,0,10,1,30,6,6,0,12,0,30,7,5,0,12,1,30,4,2,0,6,0,-27,3,0
2,4,5,0,30,6,6,0,12,2,30,7,3,0,10,0,30,3,9,0,12,0,30,6,6,0,12,1,30,2,4,0,6,0,-27,3,0
2,4,9,1,30,6,5,0,11,1,30,6,0,0,6,3,30,11,0,0,11,1,30,3,8,0,11,2,30,2,2,0,4,0,-27,3,0
2,3,9,0,30,5,6,0,11,1,30,6,0,0,6,2,30,11,0,0,11,4,30,2,9,0,11,3,30,4,0,0,4,0,-27,3,0
2,3,9,0,30,3,1,0,4,1,30,2,0,0,2,0,30,3,1,0,4,0,30,1,3,0,4,3,30,1,0,0,1,0,-27,3,0
2,4,31,0,30,3,1,0,4,3,30,4,0,0,4,3,30,2,2,0,4,0,30,1,3,0,4,0,30,0,3,0,3,1,-15,3,1
2,4,28,1,30,3,5,0,8,5,30,4,0,0,4,3,30,3,5,0,8,0,30,5,3,0,8,1,30,2,2,0,4,1,-15,3,1
2,3,9,0,30,1,3,0,4,2,30,2,0,0,2,3,30,1,3,0,4,0,30,1,3,0,4,2,30,1,0,0,1,0,-27,3,0
2,1,4,2,30,5,3,0,8,3,30,2,2,0,4,2,30,2,6,0,8,0,30,6,2,0,8,3,30,4,0,0,4,0,-27,3,0
2,4,11,5,30,4,0,0,4,0,30,0,0,0,0,3,30,4,0,0,4,0,30,2,2,0,4,2,30,1,0,0,1,1,-15,3,1
2,4,9,0,30,3,1,0,4,1,30,2,0,0,2,7,30,4,0,0,4,0,30,1,3,0,4,0,30,1,0,0,1,0,-27,3,0
2,4,27,0,30,2,3,0,5,0,30,0,0,0,0,0,30,3,2,0,5,0,30,2,3,0,5,3,30,4,0,0,4,1,-15,3,1
2,4,33,0,30,1,2,0,3,1,30,2,0,0,2,6,30,3,0,0,3,0,30,1,2,0,3,1,30,2,0,0,2,1,-15,3,1
2,2,25,1,30,0,4,0,4,2,30,2,0,0,2,6,30,4,0,0,4,0,30,0,4,0,4,1,30,1,0,0,1,1,-15,3,1
2,3,31,0,30,0,4,0,4,1,30,4,0,0,4,4,30,4,0,0,4,3,30,3,1,0,4,4,30,3,0,0,3,1,-15,3,1
2,4,9,0,30,2,2,0,4,1,30,2,0,0,2,4,30,4,0,0,4,0,30,1,3,0,4,2,30,1,0,0,1,0,-27,3,0
2,4,23,0,30,3,2,0,5,0,30,4,0,0,4,0,30,3,2,0,5,0,30,1,4,0,5,1,30,2,0,0,2,1,-15,3,1
2,4,17,1,30,1,3,0,4,0,30,2,0,0,2,0,30,1,3,0,4,1,30,1,3,0,4,3,30,1,0,0,1,1,-15,3,1
2,3,31,2,30,0,4,0,4,4,30,4,0,0,4,0,30,1,3,0,4,0,30,1,3,0,4,0,30,3,0,0,3,1,-15,3,1
2,4,9,0,30,5,6,0,11,1,30,6,0,0,6,4,30,11,0,0,11,1,30,3,8,0,11,4,30,3,1,0,4,0,-27,3,0
2,4,31,0,30,2,2,0,4,2,30,4,0,0,4,0,30,3,1,0,4,0,30,1,3,0,4,0,30,0,3,0,3,1,-15,3,1
2,3,5,1,30,6,6,0,12,2,30,6,4,0,10,0,30,6,6,0,12,0,30,7,5,0,12,2,30,3,3,0,6,0,-27,3,0
2,3,17,1,30,1,3,0,4,0,30,2,0,0,2,0,30,0,4,0,4,2,30,1,3,0,4,4,30,1,0,0,1,1,-15,3,1
2,4,3,0,30,1,3,0,4,1,30,4,0,0,4,0,30,3,1,0,4,1,30,2,2,0,4,0,30,1,2,0,3,0,-27,3,0
2,4,13,3,30,7,0,0,7,0,30,4,0,0,4,2,30,6,1,0,7,1,30,3,4,0,7,5,30,4,0,0,4,1,-15,3,1
2,4,31,2,30,0,4,0,4,2,30,4,0,0,4,1,30,4,0,0,4,0,30,1,3,0,4,0,30,2,1,0,3,1,-15,3,1
2,1,31,1,30,1,3,0,4,3,30,4,0,0,4,0,30,4,0,0,4,0,30,1,3,0,4,0,30,1,2,0,3,1,-15,3,1
2,0,20,0,30,2,6,0,8,1,30,6,2,0,8,0,30,7,1,0,8,0,30,5,3,0,8,2,30,5,0,0,5,1,-15,3,1
2,2,5,0,30,1,4,0,5,1,30,4,0,0,4,0,30,3,2,0,5,0,30,1,4,0,5,0,30,0,2,0,2,0,-27,3,0
2,3,23,0,30,2,3,0,5,1,30,4,0,0,4,5,30,5,0,0,5,0,30,0,5,0,5,1,30,2,0,0,2,1,-15,3,1
2,2,14,3,30,9,0,0,9,0,30,6,0,0,6,1,30,9,0,0,9,0,30,1,8,0,9,1,30,4,0,0,4,1,-15,3,1
2,4,25,1,30,0,4,0,4,2,30,2,0,0,2,3,30,4,0,0,4,0,30,0,4,0,4,1,30,1,0,0,1,1,-15,3,1
2,4,24,0,30,5,1,0,6,2,30,4,0,0,4,4,30,6,0,0,6,0,30,1,5,0,6,3,30,4,0,0,4,1,-15,3,1
2,4,7,1,30,4,5,0,9,0,30,4,0,0,4,3,30,8,1,0,9,1,30,3,6,0,9,2,30,5,1,0,6,0,-27,3,0
2,4,5,1,30,4,8,0,12,2,30,6,4,0,10,2,30,7,5,0,12,0,30,7,5,0,12,2,30,5,1,0,6,0,-27,3,0
2,3,24,0,30,4,2,0,6,3,30,3,1,0,4,8,30,5,1,0,6,0,30,2,4,0,6,2,30,4,0,0,4,1,-15,3,1
2,4,25,1,30,2,2,0,4,1,30,2,0,0,2,0,30,4,0,0,4,2,30,0,4,0,4,2,30,1,0,0,1,1,-15,3,1
2,2,8,2,30,7,0,0,7,3,30,2,0,0,2,1,30,6,1,0,7,0,30,5,2,0,7,5,30,3,0,0,3,0,-27,3,0
2,2,9,0,30,3,1,0,4,1,30,2,0,0,2,2,30,4,0,0,4,0,30,1,3,0,4,3,30,1,0,0,1,0,-27,3,0
2,4,5,0,30,4,1,0,5,0,30,1,3,0,4,1,30,1,4,0,5,0,30,1,4,0,5,0,30,0,2,0,2,0,-27,3,0
2,4,16,0,30,5,4,0,9,2,30,8,0,0,8,1,30,1,8,0,9,0,30,1,8,0,9,0,30,3,1,0,4,1,-15,3,1
2,4,15,0,30,2,2,0,4,0,30,6,0,0,6,0,30,2,2,0,4,3,30,4,0,0,4,0,30,2,2,0,4,1,-15,3,1
2,3,25,0,30,1,3,0,4,2,30,2,0,0,2,0,30,3,1,0,4,5,30,2,2,0,4,0,30,1,0,0,1,1,-15,3,1
2,2,9,0,30,2,2,0,4,1,30,2,0,0,2,5,30,4,0,0,4,0,30,2,2,0,4,0,30,1,0,0,1,0,-27,3,0
2,4,17,0,30,2,2,0,4,0,30,2,0,0,2,1,30,1,3,0,4,3,30,0,4,0,4,4,30,1,0,0,1,1,-15,3,1
2,4,28,0,30,2,6,0,8,5,30,4,0,0,4,0,30,1,7,0,8,0,30,7,1,0,8,1,30,2,2,0,4,1,-15,3,1
2,4,13,0,30,7,0,0,7,0,30,4,0,0,4,2,30,6,1,0,7,1,30,5,2,0,7,4,30,4,0,0,4,1,-15,3,1
2,3,27,0,30,3,2,0,5,0,30,0,0,0,0,1,30,5,0,0,5,0,30,2,3,0,5,3,30,4,0,0,4,1,-15,3,1
2,3,25,5,30,3,1,0,4,3,30,2,0,0,2,1,30,4,0,0,4,0,30,0,4,0,4,0,30,0,1,0,1,1,-15,3,1
2,3,13,2,30,3,0,0,3,0,30,2,0,0,2,4,30,3,0,0,3,1,30,1,2,0,3,2,30,2,0,0,2,1,-15,3,1
2,4,7,1,30,4,5,0,9,1,30,3,1,0,4,2,30,9,0,0,9,5,30,3,6,0,9,2,30,6,0,0,6,0,-27,3,0
2,4,24,0,30,4,2,0,6,2,30,4,0,0,4,3,30,5,1,0,6,0,30,1,5,0,6,2,30,4,0,0,4,1,-15,3,1
2,2,28,0,30,1,7,0,8,3,30,4,0,0,4,0,30,6,2,0,8,0,30,3,5,0,8,2,30,4,0,0,4,1,-15,3,1
2,4,39,1,30,4,7,0,11,5,30,6,0,0,6,7,30,10,1,0,11,0,30,2,9,0,11,0,30,1,4,0,5,1,-15,3,1
2,4,31,0,30,0,4,0,4,2,30,4,0,0,4,3,30,4,0,0,4,0,30,1,3,0,4,0,30,3,0,0,3,1,-15,3,1
2,2,31,0,30,0,4,0,4,2,30,4,0,0,4,6,30,3,1,0,4,0,30,1,3,0,4,2,30,3,0,0,3,1,-15,3,1
2,3,9,2,30,2,2,0,4,2,30,2,0,0,2,2,30,4,0,0,4,0,30,1,3,0,4,3,30,1,0,0,1,0,-27,3,0
2,2,13,0,30,2,1,0,3,0,30,2,0,0,2,3,30,3,0,0,3,5,30,2,1,0,3,3,30,2,0,0,2,1,-15,3,1
2,4,30,2,30,3,2,0,5,4,30,2,0,0,2,4,30,2,3,0,5,3,30,1,4,0,5,1,30,3,0,0,3,1,-15,3,1
2,4,30,2,30,2,3,0,5,1,30,2,0,0,2,4,30,2,3,0,5,0,30,1,4,0,5,0,30,2,1,0,3,1,-15,3,1
2,4,30,3,30,3,2,0,5,3,30,2,0,0,2,1,30,1,4,0,5,1,30,1,4,0,5,5,30,3,0,0,3,1,-15,3,1
2,4,27,0,30,2,3,0,5,0,30,0,0,0,0,2,30,5,0,0,5,0,30,2,3,0,5,3,30,4,0,0,4,1,-15,3,1
2,3,15,0,30,2,2,0,4,0,30,6,0,0,6,6,30,3,1,0,4,1,30,1,3,0,4,0,30,4,0,0,4,1,-15,3,1
2,3,27,0,30,1,4,0,5,0,30,0,0,0,0,0,30,5,0,0,5,0,30,2,3,0,5,0,30,2,2,0,4,1,-15,3,1
2,3,31,0,30,0,4,0,4,1,30,4,0,0,4,3,30,4,0,0,4,0,30,2,2,0,4,2,30,3,0,0,3,1,-15,3,1
2,4,31,0,30,1,3,0,4,3,30,4,0,0,4,6,30,4,0,0,4,0,30,1,3,0,4,0,30,0,3,0,3,1,-15,3,1
2,3,13,5,30,3,0,0,3,1,30,2,0,0,2,0,30,3,0,0,3,1,30,2,1,0,3,2,30,2,0,0,2,1,-15,3,1
2,3,16,0,30,7,2,0,9,0,30,8,0,0,8,0,30,4,5,0,9,0,30,1,8,0,9,0,30,2,2,0,4,1,-15,3,1
2,2,9,0,30,2,2,0,4,2,30,2,0,0,2,4,30,0,4,0,4,0,30,1,3,0,4,1,30,1,0,0,1,0,-27,3,0
2,3,31,3,30,1,3,0,4,4,30,4,0,0,4,0,30,1,3,0,4,0,30,2,2,0,4,0,30,1,2,0,3,1,-15,3,1
2,1,13,1,30,7,0,0,7,0,30,4,0,0,4,5,30,6,1,0,7,3,30,6,1,0,7,4,30,4,0,0,4,1,-15,3,1
2,4,4,2,30,6,2,0,8,3,30,4,0,0,4,3,30,6,2,0,8,0,30,3,5,0,8,1,30,2,2,0,4,0,-27,3,0
2,1,31,0,30,2,2,0,4,3,30,4,0,0,4,2,30,1,3,0,4,0,30,1,3,0,4,0,30,2,1,0,3,1,-15,3,1
2,3,25,1,30,2,2,0,4,1,30,2,0,0,2,0,30,4,0,0,4,2,30,0,4,0,4,2,30,1,0,0,1,1,-15,3,1
2,4,7,1,30,4,5,0,9,2,30,3,1,0,4,0,30,5,4,0,9,0,30,3,6,0,9,2,30,5,1,0,6,0,-27,3,0
2,4,31,0,30,0,4,0,4,3,30,4,0,0,4,4,30,3,1,0,4,0,30,1,3,0,4,0,30,3,0,0,3,1,-15,3,1
2,1,17,3,30,2,2,0,4,1,30,2,0,0,2,1,30,0,4,0,4,2,30,1,3,0,4,2,30,1,0,0,1,1,-15,3,1
2,4,24,0,30,5,1,0,6,3,30,4,0,0,4,9,30,6,0,0,6,0,30,1,5,0,6,1,30,4,0,0,4,1,-15,3,1
2,4,13,3,30,3,0,0,3,1,30,2,0,0,2,0,30,3,0,0,3,0,30,2,1,0,3,1,30,2,0,0,2,1,-15,3,1
2,2,4,2,30,4,4,0,8,3,30,4,0,0,4,2,30,5,3,0,8,0,30,7,1,0,8,1,30,4,0,0,4,0,-27,3,0
2,3,24,0,30,5,1,0,6,2,30,4,0,0,4,3,30,5,1,0,6,0,30,1,5,0,6,1,30,4,0,0,4,1,-15,3,1
2,2,15,2,30,4,0,0,4,0,30,6,0,0,6,3,30,3,1,0,4,1,30,2,2,0,4,0,30,2,2,0,4,1,-15,3,1
2,2,9,0,30,1,3,0,4,0,30,2,0,0,2,5,30,4,0,0,4,0,30,1,3,0,4,0,30,0,1,0,1,0,-27,3,0
2,4,17,1,30,1,3,0,4,0,30,2,0,0,2,2,30,0,4,0,4,2,30,0,4,0,4,3,30,1,0,0,1,1,-15,3,1
2,3,33,2,30,5,6,0,11,4,30,4,0,0,4,6,30,11,0,0,11,0,30,3,8,0,11,3,30,4,0,0,4,1,-15,3,1
2,3,5,1,30,5,7,0,12,1,30,7,3,0,10,0,30,8,4,0,12,0,30,8,4,0,12,4,30,3,3,0,6,0,-27,3,0
2,1,26,0,30,5,4,0,9,4,30,4,0,0,4,4,30,5,4,0,9,0,30,2,7,0,9,5,30,2,1,0,3,1,-15,3,1
2,4,7,0,30,1,3,0,4,1,30,2,0,0,2,0,30,4,0,0,4,0,30,1,3,0,4,1,30,1,1,0,2,0,-27,3,0
2,1,16,0,30,6,3,0,9,1,30,7,1,0,8,0,30,2,7,0,9,0,30,1,8,0,9,0,30,4,0,0,4,1,-15,3,1
2,3,9,0,30,5,6,0,11,1,30,6,0,0,6,1,30,9,2,0,11,2,30,3,8,0,11,3,30,4,0,0,4,0,-27,3,0
2,3,24,0,30,3,3,0,6,3,30,4,0,0,4,10,30,2,4,0,6,2,30,6,0,0,6,0,30,3,1,0,4,1,-15,3,1
2,4,26,0,30,5,4,0,9,4,30,4,0,0,4,4,30,5,4,0,9,0,30,2,7,0,9,5,30,2,1,0,3,1,-15,3,1
2,3,7,0,30,2,7,0,9,2,30,4,0,0,4,1,30,7,2,0,9,4,30,3,6,0,9,1,30,5,1,0,6,0,-27,3,0
2,1,28,0,30,2,6,0,8,5,30,4,0,0,4,1,30,1,7,0,8,0,30,4,4,0,8,4,30,4,0,0,4,1,-15,3,1
2,0,23,0,30,2,3,0,5,1,30,4,0,0,4,10,30,5,0,0,5,0,30,3,2,0,5,1,30,2,0,0,2,1,-15,3,1
2,4,24,0,30,3,3,0,6,3,30,3,1,0,4,8,30,6,0,0,6,0,30,1,5,0,6,0,30,4,0,0,4,1,-15,3,1
2,4,36,0,30,1,8,0,9,4,30,2,0,0,2,3,30,6,3,0,9,1,30,3,6,0,9,6,30,3,0,0,3,1,-15,3,1
2,2,15,4,30,1,3,0,4,0,30,4,2,0,6,0,30,4,0,0,4,1,30,2,2,0,4,0,30,2,2,0,4,1,-15,3,1
2,4,33,0,30,1,2,0,3,2,30,2,0,0,2,6,30,3,0,0,3,0,30,1,2,0,3,1,30,2,0,0,2,1,-15,3,1
2,4,7,1,30,3,6,0,9,2,30,4,0,0,4,0,30,6,3,0,9,3,30,3,6,0,9,2,30,6,0,0,6,0,-27,3,0
2,3,4,0,30,5,3,0,8,3,30,3,1,0,4,0,30,6,2,0,8,0,30,5,3,0,8,3,30,3,1,0,4,0,-27,3,0
2,4,8,3,30,7,0,0,7,3,30,2,0,0,2,4,30,6,1,0,7,0,30,6,1,0,7,1,30,3,0,0,3,0,-27,3,0
2,4,13,9,30,6,1,0,7,0,30,4,0,0,4,2,30,6,1,0,7,1,30,4,3,0,7,6,30,4,0,0,4,1,-15,3,1
2,3,7,1,30,4,5,0,9,1,30,4,0,0,4,0,30,6,3,0,9,5,30,2,7,0,9,3,30,6,0,0,6,0,-27,3,0
2,2,3,1,30,4,7,0,11,1,30,8,0,0,8,2,30,8,3,0,11,2,30,5,6,0,11,1,30,2,5,0,7,0,-27,3,0
2,2,9,2,30,3,1,0,4,2,30,2,0,0,2,2,30,4,0,0,4,0,30,1,3,0,4,1,30,1,0,0,1,0,-27,3,0
2,2,3,0,30,5,6,0,11,2,30,8,0,0,8,2,30,3,8,0,11,4,30,2,9,0,11,2,30,7,0,0,7,0,-27,3,0
2,2,24,0,30,5,1,0,6,1,30,4,0,0,4,6,30,6,0,0,6,0,30,6,0,0,6,0,30,4,0,0,4,1,-15,3,1
2,4,23,0,30,2,3,0,5,1,30,4,0,0,4,0,30,3,2,0,5,4,30,2,3,0,5,3,30,2,0,0,2,1,-15,3,1
2,4,23,0,30,2,3,0,5,2,30,4,0,0,4,3,30,4,1,0,5,0,30,0,5,0,5,5,30,2,0,0,2,1,-15,3,1
2,4,9,0,30,3,1,0,4,2,30,2,0,0,2,4,30,2,2,0,4,0,30,1,3,0,4,0,30,1,0,0,1,0,-27,3,0
2,4,9,0,30,0,4,0,4,0,30,2,0,0,2,4,30,4,0,0,4,0,30,1,3,0,4,1,30,1,0,0,1,0,-27,3,0
2,3,16,0,30,6,3,0,9,1,30,7,1,0,8,0,30,2,7,0,9,0,30,0,9,0,9,0,30,4,0,0,4,1,-15,3,1
2,1,5,2,30,7,5,0,12,3,30,5,5,0,10,0,30,3,9,0,12,0,30,7,5,0,12,1,30,4,2,0,6,0,-27,3,0
2,4,23,0,30,2,3,0,5,2,30,4,0,0,4,6,30,4,1,0,5,0,30,0,5,0,5,6,30,2,0,0,2,1,-15,3,1
2,4,23,0,30,2,3,0,5,2,30,4,0,0,4,7,30,4,1,0,5,0,30,0,5,0,5,1,30,2,0,0,2,1,-15,3,1
2,1,3,1,30,4,7,0,11,3,30,7,1,0,8,4,30,3,8,0,11,1,30,9,2,0,11,1,30,2,5,0,7,0,-27,3,0
2,3,25,1,30,0,4,0,4,2,30,2,0,0,2,3,30,4,0,0,4,0,30,2,2,0,4,0,30,1,0,0,1,1,-15,3,1
2,2,17,0,30,1,3,0,4,0,30,2,0,0,2,1,30,1,3,0,4,2,30,1,3,0,4,3,30,1,0,0,1,1,-15,3,1
2,4,13,0,30,3,0,0,3,0,30,2,0,0,2,2,30,3,0,0,3,4,30,2,1,0,3,2,30,2,0,0,2,1,-15,3,1
2,1,24,2,30,6,0,0,6,3,30,3,1,0,4,7,30,6,0,0,6,0,30,1,5,0,6,3,30,4,0,0,4,1,-15,3,1
2,0,20,0,30,2,6,0,8,0,30,6,2,0,8,2,30,8,0,0,8,0,30,1,7,0,8,1,30,3,2,0,5,1,-15,3,1
2,4,24,0,30,5,1,0,6,3,30,4,0,0,4,9,30,6,0,0,6,0,30,1,5,0,6,0,30,2,2,0,4,1,-15,3,1
2,3,31,0,30,1,3,0,4,3,30,4,0,0,4,0,30,3,1,0,4,0,30,1,3,0,4,0,30,0,3,0,3,1,-15,3,1
2,3,24,0,30,3,3,0,6,2,30,4,0,0,4,6,30,6,0,0,6,0,30,1,5,0,6,0,30,4,0,0,4,1,-15,3,1
2,3,8,2,30,7,0,0,7,2,30,2,0,0,2,4,30,5,2,0,7,0,30,5,2,0,7,0,30,2,1,0,3,0,-27,3,0
2,3,24,0,30,6,0,0,6,2,30,4,0,0,4,4,30,4,2,0,6,0,30,1,5,0,6,2,30,4,0,0,4,1,-15,3,1
2,2,9,0,30,5,6,0,11,2,30,6,0,0,6,4,30,7,4,0,11,4,30,3,8,0,11,3,30,3,1,0,4,0,-27,3,0
2,3,9,0,30,5,6,0,11,2,30,6,0,0,6,2,30,10,1,0,11,4,30,5,6,0,11,2,30,2,2,0,4,0,-27,3,0
2,3,30,3,30,4,1,0,5,4,30,2,0,0,2,4,30,1,4,0,5,1,30,2,3,0,5,0,30,2,1,0,3,1,-15,3,1
2,4,5,1,30,5,7,0,12,2,30,7,3,0,10,0,30,3,9,0,12,1,30,7,5,0,12,3,30,6,0,0,6,0,-27,3,0
2,1,5,1,30,5,7,0,12,2,30,9,1,0,10,0,30,4,8,0,12,0,30,7,5,0,12,1,30,2,4,0,6,0,-27,3,0
2,2,24,1,30,6,0,0,6,2,30,4,0,0,4,5,30,6,0,0,6,0,30,1,5,0,6,1,30,4,0,0,4,1,-15,3,1
2,4,7,0,30,4,5,0,9,2,30,4,0,0,4,2,30,6,3,0,9,0,30,2,7,0,9,4,30,4,2,0,6,0,-27,3,0
2,3,7,0,30,2,2,0,4,1,30,2,0,0,2,0,30,3,1,0,4,0,30,1,3,0,4,3,30,1,1,0,2,0,-27,3,0
2,3,24,0,30,3,3,0,6,2,30,4,0,0,4,6,30,5,1,0,6,0,30,1,5,0,6,2,30,4,0,0,4,1,-15,3,1
2,1,24,0,30,2,4,0,6,3,30,4,0,0,4,10,30,6,0,0,6,0,30,1,5,0,6,4,30,4,0,0,4,1,-15,3,1
2,4,5,0,30,4,8,0,12,3,30,7,3,0,10,0,30,3,9,0,12,0,30,7,5,0,12,4,30,6,0,0,6,0,-27,3,0
2,4,28,0,30,5,3,0,8,3,30,4,0,0,4,0,30,5,3,0,8,0,30,2,6,0,8,1,30,4,0,0,4,1,-15,3,1
2,3,9,0,30,1,3,0,4,1,30,2,0,0,2,3,30,2,2,0,4,0,30,1,3,0,4,1,30,1,0,0,1,0,-27,3,0
2,3,13,2,30,6,1,0,7,0,30,4,0,0,4,2,30,5,2,0,7,0,30,6,1,0,7,5,30,4,0,0,4,1,-15,3,1
2,1,31,0,30,2,2,0,4,2,30,4,0,0,4,3,30,4,0,0,4,0,30,1,3,0,4,0,30,0,3,0,3,1,-15,3,1
2,4,36,1,30,0,9,0,9,5,30,2,0,0,2,6,30,5,4,0,9,1,30,3,6,0,9,6,30,3,0,0,3,1,-15,3,1
2,3,12,0,30,2,5,0,7,1,30,2,4,0,6,5,30,4,3,0,7,5,30,5,2,0,7,4,30,3,0,0,3,1,-15,3,1
2,4,9,0,30,2,2,0,4,0,30,2,0,0,2,2,30,4,0,0,4,0,30,1,3,0,4,1,30,1,0,0,1,0,-27,3,0
2,4,9,1,30,6,5,0,11,1,30,6,0,0,6,1,30,11,0,0,11,2,30,3,8,0,11,4,30,4,0,0,4,0,-27,3,0
2,3,17,1,30,2,2,0,4,0,30,2,0,0,2,1,30,1,3,0,4,2,30,1,3,0,4,4,30,1,0,0,1,1,-15,3,1
2,4,28,0,30,2,6,0,8,4,30,4,0,0,4,0,30,3,5,0,8,0,30,4,4,0,8,3,30,4,0,0,4,1,-15,3,1
2,3,31,1,30,2,2,0,4,2,30,4,0,0,4,3,30,4,0,0,4,0,30,1,3,0,4,0,30,3,0,0,3,1,-15,3,1
2,3,13,2,30,3,0,0,3,1,30,2,0,0,2,0,30,2,1,0,3,3,30,2,1,0,3,2,30,2,0,0,2,1,-15,3,1
2,4,7,1,30,5,4,0,9,2,30,3,1,0,4,0,30,7,2,0,9,0,30,3,6,0,9,3,30,6,0,0,6,0,-27,3,0
2,1,9,0,30,1,3,0,4,0,30,2,0,0,2,8,30,3,1,0,4,0,30,1,3,0,4,0,30,1,0,0,1,0,-27,3,0
2,1,7,0,30,6,3,0,9,2,30,3,1,0,4,3,30,6,3,0,9,4,30,3,6,0,9,4,30,4,2,0,6,0,-27,3,0
2,3,13,2,30,3,0,0,3,0,30,2,0,0,2,1,30,3,0,0,3,0,30,1,2,0,3,3,30,2,0,0,2,1,-15,3,1
2,4,5,1,30,5,7,0,12,2,30,6,4,0,10,0,30,5,7,0,12,0,30,9,3,0,12,1,30,3,3,0,6,0,-27,3,0
2,3,7,0,30,2,7,0,9,1,30,4,0,0,4,0,30,7,2,0,9,4,30,2,7,0,9,2,30,5,1,0,6,0,-27,3,0
2,3,5,1,30,7,5,0,12,2,30,5,5,0,10,0,30,9,3,0,12,0,30,6,6,0,12,2,30,3,3,0,6,0,-27,3,0
2,3,30,2,30,2,3,0,5,4,30,2,0,0,2,1,30,2,3,0,5,3,30,3,2,0,5,0,30,2,1,0,3,1,-15,3,1
2,4,27,0,30,2,3,0,5,0,30,0,0,0,0,0,30,1,4,0,5,0,30,2,3,0,5,3,30,4,0,0,4,1,-15,3,1
2,2,25,1,30,0,4,0,4,1,30,2,0,0,2,3,30,4,0,0,4,0,30,0,4,0,4,1,30,1,0,0,1,1,-15,3,1
2,1,15,3,30,3,1,0,4,0,30,6,0,0,6,0,30,3,1,0,4,1,30,2,2,0,4,0,30,2,2,0,4,1,-15,3,1
2,4,27,0,30,1,4,0,5,0,30,0,0,0,0,0,30,3,2,0,5,0,30,2,3,0,5,1,30,4,0,0,4,1,-15,3,1
2,3,9,0,30,7,4,0,11,1,30,6,0,0,6,3,30,11,0,0,11,2,30,3,8,0,11,2,30,3,1,0,4,0,-27,3,0
2,3,31,0,30,0,4,0,4,4,30,4,0,0,4,0,30,2,2,0,4,5,30,4,0,0,4,3,30,3,0,0,3,1,-15,3,1
2,4,20,0,30,2,6,0,8,1,30,7,1,0,8,0,30,5,3,0,8,0,30,6,2,0,8,1,30,3,2,0,5,1,-15,3,1
2,3,28,0,30,1,7,0,8,3,30,4,0,0,4,0,30,5,3,0,8,0,30,7,1,0,8,4,30,4,0,0,4,1,-15,3,1
2,4,15,3,30,2,2,0,4,0,30,6,0,0,6,2,30,4,0,0,4,3,30,2,2,0,4,0,30,4,0,0,4,1,-15,3,1
2,3,5,0,30,0,5,0,5,0,30,2,2,0,4,0,30,4,1,0,5,2,30,1,4,0,5,0,30,2,0,0,2,0,-27,3,0
2,2,9,0,30,9,2,0,11,2,30,6,0,0,6,3,30,8,3,0,11,4,30,2,9,0,11,3,30,4,0,0,4,0,-27,3,0
2,4,16,0,30,5,4,0,9,1,30,8,0,0,8,0,30,3,6,0,9,0,30,1,8,0,9,0,30,3,1,0,4,1,-15,3,1
2,3,23,0,30,2,3,0,5,1,30,4,0,0,4,0,30,2,3,0,5,0,30,2,3,0,5,4,30,2,0,0,2,1,-15,3,1
2,4,27,0,30,3,2,0,5,1,30,0,0,0,0,2,30,3,2,0,5,0,30,3,2,0,5,1,30,4,0,0,4,1,-15,3,1
2,4,7,0,30,3,6,0,9,1,30,4,0,0,4,1,30,9,0,0,9,4,30,2,7,0,9,1,30,4,2,0,6,0,-27,3,0
2,1,9,0,30,1,3,0,4,0,30,2,0,0,2,4,30,3,1,0,4,4,30,1,3,0,4,4,30,1,0,0,1,0,-27,3,0
2,4,23,0,30,2,3,0,5,1,30,4,0,0,4,2,30,5,0,0,5,0,30,1,4,0,5,1,30,1,1,0,2,1,-15,3,1
2,4,9,0,30,1,3,0,4,1,30,1,1,0,2,5,30,4,0,0,4,0,30,1,3,0,4,0,30,1,0,0,1,0,-27,3,0
2,4,16,0,30,6,3,0,9,1,30,8,0,0,8,1,30,5,4,0,9,0,30,1,8,0,9,0,30,4,0,0,4,1,-15,3,1
2,4,25,1,30,0,4,0,4,1,30,2,0,0,2,0,30,3,1,0,4,0,30,0,4,0,4,2,30,1,0,0,1,1,-15,3,1
2,2,3,9,30,5,6,0,11,4,30,8,0,0,8,4,30,2,9,0,11,0,30,3,8,0,11,1,30,2,5,0,7,0,-27,3,0
2,4,24,0,30,6,0,0,6,2,30,4,0,0,4,1,30,4,2,0,6,0,30,1,5,0,6,2,30,4,0,0,4,1,-15,3,1
2,3,1,0,30,7,3,0,10,3,30,2,0,0,2,7,30,6,4,0,10,0,30,6,4,0,10,0,30,6,0,0,6,0,-27,3,0
2,4,23,0,30,3,2,0,5,2,30,4,0,0,4,10,30,5,0,0,5,0,30,0,5,0,5,1,30,2,0,0,2,1,-15,3,1
2,2,31,0,30,0,4,0,4,3,30,4,0,0,4,3,30,2,2,0,4,0,30,1,3,0,4,1,30,3,0,0,3,1,-15,3,1
2,1,5,0,30,2,3,0,5,0,30,3,1,0,4,0,30,0,5,0,5,0,30,1,4,0,5,0,30,0,2,0,2,0,-27,3,0
2,3,17,1,30,1,3,0,4,0,30,2,0,0,2,1,30,2,2,0,4,4,30,1,3,0,4,2,30,1,0,0,1,1,-15,3,1
2,4,26,0,30,6,3,0,9,3,30,2,2,0,4,2,30,4,5,0,9,0,30,2,7,0,9,0,30,2,1,0,3,1,-15,3,1
2,4,7,0,30,4,5,0,9,2,30,4,0,0,4,2,30,6,3,0,9,0,30,3,6,0,9,2,30,4,2,0,6,0,-27,3,0
2,3,5,1,30,7,5,0,12,2,30,7,3,0,10,0,30,5,7,0,12,0,30,6,6,0,12,2,30,3,3,0,6,0,-27,3,0
2,3,24,0,30,3,3,0,6,2,30,4,0,0,4,4,30,3,3,0,6,0,30,3,3,0,6,5,30,4,0,0,4,1,-15,3,1
2,3,5,1,30,7,5,0,12,2,30,6,4,0,10,1,30,7,5,0,12,0,30,5,7,0,12,1,30,2,4,0,6,0,-27,3,0
2,4,4,0,30,6,2,0,8,3,30,1,3,0,4,2,30,3,5,0,8,0,30,7,1,0,8,5,30,4,0,0,4,0,-27,3,0
2,3,7,0,30,2,2,0,4,1,30,2,0,0,2,1,30,4,0,0,4,0,30,1,3,0,4,2,30,1,1,0,2,0,-27,3,0
2,3,7,0,30,2,2,0,4,1,30,2,0,0,2,1,30,3,1,0,4,0,30,2,2,0,4,1,30,1,1,0,2,0,-27,3,0
2,4,5,1,30,6,6,0,12,2,30,7,3,0,10,0,30,7,5,0,12,0,30,8,4,0,12,1,30,4,2,0,6,0,-27,3,0
2,4,3,3,30,7,4,0,11,3,30,8,0,0,8,1,30,3,8,0,11,0,30,4,7,0,11,1,30,2,5,0,7,0,-27,3,0
2,0,24,0,30,5,1,0,6,2,30,4,0,0,4,4,30,3,3,0,6,0,30,0,6,0,6,3,30,4,0,0,4,1,-15,3,1
2,3,24,0,30,3,3,0,6,3,30,3,1,0,4,7,30,5,1,0,6,0,30,1,5,0,6,0,30,4,0,0,4,1,-15,3,1
2,4,13,1,30,3,0,0,3,1,30,2,0,0,2,0,30,2,1,0,3,3,30,3,0,0,3,2,30,2,0,0,2,1,-15,3,1
2,4,25,2,30,2,2,0,4,2,30,2,0,0,2,1,30,2,2,0,4,0,30,0,4,0,4,0,30,1,0,0,1,1,-15,3,1
2,4,15,0,30,2,2,0,4,0,30,6,0,0,6,0,30,2,2,0,4,6,30,4,0,0,4,1,30,4,0,0,4,1,-15,3,1
2,4,5,1,30,6,6,0,12,2,30,6,4,0,10,0,30,6,6,0,12,0,30,7,5,0,12,1,30,3,3,0,6,0,-27,3,0
2,4,36,0,30,6,3,0,9,3,30,2,0,0,2,4,30,9,0,0,9,1,30,1,8,0,9,3,30,2,1,0,3,1,-15,3,1
2,1,31,0,30,0,4,0,4,1,30,4,0,0,4,4,30,3,1,0,4,0,30,1,3,0,4,1,30,3,0,0,3,1,-15,3,1
2,4,7,1,30,4,5,0,9,2,30,4,0,0,4,2,30,6,3,0,9,5,30,3,6,0,9,0,30,5,1,0,6,0,-27,3,0
2,2,23,0,30,3,2,0,5,1,30,4,0,0,4,0,30,3,2,0,5,0,30,4,1,0,5,0,30,2,0,0,2,1,-15,3,1
2,3,13,2,30,5,2,0,7,0,30,4,0,0,4,2,30,6,1,0,7,3,30,7,0,0,7,5,30,4,0,0,4,1,-15,3,1
2,4,26,0,30,4,5,0,9,4,30,4,0,0,4,9,30,1,8,0,9,0,30,3,6,0,9,4,30,2,1,0,3,1,-15,3,1
2,1,5,1,30,7,5,0,12,2,30,8,2,0,10,0,30,5,7,0,12,0,30,7,5,0,12,1,30,2,4,0,6,0,-27,3,0
2,3,31,1,30,2,2,0,4,2,30,4,0,0,4,2,30,4,0,0,4,0,30,1,3,0,4,0,30,3,0,0,3,1,-15,3,1
2,2,13,4,30,3,0,0,3,2,30,2,0,0,2,0,30,2,1,0,3,1,30,2,1,0,3,1,30,2,0,0,2,1,-15,3,1
2,4,31,0,30,0,4,0,4,3,30,4,0,0,4,0,30,1,3,0,4,2,30,3,1,0,4,0,30,2,1,0,3,1,-15,3,1
2,3,17,2,30,1,3,0,4,0,30,2,0,0,2,1,30,2,2,0,4,2,30,1,3,0,4,4,30,1,0,0,1,1,-15,3,1
2,4,17,1,30,1,3,0,4,0,30,2,0,0,2,0,30,0,4,0,4,2,30,1,3,0,4,3,30,1,0,0,1,1,-15,3,1
2,3,17,1,30,0,4,0,4,0,30,2,0,0,2,3,30,0,4,0,4,2,30,1,3,0,4,4,30,1,0,0,1,1,-15,3,1
2,4,38,0,30,1,9,0,10,4,30,6,0,0,6,0,30,10,0,0,10,0,30,2,8,0,10,3,30,6,0,0,6,1,-15,3,1
2,4,13,3,30,3,0,0,3,0,30,2,0,0,2,0,30,2,1,0,3,0,30,1,2,0,3,2,30,2,0,0,2,1,-15,3,1
2,3,9,0,30,5,6,0,11,1,30,6,0,0,6,5,30,11,0,0,11,3,30,3,8,0,11,2,30,2,2,0,4,0,-27,3,0
2,3,7,0,30,1,3,0,4,0,30,2,0,0,2,3,30,4,0,0,4,0,30,1,3,0,4,2,30,2,0,0,2,0,-27,3,0
2,4,9,0,30,2,2,0,4,2,30,2,0,0,2,6,30,3,1,0,4,0,30,1,3,0,4,0,30,1,0,0,1,0,-27,3,0
2,1,20,0,30,1,7,0,8,0,30,7,1,0,8,0,30,5,3,0,8,0,30,5,3,0,8,0,30,2,3,0,5,1,-15,3,1
2,3,5,1,30,3,9,0,12,3,30,8,2,0,10,0,30,3,9,0,12,0,30,7,5,0,12,4,30,6,0,0,6,0,-27,3,0
2,4,24,0,30,4,2,0,6,2,30,3,1,0,4,7,30,5,1,0,6,0,30,1,5,0,6,6,30,4,0,0,4,1,-15,3,1
2,3,5,2,30,6,6,0,12,3,30,5,5,0,10,0,30,6,6,0,12,0,30,7,5,0,12,3,30,3,3,0,6,0,-27,3,0
2,4,22,2,30,5,3,0,8,2,30,2,0,0,2,1,30,6,2,0,8,1,30,4,4,0,8,1,30,4,0,0,4,1,-15,3,1
2,4,23,0,30,2,3,0,5,2,30,4,0,0,4,6,30,5,0,0,5,0,30,0,5,0,5,1,30,2,0,0,2,1,-15,3,1
2,2,24,0,30,6,0,0,6,2,30,4,0,0,4,3,30,6,0,0,6,0,30,1,5,0,6,3,30,4,0,0,4,1,-15,3,1
2,4,17,1,30,2,2,0,4,0,30,2,0,0,2,1,30,0,4,0,4,3,30,1,3,0,4,4,30,1,0,0,1,1,-15,3,1
2,4,24,0,30,3,3,0,6,2,30,3,1,0,4,3,30,5,1,0,6,0,30,1,5,0,6,1,30,4,0,0,4,1,-15,3,1
2,4,24,0,30,4,2,0,6,2,30,4,0,0,4,6,30,6,0,0,6,0,30,3,3,0,6,1,30,4,0,0,4,1,-15,3,1
2,2,5,0,30,6,6,0,12,3,30,8,2,0,10,0,30,3,9,0,12,0,30,7,5,0,12,5,30,5,1,0,6,0,-27,3,0
2,3,23,0,30,2,3,0,5,1,30,4,0,0,4,3,30,5,0,0,5,0,30,0,5,0,5,5,30,2,0,0,2,1,-15,3,1
2,4,27,0,30,1,4,0,5,1,30,0,0,0,0,0,30,2,3,0,5,0,30,2,3,0,5,0,30,4,0,0,4,1,-15,3,1
2,2,25,2,30,2,2,0,4,1,30,2,0,0,2,5,30,4,0,0,4,0,30,0,4,0,4,0,30,1,0,0,1,1,-15,3,1
2,3,13,2,30,3,0,0,3,0,30,2,0,0,2,0,30,2,1,0,3,4,30,3,0,0,3,3,30,2,0,0,2,1,-15,3,1
2,3,14,0,30,6,3,0,9,1,30,6,0,0,6,8,30,4,5,0,9,0,30,5,4,0,9,4,30,4,0,0,4,1,-15,3,1
2,0,20,0,30,2,6,0,8,1,30,8,0,0,8,0,30,4,4,0,8,0,30,5,3,0,8,1,30,4,1,0,5,1,-15,3,1
2,3,9,0,30,2,2,0,4,2,30,2,0,0,2,0,30,2,2,0,4,0,30,1,3,0,4,2,30,1,0,0,1,0,-27,3,0
2,4,7,0,30,2,2,0,4,0,30,2,0,0,2,0,30,4,0,0,4,2,30,2,2,0,4,1,30,1,1,0,2,0,-27,3,0
2,2,31,0,30,4,0,0,4,3,30,4,0,0,4,0,30,1,3,0,4,0,30,1,3,0,4,0,30,1,2,0,3,1,-15,3,1
2,4,15,0,30,1,3,0,4,0,30,5,1,0,6,0,30,3,1,0,4,4,30,4,0,0,4,0,30,4,0,0,4,1,-15,3,1
2,2,24,6,30,6,0,0,6,3,30,3,1,0,4,0,30,3,3,0,6,0,30,1,5,0,6,2,30,4,0,0,4,1,-15,3,1
2,4,27,0,30,1,4,0,5,0,30,0,0,0,0,0,30,5,0,0,5,0,30,2,3,0,5,3,30,4,0,0,4,1,-15,3,1
2,4,7,0,30,2,7,0,9,1,30,4,0,0,4,1,30,9,0,0,9,4,30,3,6,0,9,1,30,5,1,0,6,0,-27,3,0
2,3,20,0,30,0,8,0,8,1,30,7,1,0,8,0,30,8,0,0,8,0,30,2,6,0,8,1,30,5,0,0,5,1,-15,3,1
2,4,33,1,30,3,8,0,11,4,30,4,0,0,4,4,30,10,1,0,11,0,30,3,8,0,11,5,30,4,0,0,4,1,-15,3,1
2,3,16,0,30,5,4,0,9,1,30,8,0,0,8,1,30,5,4,0,9,0,30,1,8,0,9,0,30,3,1,0,4,1,-15,3,1
2,3,17,2,30,1,3,0,4,0,30,2,0,0,2,0,30,1,3,0,4,2,30,1,3,0,4,2,30,1,0,0,1,1,-15,3,1
2,4,24,0,30,6,0,0,6,2,30,3,1,0,4,2,30,4,2,0,6,0,30,1,5,0,6,1,30,4,0,0,4,1,-15,3,1
2,3,13,1,30,3,0,0,3,0,30,2,0,0,2,3,30,3,0,0,3,4,30,2,1,0,3,0,30,2,0,0,2,1,-15,3,1
2,3,3,0,30,5,6,0,11,2,30,8,0,0,8,0,30,5,6,0,11,2,30,6,5,0,11,1,30,2,5,0,7,0,-27,3,0
2,1,31,0,30,0,4,0,4,3,30,4,0,0,4,4,30,4,0,0,4,0,30,1,3,0,4,0,30,3,0,0,3,1,-15,3,1
2,3,24,6,30,6,0,0,6,3,30,3,1,0,4,0,30,3,3,0,6,0,30,1,5,0,6,2,30,4,0,0,4,1,-15,3,1
2,4,8,0,30,7,0,0,7,2,30,2,0,0,2,1,30,7,0,0,7,0,30,5,2,0,7,0,30,3,0,0,3,0,-27,3,0
2,4,9,0,30,1,3,0,4,1,30,2,0,0,2,9,30,4,0,0,4,0,30,1,3,0,4,0,30,0,1,0,1,0,-27,3,0
2,4,24,0,30,5,1,0,6,0,30,3,1,0,4,8,30,5,1,0,6,0,30,1,5,0,6,0,30,4,0,0,4,1,-15,3,1
2,2,5,0,30,5,7,0,12,2,30,9,1,0,10,0,30,3,9,0,12,0,30,7,5,0,12,2,30,6,0,0,6,0,-27,3,0
2,4,5,0,30,2,3,0,5,0,30,2,2,0,4,0,30,1,4,0,5,0,30,1,4,0,5,0,30,0,2,0,2,0,-27,3,0
2,4,3,0,30,3,8,0,11,2,30,8,0,0,8,0,30,5,6,0,11,4,30,6,5,0,11,2,30,2,5,0,7,0,-27,3,0
2,3,25,3,30,0,4,0,4,0,30,2,0,0,2,4,30,4,0,0,4,2,30,1,3,0,4,0,30,1,0,0,1,1,-15,3,1
2,3,16,0,30,5,4,0,9,2,30,8,0,0,8,1,30,1,8,0,9,0,30,1,8,0,9,0,30,3,1,0,4,1,-15,3,1
2,2,25,2,30,1,3,0,4,2,30,2,0,0,2,0,30,4,0,0,4,0,30,0,4,0,4,2,30,1,0,0,1,1,-15,3,1
2,3,24,0,30,4,2,0,6,2,30,3,1,0,4,4,30,5,1,0,6,0,30,1,5,0,6,1,30,4,0,0,4,1,-15,3,1
2,4,32,0,30,4,5,0,9,3,30,2,0,0,2,3,30,8,1,0,9,1,30,3,6,0,9,4,30,2,0,0,2,1,-15,3,1
2,3,13,7,30,7,0,0,7,1,30,4,0,0,4,10,30,7,0,0,7,1,30,7,0,0,7,2,30,4,0,0,4,1,-15,3,1
2,4,8,2,30,7,0,0,7,2,30,2,0,0,2,6,30,5,2,0,7,3,30,5,2,0,7,1,30,3,0,0,3,0,-27,3,0
2,4,9,1,30,2,2,0,4,2,30,2,0,0,2,0,30,3,1,0,4,0,30,1,3,0,4,0,30,1,0,0,1,0,-27,3,0
2,4,5,1,30,6,6,0,12,3,30,7,3,0,10,0,30,3,9,0,12,0,30,6,6,0,12,1,30,6,0,0,6,0,-27,3,0
2,2,24,1,30,4,2,0,6,3,30,4,0,0,4,6,30,6,0,0,6,0,30,1,5,0,6,6,30,4,0,0,4,1,-15,3,1
2,1,5,1,30,4,8,0,12,3,30,6,4,0,10,0,30,3,9,0,12,2,30,8,4,0,12,4,30,6,0,0,6,0,-27,3,0
2,3,5,1,30,5,7,0,12,2,30,9,1,0,10,0,30,3,9,0,12,0,30,7,5,0,12,1,30,3,3,0,6,0,-27,3,0
2,2,23,0,30,2,3,0,5,2,30,4,0,0,4,5,30,5,0,0,5,0,30,0,5,0,5,3,30,2,0,0,2,1,-15,3,1
2,4,9,0,30,5,6,0,11,2,30,6,0,0,6,4,30,9,2,0,11,1,30,3,8,0,11,2,30,4,0,0,4,0,-27,3,0
2,4,25,0,30,1,3,0,4,2,30,2,0,0,2,0,30,4,0,0,4,2,30,0,4,0,4,0,30,1,0,0,1,1,-15,3,1
2,4,7,1,30,5,4,0,9,2,30,4,0,0,4,1,30,7,2,0,9,5,30,2,7,0,9,3,30,5,1,0,6,0,-27,3,0
2,4,17,1,30,1,3,0,4,0,30,2,0,0,2,3,30,0,4,0,4,2,30,1,3,0,4,2,30,1,0,0,1,1,-15,3,1
2,2,17,1,30,1,3,0,4,0,30,2,0,0,2,1,30,3,1,0,4,3,30,1,3,0,4,3,30,1,0,0,1,1,-15,3,1
2,3,23,0,30,2,3,0,5,1,30,4,0,0,4,0,30,5,0,0,5,0,30,0,5,0,5,0,30,2,0,0,2,1,-15,3,1
2,4,7,0,30,2,2,0,4,1,30,2,0,0,2,0,30,4,0,0,4,0,30,1,3,0,4,0,30,2,0,0,2,0,-27,3,0
2,2,24,0,30,6,0,0,6,2,30,3,1,0,4,6,30,6,0,0,6,0,30,1,5,0,6,0,30,4,0,0,4,1,-15,3,1
2,3,28,0,30,1,7,0,8,5,30,4,0,0,4,0,30,1,7,0,8,0,30,7,1,0,8,3,30,4,0,0,4,1,-15,3,1
2,2,9,0,30,2,2,0,4,1,30,2,0,0,2,5,30,3,1,0,4,0,30,1,3,0,4,0,30,1,0,0,1,0,-27,3,0
2,3,5,1,30,6,6,0,12,2,30,3,7,0,10,0,30,6,6,0,12,0,30,7,5,0,12,1,30,4,2,0,6,0,-27,3,0
2,1,29,0,30,1,4,0,5,4,30,8,0,0,8,0,30,1,4,0,5,0,30,4,1,0,5,1,30,4,0,0,4,1,-15,3,1
2,4,9,0,30,7,4,0,11,3,30,6,0,0,6,3,30,5,6,0,11,1,30,3,8,0,11,2,30,4,0,0,4,0,-27,3,0
2,4,8,3,30,7,0,0,7,2,30,2,0,0,2,0,30,6,1,0,7,0,30,4,3,0,7,0,30,2,1,0,3,0,-27,3,0
2,4,4,0,30,6,2,0,8,4,30,2,2,0,4,4,30,3,5,0,8,0,30,2,6,0,8,3,30,3,1,0,4,0,-27,3,0
2,1,31,0,30,1,3,0,4,3,30,4,0,0,4,8,30,4,0,0,4,0,30,1,3,0,4,0,30,0,3,0,3,1,-15,3,1
2,3,24,2,30,6,0,0,6,3,30,4,0,0,4,0,30,3,3,0,6,0,30,1,5,0,6,3,30,4,0,0,4,1,-15,3,1
2,3,9,0,30,4,0,0,4,1,30,2,0,0,2,5,30,4,0,0,4,0,30,1,3,0,4,2,30,1,0,0,1,0,-27,3,0
2,3,9,1,30,8,3,0,11,3,30,6,0,0,6,4,30,8,3,0,11,2,30,3,8,0,11,0,30,4,0,0,4,0,-27,3,0
2,4,15,0,30,4,0,0,4,0,30,6,0,0,6,0,30,2,2,0,4,2,30,1,3,0,4,0,30,2,2,0,4,1,-15,3,1
2,4,7,0,30,2,2,0,4,1,30,2,0,0,2,0,30,2,2,0,4,0,30,1,3,0,4,2,30,1,1,0,2,0,-27,3,0
2,4,3,1,30,7,4,0,11,0,30,7,1,0,8,0,30,10,1,0,11,4,30,0,11,0,11,1,30,2,5,0,7,0,-27,3,0
2,4,13,0,30,6,1,0,7,0,30,4,0,0,4,5,30,7,0,0,7,4,30,2,5,0,7,4,30,4,0,0,4,1,-15,3,1
2,4,27,0,30,1,4,0,5,0,30,0,0,0,0,1,30,5,0,0,5,0,30,2,3,0,5,5,30,4,0,0,4,1,-15,3,1
2,1,5,1,30,4,8,0,12,2,30,8,2,0,10,0,30,3,9,0,12,1,30,8,4,0,12,1,30,0,6,0,6,0,-27,3,0
2,2,5,1,30,4,8,0,12,2,30,8,2,0,10,1,30,5,7,0,12,0,30,8,4,0,12,2,30,2,4,0,6,0,-27,3,0
2,3,9,0,30,6,5,0,11,3,30,6,0,0,6,5,30,6,5,0,11,1,30,6,5,0,11,1,30,3,1,0,4,0,-27,3,0
2,1,20,0,30,1,7,0,8,1,30,7,1,0,8,1,30,6,2,0,8,0,30,4,4,0,8,1,30,1,4,0,5,1,-15,3,1
2,3,25,2,30,0,4,0,4,2,30,2,0,0,2,0,30,4,0,0,4,0,30,0,4,0,4,2,30,1,0,0,1,1,-15,3,1
2,4,13,1,30,3,4,0,7,0,30,4,0,0,4,2,30,5,2,0,7,2,30,7,0,0,7,5,30,4,0,0,4,1,-15,3,1
2,3,3,0,30,5,6,0,11,2,30,8,0,0,8,0,30,5,6,0,11,4,30,5,6,0,11,1,30,2,5,0,7,0,-27,3,0
2,4,7,0,30,2,7,0,9,2,30,3,1,0,4,3,30,7,2,0,9,4,30,3,6,0,9,2,30,6,0,0,6,0,-27,3,0
2,3,9,2,30,3,1,0,4,2,30,2,0,0,2,3,30,4,0,0,4,0,30,0,4,0,4,1,30,1,0,0,1,0,-27,3,0
2,4,17,1,30,2,2,0,4,1,30,2,0,0,2,1,30,0,4,0,4,1,30,1,3,0,4,1,30,1,0,0,1,1,-15,3,1
2,3,16,0,30,6,3,0,9,1,30,8,0,0,8,0,30,3,6,0,9,0,30,0,9,0,9,0,30,3,1,0,4,1,-15,3,1
2,4,25,2,30,2,2,0,4,2,30,2,0,0,2,2,30,4,0,0,4,0,30,0,4,0,4,1,30,1,0,0,1,1,-15,3,1
2,4,9,1,30,6,5,0,11,0,30,6,0,0,6,0,30,11,0,0,11,1,30,3,8,0,11,2,30,2,2,0,4,0,-27,3,0
2,3,17,1,30,2,2,0,4,1,30,2,0,0,2,2,30,0,4,0,4,2,30,1,3,0,4,2,30,1,0,0,1,1,-15,3,1
2,1,5,1,30,7,5,0,12,3,30,8,2,0,10,3,30,5,7,0,12,0,30,8,4,0,12,1,30,1,5,0,6,0,-27,3,0
2,2,23,0,30,2,3,0,5,2,30,4,0,0,4,4,30,1,4,0,5,0,30,0,5,0,5,0,30,2,0,0,2,1,-15,3,1
2,2,25,1,30,2,2,0,4,1,30,2,0,0,2,0,30,3,1,0,4,0,30,0,4,0,4,3,30,1,0,0,1,1,-15,3,1
2,4,30,2,30,3,2,0,5,2,30,2,0,0,2,2,30,2,3,0,5,3,30,2,3,0,5,6,30,3,0,0,3,1,-15,3,1
2,3,30,2,30,2,3,0,5,5,30,2,0,0,2,1,30,2,3,0,5,3,30,2,3,0,5,0,30,2,1,0,3,1,-15,3,1
2,2,28,0,30,1,7,0,8,4,30,4,0,0,4,5,30,4,4,0,8,0,30,2,6,0,8,5,30,4,0,0,4,1,-15,3,1
2,3,17,1,30,1,3,0,4,0,30,2,0,0,2,2,30,0,4,0,4,0,30,1,3,0,4,4,30,1,0,0,1,1,-15,3,1
2,2,31,0,30,1,3,0,4,3,30,4,0,0,4,2,30,3,1,0,4,0,30,1,3,0,4,0,30,3,0,0,3,1,-15,3,1
2,3,24,0,30,5,1,0,6,2,30,3,1,0,4,4,30,4,2,0,6,0,30,2,4,0,6,4,30,4,0,0,4,1,-15,3,1
2,2,23,0,30,2,3,0,5,1,30,4,0,0,4,0,30,3,2,0,5,0,30,0,5,0,5,0,30,2,0,0,2,1,-15,3,1
2,4,24,0,30,5,1,0,6,2,30,4,0,0,4,5,30,6,0,0,6,0,30,2,4,0,6,0,30,3,1,0,4,1,-15,3,1
2,4,30,2,30,3,2,0,5,4,30,2,0,0,2,3,30,2,3,0,5,2,30,1,4,0,5,1,30,3,0,0,3,1,-15,3,1
2,2,14,0,30,9,0,0,9,0,30,6,0,0,6,3,30,7,2,0,9,0,30,4,5,0,9,3,30,4,0,0,4,1,-15,3,1
2,4,31,0,30,0,4,0,4,2,30,4,0,0,4,0,30,3,1,0,4,0,30,2,2,0,4,1,30,3,0,0,3,1,-15,3,1
2,4,17,3,30,4,0,0,4,2,30,2,0,0,2,1,30,1,3,0,4,2,30,0,4,0,4,1,30,1,0,0,1,1,-15,3,1
2,3,5,1,30,5,7,0,12,2,30,7,3,0,10,0,30,4,8,0,12,0,30,6,6,0,12,1,30,5,1,0,6,0,-27,3,0
2,3,30,2,30,3,2,0,5,3,30,2,0,0,2,2,30,2,3,0,5,3,30,2,3,0,5,0,30,2,1,0,3,1,-15,3,1
2,0,20,0,30,3,5,0,8,1,30,8,0,0,8,0,30,5,3,0,8,0,30,1,7,0,8,1,30,4,1,0,5,1,-15,3,1
2,3,7,0,30,2,7,0,9,0,30,4,0,0,4,0,30,5,4,0,9,6,30,2,7,0,9,2,30,3,3,0,6,0,-27,3,0
2,4,31,0,30,2,2,0,4,0,30,4,0,0,4,1,30,4,0,0,4,1,30,1,3,0,4,0,30,0,3,0,3,1,-15,3,1
2,3,28,0,30,3,5,0,8,3,30,4,0,0,4,0,30,7,1,0,8,0,30,2,6,0,8,1,30,3,1,0,4,1,-15,3,1
2,3,24,0,30,3,3,0,6,1,30,4,0,0,4,0,30,6,0,0,6,0,30,1,5,0,6,0,30,2,2,0,4,1,-15,3,1
2,3,25,3,30,1,3,0,4,2,30,2,0,0,2,0,30,1,3,0,4,0,30,1,3,0,4,0,30,1,0,0,1,1,-15,3,1
2,3,13,3,30,3,0,0,3,1,30,2,0,0,2,0,30,2,1,0,3,3,30,3,0,0,3,3,30,2,0,0,2,1,-15,3,1
2,3,14,0,30,4,5,0,9,1,30,6,0,0,6,2,30,8,1,0,9,2,30,9,0,0,9,5,30,4,0,0,4,1,-15,3,1
2,4,7,0,30,1,3,0,4,1,30,2,0,0,2,0,30,4,0,0,4,0,30,1,3,0,4,2,30,1,1,0,2,0,-27,3,0
2,4,9,0,30,7,4,0,11,2,30,6,0,0,6,0,30,9,2,0,11,2,30,3,8,0,11,1,30,2,2,0,4,0,-27,3,0
2,2,26,0,30,6,3,0,9,4,30,4,0,0,4,5,30,2,7,0,9,0,30,2,7,0,9,0,30,2,1,0,3,1,-15,3,1
2,4,9,1,30,6,5,0,11,1,30,5,1,0,6,7,30,11,0,0,11,0,30,2,9,0,11,2,30,3,1,0,4,0,-27,3,0
2,4,9,0,30,0,4,0,4,1,30,2,0,0,2,2,30,4,0,0,4,0,30,1,3,0,4,1,30,1,0,0,1,0,-27,3,0
2,2,5,0,30,2,3,0,5,1,30,0,4,0,4,0,30,0,5,0,5,0,30,1,4,0,5,0,30,1,1,0,2,0,-27,3,0
2,1,16,0,30,4,5,0,9,2,30,8,0,0,8,3,30,2,7,0,9,0,30,1,8,0,9,3,30,4,0,0,4,1,-15,3,1
2,3,23,2,30,6,7,0,13,1,30,6,0,0,6,8,30,12,1,0,13,0,30,6,7,0,13,2,30,6,0,0,6,1,-15,3,1
2,4,15,0,30,2,2,0,4,0,30,5,1,0,6,4,30,2,2,0,4,1,30,2,2,0,4,0,30,4,0,0,4,1,-15,3,1
2,4,30,2,30,3,2,0,5,5,30,2,0,0,2,1,30,2,3,0,5,3,30,2,3,0,5,0,30,3,0,0,3,1,-15,3,1
2,2,31,0,30,1,3,0,4,1,30,4,0,0,4,0,30,4,0,0,4,0,30,1,3,0,4,0,30,1,2,0,3,1,-15,3,1
2,3,24,0,30,3,3,0,6,2,30,4,0,0,4,0,30,1,5,0,6,0,30,1,5,0,6,3,30,4,0,0,4,1,-15,3,1
2,2,31,0,30,0,4,0,4,3,30,4,0,0,4,1,30,4,0,0,4,0,30,3,1,0,4,0,30,3,0,0,3,1,-15,3,1
2,3,4,2,30,6,2,0,8,3,30,4,0,0,4,3,30,7,1,0,8,0,30,5,3,0,8,1,30,4,0,0,4,0,-27,3,0
2,3,3,0,30,5,6,0,11,3,30,8,0,0,8,3,30,3,8,0,11,0,30,7,4,0,11,1,30,2,5,0,7,0,-27,3,0
2,4,5,1,30,10,2,0,12,2,30,4,6,0,10,0,30,3,9,0,12,0,30,5,7,0,12,2,30,4,2,0,6,0,-27,3,0
2,3,9,0,30,2,2,0,4,2,30,2,0,0,2,3,30,1,3,0,4,0,30,1,3,0,4,2,30,1,0,0,1,0,-27,3,0
2,2,9,0,30,2,2,0,4,1,30,2,0,0,2,1,30,4,0,0,4,0,30,1,3,0,4,3,30,1,0,0,1,0,-27,3,0
2,4,30,2,30,4,1,0,5,4,30,2,0,0,2,1,30,1,4,0,5,2,30,1,4,0,5,1,30,3,0,0,3,1,-15,3,1
2,3,7,0,30,4,5,0,9,2,30,4,0,0,4,1,30,7,2,0,9,4,30,2,7,0,9,1,30,6,0,0,6,0,-27,3,0
2,3,24,0,30,2,4,0,6,2,30,4,0,0,4,1,30,6,0,0,6,0,30,0,6,0,6,3,30,4,0,0,4,1,-15,3,1
2,2,9,2,30,7,4,0,11,3,30,6,0,0,6,5,30,8,3,0,11,2,30,5,6,0,11,2,30,2,2,0,4,0,-27,3,0
2,3,30,2,30,3,2,0,5,1,30,2,0,0,2,4,30,3,2,0,5,3,30,1,4,0,5,0,30,2,1,0,3,1,-15,3,1
2,3,31,0,30,2,2,0,4,3,30,4,0,0,4,0,30,3,1,0,4,0,30,1,3,0,4,0,30,2,1,0,3,1,-15,3,1
2,4,31,0,30,2,2,0,4,1,30,4,0,0,4,2,30,4,0,0,4,0,30,1,3,0,4,0,30,0,3,0,3,1,-15,3,1
2,2,27,0,30,1,4,0,5,2,30,0,0,0,0,0,30,1,4,0,5,0,30,2,3,0,5,0,30,4,0,0,4,1,-15,3,1
2,4,25,1,30,2,2,0,4,2,30,2,0,0,2,0,30,3,1,0,4,0,30,1,3,0,4,0,30,1,0,0,1,1,-15,3,1
2,4,24,0,30,5,1,0,6,2,30,3,1,0,4,9,30,6,0,0,6,4,30,1,5,0,6,0,30,4,0,0,4,1,-15,3,1
2,3,9,0,30,1,3,0,4,1,30,2,0,0,2,1,30,4,0,0,4,0,30,1,3,0,4,0,30,1,0,0,1,0,-27,3,0
2,3,24,0,30,4,2,0,6,2,30,4,0,0,4,2,30,6,0,0,6,0,30,1,5,0,6,0,30,4,0,0,4,1,-15,3,1
2,4,9,0,30,2,2,0,4,1,30,1,1,0,2,9,30,4,0,0,4,0,30,1,3,0,4,0,30,1,0,0,1,0,-27,3,0
2,3,31,1,30,2,2,0,4,2,30,4,0,0,4,0,30,3,1,0,4,0,30,1,3,0,4,0,30,2,1,0,3,1,-15,3,1
2,4,25,2,30,1,3,0,4,2,30,2,0,0,2,1,30,4,0,0,4,0,30,0,4,0,4,0,30,1,0,0,1,1,-15,3,1
2,4,23,0,30,3,2,0,5,2,30,4,0,0,4,0,30,3,2,0,5,6,30,2,3,0,5,2,30,2,0,0,2,1,-15,3,1
2,2,5,2,30,10,2,0,12,2,30,6,4,0,10,0,30,5,7,0,12,0,30,5,7,0,12,2,30,3,3,0,6,0,-27,3,0
2,3,3,0,30,0,4,0,4,1,30,4,0,0,4,2,30,4,0,0,4,0,30,2,2,0,4,0,30,1,2,0,3,0,-27,3,0
2,4,5,1,30,6,6,0,12,2,30,6,4,0,10,0,30,6,6,0,12,1,30,7,5,0,12,1,30,2,4,0,6,0,-27,3,0
2,0,24,0,30,4,2,0,6,2,30,4,0,0,4,11,30,6,0,0,6,0,30,1,5,0,6,0,30,4,0,0,4,1,-15,3,1
2,3,28,0,30,1,7,0,8,4,30,4,0,0,4,0,30,3,5,0,8,0,30,3,5,0,8,3,30,4,0,0,4,1,-15,3,1
2,3,14,0,30,3,6,0,9,1,30,6,0,0,6,2,30,3,6,0,9,0,30,3,6,0,9,2,30,4,0,0,4,1,-15,3,1
2,3,3,1,30,4,7,0,11,2,30,8,0,0,8,0,30,6,5,0,11,2,30,5,6,0,11,1,30,3,4,0,7,0,-27,3,0
2,0,24,0,30,5,1,0,6,3,30,3,1,0,4,10,30,2,4,0,6,0,30,1,5,0,6,3,30,4,0,0,4,1,-15,3,1
2,3,4,4,30,8,0,0,8,1,30,4,0,0,4,1,30,5,3,0,8,0,30,0,8,0,8,1,30,4,0,0,4,0,-27,3,0
2,3,25,1,30,2,2,0,4,1,30,2,0,0,2,1,30,4,0,0,4,0,30,0,4,0,4,2,30,1,0,0,1,1,-15,3,1
2,3,5,1,30,6,6,0,12,2,30,7,3,0,10,0,30,6,6,0,12,0,30,7,5,0,12,2,30,3,3,0,6,0,-27,3,0
2,3,22,1,30,6,2,0,8,1,30,2,0,0,2,3,30,4,4,0,8,1,30,2,6,0,8,4,30,4,0,0,4,1,-15,3,1
2,4,9,2,30,3,1,0,4,2,30,2,0,0,2,7,30,4,0,0,4,0,30,1,3,0,4,0,30,1,0,0,1,0,-27,3,0
2,4,32,0,30,4,5,0,9,3,30,2,0,0,2,3,30,9,0,0,9,4,30,3,6,0,9,3,30,2,0,0,2,1,-15,3,1
2,1,23,0,30,2,3,0,5,1,30,4,0,0,4,3,30,3,2,0,5,0,30,2,3,0,5,1,30,2,0,0,2,1,-15,3,1
2,2,31,2,30,1,3,0,4,3,30,4,0,0,4,5,30,4,0,0,4,0,30,1,3,0,4,0,30,1,2,0,3,1,-15,3,1
2,1,31,0,30,2,2,0,4,3,30,4,0,0,4,2,30,4,0,0,4,0,30,1,3,0,4,0,30,2,1,0,3,1,-15,3,1
2,4,5,0,30,1,4,0,5,0,30,1,3,0,4,0,30,1,4,0,5,0,30,1,4,0,5,0,30,1,1,0,2,0,-27,3,0
2,2,5,1,30,6,6,0,12,2,30,5,5,0,10,0,30,6,6,0,12,0,30,9,3,0,12,4,30,2,4,0,6,0,-27,3,0
2,3,24,0,30,6,0,0,6,2,30,3,1,0,4,0,30,4,2,0,6,0,30,1,5,0,6,3,30,4,0,0,4,1,-15,3,1
2,2,23,0,30,1,4,0,5,0,30,4,0,0,4,3,30,4,1,0,5,0,30,0,5,0,5,1,30,2,0,0,2,1,-15,3,1
2,4,17,0,30,1,3,0,4,0,30,2,0,0,2,0,30,1,3,0,4,3,30,1,3,0,4,2,30,1,0,0,1,1,-15,3,1
2,3,20,0,30,2,6,0,8,0,30,8,0,0,8,1,30,8,0,0,8,0,30,1,7,0,8,1,30,4,1,0,5,1,-15,3,1
2,3,7,0,30,5,4,0,9,2,30,4,0,0,4,3,30,6,3,0,9,4,30,3,6,0,9,1,30,4,2,0,6,0,-27,3,0
2,2,20,0,30,1,7,0,8,0,30,7,1,0,8,0,30,8,0,0,8,0,30,2,6,0,8,1,30,4,1,0,5,1,-15,3,1
2,3,29,1,30,0,5,0,5,4,30,8,0,0,8,0,30,2,3,0,5,0,30,0,5,0,5,0,30,4,0,0,4,1,-15,3,1
2,4,23,0,30,2,3,0,5,2,30,4,0,0,4,6,30,3,2,0,5,0,30,0,5,0,5,6,30,2,0,0,2,1,-15,3,1
2,4,7,0,30,6,3,0,9,0,30,3,1,0,4,2,30,6,3,0,9,4,30,2,7,0,9,1,30,6,0,0,6,0,-27,3,0
2,4,9,2,30,4,0,0,4,3,30,2,0,0,2,5,30,2,2,0,4,0,30,1,3,0,4,3,30,1,0,0,1,0,-27,3,0
2,1,9,0,30,5,6,0,11,3,30,6,0,0,6,3,30,5,6,0,11,1,30,3,8,0,11,2,30,4,0,0,4,0,-27,3,0
2,4,23,0,30,2,3,0,5,1,30,3,1,0,4,0,30,4,1,0,5,0,30,0,5,0,5,1,30,2,0,0,2,1,-15,3,1
2,4,20,0,30,1,7,0,8,2,30,8,0,0,8,4,30,5,3,0,8,0,30,4,4,0,8,0,30,4,1,0,5,1,-15,3,1
2,1,24,0,30,6,0,0,6,3,30,3,1,0,4,6,30,6,0,0,6,0,30,1,5,0,6,2,30,4,0,0,4,1,-15,3,1
2,4,9,2,30,9,2,0,11,2,30,6,0,0,6,2,30,11,0,0,11,0,30,2,9,0,11,2,30,3,1,0,4,0,-27,3,0
2,3,32,3,30,2,7,0,9,4,30,2,0,0,2,2,30,9,0,0,9,1,30,3,6,0,9,2,30,2,0,0,2,1,-15,3,1
2,4,23,0,30,3,2,0,5,1,30,4,0,0,4,2,30,5,0,0,5,0,30,0,5,0,5,0,30,1,1,0,2,1,-15,3,1
2,1,28,0,30,1,7,0,8,4,30,4,0,0,4,3,30,1,7,0,8,0,30,4,4,0,8,2,30,3,1,0,4,1,-15,3,1
2,2,24,0,30,4,2,0,6,2,30,3,1,0,4,2,30,4,2,0,6,0,30,1,5,0,6,0,30,4,0,0,4,1,-15,3,1
2,3,24,0,30,3,3,0,6,2,30,3,1,0,4,2,30,4,2,0,6,0,30,6,0,0,6,3,30,4,0,0,4,1,-15,3,1
2,4,27,0,30,1,4,0,5,0,30,0,0,0,0,0,30,5,0,0,5,5,30,5,0,0,5,0,30,2,2,0,4,1,-15,3,1
2,3,5,1,30,5,7,0,12,2,30,9,1,0,10,0,30,4,8,0,12,0,30,7,5,0,12,1,30,2,4,0,6,0,-27,3,0
2,3,17,1,30,2,2,0,4,0,30,2,0,0,2,2,30,1,3,0,4,2,30,1,3,0,4,4,30,1,0,0,1,1,-15,3,1
2,4,14,0,30,7,2,0,9,0,30,6,0,0,6,0,30,8,1,0,9,0,30,4,5,0,9,0,30,4,0,0,4,1,-15,3,1
2,2,20,0,30,1,7,0,8,0,30,7,1,0,8,0,30,5,3,0,8,0,30,5,3,0,8,0,30,2,3,0,5,1,-15,3,1
2,3,21,0,30,2,1,0,3,0,30,2,0,0,2,0,30,3,0,0,3,0,30,0,3,0,3,1,30,1,0,0,1,1,-15,3,1
2,4,32,0,30,4,5,0,9,4,30,2,0,0,2,5,30,9,0,0,9,1,30,3,6,0,9,2,30,2,0,0,2,1,-15,3,1
2,2,13,1,30,3,0,0,3,0,30,2,0,0,2,0,30,3,0,0,3,4,30,1,2,0,3,2,30,2,0,0,2,1,-15,3,1
2,1,17,6,30,2,2,0,4,1,30,2,0,0,2,3,30,1,3,0,4,2,30,0,4,0,4,4,30,1,0,0,1,1,-15,3,1
2,3,9,0,30,5,6,0,11,2,30,5,1,0,6,2,30,7,4,0,11,1,30,3,8,0,11,2,30,4,0,0,4,0,-27,3,0
2,3,28,0,30,2,6,0,8,3,30,4,0,0,4,2,30,6,2,0,8,0,30,2,6,0,8,0,30,2,2,0,4,1,-15,3,1
2,4,30,2,30,3,2,0,5,3,30,2,0,0,2,1,30,2,3,0,5,3,30,1,4,0,5,2,30,3,0,0,3,1,-15,3,1
2,4,11,0,30,1,3,0,4,0,30,0,0,0,0,3,30,4,0,0,4,1,30,2,2,0,4,0,30,1,0,0,1,1,-15,3,1
2,2,24,0,30,3,3,0,6,2,30,4,0,0,4,4,30,4,2,0,6,0,30,1,5,0,6,1,30,4,0,0,4,1,-15,3,1
2,1,31,3,30,5,7,0,12,4,30,8,0,0,8,5,30,12,0,0,12,0,30,3,9,0,12,0,30,3,3,0,6,1,-15,3,1
2,4,17,1,30,0,4,0,4,0,30,2,0,0,2,1,30,0,4,0,4,2,30,1,3,0,4,4,30,1,0,0,1,1,-15,3,1
2,2,5,0,30,4,8,0,12,1,30,5,5,0,10,0,30,6,6,0,12,0,30,8,4,0,12,1,30,2,4,0,6,0,-27,3,0
2,3,16,0,30,4,5,0,9,1,30,7,1,0,8,0,30,2,7,0,9,0,30,1,8,0,9,0,30,4,0,0,4,1,-15,3,1
2,2,5,1,30,4,8,0,12,2,30,3,7,0,10,0,30,5,7,0,12,2,30,8,4,0,12,2,30,4,2,0,6,0,-27,3,0
2,2,31,0,30,1,3,0,4,0,30,4,0,0,4,3,30,4,0,0,4,0,30,3,1,0,4,0,30,3,0,0,3,1,-15,3,1
2,4,7,1,30,4,5,0,9,0,30,4,0,0,4,5,30,6,3,0,9,4,30,2,7,0,9,2,30,5,1,0,6,0,-27,3,0
2,4,24,0,30,6,0,0,6,0,30,4,0,0,4,0,30,6,0,0,6,0,30,1,5,0,6,0,30,4,0,0,4,1,-15,3,1
2,3,7,0,30,2,2,0,4,1,30,2,0,0,2,1,30,4,0,0,4,0,30,1,3,0,4,3,30,2,0,0,2,0,-27,3,0
2,3,13,1,30,3,0,0,3,0,30,2,0,0,2,6,30,3,0,0,3,0,30,3,0,0,3,3,30,2,0,0,2,1,-15,3,1
2,4,31,0,30,0,4,0,4,3,30,4,0,0,4,0,30,3,1,0,4,2,30,1,3,0,4,2,30,3,0,0,3,1,-15,3,1
2,2,17,2,30,1,3,0,4,1,30,2,0,0,2,3,30,0,4,0,4,2,30,1,3,0,4,2,30,1,0,0,1,1,-15,3,1
2,3,14,0,30,6,3,0,9,0,30,6,0,0,6,4,30,8,1,0,9,0,30,6,3,0,9,3,30,4,0,0,4,1,-15,3,1
2,4,25,2,30,1,3,0,4,2,30,2,0,0,2,3,30,4,0,0,4,0,30,0,4,0,4,0,30,1,0,0,1,1,-15,3,1
2,1,9,4,30,2,2,0,4,2,30,2,0,0,2,4,30,1,3,0,4,0,30,1,3,0,4,2,30,1,0,0,1,0,-27,3,0
2,3,31,0,30,0,4,0,4,3,30,4,0,0,4,2,30,3,1,0,4,2,30,1,3,0,4,2,30,3,0,0,3,1,-15,3,1
2,1,24,0,30,5,1,0,6,2,30,3,1,0,4,4,30,2,4,0,6,0,30,1,5,0,6,1,30,4,0,0,4,1,-15,3,1
2,3,25,2,30,0,4,0,4,2,30,2,0,0,2,0,30,4,0,0,4,0,30,1,3,0,4,0,30,1,0,0,1,1,-15,3,1
2,4,17,1,30,2,2,0,4,0,30,2,0,0,2,2,30,4,0,0,4,2,30,1,3,0,4,4,30,1,0,0,1,1,-15,3,1
2,4,4,8,30,8,0,0,8,0,30,4,0,0,4,1,30,3,5,0,8,0,30,0,8,0,8,1,30,4,0,0,4,0,-27,3,0
2,4,7,0,30,3,1,0,4,2,30,2,0,0,2,1,30,3,1,0,4,0,30,1,3,0,4,1,30,2,0,0,2,0,-27,3,0
2,3,9,0,30,1,3,0,4,2,30,2,0,0,2,4,30,2,2,0,4,0,30,1,3,0,4,0,30,1,0,0,1,0,-27,3,0
2,4,8,1,30,7,0,0,7,3,30,2,0,0,2,6,30,4,3,0,7,0,30,7,0,0,7,2,30,3,0,0,3,0,-27,3,0
2,3,17,1,30,1,3,0,4,0,30,2,0,0,2,1,30,1,3,0,4,0,30,1,3,0,4,2,30,1,0,0,1,1,-15,3,1
2,4,25,2,30,1,3,0,4,2,30,2,0,0,2,1,30,1,3,0,4,0,30,0,4,0,4,3,30,1,0,0,1,1,-15,3,1
2,3,23,0,30,2,3,0,5,2,30,4,0,0,4,7,30,5,0,0,5,0,30,0,5,0,5,3,30,2,0,0,2,1,-15,3,1
2,2,5,2,30,6,6,0,12,3,30,9,1,0,10,0,30,6,6,0,12,0,30,8,4,0,12,1,30,5,1,0,6,0,-27,3,0
2,1,37,3,30,3,8,0,11,4,30,8,0,0,8,4,30,11,0,0,11,0,30,3,8,0,11,2,30,3,3,0,6,1,-15,3,1
2,3,31,0,30,1,3,0,4,2,30,4,0,0,4,2,30,1,3,0,4,0,30,1,3,0,4,0,30,2,1,0,3,1,-15,3,1
2,2,17,2,30,1,3,0,4,0,30,2,0,0,2,1,30,1,3,0,4,2,30,1,3,0,4,3,30,1,0,0,1,1,-15,3,1
2,2,24,0,30,4,2,0,6,2,30,3,1,0,4,2,30,6,0,0,6,0,30,1,5,0,6,1,30,4,0,0,4,1,-15,3,1
2,4,7,0,30,2,7,0,9,1,30,4,0,0,4,2,30,7,2,0,9,5,30,3,6,0,9,4,30,6,0,0,6,0,-27,3,0
2,4,21,3,30,3,0,0,3,2,30,2,0,0,2,3,30,2,1,0,3,0,30,1,2,0,3,0,30,1,0,0,1,1,-15,3,1
2,4,31,0,30,0,4,0,4,3,30,4,0,0,4,1,30,2,2,0,4,0,30,1,3,0,4,1,30,3,0,0,3,1,-15,3,1
2,3,17,1,30,1,3,0,4,1,30,2,0,0,2,1,30,0,4,0,4,3,30,2,2,0,4,2,30,1,0,0,1,1,-15,3,1
2,1,28,0,30,0,8,0,8,3,30,4,0,0,4,1,30,6,2,0,8,0,30,5,3,0,8,2,30,3,1,0,4,1,-15,3,1
2,4,25,2,30,1,3,0,4,2,30,2,0,0,2,0,30,3,1,0,4,5,30,1,3,0,4,1,30,1,0,0,1,1,-15,3,1
2,2,31,0,30,0,4,0,4,3,30,4,0,0,4,3,30,4,0,0,4,0,30,1,3,0,4,1,30,3,0,0,3,1,-15,3,1
2,4,25,0,30,0,4,0,4,2,30,2,0,0,2,6,30,4,0,0,4,0,30,0,4,0,4,0,30,1,0,0,1,1,-15,3,1
2,4,24,0,30,3,3,0,6,2,30,4,0,0,4,7,30,5,1,0,6,0,30,4,2,0,6,4,30,4,0,0,4,1,-15,3,1
2,1,31,0,30,0,4,0,4,2,30,4,0,0,4,6,30,3,1,0,4,0,30,1,3,0,4,0,30,3,0,0,3,1,-15,3,1
2,1,31,0,30,0,4,0,4,2,30,4,0,0,4,2,30,4,0,0,4,0,30,1,3,0,4,2,30,3,0,0,3,1,-15,3,1
2,3,27,0,30,2,3,0,5,2,30,0,0,0,0,4,30,2,3,0,5,0,30,1,4,0,5,1,30,4,0,0,4,1,-15,3,1
2,4,27,0,30,4,1,0,5,1,30,0,0,0,0,1,30,5,0,0,5,0,30,2,3,0,5,1,30,4,0,0,4,1,-15,3,1
2,4,31,0,30,0,4,0,4,1,30,4,0,0,4,4,30,4,0,0,4,0,30,1,3,0,4,2,30,3,0,0,3,1,-15,3,1
2,4,29,0,30,3,2,0,5,3,30,8,0,0,8,0,30,2,3,0,5,0,30,0,5,0,5,1,30,4,0,0,4,1,-15,3,1
2,2,24,0,30,6,0,0,6,2,30,3,1,0,4,4,30,4,2,0,6,0,30,1,5,0,6,3,30,4,0,0,4,1,-15,3,1
2,4,24,0,30,3,3,0,6,1,30,4,0,0,4,0,30,5,1,0,6,0,30,1,5,0,6,0,30,3,1,0,4,1,-15,3,1
2,2,9,0,30,1,3,0,4,2,30,2,0,0,2,2,30,2,2,0,4,0,30,1,3,0,4,1,30,1,0,0,1,0,-27,3,0
2,4,21,3,30,6,4,0,10,2,30,6,0,0,6,1,30,9,1,0,10,0,30,5,5,0,10,0,30,4,0,0,4,1,-15,3,1
2,1,5,1,30,6,6,0,12,2,30,8,2,0,10,0,30,6,6,0,12,0,30,7,5,0,12,1,30,2,4,0,6,0,-27,3,0
2,4,13,3,30,7,0,0,7,1,30,4,0,0,4,4,30,6,1,0,7,0,30,6,1,0,7,1,30,4,0,0,4,1,-15,3,1
2,4,11,0,30,1,3,0,4,0,30,0,0,0,0,4,30,4,0,0,4,0,30,3,1,0,4,0,30,1,0,0,1,1,-15,3,1
2,4,5,1,30,6,6,0,12,2,30,8,2,0,10,0,30,6,6,0,12,0,30,8,4,0,12,0,30,2,4,0,6,0,-27,3,0
2,4,9,0,30,7,4,0,11,2,30,6,0,0,6,8,30,8,3,0,11,1,30,3,8,0,11,2,30,2,2,0,4,0,-27,3,0
2,4,17,0,30,2,2,0,4,0,30,2,0,0,2,1,30,1,3,0,4,2,30,1,3,0,4,3,30,1,0,0,1,1,-15,3,1
2,0,4,2,30,5,3,0,8,4,30,4,0,0,4,3,30,3,5,0,8,0,30,4,4,0,8,2,30,4,0,0,4,0,-27,3,0
2,4,17,1,30,1,3,0,4,0,30,2,0,0,2,0,30,2,2,0,4,2,30,1,3,0,4,3,30,1,0,0,1,1,-15,3,1
2,3,9,0,30,2,2,0,4,1,30,2,0,0,2,7,30,4,0,0,4,0,30,0,4,0,4,0,30,1,0,0,1,0,-27,3,0
2,2,20,0,30,1,7,0,8,1,30,7,1,0,8,0,30,6,2,0,8,2,30,6,2,0,8,1,30,1,4,0,5,1,-15,3,1
2,3,7,0,30,4,5,0,9,1,30,4,0,0,4,0,30,8,1,0,9,6,30,3,6,0,9,1,30,6,0,0,6,0,-27,3,0
2,3,29,0,30,2,3,0,5,3,30,8,0,0,8,0,30,3,2,0,5,0,30,1,4,0,5,0,30,4,0,0,4,1,-15,3,1
2,4,5,1,30,6,6,0,12,2,30,7,3,0,10,2,30,5,7,0,12,0,30,7,5,0,12,1,30,3,3,0,6,0,-27,3,0
2,4,32,0,30,2,7,0,9,3,30,2,0,0,2,0,30,9,0,0,9,1,30,3,6,0,9,3,30,2,0,0,2,1,-15,3,1
2,2,16,0,30,7,2,0,9,1,30,8,0,0,8,0,30,3,6,0,9,0,30,0,9,0,9,2,30,4,0,0,4,1,-15,3,1
2,4,17,2,30,1,3,0,4,0,30,2,0,0,2,0,30,1,3,0,4,2,30,1,3,0,4,2,30,1,0,0,1,1,-15,3,1
2,2,31,0,30,1,3,0,4,2,30,4,0,0,4,0,30,3,1,0,4,0,30,1,3,0,4,0,30,3,0,0,3,1,-15,3,1
2,1,31,0,30,0,4,0,4,3,30,4,0,0,4,1,30,2,2,0,4,0,30,1,3,0,4,0,30,1,2,0,3,1,-15,3,1
2,4,24,0,30,5,1,0,6,2,30,4,0,0,4,0,30,5,1,0,6,0,30,1,5,0,6,3,30,4,0,0,4,1,-15,3,1
2,1,5,0,30,1,4,0,5,2,30,2,2,0,4,0,30,3,2,0,5,0,30,1,4,0,5,1,30,1,1,0,2,0,-27,3,0
2,1,24,0,30,5,1,0,6,2,30,3,1,0,4,0,30,3,3,0,6,2,30,1,5,0,6,2,30,4,0,0,4,1,-15,3,1
2,3,5,0,30,2,3,0,5,2,30,2,2,0,4,0,30,4,1,0,5,0,30,1,4,0,5,2,30,1,1,0,2,0,-27,3,0
2,4,5,1,30,6,6,0,12,3,30,7,3,0,10,4,30,5,7,0,12,0,30,7,5,0,12,1,30,1,5,0,6,0,-27,3,0
2,4,9,1,30,4,7,0,11,1,30,6,0,0,6,1,30,10,1,0,11,0,30,5,6,0,11,4,30,4,0,0,4,0,-27,3,0
2,4,21,2,30,3,0,0,3,0,30,2,0,0,2,0,30,2,1,0,3,0,30,0,3,0,3,3,30,1,0,0,1,1,-15,3,1
2,4,9,0,30,5,6,0,11,1,30,6,0,0,6,2,30,11,0,0,11,4,30,2,9,0,11,3,30,4,0,0,4,0,-27,3,0
2,4,8,1,30,7,0,0,7,3,30,2,0,0,2,4,30,7,0,0,7,0,30,5,2,0,7,1,30,3,0,0,3,0,-27,3,0
2,3,9,0,30,2,2,0,4,2,30,2,0,0,2,2,30,1,3,0,4,0,30,2,2,0,4,1,30,1,0,0,1,0,-27,3,0
2,3,24,0,30,3,3,0,6,2,30,4,0,0,4,3,30,6,0,0,6,0,30,1,5,0,6,2,30,4,0,0,4,1,-15,3,1
2,1,31,2,30,1,3,0,4,4,30,4,0,0,4,4,30,1,3,0,4,0,30,1,3,0,4,0,30,1,2,0,3,1,-15,3,1
2,3,31,0,30,0,4,0,4,3,30,4,0,0,4,3,30,2,2,0,4,0,30,3,1,0,4,1,30,3,0,0,3,1,-15,3,1
2,4,16,0,30,7,2,0,9,1,30,8,0,0,8,3,30,3,6,0,9,0,30,0,9,0,9,0,30,2,2,0,4,1,-15,3,1
2,3,32,0,30,3,6,0,9,3,30,2,0,0,2,1,30,9,0,0,9,1,30,3,6,0,9,3,30,2,0,0,2,1,-15,3,1
2,4,7,1,30,4,0,0,4,2,30,2,0,0,2,2,30,2,2,0,4,0,30,1,3,0,4,1,30,1,1,0,2,0,-27,3,0
2,2,31,0,30,0,4,0,4,3,30,4,0,0,4,0,30,1,3,0,4,0,30,3,1,0,4,0,30,3,0,0,3,1,-15,3,1
2,3,3,7,30,5,6,0,11,3,30,7,1,0,8,0,30,5,6,0,11,4,30,3,8,0,11,0,30,2,5,0,7,0,-27,3,0
2,3,9,0,30,6,5,0,11,2,30,6,0,0,6,4,30,9,2,0,11,0,30,3,8,0,11,1,30,3,1,0,4,0,-27,3,0
2,4,17,1,30,1,3,0,4,0,30,2,0,0,2,4,30,1,3,0,4,0,30,0,4,0,4,5,30,1,0,0,1,1,-15,3,1
2,4,15,3,30,4,0,0,4,0,30,5,1,0,6,0,30,4,0,0,4,1,30,1,3,0,4,0,30,3,1,0,4,1,-15,3,1
2,4,23,0,30,2,3,0,5,2,30,4,0,0,4,5,30,5,0,0,5,0,30,0,5,0,5,1,30,2,0,0,2,1,-15,3,1
2,3,28,0,30,1,7,0,8,4,30,4,0,0,4,0,30,1,7,0,8,0,30,3,5,0,8,2,30,4,0,0,4,1,-15,3,1
2,4,32,0,30,2,7,0,9,4,30,2,0,0,2,4,30,8,1,0,9,1,30,3,6,0,9,3,30,2,0,0,2,1,-15,3,1
2,2,23,0,30,2,3,0,5,2,30,4,0,0,4,6,30,5,0,0,5,0,30,0,5,0,5,4,30,2,0,0,2,1,-15,3,1
2,4,13,2,30,3,0,0,3,0,30,2,0,0,2,0,30,3,0,0,3,3,30,2,1,0,3,3,30,2,0,0,2,1,-15,3,1
2,3,24,0,30,2,4,0,6,1,30,4,0,0,4,0,30,6,0,0,6,0,30,6,0,0,6,2,30,4,0,0,4,1,-15,3,1
2,3,31,2,30,4,0,0,4,4,30,4,0,0,4,2,30,1,3,0,4,0,30,1,3,0,4,0,30,1,2,0,3,1,-15,3,1
2,3,23,0,30,2,3,0,5,2,30,4,0,0,4,3,30,3,2,0,5,0,30,1,4,0,5,2,30,2,0,0,2,1,-15,3,1
2,4,9,0,30,7,4,0,11,1,30,6,0,0,6,1,30,11,0,0,11,1,30,3,8,0,11,2,30,2,2,0,4,0,-27,3,0
2,3,23,0,30,2,3,0,5,2,30,4,0,0,4,9,30,5,0,0,5,0,30,0,5,0,5,0,30,1,1,0,2,1,-15,3,1
2,2,31,0,30,4,0,0,4,4,30,4,0,0,4,0,30,1,3,0,4,0,30,1,3,0,4,0,30,1,2,0,3,1,-15,3,1
2,3,25,2,30,1,3,0,4,2,30,2,0,0,2,0,30,2,2,0,4,0,30,0,4,0,4,0,30,1,0,0,1,1,-15,3,1
2,3,4,2,30,8,0,0,8,3,30,4,0,0,4,1,30,8,0,0,8,0,30,4,4,0,8,1,30,3,1,0,4,0,-27,3,0
2,4,23,0,30,2,3,0,5,1,30,4,0,0,4,0,30,3,2,0,5,0,30,1,4,0,5,0,30,1,1,0,2,1,-15,3,1
2,4,3,0,30,4,7,0,11,0,30,8,0,0,8,0,30,7,4,0,11,4,30,0,11,0,11,1,30,2,5,0,7,0,-27,3,0
2,4,25,1,30,0,4,0,4,0,30,2,0,0,2,8,30,4,0,0,4,0,30,0,4,0,4,0,30,0,1,0,1,1,-15,3,1
2,4,9,0,30,0,4,0,4,1,30,2,0,0,2,3,30,4,0,0,4,0,30,4,0,0,4,3,30,1,0,0,1,0,-27,3,0
2,3,31,0,30,0,4,0,4,2,30,4,0,0,4,0,30,4,0,0,4,0,30,1,3,0,4,0,30,2,1,0,3,1,-15,3,1
2,2,9,0,30,1,3,0,4,1,30,2,0,0,2,5,30,4,0,0,4,0,30,1,3,0,4,1,30,1,0,0,1,0,-27,3,0
2,4,23,0,30,2,3,0,5,1,30,4,0,0,4,6,30,5,0,0,5,0,30,0,5,0,5,0,30,1,1,0,2,1,-15,3,1
2,3,15,0,30,4,0,0,4,0,30,6,0,0,6,0,30,2,2,0,4,2,30,1,3,0,4,0,30,2,2,0,4,1,-15,3,1
2,3,23,0,30,2,3,0,5,1,30,4,0,0,4,4,30,5,0,0,5,0,30,0,5,0,5,1,30,1,1,0,2,1,-15,3,1
2,3,5,1,30,7,5,0,12,0,30,7,3,0,10,0,30,10,2,0,12,0,30,8,4,0,12,2,30,4,2,0,6,0,-27,3,0
2,3,31,0,30,1,3,0,4,3,30,4,0,0,4,5,30,4,0,0,4,0,30,1,3,0,4,0,30,1,2,0,3,1,-15,3,1
2,1,5,1,30,6,6,0,12,2,30,6,4,0,10,0,30,6,6,0,12,0,30,7,5,0,12,1,30,3,3,0,6,0,-27,3,0
2,3,9,0,30,1,3,0,4,2,30,2,0,0,2,2,30,2,2,0,4,0,30,1,3,0,4,1,30,1,0,0,1,0,-27,3,0
2,2,25,1,30,1,3,0,4,1,30,2,0,0,2,0,30,2,2,0,4,0,30,0,4,0,4,2,30,1,0,0,1,1,-15,3,1
2,2,23,0,30,1,4,0,5,1,30,4,0,0,4,3,30,5,0,0,5,0,30,0,5,0,5,1,30,2,0,0,2,1,-15,3,1
2,2,3,1,30,5,6,0,11,1,30,8,0,0,8,0,30,6,5,0,11,4,30,1,10,0,11,1,30,4,3,0,7,0,-27,3,0
2,2,31,0,30,1,3,0,4,2,30,4,0,0,4,2,30,3,1,0,4,0,30,1,3,0,4,0,30,3,0,0,3,1,-15,3,1
2,4,25,2,30,1,3,0,4,2,30,2,0,0,2,3,30,4,0,0,4,0,30,0,4,0,4,1,30,1,0,0,1,1,-15,3,1
2,4,4,2,30,7,1,0,8,0,30,4,0,0,4,0,30,6,2,0,8,0,30,4,4,0,8,2,30,3,1,0,4,0,-27,3,0
2,4,32,0,30,3,6,0,9,4,30,2,0,0,2,1,30,8,1,0,9,1,30,3,6,0,9,5,30,2,0,0,2,1,-15,3,1
2,4,30,2,30,3,2,0,5,3,30,2,0,0,2,2,30,2,3,0,5,3,30,1,4,0,5,2,30,2,1,0,3,1,-15,3,1
2,4,7,0,30,2,7,0,9,0,30,4,0,0,4,0,30,8,1,0,9,0,30,2,7,0,9,2,30,4,2,0,6,0,-27,3,0
2,4,31,0,30,0,4,0,4,1,30,4,0,0,4,4,30,4,0,0,4,3,30,3,1,0,4,4,30,3,0,0,3,1,-15,3,1
2,4,30,2,30,3,2,0,5,4,30,2,0,0,2,3,30,2,3,0,5,3,30,2,3,0,5,0,30,2,1,0,3,1,-15,3,1
2,4,23,0,30,1,4,0,5,1,30,4,0,0,4,3,30,4,1,0,5,0,30,0,5,0,5,3,30,2,0,0,2,1,-15,3,1
2,4,24,0,30,5,1,0,6,1,30,4,0,0,4,0,30,5,1,0,6,0,30,2,4,0,6,1,30,4,0,0,4,1,-15,3,1
2,4,31,2,30,0,4,0,4,3,30,4,0,0,4,2,30,4,0,0,4,0,30,1,3,0,4,0,30,0,3,0,3,1,-15,3,1
2,3,16,0,30,4,5,0,9,2,30,8,0,0,8,3,30,2,7,0,9,0,30,3,6,0,9,0,30,4,0,0,4,1,-15,3,1
2,4,17,1,30,1,3,0,4,0,30,2,0,0,2,1,30,0,4,0,4,0,30,1,3,0,4,4,30,1,0,0,1,1,-15,3,1
2,3,25,1,30,0,4,0,4,1,30,2,0,0,2,0,30,4,0,0,4,2,30,0,4,0,4,2,30,1,0,0,1,1,-15,3,1
2,1,4,4,30,8,0,0,8,2,30,4,0,0,4,0,30,7,1,0,8,0,30,0,8,0,8,1,30,4,0,0,4,0,-27,3,0
2,4,23,0,30,3,2,0,5,0,30,4,0,0,4,3,30,3,2,0,5,0,30,0,5,0,5,4,30,2,0,0,2,1,-15,3,1
2,4,25,1,30,2,2,0,4,2,30,2,0,0,2,1,30,4,0,0,4,0,30,0,4,0,4,0,30,1,0,0,1,1,-15,3,1
2,1,23,0,30,2,3,0,5,1,30,4,0,0,4,7,30,5,0,0,5,0,30,0,5,0,5,4,30,2,0,0,2,1,-15,3,1
2,3,25,1,30,1,3,0,4,2,30,2,0,0,2,3,30,4,0,0,4,0,30,0,4,0,4,3,30,1,0,0,1,1,-15,3,1
2,4,3,0,30,5,6,0,11,2,30,8,0,0,8,1,30,4,7,0,11,1,30,3,8,0,11,1,30,2,5,0,7,0,-27,3,0
2,3,7,0,30,1,3,0,4,1,30,2,0,0,2,1,30,3,1,0,4,0,30,1,3,0,4,2,30,1,1,0,2,0,-27,3,0
2,3,16,0,30,7,2,0,9,1,30,8,0,0,8,0,30,3,6,0,9,0,30,0,9,0,9,0,30,3,1,0,4,1,-15,3,1
2,4,31,0,30,0,4,0,4,2,30,4,0,0,4,3,30,2,2,0,4,0,30,1,3,0,4,0,30,3,0,0,3,1,-15,3,1
2,3,13,1,30,6,1,0,7,0,30,4,0,0,4,3,30,7,0,0,7,3,30,3,4,0,7,3,30,4,0,0,4,1,-15,3,1
2,4,24,0,30,2,4,0,6,0,30,4,0,0,4,4,30,6,0,0,6,0,30,2,4,0,6,2,30,4,0,0,4,1,-15,3,1
2,2,9,0,30,1,3,0,4,1,30,2,0,0,2,4,30,3,1,0,4,0,30,1,3,0,4,0,30,1,0,0,1,0,-27,3,0
2,3,23,0,30,2,3,0,5,1,30,4,0,0,4,1,30,5,0,0,5,0,30,0,5,0,5,3,30,2,0,0,2,1,-15,3,1
2,4,7,0,30,2,2,0,4,1,30,2,0,0,2,1,30,3,1,0,4,0,30,1,3,0,4,1,30,2,0,0,2,0,-27,3,0
2,4,2,0,30,7,3,0,10,3,30,4,0,0,4,5,30,6,4,0,10,0,30,5,5,0,10,3,30,8,0,0,8,0,-27,3,0
2,4,24,0,30,5,1,0,6,2,30,3,1,0,4,4,30,3,3,0,6,0,30,1,5,0,6,2,30,4,0,0,4,1,-15,3,1
2,4,28,0,30,2,6,0,8,5,30,4,0,0,4,4,30,1,7,0,8,0,30,6,2,0,8,0,30,4,0,0,4,1,-15,3,1
2,4,31,2,30,7,5,0,12,3,30,8,0,0,8,8,30,11,1,0,12,0,30,3,9,0,12,1,30,1,5,0,6,1,-15,3,1
2,2,9,0,30,1,3,0,4,1,30,2,0,0,2,5,30,4,0,0,4,1,30,2,2,0,4,1,30,1,0,0,1,0,-27,3,0
2,2,20,0,30,2,6,0,8,0,30,7,1,0,8,0,30,6,2,0,8,0,30,5,3,0,8,1,30,5,0,0,5,1,-15,3,1
2,4,31,1,30,2,2,0,4,3,30,4,0,0,4,0,30,2,2,0,4,0,30,1,3,0,4,0,30,0,3,0,3,1,-15,3,1
2,3,24,1,30,6,0,0,6,2,30,4,0,0,4,0,30,3,3,0,6,0,30,1,5,0,6,3,30,4,0,0,4,1,-15,3,1
2,4,27,4,30,2,3,0,5,2,30,0,0,0,0,2,30,5,0,0,5,0,30,3,2,0,5,3,30,4,0,0,4,1,-15,3,1
2,2,27,4,30,2,3,0,5,2,30,0,0,0,0,2,30,5,0,0,5,0,30,3,2,0,5,3,30,4,0,0,4,1,-15,3,1
2,0,5,1,30,7,5,0,12,2,30,4,6,0,10,0,30,5,7,0,12,0,30,6,6,0,12,3,30,1,5,0,6,0,-27,3,0
2,4,3,2,30,4,7,0,11,2,30,8,0,0,8,8,30,6,5,0,11,7,30,2,9,0,11,0,30,2,5,0,7,0,-27,3,0
2,4,7,1,30,4,5,0,9,2,30,4,0,0,4,3,30,6,3,0,9,5,30,3,6,0,9,1,30,3,3,0,6,0,-27,3,0
2,3,31,0,30,0,4,0,4,3,30,4,0,0,4,6,30,3,1,0,4,0,30,1,3,0,4,0,30,2,1,0,3,1,-15,3,1
2,4,25,1,30,4,0,0,4,0,30,2,0,0,2,3,30,4,0,0,4,0,30,0,4,0,4,0,30,1,0,0,1,1,-15,3,1
2,3,9,1,30,7,4,0,11,2,30,6,0,0,6,4,30,9,2,0,11,1,30,3,8,0,11,3,30,4,0,0,4,0,-27,3,0
2,4,17,1,30,1,3,0,4,1,30,2,0,0,2,2,30,1,3,0,4,2,30,1,3,0,4,2,30,1,0,0,1,1,-15,3,1
2,4,7,0,30,5,4,0,9,2,30,3,1,0,4,5,30,6,3,0,9,2,30,2,7,0,9,1,30,6,0,0,6,0,-27,3,0
2,3,31,2,30,2,2,0,4,3,30,4,0,0,4,4,30,4,0,0,4,0,30,1,3,0,4,0,30,2,1,0,3,1,-15,3,1
2,3,9,1,30,6,5,0,11,1,30,6,0,0,6,3,30,11,0,0,11,1,30,4,7,0,11,0,30,3,1,0,4,0,-27,3,0
2,4,9,0,30,7,4,0,11,2,30,6,0,0,6,3,30,10,1,0,11,2,30,3,8,0,11,2,30,3,1,0,4,0,-27,3,0
2,1,9,0,30,3,1,0,4,1,30,2,0,0,2,5,30,4,0,0,4,0,30,1,3,0,4,1,30,1,0,0,1,0,-27,3,0
2,3,16,0,30,6,3,0,9,0,30,8,0,0,8,2,30,6,3,0,9,0,30,1,8,0,9,1,30,4,0,0,4,1,-15,3,1
2,3,5,1,30,6,6,0,12,2,30,8,2,0,10,0,30,3,9,0,12,0,30,6,6,0,12,1,30,3,3,0,6,0,-27,3,0
2,4,24,0,30,2,4,0,6,2,30,3,1,0,4,10,30,6,0,0,6,0,30,1,5,0,6,4,30,4,0,0,4,1,-15,3,1
2,1,13,2,30,5,2,0,7,1,30,4,0,0,4,2,30,6,1,0,7,2,30,6,1,0,7,4,30,4,0,0,4,1,-15,3,1
2,4,17,1,30,1,3,0,4,0,30,2,0,0,2,2,30,0,4,0,4,2,30,1,3,0,4,0,30,1,0,0,1,1,-15,3,1
2,3,7,0,30,5,4,0,9,0,30,4,0,0,4,0,30,8,1,0,9,0,30,2,7,0,9,1,30,5,1,0,6,0,-27,3,0
2,1,13,4,30,5,2,0,7,0,30,4,0,0,4,2,30,7,0,0,7,2,30,6,1,0,7,4,30,4,0,0,4,1,-15,3,1
2,1,5,1,30,6,6,0,12,2,30,5,5,0,10,1,30,4,8,0,12,0,30,9,3,0,12,4,30,2,4,0,6,0,-27,3,0
2,4,4,3,30,8,0,0,8,3,30,4,0,0,4,0,30,6,2,0,8,0,30,4,4,0,8,1,30,3,1,0,4,0,-27,3,0
2,3,2,0,30,6,4,0,10,3,30,4,0,0,4,4,30,5,5,0,10,0,30,8,2,0,10,1,30,8,0,0,8,0,-27,3,0
2,2,4,2,30,8,0,0,8,3,30,4,0,0,4,1,30,6,2,0,8,0,30,4,4,0,8,1,30,4,0,0,4,0,-27,3,0
2,3,3,4,30,3,8,0,11,1,30,8,0,0,8,1,30,11,0,0,11,4,30,3,8,0,11,0,30,2,5,0,7,0,-27,3,0
2,2,9,0,30,4,7,0,11,3,30,6,0,0,6,5,30,6,5,0,11,6,30,4,7,0,11,4,30,4,0,0,4,0,-27,3,0
2,4,7,0,30,3,1,0,4,1,30,2,0,0,2,0,30,4,0,0,4,0,30,1,3,0,4,1,30,2,0,0,2,0,-27,3,0
2,3,16,1,30,5,4,0,9,1,30,8,0,0,8,0,30,3,6,0,9,0,30,2,7,0,9,0,30,4,0,0,4,1,-15,3,1
2,4,24,0,30,3,3,0,6,2,30,4,0,0,4,4,30,6,0,0,6,2,30,2,4,0,6,1,30,4,0,0,4,1,-15,3,1
2,0,26,0,30,4,5,0,9,4,30,4,0,0,4,9,30,2,7,0,9,0,30,4,5,0,9,4,30,3,0,0,3,1,-15,3,1
2,4,9,6,30,2,2,0,4,2,30,2,0,0,2,0,30,4,0,0,4,0,30,1,3,0,4,2,30,1,0,0,1,0,-27,3,0
2,2,23,0,30,3,2,0,5,1,30,4,0,0,4,3,30,3,2,0,5,0,30,3,2,0,5,1,30,2,0,0,2,1,-15,3,1
2,4,9,0,30,2,2,0,4,1,30,2,0,0,2,8,30,4,0,0,4,0,30,0,4,0,4,2,30,1,0,0,1,0,-27,3,0
2,4,30,2,30,2,3,0,5,4,30,2,0,0,2,1,30,2,3,0,5,2,30,2,3,0,5,0,30,3,0,0,3,1,-15,3,1
2,4,23,0,30,3,2,0,5,1,30,4,0,0,4,3,30,5,0,0,5,0,30,0,5,0,5,0,30,1,1,0,2,1,-15,3,1
2,3,24,0,30,4,2,0,6,2,30,4,0,0,4,7,30,4,2,0,6,0,30,3,3,0,6,1,30,4,0,0,4,1,-15,3,1
2,4,30,2,30,3,2,0,5,3,30,2,0,0,2,2,30,2,3,0,5,3,30,1,4,0,5,1,30,2,1,0,3,1,-15,3,1
2,3,5,0,30,2,3,0,5,0,30,4,0,0,4,0,30,0,5,0,5,0,30,1,4,0,5,0,30,0,2,0,2,0,-27,3,0
2,2,16,0,30,6,3,0,9,2,30,7,1,0,8,4,30,3,6,0,9,0,30,1,8,0,9,0,30,3,1,0,4,1,-15,3,1
2,3,24,0,30,4,2,0,6,0,30,3,1,0,4,11,30,4,2,0,6,0,30,2,4,0,6,0,30,4,0,0,4,1,-15,3,1
2,3,7,0,30,2,2,0,4,2,30,2,0,0,2,7,30,1,3,0,4,0,30,1,3,0,4,2,30,1,1,0,2,0,-27,3,0
2,3,31,0,30,0,4,0,4,3,30,4,0,0,4,1,30,1,3,0,4,1,30,2,2,0,4,0,30,3,0,0,3,1,-15,3,1
2,3,13,4,30,3,0,0,3,0,30,2,0,0,2,1,30,3,0,0,3,0,30,1,2,0,3,3,30,2,0,0,2,1,-15,3,1
2,4,25,1,30,1,3,0,4,1,30,2,0,0,2,0,30,2,2,0,4,0,30,0,4,0,4,4,30,1,0,0,1,1,-15,3,1
2,3,3,0,30,4,7,0,11,0,30,8,0,0,8,0,30,3,8,0,11,0,30,4,7,0,11,1,30,3,4,0,7,0,-27,3,0
2,2,31,0,30,2,2,0,4,2,30,4,0,0,4,3,30,2,2,0,4,2,30,3,1,0,4,1,30,3,0,0,3,1,-15,3,1
2,3,27,0,30,1,4,0,5,0,30,0,0,0,0,5,30,5,0,0,5,0,30,2,3,0,5,1,30,4,0,0,4,1,-15,3,1
2,2,31,1,30,1,3,0,4,3,30,4,0,0,4,5,30,4,0,0,4,0,30,1,3,0,4,0,30,1,2,0,3,1,-15,3,1
2,1,3,1,30,4,7,0,11,2,30,7,1,0,8,0,30,3,8,0,11,0,30,7,4,0,11,1,30,3,4,0,7,0,-27,3,0
2,3,23,0,30,2,3,0,5,2,30,4,0,0,4,0,30,1,4,0,5,0,30,4,1,0,5,1,30,2,0,0,2,1,-15,3,1
2,4,7,1,30,4,5,0,9,2,30,4,0,0,4,2,30,6,3,0,9,0,30,3,6,0,9,1,30,4,2,0,6,0,-27,3,0
2,0,23,0,30,2,3,0,5,2,30,3,1,0,4,11,30,4,1,0,5,0,30,0,5,0,5,3,30,2,0,0,2,1,-15,3,1
2,4,31,0,30,0,4,0,4,2,30,4,0,0,4,0,30,4,0,0,4,4,30,3,1,0,4,0,30,3,0,0,3,1,-15,3,1
2,4,25,2,30,1,3,0,4,2,30,2,0,0,2,2,30,4,0,0,4,0,30,0,4,0,4,1,30,1,0,0,1,1,-15,3,1
2,4,15,0,30,2,2,0,4,0,30,6,0,0,6,7,30,3,1,0,4,2,30,4,0,0,4,0,30,3,1,0,4,1,-15,3,1
2,4,27,0,30,2,3,0,5,1,30,0,0,0,0,0,30,5,0,0,5,0,30,3,2,0,5,1,30,4,0,0,4,1,-15,3,1
2,4,24,0,30,3,3,0,6,2,30,4,0,0,4,3,30,5,1,0,6,0,30,5,1,0,6,1,30,4,0,0,4,1,-15,3,1
2,3,31,0,30,0,4,0,4,2,30,4,0,0,4,2,30,3,1,0,4,0,30,1,3,0,4,1,30,3,0,0,3,1,-15,3,1
2,2,17,1,30,1,3,0,4,1,30,2,0,0,2,1,30,0,4,0,4,2,30,1,3,0,4,1,30,1,0,0,1,1,-15,3,1
2,4,25,5,30,3,1,0,4,3,30,2,0,0,2,4,30,4,0,0,4,0,30,0,4,0,4,0,30,1,0,0,1,1,-15,3,1
2,4,46,0,30,0,8,0,8,7,30,4,0,0,4,16,30,4,4,0,8,0,30,0,8,0,8,2,30,4,0,0,4,1,-15,3,1
2,4,5,1,30,4,8,0,12,2,30,8,2,0,10,3,30,8,4,0,12,0,30,8,4,0,12,2,30,3,3,0,6,0,-27,3,0
2,4,9,0,30,5,6,0,11,1,30,6,0,0,6,4,30,11,0,0,11,0,30,3,8,0,11,3,30,2,2,0,4,0,-27,3,0
2,2,13,2,30,5,2,0,7,1,30,4,0,0,4,2,30,6,1,0,7,0,30,7,0,0,7,4,30,4,0,0,4,1,-15,3,1
2,2,5,1,30,6,6,0,12,2,30,6,4,0,10,0,30,6,6,0,12,0,30,9,3,0,12,3,30,5,1,0,6,0,-27,3,0
2,3,36,0,30,1,8,0,9,4,30,2,0,0,2,6,30,6,3,0,9,1,30,1,8,0,9,5,30,3,0,0,3,1,-15,3,1
2,3,16,0,30,4,5,0,9,0,30,8,0,0,8,0,30,4,5,0,9,0,30,1,8,0,9,0,30,3,1,0,4,1,-15,3,1
2,2,31,2,30,1,3,0,4,4,30,4,0,0,4,4,30,2,2,0,4,0,30,1,3,0,4,0,30,1,2,0,3,1,-15,3,1
2,4,24,0,30,4,2,0,6,2,30,4,0,0,4,7,30,5,1,0,6,0,30,4,2,0,6,1,30,4,0,0,4,1,-15,3,1
2,4,25,3,30,1,3,0,4,2,30,2,0,0,2,2,30,4,0,0,4,0,30,0,4,0,4,0,30,1,0,0,1,1,-15,3,1
2,2,31,0,30,1,3,0,4,2,30,4,0,0,4,3,30,4,0,0,4,0,30,1,3,0,4,0,30,1,2,0,3,1,-15,3,1
2,4,3,2,30,5,6,0,11,4,30,8,0,0,8,0,30,1,10,0,11,0,30,6,5,0,11,1,30,5,2,0,7,0,-27,3,0
2,3,27,0,30,2,3,0,5,0,30,0,0,0,0,0,30,2,3,0,5,0,30,2,3,0,5,4,30,4,0,0,4,1,-15,3,1
2,3,27,0,30,2,3,0,5,2,30,0,0,0,0,6,30,5,0,0,5,0,30,2,3,0,5,0,30,3,1,0,4,1,-15,3,1
2,4,24,0,30,3,3,0,6,3,30,4,0,0,4,10,30,6,0,0,6,0,30,1,5,0,6,4,30,4,0,0,4,1,-15,3,1
2,4,7,0,30,5,4,0,9,1,30,2,2,0,4,3,30,9,0,0,9,4,30,3,6,0,9,1,30,5,1,0,6,0,-27,3,0
2,4,15,4,30,2,2,0,4,0,30,6,0,0,6,0,30,3,1,0,4,1,30,1,3,0,4,0,30,2,2,0,4,1,-15,3,1
2,3,31,0,30,0,4,0,4,3,30,4,0,0,4,3,30,2,2,0,4,1,30,4,0,0,4,2,30,3,0,0,3,1,-15,3,1
2,3,9,0,30,4,0,0,4,2,30,2,0,0,2,4,30,3,1,0,4,0,30,1,3,0,4,0,30,1,0,0,1,0,-27,3,0
2,2,25,2,30,1,3,0,4,1,30,2,0,0,2,0,30,2,2,0,4,0,30,0,4,0,4,0,30,1,0,0,1,1,-15,3,1
2,4,9,0,30,2,2,0,4,1,30,2,0,0,2,3,30,4,0,0,4,0,30,2,2,0,4,0,30,1,0,0,1,0,-27,3,0
2,4,5,1,30,6,6,0,12,2,30,7,3,0,10,0,30,6,6,0,12,0,30,7,5,0,12,2,30,5,1,0,6,0,-27,3,0
2,4,30,2,30,3,2,0,5,3,30,2,0,0,2,2,30,2,3,0,5,3,30,1,4,0,5,1,30,3,0,0,3,1,-15,3,1
2,3,9,0,30,1,3,0,4,1,30,2,0,0,2,3,30,3,1,0,4,0,30,1,3,0,4,2,30,1,0,0,1,0,-27,3,0
2,4,9,1,30,5,6,0,11,1,30,6,0,0,6,4,30,11,0,0,11,1,30,3,8,0,11,1,30,2,2,0,4,0,-27,3,0
2,2,5,0,30,2,3,0,5,2,30,0,4,0,4,2,30,4,1,0,5,0,30,1,4,0,5,0,30,0,2,0,2,0,-27,3,0
2,2,5,0,30,5,7,0,12,2,30,6,4,0,10,0,30,7,5,0,12,0,30,8,4,0,12,4,30,4,2,0,6,0,-27,3,0
2,1,17,2,30,1,3,0,4,0,30,2,0,0,2,1,30,0,4,0,4,3,30,0,4,0,4,4,30,1,0,0,1,1,-15,3,1
2,2,20,0,30,1,7,0,8,0,30,7,1,0,8,0,30,8,0,0,8,0,30,2,6,0,8,1,30,1,4,0,5,1,-15,3,1
2,2,29,1,30,1,4,0,5,4,30,8,0,0,8,0,30,2,3,0,5,0,30,0,5,0,5,2,30,4,0,0,4,1,-15,3,1
2,4,3,0,30,1,3,0,4,2,30,4,0,0,4,3,30,3,1,0,4,0,30,0,4,0,4,0,30,2,1,0,3,0,-27,3,0
2,2,26,0,30,5,4,0,9,3,30,4,0,0,4,5,30,3,6,0,9,0,30,2,7,0,9,5,30,2,1,0,3,1,-15,3,1
2,1,5,1,30,7,5,0,12,3,30,6,4,0,10,0,30,4,8,0,12,0,30,6,6,0,12,2,30,6,0,0,6,0,-27,3,0
2,3,28,0,30,2,6,0,8,4,30,4,0,0,4,2,30,3,5,0,8,0,30,7,1,0,8,0,30,4,0,0,4,1,-15,3,1
2,2,31,0,30,2,2,0,4,3,30,4,0,0,4,4,30,3,1,0,4,0,30,1,3,0,4,0,30,0,3,0,3,1,-15,3,1
2,4,9,0,30,2,2,0,4,1,30,2,0,0,2,0,30,4,0,0,4,0,30,1,3,0,4,3,30,1,0,0,1,0,-27,3,0
2,4,16,0,30,7,2,0,9,2,30,8,0,0,8,1,30,1,8,0,9,0,30,0,9,0,9,0,30,4,0,0,4,1,-15,3,1
2,4,23,0,30,2,3,0,5,2,30,4,0,0,4,3,30,3,2,0,5,0,30,4,1,0,5,1,30,1,1,0,2,1,-15,3,1
2,4,33,0,30,1,2,0,3,1,30,2,0,0,2,7,30,3,0,0,3,0,30,1,2,0,3,0,30,2,0,0,2,1,-15,3,1
2,3,5,0,30,2,3,0,5,0,30,4,0,0,4,0,30,0,5,0,5,0,30,1,4,0,5,1,30,1,1,0,2,0,-27,3,0
2,3,8,1,30,7,0,0,7,2,30,2,0,0,2,4,30,7,0,0,7,0,30,5,2,0,7,0,30,3,0,0,3,0,-27,3,0
2,2,5,1,30,8,4,0,12,2,30,5,5,0,10,4,30,7,5,0,12,0,30,8,4,0,12,1,30,0,6,0,6,0,-27,3,0
2,2,28,0,30,2,6,0,8,4,30,4,0,0,4,1,30,5,3,0,8,2,30,3,5,0,8,2,30,4,0,0,4,1,-15,3,1
2,3,7,0,30,2,7,0,9,2,30,4,0,0,4,1,30,7,2,0,9,4,30,3,6,0,9,2,30,6,0,0,6,0,-27,3,0
2,3,4,2,30,5,3,0,8,2,30,4,0,0,4,2,30,8,0,0,8,0,30,2,6,0,8,3,30,4,0,0,4,0,-27,3,0
2,4,5,1,30,4,8,0,12,2,30,4,6,0,10,0,30,7,5,0,12,0,30,7,5,0,12,1,30,5,1,0,6,0,-27,3,0
2,4,16,0,30,6,3,0,9,2,30,8,0,0,8,0,30,2,7,0,9,0,30,2,7,0,9,1,30,4,0,0,4,1,-15,3,1
2,3,31,2,30,0,4,0,4,2,30,4,0,0,4,8,30,4,0,0,4,0,30,1,3,0,4,0,30,1,2,0,3,1,-15,3,1
2,1,31,2,30,1,3,0,4,3,30,4,0,0,4,5,30,4,0,0,4,0,30,1,3,0,4,1,30,3,0,0,3,1,-15,3,1
2,3,24,0,30,6,0,0,6,2,30,3,1,0,4,6,30,6,0,0,6,0,30,4,2,0,6,0,30,4,0,0,4,1,-15,3,1
2,3,9,0,30,0,4,0,4,0,30,2,0,0,2,3,30,4,0,0,4,0,30,1,3,0,4,2,30,1,0,0,1,0,-27,3,0
2,3,16,0,30,7,2,0,9,1,30,8,0,0,8,3,30,3,6,0,9,0,30,2,7,0,9,0,30,2,2,0,4,1,-15,3,1
2,3,24,0,30,4,2,0,6,2,30,3,1,0,4,0,30,1,5,0,6,0,30,1,5,0,6,3,30,4,0,0,4,1,-15,3,1
2,4,17,1,30,2,2,0,4,1,30,2,0,0,2,3,30,1,3,0,4,2,30,1,3,0,4,1,30,1,0,0,1,1,-15,3,1
2,3,29,0,30,0,5,0,5,4,30,8,0,0,8,0,30,1,4,0,5,0,30,0,5,0,5,1,30,4,0,0,4,1,-15,3,1
2,2,5,1,30,4,8,0,12,2,30,9,1,0,10,0,30,4,8,0,12,0,30,8,4,0,12,1,30,5,1,0,6,0,-27,3,0
2,3,25,1,30,3,1,0,4,2,30,2,0,0,2,2,30,4,0,0,4,0,30,0,4,0,4,0,30,0,1,0,1,1,-15,3,1
2,2,28,0,30,0,8,0,8,5,30,4,0,0,4,0,30,1,7,0,8,0,30,7,1,0,8,5,30,4,0,0,4,1,-15,3,1
2,4,24,0,30,4,2,0,6,2,30,4,0,0,4,6,30,6,0,0,6,0,30,1,5,0,6,0,30,2,2,0,4,1,-15,3,1
2,3,25,1,30,0,4,0,4,1,30,2,0,0,2,3,30,4,0,0,4,0,30,0,4,0,4,4,30,1,0,0,1,1,-15,3,1
2,3,7,0,30,4,0,0,4,0,30,2,0,0,2,4,30,3,1,0,4,0,30,0,4,0,4,1,30,2,0,0,2,0,-27,3,0
2,3,5,1,30,6,6,0,12,3,30,9,1,0,10,0,30,4,8,0,12,0,30,7,5,0,12,1,30,4,2,0,6,0,-27,3,0
2,4,7,2,30,3,6,0,9,0,30,3,1,0,4,2,30,6,3,0,9,4,30,2,7,0,9,2,30,6,0,0,6,0,-27,3,0
2,1,31,0,30,1,3,0,4,3,30,4,0,0,4,3,30,2,2,0,4,0,30,1,3,0,4,0,30,1,2,0,3,1,-15,3,1
2,3,24,0,30,2,4,0,6,3,30,4,0,0,4,0,30,1,5,0,6,0,30,1,5,0,6,4,30,4,0,0,4,1,-15,3,1
2,3,9,1,30,5,6,0,11,1,30,6,0,0,6,7,30,10,1,0,11,1,30,3,8,0,11,4,30,2,2,0,4,0,-27,3,0
2,4,3,0,30,5,6,0,11,0,30,8,0,0,8,1,30,7,4,0,11,5,30,1,10,0,11,0,30,3,4,0,7,0,-27,3,0
2,3,27,0,30,1,4,0,5,0,30,0,0,0,0,0,30,4,1,0,5,0,30,2,3,0,5,5,30,4,0,0,4,1,-15,3,1
2,4,8,1,30,7,0,0,7,3,30,2,0,0,2,3,30,5,2,0,7,0,30,2,5,0,7,4,30,3,0,0,3,0,-27,3,0
2,3,16,3,30,6,3,0,9,2,30,7,1,0,8,0,30,1,8,0,9,0,30,0,9,0,9,1,30,4,0,0,4,1,-15,3,1
2,4,4,2,30,8,0,0,8,3,30,4,0,0,4,1,30,7,1,0,8,0,30,4,4,0,8,1,30,4,0,0,4,0,-27,3,0
2,3,25,1,30,1,3,0,4,2,30,2,0,0,2,6,30,4,0,0,4,0,30,0,4,0,4,0,30,1,0,0,1,1,-15,3,1
2,2,31,0,30,1,3,0,4,3,30,4,0,0,4,0,30,3,1,0,4,0,30,1,3,0,4,0,30,2,1,0,3,1,-15,3,1
2,2,13,1,30,3,0,0,3,0,30,2,0,0,2,1,30,3,0,0,3,6,30,3,0,0,3,3,30,2,0,0,2,1,-15,3,1
2,4,31,1,30,1,3,0,4,2,30,4,0,0,4,0,30,3,1,0,4,0,30,1,3,0,4,0,30,1,2,0,3,1,-15,3,1
2,2,9,0,30,3,1,0,4,0,30,2,0,0,2,2,30,2,2,0,4,0,30,1,3,0,4,0,30,1,0,0,1,0,-27,3,0
2,2,25,1,30,3,1,0,4,2,30,2,0,0,2,2,30,4,0,0,4,0,30,0,4,0,4,0,30,0,1,0,1,1,-15,3,1
2,3,31,1,30,1,3,0,4,3,30,4,0,0,4,0,30,2,2,0,4,0,30,1,3,0,4,0,30,2,1,0,3,1,-15,3,1
2,3,31,2,30,0,4,0,4,2,30,4,0,0,4,4,30,4,0,0,4,0,30,1,3,0,4,0,30,1,2,0,3,1,-15,3,1
2,2,31,0,30,1,3,0,4,3,30,4,0,0,4,0,30,2,2,0,4,0,30,1,3,0,4,2,30,3,0,0,3,1,-15,3,1
2,4,23,4,30,2,3,0,5,3,30,4,0,0,4,6,30,5,0,0,5,0,30,0,5,0,5,1,30,1,1,0,2,1,-15,3,1
2,4,13,1,30,3,0,0,3,0,30,2,0,0,2,0,30,2,1,0,3,3,30,3,0,0,3,3,30,2,0,0,2,1,-15,3,1
2,2,11,2,30,4,0,0,4,0,30,0,0,0,0,0,30,2,2,0,4,0,30,1,3,0,4,2,30,1,0,0,1,1,-15,3,1
2,4,9,0,30,1,3,0,4,1,30,2,0,0,2,2,30,4,0,0,4,0,30,1,3,0,4,2,30,1,0,0,1,0,-27,3,0
2,3,24,1,30,3,3,0,6,2,30,4,0,0,4,3,30,4,2,0,6,0,30,3,3,0,6,5,30,4,0,0,4,1,-15,3,1
2,2,13,4,30,3,0,0,3,1,30,2,0,0,2,0,30,2,1,0,3,0,30,2,1,0,3,2,30,2,0,0,2,1,-15,3,1
2,2,13,5,30,7,0,0,7,1,30,4,0,0,4,1,30,7,0,0,7,0,30,4,3,0,7,4,30,4,0,0,4,1,-15,3,1
2,3,31,0,30,2,2,0,4,2,30,4,0,0,4,2,30,4,0,0,4,0,30,1,3,0,4,1,30,3,0,0,3,1,-15,3,1
2,4,23,0,30,2,3,0,5,2,30,4,0,0,4,4,30,4,1,0,5,0,30,0,5,0,5,0,30,1,1,0,2,1,-15,3,1
2,3,9,0,30,6,5,0,11,2,30,6,0,0,6,3,30,6,5,0,11,2,30,3,8,0,11,2,30,3,1,0,4,0,-27,3,0
2,4,13,3,30,6,1,0,7,0,30,4,0,0,4,2,30,6,1,0,7,0,30,5,2,0,7,0,30,4,0,0,4,1,-15,3,1
2,4,37,1,30,6,5,0,11,4,30,3,5,0,8,6,30,10,1,0,11,4,30,2,9,0,11,0,30,6,0,0,6,1,-15,3,1
2,1,28,0,30,0,8,0,8,5,30,4,0,0,4,0,30,1,7,0,8,0,30,8,0,0,8,2,30,4,0,0,4,1,-15,3,1
2,4,7,1,30,4,5,0,9,2,30,4,0,0,4,2,30,6,3,0,9,1,30,1,8,0,9,3,30,5,1,0,6,0,-27,3,0
2,4,23,0,30,2,3,0,5,2,30,4,0,0,4,7,30,5,0,0,5,0,30,1,4,0,5,1,30,1,1,0,2,1,-15,3,1
2,4,32,4,30,6,3,0,9,2,30,2,0,0,2,3,30,9,0,0,9,1,30,2,7,0,9,2,30,1,1,0,2,1,-15,3,1
2,2,13,1,30,6,1,0,7,1,30,4,0,0,4,2,30,6,1,0,7,2,30,6,1,0,7,5,30,4,0,0,4,1,-15,3,1
2,4,5,0,30,2,3,0,5,0,30,4,0,0,4,0,30,0,5,0,5,0,30,1,4,0,5,0,30,2,0,0,2,0,-27,3,0
2,1,23,0,30,1,4,0,5,0,30,4,0,0,4,9,30,5,0,0,5,0,30,0,5,0,5,2,30,2,0,0,2,1,-15,3,1
2,3,32,0,30,7,2,0,9,3,30,2,0,0,2,4,30,9,0,0,9,1,30,3,6,0,9,3,30,1,1,0,2,1,-15,3,1
2,0,31,0,30,0,4,0,4,3,30,4,0,0,4,0,30,1,3,0,4,0,30,3,1,0,4,1,30,3,0,0,3,1,-15,3,1
2,1,31,0,30,1,3,0,4,3,30,4,0,0,4,7,30,4,0,0,4,0,30,1,3,0,4,0,30,0,3,0,3,1,-15,3,1
2,2,31,0,30,1,3,0,4,3,30,4,0,0,4,0,30,1,3,0,4,0,30,1,3,0,4,0,30,2,1,0,3,1,-15,3,1
2,2,9,0,30,2,2,0,4,0,30,2,0,0,2,2,30,4,0,0,4,3,30,2,2,0,4,3,30,1,0,0,1,0,-27,3,0
2,4,24,0,30,3,3,0,6,2,30,3,1,0,4,8,30,6,0,0,6,0,30,1,5,0,6,5,30,4,0,0,4,1,-15,3,1
2,4,13,0,30,3,0,0,3,0,30,2,0,0,2,1,30,3,0,0,3,4,30,3,0,0,3,2,30,2,0,0,2,1,-15,3,1
2,4,5,2,30,7,5,0,12,3,30,4,6,0,10,0,30,5,7,0,12,0,30,7,5,0,12,1,30,2,4,0,6,0,-27,3,0
2,0,20,0,30,2,6,0,8,1,30,5,3,0,8,5,30,8,0,0,8,0,30,1,7,0,8,1,30,4,1,0,5,1,-15,3,1
2,4,9,1,30,3,8,0,11,2,30,6,0,0,6,9,30,9,2,0,11,2,30,3,8,0,11,4,30,3,1,0,4,0,-27,3,0
2,4,7,0,30,2,2,0,4,0,30,2,0,0,2,3,30,3,1,0,4,0,30,1,3,0,4,2,30,2,0,0,2,0,-27,3,0
2,4,30,2,30,3,2,0,5,4,30,2,0,0,2,4,30,1,4,0,5,1,30,1,4,0,5,0,30,3,0,0,3,1,-15,3,1
2,1,13,1,30,5,2,0,7,0,30,4,0,0,4,2,30,5,2,0,7,2,30,5,2,0,7,4,30,4,0,0,4,1,-15,3,1
2,4,25,3,30,2,2,0,4,2,30,2,0,0,2,4,30,4,0,0,4,0,30,1,3,0,4,0,30,1,0,0,1,1,-15,3,1
2,3,7,0,30,5,4,0,9,1,30,4,0,0,4,0,30,9,0,0,9,5,30,3,6,0,9,1,30,4,2,0,6,0,-27,3,0
2,1,25,1,30,1,3,0,4,2,30,2,0,0,2,7,30,4,0,0,4,0,30,0,4,0,4,1,30,1,0,0,1,1,-15,3,1
2,4,30,3,30,3,2,0,5,5,30,2,0,0,2,1,30,2,3,0,5,2,30,1,4,0,5,0,30,2,1,0,3,1,-15,3,1
2,4,25,0,30,3,1,0,4,1,30,2,0,0,2,1,30,4,0,0,4,0,30,0,4,0,4,0,30,1,0,0,1,1,-15,3,1
2,3,4,3,30,8,0,0,8,3,30,4,0,0,4,1,30,5,3,0,8,0,30,4,4,0,8,1,30,3,1,0,4,0,-27,3,0
2,3,25,1,30,3,1,0,4,2,30,2,0,0,2,6,30,4,0,0,4,0,30,1,3,0,4,0,30,1,0,0,1,1,-15,3,1
2,4,27,0,30,2,3,0,5,1,30,0,0,0,0,3,30,5,0,0,5,0,30,2,3,0,5,0,30,3,1,0,4,1,-15,3,1
2,2,20,0,30,1,7,0,8,1,30,8,0,0,8,0,30,4,4,0,8,0,30,4,4,0,8,1,30,5,0,0,5,1,-15,3,1
2,3,15,1,30,3,1,0,4,0,30,6,0,0,6,0,30,2,2,0,4,1,30,3,1,0,4,1,30,4,0,0,4,1,-15,3,1
2,0,23,0,30,2,3,0,5,1,30,4,0,0,4,4,30,4,1,0,5,0,30,0,5,0,5,5,30,2,0,0,2,1,-15,3,1
2,3,39,0,30,3,8,0,11,4,30,4,2,0,6,11,30,7,4,0,11,0,30,1,10,0,11,0,30,3,2,0,5,1,-15,3,1
2,4,5,1,30,6,6,0,12,2,30,9,1,0,10,0,30,5,7,0,12,0,30,7,5,0,12,3,30,4,2,0,6,0,-27,3,0
2,3,23,0,30,4,1,0,5,0,30,4,0,0,4,5,30,4,1,0,5,0,30,0,5,0,5,1,30,2,0,0,2,1,-15,3,1
2,2,25,1,30,1,3,0,4,1,30,2,0,0,2,1,30,4,0,0,4,2,30,0,4,0,4,2,30,1,0,0,1,1,-15,3,1
2,2,25,1,30,1,3,0,4,0,30,2,0,0,2,3,30,4,0,0,4,0,30,0,4,0,4,0,30,1,0,0,1,1,-15,3,1
2,3,9,1,30,1,3,0,4,2,30,2,0,0,2,4,30,2,2,0,4,0,30,1,3,0,4,0,30,0,1,0,1,0,-27,3,0
2,2,25,1,30,3,1,0,4,1,30,2,0,0,2,0,30,2,2,0,4,0,30,0,4,0,4,2,30,1,0,0,1,1,-15,3,1
2,3,17,1,30,3,1,0,4,1,30,2,0,0,2,2,30,1,3,0,4,2,30,1,3,0,4,3,30,1,0,0,1,1,-15,3,1
2,2,5,1,30,6,6,0,12,2,30,5,5,0,10,1,30,5,7,0,12,0,30,7,5,0,12,0,30,3,3,0,6,0,-27,3,0
2,2,9,0,30,1,3,0,4,1,30,2,0,0,2,3,30,2,2,0,4,0,30,1,3,0,4,1,30,1,0,0,1,0,-27,3,0
2,2,31,1,30,1,3,0,4,3,30,4,0,0,4,1,30,3,1,0,4,0,30,1,3,0,4,0,30,0,3,0,3,1,-15,3,1
2,2,24,0,30,4,2,0,6,2,30,4,0,0,4,4,30,5,1,0,6,0,30,1,5,0,6,2,30,4,0,0,4,1,-15,3,1
2,4,31,0,30,1,3,0,4,2,30,4,0,0,4,4,30,1,3,0,4,0,30,1,3,0,4,0,30,3,0,0,3,1,-15,3,1
2,3,7,0,30,2,2,0,4,0,30,2,0,0,2,1,30,3,1,0,4,0,30,1,3,0,4,1,30,1,1,0,2,0,-27,3,0
2,1,5,1,30,6,6,0,12,2,30,7,3,0,10,1,30,6,6,0,12,0,30,8,4,0,12,2,30,3,3,0,6,0,-27,3,0
2,1,5,1,30,9,3,0,12,2,30,5,5,0,10,0,30,4,8,0,12,0,30,6,6,0,12,2,30,6,0,0,6,0,-27,3,0
2,1,23,3,30,5,0,0,5,2,30,4,0,0,4,0,30,1,4,0,5,0,30,0,5,0,5,0,30,2,0,0,2,1,-15,3,1
2,2,17,2,30,2,2,0,4,1,30,2,0,0,2,2,30,0,4,0,4,2,30,0,4,0,4,2,30,1,0,0,1,1,-15,3,1
2,4,26,0,30,6,3,0,9,3,30,4,0,0,4,4,30,5,4,0,9,0,30,4,5,0,9,0,30,2,1,0,3,1,-15,3,1
2,2,13,3,30,6,1,0,7,1,30,4,0,0,4,2,30,5,2,0,7,1,30,6,1,0,7,6,30,4,0,0,4,1,-15,3,1
2,4,7,0,30,4,5,0,9,1,30,4,0,0,4,1,30,7,2,0,9,0,30,2,7,0,9,1,30,4,2,0,6,0,-27,3,0
2,3,28,0,30,3,5,0,8,3,30,4,0,0,4,1,30,7,1,0,8,0,30,2,6,0,8,1,30,3,1,0,4,1,-15,3,1
2,4,21,1,30,3,0,0,3,0,30,2,0,0,2,1,30,2,1,0,3,0,30,1,2,0,3,4,30,1,0,0,1,1,-15,3,1
2,3,31,0,30,3,1,0,4,3,30,4,0,0,4,0,30,1,3,0,4,0,30,1,3,0,4,0,30,1,2,0,3,1,-15,3,1
2,4,9,0,30,2,2,0,4,1,30,2,0,0,2,7,30,3,1,0,4,0,30,1,3,0,4,4,30,1,0,0,1,0,-27,3,0
2,4,30,6,30,3,2,0,5,4,30,2,0,0,2,1,30,2,3,0,5,3,30,1,4,0,5,0,30,2,1,0,3,1,-15,3,1
2,3,28,2,30,3,5,0,8,4,30,4,0,0,4,0,30,1,7,0,8,0,30,2,6,0,8,1,30,2,2,0,4,1,-15,3,1
2,3,17,1,30,1,3,0,4,0,30,2,0,0,2,4,30,1,3,0,4,0,30,0,4,0,4,5,30,1,0,0,1,1,-15,3,1
2,3,31,2,30,0,4,0,4,4,30,4,0,0,4,0,30,1,3,0,4,0,30,1,3,0,4,0,30,1,2,0,3,1,-15,3,1
2,4,24,1,30,6,0,0,6,2,30,4,0,0,4,0,30,5,1,0,6,0,30,2,4,0,6,1,30,4,0,0,4,1,-15,3,1
2,4,31,0,30,2,2,0,4,2,30,4,0,0,4,0,30,4,0,0,4,0,30,1,3,0,4,0,30,2,1,0,3,1,-15,3,1
2,3,15,0,30,2,2,0,4,0,30,6,0,0,6,0,30,3,1,0,4,5,30,4,0,0,4,0,30,3,1,0,4,1,-15,3,1
2,4,11,0,30,1,3,0,4,0,30,0,0,0,0,5,30,1,3,0,4,1,30,3,1,0,4,0,30,1,0,0,1,1,-15,3,1
2,4,32,0,30,2,7,0,9,4,30,2,0,0,2,4,30,9,0,0,9,1,30,2,7,0,9,3,30,2,0,0,2,1,-15,3,1
2,4,24,0,30,3,3,0,6,2,30,4,0,0,4,2,30,6,0,0,6,0,30,1,5,0,6,2,30,4,0,0,4,1,-15,3,1
2,4,3,7,30,4,7,0,11,2,30,7,1,0,8,0,30,7,4,0,11,0,30,5,6,0,11,2,30,4,3,0,7,0,-27,3,0
2,4,31,0,30,0,4,0,4,3,30,4,0,0,4,2,30,2,2,0,4,0,30,1,3,0,4,1,30,3,0,0,3,1,-15,3,1
2,3,28,1,30,6,2,0,8,3,30,4,0,0,4,0,30,5,3,0,8,0,30,1,7,0,8,1,30,2,2,0,4,1,-15,3,1
2,2,31,0,30,1,3,0,4,3,30,4,0,0,4,2,30,3,1,0,4,0,30,1,3,0,4,0,30,1,2,0,3,1,-15,3,1
2,3,7,0,30,0,4,0,4,0,30,2,0,0,2,0,30,4,0,0,4,0,30,1,3,0,4,2,30,2,0,0,2,0,-27,3,0
2,3,23,0,30,4,1,0,5,2,30,4,0,0,4,2,30,4,1,0,5,0,30,0,5,0,5,2,30,2,0,0,2,1,-15,3,1
2,4,24,0,30,5,1,0,6,2,30,4,0,0,4,3,30,5,1,0,6,0,30,1,5,0,6,1,30,4,0,0,4,1,-15,3,1
2,3,15,0,30,3,1,0,4,0,30,5,1,0,6,0,30,2,2,0,4,3,30,4,0,0,4,3,30,4,0,0,4,1,-15,3,1
2,3,5,1,30,5,7,0,12,2,30,8,2,0,10,0,30,6,6,0,12,0,30,8,4,0,12,1,30,2,4,0,6,0,-27,3,0
2,4,29,0,30,1,4,0,5,4,30,8,0,0,8,1,30,2,3,0,5,0,30,0,5,0,5,0,30,4,0,0,4,1,-15,3,1
2,1,5,1,30,5,7,0,12,2,30,9,1,0,10,0,30,4,8,0,12,0,30,8,4,0,12,1,30,4,2,0,6,0,-27,3,0
2,3,9,0,30,4,7,0,11,1,30,6,0,0,6,1,30,11,0,0,11,5,30,3,8,0,11,3,30,4,0,0,4,0,-27,3,0
2,4,24,0,30,5,1,0,6,2,30,4,0,0,4,2,30,6,0,0,6,0,30,1,5,0,6,4,30,4,0,0,4,1,-15,3,1
2,4,9,0,30,1,3,0,4,1,30,2,0,0,2,1,30,4,0,0,4,0,30,1,3,0,4,1,30,1,0,0,1,0,-27,3,0
2,1,24,0,30,3,3,0,6,3,30,4,0,0,4,12,30,6,0,0,6,0,30,1,5,0,6,0,30,4,0,0,4,1,-15,3,1
2,4,27,0,30,1,4,0,5,2,30,0,0,0,0,3,30,5,0,0,5,0,30,2,3,0,5,0,30,4,0,0,4,1,-15,3,1
2,1,5,2,30,6,6,0,12,2,30,3,7,0,10,0,30,7,5,0,12,4,30,6,6,0,12,1,30,5,1,0,6,0,-27,3,0
2,2,3,0,30,4,7,0,11,2,30,8,0,0,8,0,30,1,10,0,11,5,30,3,8,0,11,3,30,7,0,0,7,0,-27,3,0
2,4,13,0,30,7,0,0,7,0,30,4,0,0,4,5,30,7,0,0,7,0,30,3,4,0,7,1,30,3,1,0,4,1,-15,3,1
2,0,5,1,30,5,7,0,12,3,30,8,2,0,10,0,30,3,9,0,12,1,30,8,4,0,12,3,30,6,0,0,6,0,-27,3,0
2,4,4,0,30,7,1,0,8,3,30,4,0,0,4,0,30,3,5,0,8,0,30,2,6,0,8,2,30,4,0,0,4,0,-27,3,0
2,4,7,0,30,3,6,0,9,2,30,4,0,0,4,2,30,6,3,0,9,2,30,4,5,0,9,1,30,4,2,0,6,0,-27,3,0
2,3,31,0,30,0,4,0,4,2,30,4,0,0,4,7,30,2,2,0,4,0,30,1,3,0,4,0,30,1,2,0,3,1,-15,3,1
2,2,17,2,30,1,3,0,4,0,30,2,0,0,2,1,30,0,4,0,4,2,30,2,2,0,4,2,30,1,0,0,1,1,-15,3,1
2,3,24,0,30,3,3,0,6,2,30,3,1,0,4,3,30,2,4,0,6,0,30,1,5,0,6,3,30,4,0,0,4,1,-15,3,1
2,4,17,1,30,2,2,0,4,1,30,2,0,0,2,1,30,1,3,0,4,2,30,1,3,0,4,3,30,1,0,0,1,1,-15,3,1
2,2,25,2,30,2,2,0,4,1,30,2,0,0,2,2,30,4,0,0,4,0,30,0,4,0,4,4,30,1,0,0,1,1,-15,3,1
2,2,16,0,30,4,5,0,9,1,30,8,0,0,8,0,30,1,8,0,9,0,30,1,8,0,9,0,30,4,0,0,4,1,-15,3,1
2,2,9,0,30,5,6,0,11,1,30,6,0,0,6,4,30,11,0,0,11,3,30,3,8,0,11,3,30,3,1,0,4,0,-27,3,0
2,4,16,0,30,3,6,0,9,2,30,8,0,0,8,1,30,1,8,0,9,0,30,1,8,0,9,0,30,4,0,0,4,1,-15,3,1
2,3,37,1,30,4,7,0,11,4,30,6,2,0,8,1,30,10,1,0,11,0,30,3,8,0,11,0,30,6,0,0,6,1,-15,3,1
2,4,16,0,30,3,6,0,9,1,30,8,0,0,8,0,30,4,5,0,9,0,30,1,8,0,9,1,30,4,0,0,4,1,-15,3,1
2,0,9,2,30,7,4,0,11,3,30,6,0,0,6,5,30,8,3,0,11,2,30,5,6,0,11,2,30,2,2,0,4,0,-27,3,0
2,0,9,4,30,3,1,0,4,3,30,2,0,0,2,7,30,1,3,0,4,0,30,1,3,0,4,0,30,1,0,0,1,0,-27,3,0
2,4,23,0,30,2,3,0,5,1,30,4,0,0,4,3,30,3,2,0,5,0,30,0,5,0,5,4,30,2,0,0,2,1,-15,3,1
2,4,22,1,30,5,3,0,8,2,30,2,0,0,2,1,30,5,3,0,8,1,30,4,4,0,8,1,30,1,3,0,4,1,-15,3,1
2,0,5,1,30,5,7,0,12,3,30,3,7,0,10,2,30,4,8,0,12,1,30,8,4,0,12,1,30,4,2,0,6,0,-27,3,0
2,4,9,0,30,3,1,0,4,2,30,2,0,0,2,2,30,2,2,0,4,0,30,1,3,0,4,3,30,1,0,0,1,0,-27,3,0
2,3,5,1,30,5,7,0,12,2,30,8,2,0,10,0,30,3,9,0,12,0,30,7,5,0,12,3,30,4,2,0,6,0,-27,3,0
2,3,15,2,30,2,2,0,4,0,30,6,0,0,6,0,30,2,2,0,4,1,30,1,3,0,4,1,30,4,0,0,4,1,-15,3,1
2,4,25,1,30,0,4,0,4,2,30,2,0,0,2,4,30,4,0,0,4,0,30,0,4,0,4,1,30,1,0,0,1,1,-15,3,1
2,3,9,0,30,8,3,0,11,2,30,6,0,0,6,4,30,8,3,0,11,1,30,3,8,0,11,1,30,3,1,0,4,0,-27,3,0
2,2,5,1,30,5,7,0,12,2,30,9,1,0,10,0,30,3,9,0,12,0,30,7,5,0,12,0,30,2,4,0,6,0,-27,3,0
2,3,23,0,30,5,0,0,5,2,30,4,0,0,4,5,30,4,1,0,5,0,30,0,5,0,5,1,30,2,0,0,2,1,-15,3,1
2,3,7,0,30,1,3,0,4,2,30,2,0,0,2,5,30,3,1,0,4,0,30,1,3,0,4,0,30,2,0,0,2,0,-27,3,0
2,2,25,5,30,0,4,0,4,3,30,2,0,0,2,1,30,4,0,0,4,6,30,0,4,0,4,0,30,1,0,0,1,1,-15,3,1
2,4,31,0,30,0,4,0,4,4,30,4,0,0,4,0,30,1,3,0,4,6,30,3,1,0,4,0,30,3,0,0,3,1,-15,3,1
2,3,8,0,30,7,0,0,7,3,30,2,0,0,2,3,30,4,3,0,7,0,30,4,3,0,7,3,30,3,0,0,3,0,-27,3,0
2,1,5,0,30,6,6,0,12,2,30,6,4,0,10,0,30,4,8,0,12,1,30,6,6,0,12,3,30,4,2,0,6,0,-27,3,0
2,4,25,2,30,1,3,0,4,2,30,2,0,0,2,0,30,3,1,0,4,0,30,0,4,0,4,1,30,1,0,0,1,1,-15,3,1
2,3,5,1,30,4,8,0,12,3,30,8,2,0,10,1,30,3,9,0,12,0,30,8,4,0,12,1,30,6,0,0,6,0,-27,3,0
2,4,25,2,30,3,1,0,4,2,30,2,0,0,2,1,30,4,0,0,4,0,30,3,1,0,4,0,30,1,0,0,1,1,-15,3,1
2,3,30,2,30,3,2,0,5,5,30,2,0,0,2,1,30,2,3,0,5,3,30,2,3,0,5,0,30,3,0,0,3,1,-15,3,1
2,3,4,0,30,7,1,0,8,3,30,4,0,0,4,0,30,3,5,0,8,0,30,2,6,0,8,2,30,4,0,0,4,0,-27,3,0
2,2,31,0,30,0,4,0,4,3,30,4,0,0,4,5,30,4,0,0,4,0,30,1,3,0,4,0,30,2,1,0,3,1,-15,3,1
2,3,23,0,30,3,2,0,5,0,30,4,0,0,4,0,30,3,2,0,5,0,30,0,5,0,5,0,30,1,1,0,2,1,-15,3,1
2,4,17,1,30,1,3,0,4,1,30,2,0,0,2,3,30,0,4,0,4,2,30,1,3,0,4,3,30,1,0,0,1,1,-15,3,1
2,4,23,0,30,3,2,0,5,2,30,4,0,0,4,4,30,3,2,0,5,0,30,0,5,0,5,0,30,1,1,0,2,1,-15,3,1
2,3,31,0,30,0,4,0,4,3,30,4,0,0,4,0,30,2,2,0,4,0,30,1,3,0,4,0,30,3,0,0,3,1,-15,3,1
2,3,24,0,30,3,3,0,6,2,30,4,0,0,4,4,30,4,2,0,6,0,30,1,5,0,6,1,30,4,0,0,4,1,-15,3,1
2,2,5,0,30,5,7,0,12,2,30,9,1,0,10,1,30,7,5,0,12,0,30,8,4,0,12,0,30,5,1,0,6,0,-27,3,0
2,4,9,0,30,6,5,0,11,2,30,6,0,0,6,8,30,7,4,0,11,2,30,3,8,0,11,2,30,2,2,0,4,0,-27,3,0
2,4,20,0,30,1,7,0,8,1,30,8,0,0,8,0,30,6,2,0,8,0,30,1,7,0,8,1,30,5,0,0,5,1,-15,3,1
2,2,17,1,30,1,3,0,4,0,30,2,0,0,2,2,30,2,2,0,4,2,30,3,1,0,4,4,30,1,0,0,1,1,-15,3,1
2,4,23,0,30,2,3,0,5,1,30,4,0,0,4,2,30,5,0,0,5,0,30,0,5,0,5,1,30,1,1,0,2,1,-15,3,1
2,1,28,0,30,3,5,0,8,3,30,4,0,0,4,6,30,8,0,0,8,0,30,2,6,0,8,2,30,3,1,0,4,1,-15,3,1
2,4,16,0,30,5,4,0,9,1,30,8,0,0,8,0,30,4,5,0,9,0,30,1,8,0,9,0,30,3,1,0,4,1,-15,3,1
2,1,3,1,30,4,7,0,11,1,30,7,1,0,8,0,30,9,2,0,11,1,30,5,6,0,11,1,30,7,0,0,7,0,-27,3,0
2,4,24,0,30,3,3,0,6,3,30,4,0,0,4,9,30,6,0,0,6,0,30,1,5,0,6,0,30,4,0,0,4,1,-15,3,1
2,4,31,0,30,3,1,0,4,3,30,4,0,0,4,4,30,1,3,0,4,0,30,1,3,0,4,0,30,1,2,0,3,1,-15,3,1
2,3,5,1,30,5,7,0,12,2,30,10,0,0,10,0,30,3,9,0,12,0,30,7,5,0,12,1,30,2,4,0,6,0,-27,3,0
2,4,9,1,30,6,5,0,11,1,30,6,0,0,6,2,30,11,0,0,11,1,30,3,8,0,11,4,30,3,1,0,4,0,-27,3,0
2,0,31,3,30,3,1,0,4,4,30,4,0,0,4,0,30,1,3,0,4,1,30,3,1,0,4,0,30,0,3,0,3,1,-15,3,1
2,2,23,0,30,2,3,0,5,2,30,4,0,0,4,0,30,1,4,0,5,0,30,0,5,0,5,0,30,2,0,0,2,1,-15,3,1
2,3,31,0,30,1,3,0,4,2,30,4,0,0,4,6,30,3,1,0,4,0,30,1,3,0,4,0,30,3,0,0,3,1,-15,3,1
2,4,24,0,30,5,1,0,6,2,30,4,0,0,4,0,30,4,2,0,6,0,30,2,4,0,6,1,30,4,0,0,4,1,-15,3,1
2,4,3,4,30,4,7,0,11,1,30,8,0,0,8,0,30,8,3,0,11,3,30,2,9,0,11,1,30,4,3,0,7,0,-27,3,0
2,4,31,0,30,0,4,0,4,2,30,4,0,0,4,6,30,4,0,0,4,0,30,1,3,0,4,0,30,2,1,0,3,1,-15,3,1
2,4,23,0,30,2,3,0,5,1,30,4,0,0,4,0,30,3,2,0,5,0,30,0,5,0,5,1,30,1,1,0,2,1,-15,3,1
2,3,5,0,30,1,4,0,5,0,30,0,4,0,4,0,30,0,5,0,5,0,30,1,4,0,5,0,30,2,0,0,2,0,-27,3,0
2,4,15,1,30,1,3,0,4,0,30,6,0,0,6,2,30,2,2,0,4,1,30,1,3,0,4,0,30,1,3,0,4,1,-15,3,1
2,4,15,0,30,2,2,0,4,0,30,6,0,0,6,1,30,4,0,0,4,2,30,4,0,0,4,0,30,4,0,0,4,1,-15,3,1
2,2,25,1,30,1,3,0,4,2,30,2,0,0,2,6,30,2,2,0,4,0,30,0,4,0,4,0,30,1,0,0,1,1,-15,3,1
2,2,31,0,30,0,4,0,4,2,30,4,0,0,4,4,30,3,1,0,4,0,30,1,3,0,4,1,30,3,0,0,3,1,-15,3,1
2,4,24,0,30,2,4,0,6,2,30,4,0,0,4,0,30,4,2,0,6,0,30,1,5,0,6,3,30,4,0,0,4,1,-15,3,1
2,4,3,0,30,3,8,0,11,2,30,8,0,0,8,0,30,5,6,0,11,4,30,5,6,0,11,1,30,4,3,0,7,0,-27,3,0
2,1,23,0,30,2,3,0,5,1,30,4,0,0,4,1,30,5,0,0,5,0,30,0,5,0,5,5,30,2,0,0,2,1,-15,3,1
2,1,5,1,30,6,6,0,12,2,30,8,2,0,10,0,30,5,7,0,12,0,30,8,4,0,12,1,30,4,2,0,6,0,-27,3,0
2,3,25,1,30,0,4,0,4,0,30,2,0,0,2,2,30,4,0,0,4,0,30,0,4,0,4,0,30,1,0,0,1,1,-15,3,1
2,4,5,0,30,0,5,0,5,0,30,3,1,0,4,0,30,0,5,0,5,0,30,1,4,0,5,0,30,1,1,0,2,0,-27,3,0
2,2,5,0,30,2,3,0,5,1,30,4,0,0,4,0,30,0,5,0,5,0,30,1,4,0,5,0,30,0,2,0,2,0,-27,3,0
2,4,16,0,30,6,3,0,9,2,30,8,0,0,8,4,30,3,6,0,9,0,30,1,8,0,9,0,30,3,1,0,4,1,-15,3,1
2,4,7,0,30,1,3,0,4,0,30,2,0,0,2,0,30,2,2,0,4,0,30,0,4,0,4,2,30,1,1,0,2,0,-27,3,0
2,4,31,0,30,1,3,0,4,4,30,4,0,0,4,0,30,1,3,0,4,0,30,3,1,0,4,0,30,3,0,0,3,1,-15,3,1
2,3,9,2,30,3,1,0,4,2,30,2,0,0,2,0,30,3,1,0,4,0,30,1,3,0,4,1,30,1,0,0,1,0,-27,3,0
2,3,7,0,30,2,2,0,4,2,30,2,0,0,2,3,30,1,3,0,4,0,30,1,3,0,4,2,30,1,1,0,2,0,-27,3,0
2,1,17,1,30,1,3,0,4,1,30,2,0,0,2,2,30,1,3,0,4,7,30,1,3,0,4,2,30,1,0,0,1,1,-15,3,1
2,4,5,0,30,4,8,0,12,2,30,8,2,0,10,0,30,6,6,0,12,0,30,8,4,0,12,0,30,3,3,0,6,0,-27,3,0
2,4,27,0,30,1,4,0,5,0,30,0,0,0,0,0,30,2,3,0,5,0,30,2,3,0,5,1,30,4,0,0,4,1,-15,3,1
2,4,31,0,30,0,4,0,4,2,30,4,0,0,4,7,30,4,0,0,4,0,30,1,3,0,4,0,30,0,3,0,3,1,-15,3,1
2,1,31,3,30,4,0,0,4,4,30,4,0,0,4,2,30,3,1,0,4,0,30,1,3,0,4,0,30,0,3,0,3,1,-15,3,1
2,2,5,1,30,6,6,0,12,2,30,8,2,0,10,0,30,5,7,0,12,0,30,7,5,0,12,1,30,3,3,0,6,0,-27,3,0
2,3,24,0,30,1,5,0,6,2,30,4,0,0,4,0,30,4,2,0,6,0,30,2,4,0,6,3,30,4,0,0,4,1,-15,3,1
2,2,31,0,30,0,4,0,4,2,30,4,0,0,4,0,30,4,0,0,4,3,30,3,1,0,4,0,30,1,2,0,3,1,-15,3,1
2,3,25,2,30,0,4,0,4,0,30,2,0,0,2,1,30,4,0,0,4,1,30,1,3,0,4,3,30,1,0,0,1,1,-15,3,1
2,4,24,0,30,4,2,0,6,2,30,4,0,0,4,0,30,6,0,0,6,3,30,3,3,0,6,0,30,4,0,0,4,1,-15,3,1
2,3,5,0,30,2,3,0,5,0,30,1,3,0,4,1,30,2,3,0,5,0,30,5,0,0,5,0,30,0,2,0,2,0,-27,3,0
2,4,16,0,30,6,3,0,9,1,30,7,1,0,8,2,30,4,5,0,9,0,30,1,8,0,9,0,30,3,1,0,4,1,-15,3,1
2,4,24,0,30,3,3,0,6,2,30,3,1,0,4,0,30,6,0,0,6,0,30,1,5,0,6,1,30,4,0,0,4,1,-15,3,1
2,2,9,0,30,4,0,0,4,2,30,2,0,0,2,4,30,4,0,0,4,0,30,1,3,0,4,0,30,1,0,0,1,0,-27,3,0
2,3,9,1,30,4,7,0,11,2,30,6,0,0,6,2,30,8,3,0,11,5,30,3,8,0,11,5,30,4,0,0,4,0,-27,3,0
2,3,28,0,30,1,7,0,8,3,30,4,0,0,4,0,30,4,4,0,8,0,30,6,2,0,8,1,30,1,3,0,4,1,-15,3,1
2,4,5,1,30,6,6,0,12,3,30,5,5,0,10,0,30,4,8,0,12,0,30,8,4,0,12,1,30,4,2,0,6,0,-27,3,0
2,2,28,0,30,1,7,0,8,3,30,4,0,0,4,0,30,5,3,0,8,0,30,4,4,0,8,2,30,4,0,0,4,1,-15,3,1
2,3,20,0,30,2,6,0,8,0,30,8,0,0,8,3,30,8,0,0,8,0,30,1,7,0,8,1,30,2,3,0,5,1,-15,3,1
2,2,23,0,30,2,3,0,5,1,30,4,0,0,4,0,30,2,3,0,5,0,30,0,5,0,5,0,30,2,0,0,2,1,-15,3,1
2,2,13,3,30,7,0,0,7,1,30,4,0,0,4,2,30,6,1,0,7,0,30,6,1,0,7,3,30,4,0,0,4,1,-15,3,1
2,4,43,0,30,2,3,0,5,4,30,4,0,0,4,3,30,4,1,0,5,0,30,0,5,0,5,0,30,2,0,0,2,1,-15,3,1
2,3,13,2,30,3,0,0,3,1,30,2,0,0,2,0,30,3,0,0,3,4,30,2,1,0,3,0,30,2,0,0,2,1,-15,3,1
2,3,3,0,30,6,5,0,11,1,30,8,0,0,8,1,30,8,3,0,11,0,30,3,8,0,11,1,30,3,4,0,7,0,-27,3,0
2,2,3,0,30,5,6,0,11,0,30,8,0,0,8,0,30,9,2,0,11,4,30,1,10,0,11,1,30,2,5,0,7,0,-27,3,0
2,4,7,0,30,4,0,0,4,2,30,2,0,0,2,0,30,4,0,0,4,0,30,1,3,0,4,1,30,2,0,0,2,0,-27,3,0
2,2,5,1,30,7,5,0,12,2,30,6,4,0,10,0,30,6,6,0,12,0,30,8,4,0,12,2,30,4,2,0,6,0,-27,3,0
2,3,5,1,30,5,7,0,12,2,30,9,1,0,10,1,30,7,5,0,12,0,30,8,4,0,12,1,30,6,0,0,6,0,-27,3,0
2,3,28,0,30,1,7,0,8,4,30,4,0,0,4,2,30,6,2,0,8,0,30,4,4,0,8,5,30,4,0,0,4,1,-15,3,1
2,3,3,2,30,4,7,0,11,2,30,8,0,0,8,1,30,4,7,0,11,1,30,5,6,0,11,1,30,2,5,0,7,0,-27,3,0
2,4,27,0,30,1,4,0,5,1,30,0,0,0,0,0,30,5,0,0,5,3,30,3,2,0,5,1,30,4,0,0,4,1,-15,3,1
2,2,23,0,30,3,2,0,5,2,30,4,0,0,4,6,30,4,1,0,5,0,30,0,5,0,5,1,30,2,0,0,2,1,-15,3,1
2,4,8,2,30,7,0,0,7,4,30,2,0,0,2,9,30,4,3,0,7,0,30,2,5,0,7,4,30,3,0,0,3,0,-27,3,0
2,2,24,0,30,6,0,0,6,2,30,3,1,0,4,6,30,6,0,0,6,0,30,1,5,0,6,1,30,4,0,0,4,1,-15,3,1
2,2,25,3,30,0,4,0,4,0,30,2,0,0,2,0,30,2,2,0,4,0,30,0,4,0,4,0,30,1,0,0,1,1,-15,3,1
2,4,3,1,30,4,7,0,11,3,30,8,0,0,8,0,30,3,8,0,11,0,30,8,3,0,11,1,30,2,5,0,7,0,-27,3,0
2,2,9,1,30,7,4,0,11,3,30,6,0,0,6,5,30,8,3,0,11,1,30,7,4,0,11,0,30,2,2,0,4,0,-27,3,0
2,3,31,0,30,1,3,0,4,2,30,4,0,0,4,1,30,4,0,0,4,0,30,3,1,0,4,2,30,3,0,0,3,1,-15,3,1
2,4,7,1,30,6,3,0,9,2,30,4,0,0,4,0,30,5,4,0,9,0,30,2,7,0,9,1,30,5,1,0,6,0,-27,3,0
2,4,20,0,30,1,7,0,8,0,30,6,2,0,8,3,30,8,0,0,8,0,30,1,7,0,8,1,30,4,1,0,5,1,-15,3,1
2,3,7,0,30,3,6,0,9,2,30,4,0,0,4,0,30,6,3,0,9,2,30,3,6,0,9,1,30,5,1,0,6,0,-27,3,0
2,4,7,0,30,4,5,0,9,2,30,4,0,0,4,5,30,6,3,0,9,4,30,2,7,0,9,1,30,5,1,0,6,0,-27,3,0
2,2,5,1,30,5,7,0,12,2,30,6,4,0,10,0,30,4,8,0,12,0,30,5,7,0,12,1,30,4,2,0,6,0,-27,3,0
2,2,9,0,30,3,1,0,4,2,30,2,0,0,2,3,30,2,2,0,4,0,30,1,3,0,4,0,30,1,0,0,1,0,-27,3,0
2,4,15,2,30,3,1,0,4,0,30,6,0,0,6,0,30,2,2,0,4,1,30,1,3,0,4,1,30,4,0,0,4,1,-15,3,1
2,3,9,0,30,2,2,0,4,1,30,2,0,0,2,4,30,3,1,0,4,0,30,1,3,0,4,1,30,1,0,0,1,0,-27,3,0
2,3,9,1,30,6,5,0,11,1,30,6,0,0,6,5,30,10,1,0,11,3,30,3,8,0,11,3,30,3,1,0,4,0,-27,3,0
2,2,16,0,30,6,3,0,9,2,30,8,0,0,8,1,30,1,8,0,9,0,30,1,8,0,9,0,30,4,0,0,4,1,-15,3,1
2,3,24,0,30,5,1,0,6,2,30,4,0,0,4,4,30,5,1,0,6,0,30,1,5,0,6,2,30,3,1,0,4,1,-15,3,1
2,3,28,0,30,2,6,0,8,4,30,4,0,0,4,6,30,5,3,0,8,0,30,2,6,0,8,1,30,3,1,0,4,1,-15,3,1
2,3,27,0,30,2,3,0,5,0,30,0,0,0,0,4,30,5,0,0,5,0,30,2,3,0,5,0,30,2,2,0,4,1,-15,3,1
2,3,24,0,30,4,2,0,6,3,30,4,0,0,4,7,30,6,0,0,6,0,30,1,5,0,6,4,30,3,1,0,4,1,-15,3,1
2,3,15,0,30,2,2,0,4,0,30,6,0,0,6,1,30,2,2,0,4,2,30,4,0,0,4,1,30,4,0,0,4,1,-15,3,1
2,4,24,0,30,6,0,0,6,2,30,3,1,0,4,2,30,6,0,0,6,0,30,1,5,0,6,2,30,4,0,0,4,1,-15,3,1
2,3,28,0,30,2,6,0,8,5,30,4,0,0,4,2,30,2,6,0,8,0,30,6,2,0,8,3,30,4,0,0,4,1,-15,3,1
2,3,5,1,30,5,7,0,12,2,30,5,5,0,10,1,30,8,4,0,12,0,30,7,5,0,12,2,30,3,3,0,6,0,-27,3,0
2,2,23,0,30,1,4,0,5,1,30,4,0,0,4,2,30,5,0,0,5,0,30,0,5,0,5,4,30,2,0,0,2,1,-15,3,1
2,2,5,1,30,4,8,0,12,2,30,6,4,0,10,2,30,7,5,0,12,0,30,7,5,0,12,2,30,5,1,0,6,0,-27,3,0
2,4,25,0,30,0,4,0,4,2,30,2,0,0,2,6,30,2,2,0,4,0,30,0,4,0,4,1,30,1,0,0,1,1,-15,3,1
2,4,24,0,30,1,5,0,6,2,30,4,0,0,4,4,30,3,3,0,6,0,30,2,4,0,6,6,30,4,0,0,4,1,-15,3,1
2,4,7,3,30,4,5,0,9,3,30,3,1,0,4,3,30,6,3,0,9,0,30,2,7,0,9,1,30,5,1,0,6,0,-27,3,0
2,4,4,2,30,7,1,0,8,3,30,4,0,0,4,3,30,6,2,0,8,0,30,5,3,0,8,1,30,3,1,0,4,0,-27,3,0
2,3,27,0,30,1,4,0,5,0,30,0,0,0,0,0,30,3,2,0,5,0,30,2,3,0,5,4,30,4,0,0,4,1,-15,3,1
2,2,28,0,30,2,6,0,8,5,30,4,0,0,4,0,30,1,7,0,8,0,30,6,2,0,8,0,30,4,0,0,4,1,-15,3,1
2,4,7,0,30,0,4,0,4,1,30,2,0,0,2,2,30,2,2,0,4,0,30,1,3,0,4,3,30,2,0,0,2,0,-27,3,0
2,2,5,1,30,3,9,0,12,2,30,7,3,0,10,0,30,3,9,0,12,0,30,6,6,0,12,2,30,6,0,0,6,0,-27,3,0
2,3,7,0,30,1,3,0,4,0,30,2,0,0,2,0,30,1,3,0,4,0,30,1,3,0,4,1,30,1,1,0,2,0,-27,3,0
2,2,15,0,30,2,2,0,4,0,30,5,1,0,6,0,30,2,2,0,4,3,30,4,0,0,4,0,30,4,0,0,4,1,-15,3,1
2,3,5,1,30,5,7,0,12,3,30,5,5,0,10,0,30,3,9,0,12,1,30,6,6,0,12,1,30,6,0,0,6,0,-27,3,0
2,2,31,0,30,0,4,0,4,4,30,4,0,0,4,0,30,1,3,0,4,2,30,4,0,0,4,0,30,2,1,0,3,1,-15,3,1
2,0,20,0,30,2,6,0,8,1,30,7,1,0,8,0,30,5,3,0,8,0,30,6,2,0,8,1,30,3,2,0,5,1,-15,3,1
2,2,33,1,30,2,9,0,11,4,30,4,0,0,4,6,30,10,1,0,11,1,30,4,7,0,11,7,30,4,0,0,4,1,-15,3,1
2,2,3,1,30,4,7,0,11,4,30,8,0,0,8,4,30,1,10,0,11,1,30,6,5,0,11,1,30,5,2,0,7,0,-27,3,0
2,1,24,0,30,2,4,0,6,2,30,4,0,0,4,7,30,5,1,0,6,0,30,1,5,0,6,6,30,4,0,0,4,1,-15,3,1
2,2,9,1,30,6,5,0,11,2,30,5,1,0,6,1,30,10,1,0,11,0,30,7,4,0,11,2,30,2,2,0,4,0,-27,3,0
2,1,5,1,30,7,5,0,12,1,30,9,1,0,10,1,30,9,3,0,12,0,30,9,3,0,12,2,30,1,5,0,6,0,-27,3,0
2,3,20,0,30,1,7,0,8,1,30,6,2,0,8,0,30,7,1,0,8,0,30,4,4,0,8,1,30,3,2,0,5,1,-15,3,1
2,4,31,0,30,0,4,0,4,4,30,4,0,0,4,4,30,1,3,0,4,0,30,4,0,0,4,0,30,3,0,0,3,1,-15,3,1
2,3,31,1,30,6,6,0,12,3,30,8,0,0,8,7,30,11,1,0,12,0,30,5,7,0,12,0,30,2,4,0,6,1,-15,3,1
2,4,7,0,30,2,2,0,4,1,30,2,0,0,2,4,30,3,1,0,4,0,30,1,3,0,4,2,30,2,0,0,2,0,-27,3,0
2,2,25,1,30,3,1,0,4,2,30,2,0,0,2,1,30,4,0,0,4,0,30,0,4,0,4,0,30,1,0,0,1,1,-15,3,1
2,2,9,1,30,2,2,0,4,2,30,2,0,0,2,0,30,3,1,0,4,0,30,1,3,0,4,2,30,1,0,0,1,0,-27,3,0
2,1,9,0,30,3,8,0,11,2,30,6,0,0,6,1,30,6,5,0,11,5,30,3,8,0,11,5,30,4,0,0,4,0,-27,3,0
2,3,9,1,30,7,4,0,11,1,30,6,0,0,6,5,30,11,0,0,11,0,30,3,8,0,11,2,30,2,2,0,4,0,-27,3,0
2,3,25,2,30,2,2,0,4,1,30,2,0,0,2,2,30,4,0,0,4,0,30,0,4,0,4,0,30,1,0,0,1,1,-15,3,1
2,4,11,0,30,1,3,0,4,0,30,0,0,0,0,5,30,1,3,0,4,0,30,1,3,0,4,0,30,1,0,0,1,1,-15,3,1
2,3,31,0,30,0,4,0,4,2,30,4,0,0,4,6,30,4,0,0,4,0,30,1,3,0,4,2,30,3,0,0,3,1,-15,3,1
2,4,4,2,30,4,4,0,8,3,30,4,0,0,4,5,30,4,4,0,8,0,30,0,8,0,8,0,30,3,1,0,4,0,-27,3,0
2,0,3,1,30,4,7,0,11,3,30,7,1,0,8,4,30,3,8,0,11,1,30,9,2,0,11,1,30,2,5,0,7,0,-27,3,0
2,4,25,0,30,0,4,0,4,0,30,2,0,0,2,3,30,4,0,0,4,0,30,0,4,0,4,2,30,1,0,0,1,1,-15,3,1
2,2,4,2,30,6,2,0,8,4,30,4,0,0,4,4,30,3,5,0,8,0,30,4,4,0,8,2,30,4,0,0,4,0,-27,3,0
2,4,31,0,30,0,4,0,4,3,30,4,0,0,4,0,30,1,3,0,4,0,30,1,3,0,4,0,30,1,2,0,3,1,-15,3,1
2,4,7,0,30,3,6,0,9,2,30,4,0,0,4,0,30,7,2,0,9,4,30,5,4,0,9,4,30,6,0,0,6,0,-27,3,0
2,4,24,3,30,5,1,0,6,3,30,3,1,0,4,0,30,3,3,0,6,0,30,1,5,0,6,3,30,4,0,0,4,1,-15,3,1
2,2,3,6,30,5,6,0,11,1,30,8,0,0,8,0,30,8,3,0,11,4,30,1,10,0,11,1,30,2,5,0,7,0,-27,3,0
2,3,24,0,30,3,3,0,6,2,30,4,0,0,4,6,30,6,0,0,6,0,30,1,5,0,6,4,30,4,0,0,4,1,-15,3,1
2,4,9,0,30,1,3,0,4,0,30,2,0,0,2,5,30,4,0,0,4,0,30,1,3,0,4,0,30,1,0,0,1,0,-27,3,0
2,3,33,1,30,2,9,0,11,4,30,4,0,0,4,6,30,10,1,0,11,1,30,4,7,0,11,7,30,4,0,0,4,1,-15,3,1
2,4,9,0,30,3,8,0,11,2,30,6,0,0,6,5,30,8,3,0,11,1,30,4,7,0,11,4,30,4,0,0,4,0,-27,3,0
2,3,9,0,30,6,5,0,11,2,30,6,0,0,6,5,30,8,3,0,11,1,30,3,8,0,11,2,30,4,0,0,4,0,-27,3,0
2,2,4,0,30,6,2,0,8,3,30,2,2,0,4,0,30,5,3,0,8,1,30,6,2,0,8,2,30,4,0,0,4,0,-27,3,0
